date,operator,flight_phase,flight_type,country,region,total_on_board,crew_on_board,crew_fatalities,passengers_on_board,passenger_fatalities,total_fatalities,total_survivors,crash_cause
1985-08-12 00:00:00,Japan Airlines,Flight,Commercial,Japan,Asia,524,15,14,509,506,520,4,Human Factor
1974-03-03 00:00:00,Turkish Airlines - THY Türk Hava Yollari,Flight,Commercial,France,Europe,346,12,12,334,334,346,0,Technical Failure
1977-03-27 00:00:00,Pan American World Airways - PAA,Taxiing,Commercial,Spain,Europe,396,16,9,380,326,335,61,Human Factor
1985-06-23 00:00:00,Air India,Flight,Commercial,World,World,329,22,22,307,307,329,0,Terrorism
1996-11-12 00:00:00,Saudi Arabian Airlines - SAUDIA,Flight,Commercial,India,Asia,312,23,23,289,289,312,0,Human Factor
1980-08-19 00:00:00,Saudi Arabian Airlines - SAUDIA,Landing (descent or approach),Commercial,Saudi Arabia,Asia,301,14,14,287,287,301,0,Other
2014-07-17 00:00:00,Malaysian Airlines System - MAS,Flight,Commercial,Ukraine,Europe,298,15,15,283,283,298,0,Terrorism
1988-07-03 00:00:00,Iran Air,Flight,Commercial,Iran,Asia,290,16,16,274,274,290,0,Terrorism
2003-02-19 00:00:00,Islamic Revolutionary Guard Corps,Landing (descent or approach),Military / Government,Iran,Asia,275,18,18,257,257,275,0,Human Factor
1979-05-25 00:00:00,American Airlines,Takeoff (climb),Commercial,United States of America,North America,271,13,13,258,258,271,0,Technical Failure
1983-09-01 00:00:00,Korean Air,Flight,Commercial,Russia,Asia,269,23,23,246,246,269,0,Terrorism
1994-04-26 00:00:00,China Airlines,Landing (descent or approach),Commercial,Japan,Asia,271,15,15,256,249,264,7,Human Factor
1991-07-11 00:00:00,Nigeria Airways,Landing (descent or approach),Commercial,Saudi Arabia,Asia,261,14,14,247,247,261,0,Technical Failure
2001-11-12 00:00:00,American Airlines,Takeoff (climb),Commercial,United States of America,North America,260,9,9,251,251,260,0,Human Factor
1988-12-21 00:00:00,Pan American World Airways - PAA,Flight,Commercial,United Kingdom,Europe,259,16,16,243,243,259,0,Terrorism
1979-11-28 00:00:00,Air New Zealand,Flight,Commercial,Antarctica,Antarctica,257,20,20,237,237,257,0,Human Factor
2018-04-11 00:00:00,Algerian Air Force - Al Quwwat Aljawwija Aljaza'Eriiya,Takeoff (climb),Military / Government,Algeria,Africa,257,10,10,247,247,257,0,Unknown
1985-12-12 00:00:00,Arrow Air,Takeoff (climb),Commercial,Canada,North America,256,8,8,248,248,256,0,Unknown
1977-03-27 00:00:00,KLM Royal Dutch Airlines - Koninklijke Luchtvaart Maatschappij,Takeoff (climb),Commercial,Spain,Europe,248,14,14,234,234,248,0,Human Factor
2014-03-08 00:00:00,Malaysian Airlines System - MAS,Flight,Commercial,World,World,239,12,12,227,227,239,0,Unknown
1997-09-26 00:00:00,Garuda Indonesian Airways,Landing (descent or approach),Commercial,Indonesia,Asia,234,12,12,222,222,234,0,Human Factor
1996-07-17 00:00:00,Trans World Airlines - TWA,Flight,Commercial,United States of America,North America,230,18,18,212,212,230,0,Technical Failure
1998-09-02 00:00:00,Swissair,Flight,Commercial,Canada,North America,229,14,14,215,215,229,0,Technical Failure
1997-08-06 00:00:00,Korean Air,Landing (descent or approach),Commercial,Guam Island,Asia,254,17,14,237,214,228,26,Human Factor
2009-06-01 00:00:00,Air France,Flight,Commercial,Brazil,South America,228,12,12,216,216,228,0,Human Factor
2002-05-25 00:00:00,China Airlines,Flight,Commercial,Taiwan,Asia,225,19,19,206,206,225,0,Technical Failure
2015-10-31 00:00:00,MetroJet,Flight,Commercial,Egypt,Africa,224,7,7,217,217,224,0,Terrorism
1991-05-26 00:00:00,Lauda Air,Flight,Commercial,Thailand,Asia,223,10,10,213,213,223,0,Technical Failure
1999-10-31 00:00:00,Egyptair,Flight,Commercial,World,World,217,15,15,202,202,217,0,Human Factor
1978-01-01 00:00:00,Air India,Takeoff (climb),Commercial,India,Asia,213,23,23,190,190,213,0,Human Factor
1985-07-10 00:00:00,Aeroflot - Russian International Airlines,Flight,Commercial,Uzbekistan,Asia,200,9,9,191,191,200,0,Human Factor
1998-02-16 00:00:00,China Airlines,Landing (descent or approach),Commercial,Taiwan,Asia,196,14,14,182,182,196,0,Human Factor
1974-12-04 00:00:00,Martinair Holland,Landing (descent or approach),Commercial,Sri Lanka,Asia,191,9,9,182,182,191,0,Human Factor
1996-02-06 00:00:00,Birgenair,Takeoff (climb),Commercial,Dominican Republic,Central America,189,13,13,176,176,189,0,Human Factor
2018-10-29 00:00:00,Lion Air,Takeoff (climb),Commercial,Indonesia,Asia,189,8,8,181,181,189,0,Unknown
1975-08-03 00:00:00,Royal Jordanian Airlines - ALIA,Landing (descent or approach),Commercial,Morocco,Africa,188,7,7,181,181,188,0,Human Factor
2007-07-17 00:00:00,TAM Brasil - Taxi Aéreo Marilia - Transportes Aéreos Regionais,Landing (descent or approach),Commercial,Brazil,South America,187,6,6,181,181,187,0,Human Factor
1978-11-15 00:00:00,Loftleidir Icelandic Airlines,Landing (descent or approach),Commercial,Sri Lanka,Asia,262,13,8,249,175,183,79,Human Factor
1987-05-09 00:00:00,LOT Polish Airlines - Polskie Linie Lotnicze,Landing (descent or approach),Commercial,Poland,Europe,183,11,11,172,172,183,0,Technical Failure
1983-11-27 00:00:00,Avianca,Landing (descent or approach),Commercial,Spain,Europe,192,19,19,173,162,181,11,Human Factor
1981-12-01 00:00:00,Inex-Adria Airways,Flight,Commercial,France,Europe,180,8,8,172,172,180,0,Human Factor
1973-01-22 00:00:00,Royal Jordanian Airlines - ALIA,Landing (descent or approach),Commercial,Nigeria,Africa,202,9,6,193,170,176,26,Other
1989-06-07 00:00:00,SLM Surinam Airways - Surinaamse Luchtvaart Maatschappij,Landing (descent or approach),Commercial,Suriname,South America,187,9,9,178,167,176,11,Human Factor
2020-01-08 00:00:00,Ukraine International Airlines,Takeoff (climb),Commercial,Iran,Asia,176,9,9,167,167,176,0,Terrorism
1972-10-13 00:00:00,Aeroflot - Russian International Airlines,Landing (descent or approach),Commercial,Russia,Asia,174,10,10,164,164,174,0,Unknown
1984-10-11 00:00:00,Aeroflot - Russian International Airlines,Landing (descent or approach),Commercial,Russia,Asia,179,9,5,170,169,174,5,Human Factor
1989-09-19 00:00:00,Union des Transports Aériens - UTA,Flight,Commercial,Niger,Africa,170,14,14,156,156,170,0,Terrorism
2006-08-22 00:00:00,Pulkovo Aviation Enterprise,Flight,Commercial,Ukraine,Europe,170,10,10,160,160,170,0,Weather
2000-01-30 00:00:00,Kenya Airways,Takeoff (climb),Commercial,Ivory Coast,Africa,179,10,10,169,159,169,10,Human Factor
2009-07-15 00:00:00,Caspian Airlines,Flight,Commercial,Iran,Asia,168,12,12,156,156,168,0,Technical Failure
1986-03-31 00:00:00,Mexicana de Aviación,Flight,Commercial,Mexico,Central America,167,8,8,159,159,167,0,Technical Failure
1992-09-28 00:00:00,Pakistan International Airlines - PIA,Landing (descent or approach),Commercial,Nepal,Asia,167,19,19,148,148,167,0,Human Factor
1980-07-08 00:00:00,Aeroflot - Russian International Airlines,Takeoff (climb),Commercial,Kazakhstan,Asia,166,10,10,156,156,166,0,Weather
1971-07-30 00:00:00,All Nippon Airways,Flight,Commercial,Japan,Asia,162,7,7,155,155,162,0,Human Factor
2014-12-28 00:00:00,Air Asia Indonesia,Flight,Commercial,Indonesia,Asia,162,6,6,156,156,162,0,Technical Failure
1994-06-06 00:00:00,China Northwest Airlines,Takeoff (climb),Commercial,China,Asia,160,14,14,146,146,160,0,Human Factor
2005-08-16 00:00:00,West Caribbean Airways,Flight,Commercial,Venezuela,South America,160,8,8,152,152,160,0,Human Factor
1987-11-28 00:00:00,South African Airways -SAA - Suid Afrikaanse Lugdiens - SAL,Flight,Commercial,World,World,159,19,19,140,140,159,0,Technical Failure
1992-09-26 00:00:00,Nigerian Air Force,Takeoff (climb),Military / Government,Nigeria,Africa,159,8,8,151,151,159,0,Technical Failure
1995-12-20 00:00:00,American Airlines,Flight,Commercial,Colombia,South America,163,8,8,155,151,159,4,Human Factor
2010-05-22 00:00:00,Air India Express,Landing (descent or approach),Commercial,India,Asia,166,6,6,160,152,158,8,Human Factor
1992-12-22 00:00:00,Libyan Arab Airlines,Landing (descent or approach),Commercial,Libya,Africa,157,10,10,147,147,157,0,Human Factor
2019-03-10 00:00:00,Ethiopian Airlines,Takeoff (climb),Commercial,Ethiopia,Africa,157,8,8,149,149,157,0,Technical Failure
1972-08-14 00:00:00,Interflug,Flight,Commercial,Germany,Europe,156,8,8,148,148,156,0,Technical Failure
1979-11-26 00:00:00,Pakistan International Airlines - PIA,Flight,Commercial,Saudi Arabia,Asia,156,11,11,145,145,156,0,Other
1968-05-12 00:00:00,United States Air Force - USAF,Takeoff (climb),Military / Government,Vietnam,Asia,155,5,5,150,150,155,0,Terrorism
1972-12-03 00:00:00,Spantax,Takeoff (climb),Commercial,Spain,Europe,155,7,7,148,148,155,0,Human Factor
1975-04-04 00:00:00,United States Air Force - USAF,Landing (descent or approach),Humanitarian,Vietnam,Asia,330,16,5,314,150,155,175,Technical Failure
1976-09-19 00:00:00,Turkish Airlines - THY Türk Hava Yollari,Landing (descent or approach),Commercial,Turkey,Asia,154,8,8,146,146,154,0,Human Factor
1987-08-16 00:00:00,Northwest Airlines,Takeoff (climb),Commercial,United States of America,North America,155,6,6,149,148,154,1,Human Factor
2006-09-29 00:00:00,GOL Transportes Aéreos,Flight,Commercial,Brazil,South America,154,6,6,148,148,154,0,Human Factor
2008-08-20 00:00:00,Spanair,Takeoff (climb),Commercial,Spain,Europe,172,6,6,166,148,154,18,Human Factor
2012-06-03 00:00:00,Dana Air,Landing (descent or approach),Commercial,Nigeria,Africa,153,6,6,147,147,153,0,Technical Failure
2009-06-30 00:00:00,Yemenia Yemen Airways,Landing (descent or approach),Commercial,Comoros Islands,Africa,153,11,11,142,141,152,1,Human Factor
2010-07-28 00:00:00,Airblue,Landing (descent or approach),Commercial,Pakistan,Asia,152,6,6,146,146,152,0,Human Factor
2015-03-24 00:00:00,Germanwings,Flight,Commercial,France,Europe,150,6,6,144,144,150,0,Human Factor
1985-02-19 00:00:00,Iberia - Lineas Aéreas de Espana,Landing (descent or approach),Commercial,Spain,Europe,148,7,7,141,141,148,0,Human Factor
2004-01-03 00:00:00,Flash Airlines,Takeoff (climb),Commercial,Egypt,Africa,148,13,13,135,135,148,0,Human Factor
1980-04-25 00:00:00,Dan-Air London,Landing (descent or approach),Commercial,Spain,Europe,146,8,8,138,138,146,0,Human Factor
1982-07-09 00:00:00,Pan American World Airways - PAA,Takeoff (climb),Commercial,United States of America,North America,145,7,7,138,138,145,0,Weather
2001-07-04 00:00:00,Vladivostok Avia - Vladivostok Air,Landing (descent or approach),Commercial,Russia,Asia,145,9,9,136,136,145,0,Human Factor
1989-02-08 00:00:00,Independent Air,Landing (descent or approach),Commercial,Portugal,Europe,144,7,7,137,137,144,0,Human Factor
1996-11-07 00:00:00,ADC Airlines - Aviation Development Company,Flight,Commercial,Nigeria,Africa,144,10,10,134,134,144,0,Human Factor
1988-03-17 00:00:00,Avianca,Takeoff (climb),Commercial,Colombia,South America,143,7,7,136,136,143,0,Human Factor
2000-08-23 00:00:00,Gulf Air,Landing (descent or approach),Commercial,Bahrain,Asia,143,8,8,135,135,143,0,Human Factor
1992-11-24 00:00:00,China Southern Airlines,Landing (descent or approach),Commercial,China,Asia,141,10,10,131,131,141,0,Human Factor
1995-12-18 00:00:00,Trans Service Airlift - TSA,Takeoff (climb),Humanitarian,Angola,Africa,144,5,4,139,137,141,3,Other
1996-08-29 00:00:00,Vnukovo Airlines - Vnukovskie Avialinii,Landing (descent or approach),Commercial,Norway,Europe,141,11,11,130,130,141,0,Human Factor
2003-12-25 00:00:00,Union des Transports Africains de Guinée - UTA,Takeoff (climb),Commercial,Benin,Africa,163,10,5,153,136,141,22,Human Factor
1982-06-08 00:00:00,VASP - Viação Aérea de São Paulo,Landing (descent or approach),Commercial,Brazil,South America,137,9,9,128,128,137,0,Human Factor
1978-09-25 00:00:00,Pacific Southwest Airlines - PSA,Landing (descent or approach),Commercial,United States of America,North America,135,7,7,128,128,135,0,Human Factor
1985-08-02 00:00:00,Delta Airlines,Landing (descent or approach),Commercial,United States of America,North America,163,11,8,152,126,134,29,Weather
1966-02-04 00:00:00,All Nippon Airways,Landing (descent or approach),Commercial,Japan,Asia,133,7,7,126,126,133,0,Unknown
1988-10-19 00:00:00,Indian Airlines,Landing (descent or approach),Commercial,India,Asia,135,6,6,129,127,133,2,Human Factor
1991-10-05 00:00:00,Indonesian Air Force - TNI-AU Tentara Nasional Indonesia - Angkatan Udara,Takeoff (climb),Military / Government,Indonesia,Asia,134,12,12,122,121,133,1,Technical Failure
1982-06-28 00:00:00,Aeroflot - Russian International Airlines,Flight,Commercial,Belarus,Europe,132,8,8,124,124,132,0,Technical Failure
1993-05-19 00:00:00,SAM Colombia - Sociedad Aeronáutica de Medellín,Flight,Commercial,Colombia,South America,132,7,7,125,125,132,0,Human Factor
1994-09-08 00:00:00,USAir - US Airways,Landing (descent or approach),Commercial,United States of America,North America,132,5,5,127,127,132,0,Technical Failure
2022-03-21 00:00:00,China Eastern Airlines,Flight,Commercial,China,Asia,132,9,9,123,123,132,0,Unknown
1977-11-19 00:00:00,Air Portugal - Transportes Aéreos Portugueses,Landing (descent or approach),Commercial,Portugal,Europe,164,8,6,156,125,131,33,Human Factor
1989-10-21 00:00:00,TAN Airlines - Transportes Aéreos Nacionales de Honduras,Landing (descent or approach),Commercial,Honduras,Central America,146,8,4,138,127,131,15,Human Factor
1993-02-08 00:00:00,Iran Airtour,Takeoff (climb),Commercial,Iran,Asia,131,12,12,119,119,131,0,Human Factor
2000-04-19 00:00:00,Air Philippines,Landing (descent or approach),Commercial,Philippines,Asia,131,7,7,124,124,131,0,Human Factor
1962-06-03 00:00:00,Air France,Takeoff (climb),Commercial,France,Europe,132,10,10,122,120,130,2,Technical Failure
1983-11-08 00:00:00,TAAG Angola Airlines - Transportes Aéreos de Angola,Takeoff (climb),Commercial,Angola,Africa,130,7,7,123,123,130,0,Terrorism
1953-06-18 00:00:00,United States Air Force - USAF,Landing (descent or approach),Military / Government,Japan,Asia,129,7,7,122,122,129,0,Technical Failure
2002-04-15 00:00:00,Air China,Landing (descent or approach),Commercial,South Korea,Asia,166,11,8,155,121,129,37,Human Factor
1980-01-21 00:00:00,Iran Air,Landing (descent or approach),Commercial,Iran,Asia,128,8,8,120,120,128,0,Technical Failure
2012-04-20 00:00:00,Bhoja Airlines - Bhoja Air,Landing (descent or approach),Commercial,Pakistan,Asia,127,6,6,121,121,127,0,Human Factor
1967-04-20 00:00:00,Globe Air,Landing (descent or approach),Commercial,Cyprus,Europe,130,10,9,120,117,126,4,Human Factor
1975-08-20 00:00:00,CSA Czech Airlines - Československé Státní Aerolinie,Landing (descent or approach),Commercial,Syria,Asia,128,11,11,117,115,126,2,Human Factor
1989-09-03 00:00:00,Cubana de Aviación,Takeoff (climb),Commercial,Cuba,Central America,126,11,11,115,115,126,0,Human Factor
1996-11-23 00:00:00,Ethiopian Airlines,Landing (descent or approach),Commercial,Comoros Islands,Africa,175,12,6,163,119,125,50,Terrorism
2006-07-09 00:00:00,S7 Airlines,Landing (descent or approach),Commercial,Russia,Asia,203,8,5,195,120,125,78,Human Factor
1966-03-05 00:00:00,British Overseas Airways Corporation - BOAC,Flight,Commercial,Japan,Asia,124,11,11,113,113,124,0,Weather
1994-01-03 00:00:00,Baikal Airlines,Flight,Commercial,Russia,Asia,124,9,9,115,115,124,0,Technical Failure
1968-04-20 00:00:00,South African Airways -SAA - Suid Afrikaanse Lugdiens - SAL,Takeoff (climb),Commercial,Namibia,Africa,128,12,12,116,111,123,5,Human Factor
1973-07-11 00:00:00,VARIG - Viação Aérea Rio Grandense,Landing (descent or approach),Commercial,France,Europe,134,17,7,117,116,123,11,Technical Failure
1996-02-29 00:00:00,Faucett,Landing (descent or approach),Commercial,Peru,South America,123,6,6,117,117,123,0,Human Factor
1972-05-18 00:00:00,Aeroflot - Russian International Airlines,Landing (descent or approach),Commercial,Ukraine,Europe,122,7,7,115,115,122,0,Technical Failure
1973-10-13 00:00:00,Aeroflot - Russian International Airlines,Landing (descent or approach),Commercial,Russia,Asia,122,8,8,114,114,122,0,Technical Failure
2015-06-30 00:00:00,Indonesian Air Force - TNI-AU Tentara Nasional Indonesia - Angkatan Udara,Takeoff (climb),Military / Government,Indonesia,Asia,122,11,11,111,111,122,0,Technical Failure
2017-06-07 00:00:00,Myanmar Air Force - Tatmadaw Lei,Flight,Military / Government,World,World,122,14,14,108,108,122,0,Unknown
1965-05-20 00:00:00,Pakistan International Airlines - PIA,Landing (descent or approach),Commercial,Egypt,Africa,127,13,13,114,108,121,6,Human Factor
2005-08-14 00:00:00,Helios Airways,Flight,Commercial,Greece,Europe,121,6,6,115,115,121,0,Human Factor
1983-07-11 00:00:00,Transportes Aéreos Mercantiles Ecuatorianos - TAME,Landing (descent or approach),Commercial,Ecuador,South America,119,8,8,111,111,119,0,Human Factor
2002-02-12 00:00:00,Iran Airtour,Landing (descent or approach),Commercial,Iran,Asia,119,12,12,107,107,119,0,Human Factor
1963-11-29 00:00:00,Trans-Canada Air Lines - TCAL,Takeoff (climb),Commercial,Canada,North America,118,7,7,111,111,118,0,Technical Failure
1972-06-18 00:00:00,British European Airways - BEA,Takeoff (climb),Commercial,United Kingdom,Europe,118,9,9,109,109,118,0,Human Factor
1966-01-24 00:00:00,Air India,Flight,Commercial,France,Europe,117,11,11,106,106,117,0,Human Factor
2005-10-22 00:00:00,Bellview Airlines,Takeoff (climb),Commercial,Nigeria,Africa,117,6,6,111,111,117,0,Technical Failure
1993-11-20 00:00:00,Avioimpex,Landing (descent or approach),Commercial,Macedonia,Europe,116,8,8,108,108,116,0,Human Factor
2003-07-08 00:00:00,Sudan Airways,Landing (descent or approach),Commercial,Sudan,Africa,117,11,11,106,105,116,1,Technical Failure
2014-07-24 00:00:00,Swiftair,Flight,Commercial,Mali,Africa,116,6,6,110,110,116,0,Human Factor
1972-05-05 00:00:00,Alitalia - Linee Aeree Italiane,Landing (descent or approach),Commercial,Italy,Europe,115,7,7,108,108,115,0,Human Factor
1987-11-29 00:00:00,Korean Air,Flight,Commercial,World,World,115,11,11,104,104,115,0,Terrorism
2007-05-05 00:00:00,Kenya Airways,Takeoff (climb),Commercial,Cameroon,Africa,114,6,6,108,108,114,0,Human Factor
1962-06-22 00:00:00,Air France,Landing (descent or approach),Commercial,Guadeloupe,Central America,113,10,10,103,103,113,0,Other
1975-06-24 00:00:00,Eastern Airlines,Landing (descent or approach),Commercial,United States of America,North America,124,8,6,116,107,113,11,Weather
1976-09-10 00:00:00,Inex-Adria Airways,Flight,Commercial,Croatia,Europe,113,5,5,108,108,113,0,Human Factor
1992-07-31 00:00:00,Thai Airways International,Landing (descent or approach),Commercial,Nepal,Asia,113,14,14,99,99,113,0,Human Factor
2006-05-03 00:00:00,Armavia,Landing (descent or approach),Commercial,Russia,Asia,113,8,8,105,105,113,0,Human Factor
1970-07-03 00:00:00,Dan-Air London,Landing (descent or approach),Commercial,Spain,Europe,112,7,7,105,105,112,0,Human Factor
1972-03-14 00:00:00,Sterling Airways,Flight,Commercial,United Arab Emirates,Asia,112,6,6,106,106,112,0,Human Factor
1982-04-26 00:00:00,CAAC - Civil Aviation Administration of China,Flight,Commercial,China,Asia,112,8,8,104,104,112,0,Human Factor
1983-09-23 00:00:00,Gulf Air,Landing (descent or approach),Commercial,United Arab Emirates,Asia,112,6,6,106,106,112,0,Terrorism
2002-05-07 00:00:00,China Northern Airlines,Landing (descent or approach),Commercial,China,Asia,112,9,9,103,103,112,0,Terrorism
2018-05-18 00:00:00,Cubana de Aviación,Takeoff (climb),Commercial,Cuba,Central America,113,6,6,107,106,112,1,Human Factor
1962-03-04 00:00:00,Caledonian Airways,Takeoff (climb),Commercial,Cameroon,Africa,111,10,10,101,101,111,0,Unknown
1971-09-04 00:00:00,Alaska Airlines,Landing (descent or approach),Commercial,United States of America,North America,111,7,7,104,104,111,0,Human Factor
1976-03-06 00:00:00,Aeroflot - Russian International Airlines,Flight,Commercial,Russia,Asia,111,11,11,100,100,111,0,Technical Failure
1989-07-19 00:00:00,United Airlines,Landing (descent or approach),Commercial,United States of America,North America,296,11,1,285,110,111,185,Technical Failure
1981-08-22 00:00:00,Far Eastern Air Transport - FAT,Flight,Commercial,Taiwan,Asia,110,6,6,104,104,110,0,Technical Failure
1984-12-23 00:00:00,Aeroflot - Russian International Airlines,Landing (descent or approach),Commercial,Russia,Asia,111,7,7,104,103,110,1,Technical Failure
1996-05-11 00:00:00,ValuJet,Flight,Commercial,United States of America,North America,110,5,5,105,105,110,0,Technical Failure
2001-10-08 00:00:00,Scandinavian Airlines System - SAS,Takeoff (climb),Commercial,Italy,Europe,110,6,6,104,104,110,0,Human Factor
1970-07-05 00:00:00,Air Canada,Landing (descent or approach),Commercial,Canada,North America,109,9,9,100,100,109,0,Human Factor
1972-10-01 00:00:00,Aeroflot - Russian International Airlines,Takeoff (climb),Commercial,Russia,Asia,109,8,8,101,101,109,0,Unknown
1974-04-27 00:00:00,Aeroflot - Russian International Airlines,Landing (descent or approach),Commercial,Russia,Asia,109,7,7,102,102,109,0,Technical Failure
2000-07-25 00:00:00,Air France,Takeoff (climb),Commercial,France,Europe,109,9,9,100,100,109,0,Technical Failure
1973-02-21 00:00:00,Libyan Arab Airlines,Flight,Commercial,Egypt,Africa,113,9,8,104,100,108,5,Terrorism
1973-04-10 00:00:00,Invicta International Airways,Landing (descent or approach),Commercial,Switzerland,Europe,145,6,4,139,104,108,37,Human Factor
1973-09-30 00:00:00,Aeroflot - Russian International Airlines,Takeoff (climb),Commercial,Russia,Asia,108,8,8,100,100,108,0,Technical Failure
1978-12-23 00:00:00,Alitalia - Linee Aeree Italiane,Landing (descent or approach),Commercial,Italy,Europe,129,5,5,124,103,108,21,Human Factor
1988-01-18 00:00:00,China Southwest Airlines,Landing (descent or approach),Commercial,China,Asia,108,10,10,98,98,108,0,Technical Failure
1993-09-22 00:00:00,ORBI Georgian Airways - ORBI Air Company,Landing (descent or approach),Commercial,Georgia,Asia,132,12,8,120,100,108,24,Terrorism
2005-12-10 00:00:00,Sosoliso Airlines,Landing (descent or approach),Commercial,Nigeria,Africa,110,7,7,103,101,108,2,Human Factor
1962-03-16 00:00:00,Flying Tiger Line,Flight,Commercial,World,World,107,11,11,96,96,107,0,Unknown
1967-11-16 00:00:00,Aeroflot - Russian International Airlines,Takeoff (climb),Commercial,Russia,Asia,107,8,8,99,99,107,0,Technical Failure
1974-04-22 00:00:00,Pan American World Airways - PAA,Landing (descent or approach),Commercial,Indonesia,Asia,107,11,11,96,96,107,0,Technical Failure
1989-11-27 00:00:00,Avianca,Takeoff (climb),Commercial,Colombia,South America,107,6,6,101,101,107,0,Terrorism
1992-07-31 00:00:00,China General Aviation Corporation - CGAC,Takeoff (climb),Commercial,China,Asia,126,10,9,116,98,107,19,Human Factor
1973-12-22 00:00:00,Sobelair,Landing (descent or approach),Commercial,Morocco,Africa,106,8,8,98,98,106,0,Human Factor
2005-02-03 00:00:00,Kam Air,Flight,Commercial,Afghanistan,Asia,105,8,8,97,97,105,0,Human Factor
1972-01-07 00:00:00,Iberia - Lineas Aéreas de Espana,Landing (descent or approach),Commercial,Spain,Europe,104,6,6,98,98,104,0,Human Factor
1997-12-19 00:00:00,Silkair,Flight,Commercial,Indonesia,Asia,104,7,7,97,97,104,0,Human Factor
1998-02-02 00:00:00,Cebu Pacific Air,Flight,Commercial,Philippines,Asia,104,5,5,99,99,104,0,Human Factor
1986-11-03 00:00:00,Islamic Republic of Iran Air Force,Landing (descent or approach),Military / Government,Iran,Asia,103,7,7,96,96,103,0,Human Factor
2010-05-12 00:00:00,Afriqiyah Airways,Landing (descent or approach),Commercial,Libya,Africa,104,11,11,93,92,103,1,Human Factor
1968-02-07 00:00:00,Indian Air Force - Bharatiya Vayu Sena,Flight,Military / Government,India,Asia,102,4,4,98,98,102,0,Weather
1970-02-15 00:00:00,Dominicana de Aviación,Takeoff (climb),Commercial,Dominican Republic,Central America,102,5,5,97,97,102,0,Technical Failure
1972-08-31 00:00:00,Aeroflot - Russian International Airlines,Landing (descent or approach),Commercial,Russia,Asia,102,9,9,93,93,102,0,Other
2003-03-06 00:00:00,Air Algérie,Takeoff (climb),Commercial,Algeria,Africa,103,6,6,97,96,102,1,Technical Failure
2007-01-01 00:00:00,AdamAir,Flight,Commercial,Indonesia,Asia,102,6,6,96,96,102,0,Human Factor
1963-06-03 00:00:00,Northwest Airlines,Flight,Commercial,World,World,101,6,6,95,95,101,0,Unknown
1972-12-29 00:00:00,Eastern Airlines,Landing (descent or approach),Commercial,United States of America,North America,176,13,5,163,96,101,75,Human Factor
1998-12-11 00:00:00,Thai Airways International,Landing (descent or approach),Commercial,Thailand,Asia,146,14,11,132,90,101,45,Human Factor
1969-03-20 00:00:00,United Arab Airlines,Landing (descent or approach),Commercial,Egypt,Africa,105,7,7,98,93,100,5,Human Factor
1977-12-04 00:00:00,Malaysian Airlines System - MAS,Flight,Commercial,Malaysia,Asia,100,7,7,93,93,100,0,Terrorism
2005-09-05 00:00:00,Mandala Airlines,Takeoff (climb),Commercial,Indonesia,Asia,117,5,5,112,95,100,17,Human Factor
1958-08-14 00:00:00,KLM Royal Dutch Airlines - Koninklijke Luchtvaart Maatschappij,Flight,Commercial,World,World,99,8,8,91,91,99,0,Technical Failure
1970-08-09 00:00:00,LANSA Peru - Lineas Aéreas Nacionales del Peru,Takeoff (climb),Commercial,Peru,South America,100,9,8,91,91,99,1,Human Factor
1981-11-16 00:00:00,Aeroflot - Russian International Airlines,Landing (descent or approach),Commercial,Russia,Asia,167,7,4,160,95,99,68,Human Factor
1966-09-01 00:00:00,Britannia Airways,Landing (descent or approach),Commercial,Slovenia,Europe,117,7,6,110,92,98,19,Human Factor
1991-03-21 00:00:00,Royal Saudi Air Force,Landing (descent or approach),Military / Government,Saudi Arabia,Asia,101,6,6,95,92,98,3,Human Factor
1995-12-07 00:00:00,Dalavia - Dal'nevostochny Avialinii,Flight,Commercial,Russia,Asia,98,8,8,90,90,98,0,Human Factor
2009-05-20 00:00:00,Indonesian Air Force - TNI-AU Tentara Nasional Indonesia - Angkatan Udara,Landing (descent or approach),Military / Government,Indonesia,Asia,112,14,10,98,88,98,14,Human Factor
1962-11-27 00:00:00,VARIG - Viação Aérea Rio Grandense,Landing (descent or approach),Commercial,Peru,South America,97,17,17,80,80,97,0,Technical Failure
1971-07-25 00:00:00,Aeroflot - Russian International Airlines,Landing (descent or approach),Commercial,Russia,Asia,126,8,4,118,93,97,29,Human Factor
1974-01-30 00:00:00,Pan American World Airways - PAA,Landing (descent or approach),Commercial,Samoa,Oceania,101,10,10,91,87,97,4,Human Factor
2020-05-22 00:00:00,Pakistan International Airlines - PIA,Landing (descent or approach),Commercial,Pakistan,Asia,99,8,8,91,89,97,2,Human Factor
1969-06-23 00:00:00,Soviet Air Force - Voyenno-vozdushnye sily CCCP,Flight,Military / Government,Russia,Asia,96,5,5,91,91,96,0,Human Factor
2006-10-29 00:00:00,ADC Airlines - Aviation Development Company,Takeoff (climb),Commercial,Nigeria,Africa,105,5,4,100,92,96,9,Human Factor
2010-04-10 00:00:00,Polish Air Force - Polska Wojska Lotnicze i Obrony Powietrznej,Landing (descent or approach),Military / Government,Russia,Asia,96,8,8,88,88,96,0,Human Factor
1962-03-01 00:00:00,American Airlines,Takeoff (climb),Commercial,United States of America,North America,95,8,8,87,87,95,0,Other
1968-09-11 00:00:00,Air France,Flight,Commercial,France,Europe,95,6,6,89,89,95,0,Technical Failure
1976-10-12 00:00:00,Indian Airlines,Landing (descent or approach),Commercial,India,Asia,95,6,6,89,89,95,0,Technical Failure
1996-10-31 00:00:00,TAM Brasil - Taxi Aéreo Marilia - Transportes Aéreos Regionais,Takeoff (climb),Commercial,Brazil,South America,95,6,6,89,89,95,0,Technical Failure
1962-07-07 00:00:00,Alitalia - Linee Aeree Italiane,Flight,Commercial,India,Asia,94,9,9,85,85,94,0,Human Factor
1979-08-11 00:00:00,Aeroflot - Russian International Airlines,Flight,Commercial,Ukraine,Europe,94,6,6,88,88,94,0,Human Factor
1979-08-11 00:00:00,Aeroflot - Russian International Airlines,Flight,Commercial,Ukraine,Europe,94,6,6,88,88,94,0,Human Factor
1986-01-18 00:00:00,Aerovias Guatemala,Landing (descent or approach),Commercial,Guatemala,Central America,94,6,6,88,88,94,0,Human Factor
2002-01-28 00:00:00,Transportes Aéreos Mercantiles Ecuatorianos - TAME,Flight,Commercial,Colombia,South America,94,7,7,87,87,94,0,Human Factor
2005-12-06 00:00:00,Islamic Republic of Iran Air Force,Landing (descent or approach),Military / Government,Iran,Asia,94,10,10,84,84,94,0,Technical Failure
1970-02-06 00:00:00,Aeroflot - Russian International Airlines,Landing (descent or approach),Commercial,Uzbekistan,Asia,106,8,7,98,85,92,14,Human Factor
1974-12-01 00:00:00,Trans World Airlines - TWA,Landing (descent or approach),Commercial,United States of America,North America,92,7,7,85,85,92,0,Human Factor
1990-02-14 00:00:00,Indian Airlines,Landing (descent or approach),Commercial,India,Asia,146,7,4,139,88,92,54,Human Factor
2001-09-11 00:00:00,American Airlines,Flight,Commercial,United States of America,North America,92,11,11,81,81,92,0,Terrorism
2016-12-25 00:00:00,Russian Air Force - Voyenno-vozdushnye sily Rossii,Takeoff (climb),Military / Government,Russia,Asia,92,8,8,84,84,92,0,Human Factor
1971-12-24 00:00:00,LANSA Peru - Lineas Aéreas Nacionales del Peru,Flight,Commercial,Peru,South America,92,6,6,86,85,91,1,Weather
1996-02-26 00:00:00,Sudanese Air Force - Al Quwwat al-Jawwiya As-Sudaniya,Landing (descent or approach),Military / Government,Sudan,Africa,91,6,6,85,85,91,0,Technical Failure
1969-12-08 00:00:00,Olympic Airways,Landing (descent or approach),Commercial,Greece,Europe,90,5,5,85,85,90,0,Human Factor
1977-01-13 00:00:00,Aeroflot - Russian International Airlines,Landing (descent or approach),Commercial,Kazakhstan,Asia,90,8,8,82,82,90,0,Technical Failure
1982-07-06 00:00:00,Aeroflot - Russian International Airlines,Takeoff (climb),Commercial,Russia,Asia,90,8,8,82,82,90,0,Technical Failure
1983-08-30 00:00:00,Aeroflot - Russian International Airlines,Landing (descent or approach),Commercial,Kazakhstan,Asia,90,6,6,84,84,90,0,Human Factor
2007-09-16 00:00:00,One-Two-Go Airlines,Landing (descent or approach),Commercial,Thailand,Asia,130,7,5,123,85,90,40,Human Factor
2010-01-25 00:00:00,Ethiopian Airlines,Takeoff (climb),Commercial,Lebanon,Asia,90,8,8,82,82,90,0,Human Factor
1980-09-15 00:00:00,Royal Saudi Air Force,Takeoff (climb),Military / Government,Saudi Arabia,Asia,89,8,8,81,81,89,0,Technical Failure
1967-06-03 00:00:00,Air Ferry,Flight,Commercial,France,Europe,88,5,5,83,83,88,0,Human Factor
1973-07-31 00:00:00,Delta Airlines,Landing (descent or approach),Commercial,United States of America,North America,89,6,6,83,82,88,1,Human Factor
1974-09-08 00:00:00,Trans World Airlines - TWA,Flight,Commercial,World,World,88,9,9,79,79,88,0,Terrorism
1997-03-13 00:00:00,Islamic Republic of Iran Air Force,Landing (descent or approach),Military / Government,Iran,Asia,88,8,8,80,80,88,0,Technical Failure
2000-01-31 00:00:00,Alaska Airlines,Flight,Commercial,United States of America,North America,88,5,5,83,83,88,0,Technical Failure
2008-09-14 00:00:00,Aeroflot Nord,Landing (descent or approach),Commercial,Russia,Asia,88,6,6,82,82,88,0,Human Factor
1952-12-20 00:00:00,United States Air Force - USAF,Takeoff (climb),Military / Government,United States of America,North America,115,10,5,105,82,87,28,Human Factor
1964-09-02 00:00:00,Aeroflot - Russian International Airlines,Landing (descent or approach),Commercial,Russia,Asia,93,9,9,84,78,87,6,Human Factor
1965-02-06 00:00:00,LAN Chile - Linea Aérea Nacional de Chile,Flight,Commercial,Chile,South America,87,7,7,80,80,87,0,Human Factor
1969-11-20 00:00:00,Nigeria Airways,Landing (descent or approach),Commercial,Nigeria,Africa,87,11,11,76,76,87,0,Human Factor
1980-03-14 00:00:00,LOT Polish Airlines - Polskie Linie Lotnicze,Landing (descent or approach),Commercial,Poland,Europe,87,10,10,77,77,87,0,Technical Failure
1992-01-20 00:00:00,Air Inter,Landing (descent or approach),Commercial,France,Europe,96,6,5,90,82,87,9,Human Factor
1962-09-02 00:00:00,Aeroflot - Russian International Airlines,Flight,Commercial,Russia,Asia,86,7,7,79,79,86,0,Unknown
1964-03-01 00:00:00,Paradise Airlines,Landing (descent or approach),Commercial,United States of America,North America,85,4,4,81,81,85,0,Human Factor
1965-12-11 00:00:00,United States Air Force - USAF,Landing (descent or approach),Military / Government,Vietnam,Asia,85,4,4,81,81,85,0,Human Factor
1968-05-03 00:00:00,Braniff Airways,Flight,Commercial,United States of America,North America,85,5,5,80,80,85,0,Weather
1973-08-13 00:00:00,Aviaco - Aviacion y Comercio,Landing (descent or approach),Commercial,Spain,Europe,85,6,6,79,79,85,0,Human Factor
1997-12-15 00:00:00,Tajikistan Airlines - Tajik Air,Landing (descent or approach),Commercial,United Arab Emirates,Asia,86,7,6,79,79,85,1,Human Factor
1960-12-16 00:00:00,United Airlines,Landing (descent or approach),Commercial,United States of America,North America,84,7,7,77,77,84,0,Human Factor
1962-06-30 00:00:00,Aeroflot - Russian International Airlines,Flight,Commercial,Russia,Asia,84,8,8,76,76,84,0,Terrorism
1965-02-08 00:00:00,Eastern Airlines,Takeoff (climb),Commercial,United States of America,North America,84,5,5,79,79,84,0,Human Factor
1965-06-25 00:00:00,United States Air Force - USAF,Takeoff (climb),Military / Government,United States of America,North America,84,12,12,72,72,84,0,Human Factor
1969-03-16 00:00:00,VIASA - Venezolana Internacional de Aviacion SA,Takeoff (climb),Commercial,Venezuela,South America,84,10,10,74,74,84,0,Other
1992-08-27 00:00:00,Aeroflot - Russian International Airlines,Landing (descent or approach),Commercial,Russia,Asia,84,7,7,77,77,84,0,Human Factor
2000-10-25 00:00:00,Russian Air Force - Voyenno-vozdushnye sily Rossii,Landing (descent or approach),Military / Government,Georgia,Asia,84,11,11,73,73,84,0,Human Factor
1961-09-10 00:00:00,President Airlines,Takeoff (climb),Commercial,Ireland,Europe,83,6,6,77,77,83,0,Technical Failure
1964-02-29 00:00:00,British Eagle Airways - BEA,Flight,Commercial,Austria,Europe,83,8,8,75,75,83,0,Human Factor
1966-04-22 00:00:00,American Flyers Airline,Landing (descent or approach),Commercial,United States of America,North America,98,5,5,93,78,83,15,Human Factor
1968-02-29 00:00:00,Aeroflot - Russian International Airlines,Flight,Commercial,Russia,Asia,84,9,9,75,74,83,1,Technical Failure
1987-08-31 00:00:00,Thai Airways International,Landing (descent or approach),Commercial,Thailand,Asia,83,9,9,74,74,83,0,Human Factor
1990-08-10 00:00:00,Afghan Republican Air Force - Afghan Hanai Qurah,Takeoff (climb),Military / Government,Afghanistan,Asia,83,5,5,78,78,83,0,Technical Failure
1993-03-05 00:00:00,Palair Macedonian,Takeoff (climb),Commercial,Macedonia,Europe,97,5,4,92,79,83,14,Human Factor
2000-10-31 00:00:00,Singapore Airlines,Takeoff (climb),Commercial,Taiwan,Asia,179,20,4,159,79,83,96,Human Factor
1966-11-24 00:00:00,Transportno Aviatsionno Bulgaro-Savetsko Obedinenie - TABSO,Takeoff (climb),Commercial,Slovakia,Europe,82,8,8,74,74,82,0,Human Factor
1969-09-09 00:00:00,Allegheny Airlines,Landing (descent or approach),Commercial,United States of America,North America,82,4,4,78,78,82,0,Human Factor
1972-06-14 00:00:00,Japan Airlines,Landing (descent or approach),Commercial,India,Asia,87,11,10,76,72,82,5,Human Factor
1976-01-01 00:00:00,Middle East Airlines - MEA,Flight,Commercial,Saudi Arabia,Asia,82,15,15,67,67,82,0,Terrorism
1990-10-02 00:00:00,Xiamen Air,Landing (descent or approach),Commercial,China,Asia,102,9,7,93,75,82,20,Terrorism
1993-08-28 00:00:00,Tajikistan Airlines - Tajik Air,Takeoff (climb),Commercial,Tajikistan,Asia,86,5,5,81,77,82,4,Terrorism
1962-07-28 00:00:00,Aeroflot - Russian International Airlines,Landing (descent or approach),Commercial,Russia,Asia,81,7,7,74,74,81,0,Human Factor
1963-12-08 00:00:00,Pan American World Airways - PAA,Flight,Commercial,United States of America,North America,81,8,8,73,73,81,0,Weather
1972-06-15 00:00:00,Cathay Pacific Airways,Flight,Commercial,Vietnam,Asia,81,10,10,71,71,81,0,Terrorism
1973-05-18 00:00:00,Aeroflot - Russian International Airlines,Flight,Commercial,Russia,Asia,81,9,9,72,72,81,0,Terrorism
1980-06-27 00:00:00,Aerolinee Itavia,Flight,Commercial,Italy,Europe,81,4,4,77,77,81,0,Terrorism
1950-03-12 00:00:00,Fairflight,Landing (descent or approach),Commercial,United Kingdom,Europe,83,5,5,78,75,80,3,Other
1958-10-17 00:00:00,Aeroflot - Russian International Airlines,Flight,Commercial,Russia,Asia,80,9,9,71,71,80,0,Weather
1960-09-19 00:00:00,World Airways,Takeoff (climb),Commercial,Guam Island,Asia,94,8,7,86,73,80,14,Human Factor
1963-09-04 00:00:00,Swissair,Takeoff (climb),Commercial,Switzerland,Europe,80,6,6,74,74,80,0,Technical Failure
1964-10-02 00:00:00,Union des Transports Aériens - UTA,Flight,Commercial,Spain,Europe,80,7,7,73,73,80,0,Human Factor
1981-09-29 00:00:00,Islamic Republic of Iran Air Force,Landing (descent or approach),Military / Government,Iran,Asia,80,5,5,75,75,80,0,Unknown
1985-07-24 00:00:00,Colombian Air Force - Fuerza Aérea Colombiana,Flight,Commercial,Colombia,South America,80,4,4,76,76,80,0,Technical Failure
1994-07-01 00:00:00,Air Mauritanie,Landing (descent or approach),Commercial,Mauritania,Africa,93,4,4,89,76,80,13,Human Factor
2011-07-26 00:00:00,Royal Moroccan Air Force - Forces Royales Air,Landing (descent or approach),Military / Government,Morocco,Africa,80,8,8,72,72,80,0,Human Factor
1957-08-11 00:00:00,Maritime Central Airways,Flight,Commercial,Canada,North America,79,6,6,73,73,79,0,Weather
1964-05-11 00:00:00,United States Air Force - USAF,Landing (descent or approach),Military / Government,Philippines,Asia,84,10,5,74,74,79,5,Human Factor
1967-07-19 00:00:00,Piedmont Airlines,Takeoff (climb),Commercial,United States of America,North America,79,5,5,74,74,79,0,Human Factor
1969-06-04 00:00:00,Mexicana de Aviación,Landing (descent or approach),Commercial,Mexico,Central America,79,7,7,72,72,79,0,Human Factor
1970-11-27 00:00:00,United States Air Force - USAF,Landing (descent or approach),Military / Government,Vietnam,Asia,79,6,6,73,73,79,0,Human Factor
1973-02-24 00:00:00,Aeroflot - Russian International Airlines,Flight,Commercial,Tajikistan,Asia,79,8,8,71,71,79,0,Unknown
1985-05-03 00:00:00,Aeroflot - Russian International Airlines,Flight,Commercial,Ukraine,Europe,79,7,7,72,72,79,0,Human Factor
1961-05-10 00:00:00,Air France,Flight,Commercial,Algeria,Africa,78,9,9,69,69,78,0,Terrorism
1961-09-01 00:00:00,Trans World Airlines - TWA,Takeoff (climb),Commercial,United States of America,North America,78,5,5,73,73,78,0,Technical Failure
1971-05-23 00:00:00,Aviogenex,Landing (descent or approach),Commercial,Croatia,Europe,83,7,3,76,75,78,5,Human Factor
1973-07-22 00:00:00,Pan American World Airways - PAA,Takeoff (climb),Commercial,French Polynesia,Oceania,79,10,10,69,68,78,1,Human Factor
1974-04-04 00:00:00,Wenela Air Services,Takeoff (climb),Commercial,Botswana,Africa,84,4,3,80,75,78,6,Human Factor
1988-12-11 00:00:00,Aeroflot - Russian International Airlines,Landing (descent or approach),Humanitarian,Armenia,Asia,78,9,9,69,69,78,0,Human Factor
2001-10-04 00:00:00,Sibir Airlines,Flight,Commercial,World,World,78,12,12,66,66,78,0,Terrorism
2011-01-09 00:00:00,Iran Air,Landing (descent or approach),Commercial,Iran,Asia,105,9,8,96,70,78,27,Human Factor
1961-09-12 00:00:00,Air France,Landing (descent or approach),Commercial,Morocco,Africa,77,6,6,71,71,77,0,Human Factor
1961-11-08 00:00:00,Imperial Airlines,Landing (descent or approach),Commercial,United States of America,North America,79,5,3,74,74,77,2,Human Factor
1977-02-15 00:00:00,Aeroflot - Russian International Airlines,Landing (descent or approach),Commercial,Russia,Asia,98,6,1,92,76,77,21,Human Factor
1978-11-19 00:00:00,Indian Air Force - Bharatiya Vayu Sena,Landing (descent or approach),Military / Government,India,Asia,77,7,7,70,70,77,0,Technical Failure
2011-07-08 00:00:00,Hewa Bora Airways,Landing (descent or approach),Commercial,Democratic Republic of Congo,Africa,115,7,5,108,72,77,38,Human Factor
1976-07-28 00:00:00,CSA Czech Airlines - Československé Státní Aerolinie,Landing (descent or approach),Commercial,Slovakia,Europe,79,6,6,73,70,76,3,Human Factor
1988-09-09 00:00:00,Vietnam Airlines,Landing (descent or approach),Commercial,Thailand,Asia,9,6,3,3,73,76,-67,Human Factor
1993-04-27 00:00:00,Afghan Republican Air Force - Afghan Hanai Qurah,Flight,Military / Government,Afghanistan,Asia,76,5,5,71,71,76,0,Human Factor
2014-02-11 00:00:00,Algerian Air Force - Al Quwwat Aljawwija Aljaza'Eriiya,Landing (descent or approach),Military / Government,Algeria,Africa,77,4,4,73,72,76,1,Human Factor
1969-09-20 00:00:00,Air Vietnam,Landing (descent or approach),Commercial,Vietnam,Asia,77,6,6,71,69,75,2,Human Factor
1970-11-14 00:00:00,Southern Airways,Landing (descent or approach),Commercial,United States of America,North America,75,4,4,71,71,75,0,Human Factor
1974-09-15 00:00:00,Air Vietnam,Landing (descent or approach),Commercial,Vietnam,Asia,75,8,8,67,67,75,0,Terrorism
1974-12-22 00:00:00,AVENSA - Aerovias Venezolanas,Takeoff (climb),Commercial,Venezuela,South America,75,6,6,69,69,75,0,Unknown
1975-10-30 00:00:00,Inex-Adria Airways,Landing (descent or approach),Commercial,Czech Republic,Europe,120,5,4,115,71,75,45,Human Factor
1989-07-27 00:00:00,Korean Air,Landing (descent or approach),Commercial,Libya,Africa,199,18,3,181,72,75,124,Human Factor
1994-03-23 00:00:00,Aeroflot - Russian International Airlines,Flight,Commercial,Russia,Asia,75,12,12,63,63,75,0,Human Factor
1995-09-12 00:00:00,Sri Lanka Air Force,Flight,Military / Government,Sri Lanka,Asia,75,5,5,70,70,75,0,Technical Failure
1998-05-05 00:00:00,Peruvian Air Force - Fuerza Aérea del Perú,Landing (descent or approach),Commercial,Peru,South America,88,8,6,80,69,75,13,Human Factor
2003-01-08 00:00:00,Turkish Airlines - THY Türk Hava Yollari,Landing (descent or approach),Commercial,Turkey,Asia,80,5,5,75,70,75,5,Human Factor
2003-05-26 00:00:00,UM Air - Ukrainian-Mediterranean Airlines - Ukrainske-Tschermomorskie Avialinii,Landing (descent or approach),Commercial,Turkey,Asia,75,13,13,62,62,75,0,Human Factor
1956-06-20 00:00:00,Linea Aeropostal Venezolana - LAV,Flight,Commercial,United States of America,North America,74,10,10,64,64,74,0,Technical Failure
1969-09-26 00:00:00,Lloyd Aéreo Boliviano - LAB Airlines,Flight,Commercial,Bolivia,South America,74,5,5,69,69,74,0,Human Factor
1982-01-13 00:00:00,Air Florida,Takeoff (climb),Commercial,United States of America,North America,79,5,4,74,70,74,5,Human Factor
1997-10-10 00:00:00,Austral Lineas Aéreas,Flight,Commercial,Uruguay,South America,74,5,5,69,69,74,0,Human Factor
1976-10-06 00:00:00,Cubana de Aviación,Takeoff (climb),Commercial,Barbados,Central America,73,25,25,48,48,73,0,Terrorism
1976-11-28 00:00:00,Aeroflot - Russian International Airlines,Takeoff (climb),Commercial,Russia,Asia,73,6,6,67,67,73,0,Technical Failure
1978-03-16 00:00:00,Balkan Bulgarian Airlines,Flight,Commercial,Bulgaria,Europe,73,7,7,66,66,73,0,Technical Failure
1982-01-14 00:00:00,Ethiopian Air Force - Ye Ityopya Ayer Hayl,Takeoff (climb),Military / Government,Ethiopia,Africa,73,6,6,67,67,73,0,Terrorism
1990-01-25 00:00:00,Avianca,Landing (descent or approach),Commercial,United States of America,North America,158,9,8,149,65,73,85,Human Factor
1961-02-15 00:00:00,SABENA - Société Anonyme Belge d'Exploitation de la Navigation Aérienne,Landing (descent or approach),Commercial,Belgium,Europe,72,11,11,61,61,72,0,Technical Failure
1961-07-12 00:00:00,CSA Czech Airlines - Československé Státní Aerolinie,Landing (descent or approach),Commercial,Morocco,Africa,72,8,8,64,64,72,0,Human Factor
1967-06-04 00:00:00,British Midland Airways - BMA,Landing (descent or approach),Commercial,United Kingdom,Europe,84,5,3,79,69,72,12,Human Factor
1974-09-11 00:00:00,Eastern Airlines,Landing (descent or approach),Commercial,United States of America,North America,82,4,2,78,70,72,10,Human Factor
1979-10-31 00:00:00,Western Airlines,Landing (descent or approach),Commercial,Mexico,Central America,88,11,9,77,63,72,16,Human Factor
1986-12-12 00:00:00,Aeroflot - Russian International Airlines,Landing (descent or approach),Commercial,Germany,Europe,82,9,9,73,63,72,10,Human Factor
1995-12-03 00:00:00,Cameroon Airlines,Landing (descent or approach),Commercial,Cameroon,Africa,76,5,3,71,68,71,5,Technical Failure
2016-11-28 00:00:00,LAMIA Bolivia - Línea Aérea Mérida Internacional de Aviación,Landing (descent or approach),Commercial,Colombia,South America,77,4,3,73,68,71,6,Human Factor
2018-02-11 00:00:00,Saratov Airlines,Takeoff (climb),Commercial,Russia,Asia,71,6,6,65,65,71,0,Human Factor
1956-06-30 00:00:00,Trans World Airlines - TWA,Flight,Commercial,United States of America,North America,70,6,6,64,64,70,0,Human Factor
1967-11-20 00:00:00,Trans World Airlines - TWA,Landing (descent or approach),Commercial,United States of America,North America,82,7,5,75,65,70,12,Human Factor
1980-12-21 00:00:00,Transportes Aéreos del Caribe - TAC Colombia,Takeoff (climb),Commercial,Colombia,South America,70,7,7,63,63,70,0,Other
1985-01-21 00:00:00,Galaxy Airlines,Landing (descent or approach),Commercial,United States of America,North America,71,6,6,65,64,70,1,Human Factor
1986-10-20 00:00:00,Aeroflot - Russian International Airlines,Landing (descent or approach),Commercial,Russia,Asia,94,7,4,87,66,70,24,Human Factor
1992-07-24 00:00:00,Mandala Airlines,Landing (descent or approach),Commercial,Indonesia,Asia,70,7,7,63,63,70,0,Human Factor
1996-10-02 00:00:00,AeroPeru,Flight,Commercial,Peru,South America,70,9,9,61,61,70,0,Human Factor
1997-12-17 00:00:00,Aerosweet Airlines,Flight,Commercial,Greece,Europe,70,8,8,62,62,70,0,Human Factor
1998-08-29 00:00:00,Cubana de Aviación,Takeoff (climb),Commercial,Ecuador,South America,91,14,14,77,56,70,21,Human Factor
1965-11-03 00:00:00,Argentinian Air Force - Fuerza Aérea Argentina,Flight,Military / Government,Costa Rica,Central America,69,9,9,60,60,69,0,Technical Failure
1971-11-10 00:00:00,Merpati Nusantara Airlines - MNA,Flight,Commercial,Indonesia,Asia,69,7,7,62,62,69,0,Unknown
1991-08-16 00:00:00,Indian Airlines,Landing (descent or approach),Commercial,India,Asia,69,6,6,63,63,69,0,Human Factor
2002-07-01 00:00:00,Bashkirian Airlines - Bashkirskie Avialinii,Flight,Commercial,Germany,Europe,69,9,9,60,60,69,0,Human Factor
1959-06-26 00:00:00,Trans World Airlines - TWA,Flight,Commercial,Italy,Europe,68,9,9,59,59,68,0,Weather
1971-07-03 00:00:00,TOA Domestic Airlines,Landing (descent or approach),Commercial,Japan,Asia,68,4,4,64,64,68,0,Human Factor
1973-03-05 00:00:00,Iberia - Lineas Aéreas de Espana,Flight,Commercial,France,Europe,68,7,7,61,61,68,0,Human Factor
1976-09-03 00:00:00,Venezuelan Air Force - Fuerza Aérea Venezolana,Landing (descent or approach),Commercial,Portugal,Europe,68,10,10,58,58,68,0,Human Factor
1993-07-26 00:00:00,Asiana Airlines,Landing (descent or approach),Commercial,South Korea,Asia,116,6,2,110,66,68,48,Human Factor
1994-10-31 00:00:00,American Eagle,Flight,Commercial,United States of America,North America,68,4,4,64,64,68,0,Weather
2010-11-04 00:00:00,Aerocaribbean,Flight,Commercial,Cuba,Central America,68,7,7,61,61,68,0,Weather
1957-03-22 00:00:00,United States Air Force - USAF,Flight,Military / Government,World,World,67,10,10,57,57,67,0,Unknown
1961-07-19 00:00:00,Aerolineas Argentinas,Flight,Commercial,Argentina,South America,67,7,7,60,60,67,0,Weather
1963-04-04 00:00:00,Aeroflot - Russian International Airlines,Flight,Commercial,Russia,Asia,67,8,8,59,59,67,0,Technical Failure
1967-12-08 00:00:00,Faucett,Flight,Commercial,Peru,South America,67,6,6,61,61,67,0,Human Factor
1975-10-27 00:00:00,TAM Bolivia - Transporte Aéreo Militar Boliviano,Takeoff (climb),Military / Government,Bolivia,South America,67,4,4,63,63,67,0,Other
1977-05-27 00:00:00,Aeroflot - Russian International Airlines,Landing (descent or approach),Commercial,Cuba,Central America,69,10,10,59,57,67,2,Human Factor
1955-03-22 00:00:00,United States Navy - USN,Landing (descent or approach),Military / Government,United States of America,North America,66,6,6,60,60,66,0,Human Factor
1955-10-06 00:00:00,United Airlines,Flight,Commercial,United States of America,North America,66,3,3,63,63,66,0,Human Factor
1967-10-12 00:00:00,British European Airways - BEA,Flight,Commercial,Turkey,Asia,66,7,7,59,59,66,0,Terrorism
1973-02-19 00:00:00,Aeroflot - Russian International Airlines,Landing (descent or approach),Commercial,Czech Republic,Europe,100,13,4,87,62,66,34,Weather
1974-01-26 00:00:00,Turkish Airlines - THY Türk Hava Yollari,Takeoff (climb),Commercial,Turkey,Asia,73,5,4,68,62,66,7,Weather
1994-10-12 00:00:00,Iran Aseman Airlines,Flight,Commercial,Iran,Asia,66,7,7,59,59,66,0,Technical Failure
2016-05-19 00:00:00,Egyptair,Flight,Commercial,World,World,66,10,10,56,56,66,0,Unknown
2018-02-18 00:00:00,Iran Aseman Airlines,Flight,Commercial,Iran,Asia,66,6,6,60,60,66,0,Human Factor
1958-05-18 00:00:00,SABENA - Société Anonyme Belge d'Exploitation de la Navigation Aérienne,Landing (descent or approach),Commercial,Morocco,Africa,69,9,9,60,56,65,4,Human Factor
1959-02-03 00:00:00,American Airlines,Landing (descent or approach),Commercial,United States of America,North America,73,5,3,68,62,65,8,Human Factor
1971-03-31 00:00:00,Aeroflot - Russian International Airlines,Landing (descent or approach),Commercial,Ukraine,Europe,65,8,8,57,57,65,0,Unknown
1995-08-09 00:00:00,Aviateca,Landing (descent or approach),Commercial,Salvador,Central America,65,7,7,58,58,65,0,Human Factor
1997-09-03 00:00:00,Vietnam Airlines,Landing (descent or approach),Commercial,Cambodia,Asia,66,6,6,60,59,65,1,Human Factor
2001-09-11 00:00:00,United Airlines,Flight,Commercial,United States of America,North America,65,9,9,56,56,65,0,Terrorism
2008-08-24 00:00:00,Itek Air,Landing (descent or approach),Commercial,Kyrgyzstan,Asia,90,5,0,85,65,65,25,Technical Failure
1958-08-15 00:00:00,Aeroflot - Russian International Airlines,Flight,Commercial,Russia,Asia,64,6,6,58,58,64,0,Human Factor
1965-01-04 00:00:00,Aeroflot - Russian International Airlines,Landing (descent or approach),Commercial,Kazakhstan,Asia,103,8,3,95,61,64,39,Human Factor
1966-03-04 00:00:00,Canadian Pacific Airlines - CP Air,Landing (descent or approach),Commercial,Japan,Asia,72,10,10,62,54,64,8,Human Factor
1986-08-31 00:00:00,AeroMéxico,Landing (descent or approach),Commercial,United States of America,North America,64,6,6,58,58,64,0,Human Factor
2001-09-11 00:00:00,American Airlines,Flight,Commercial,United States of America,North America,64,6,6,58,58,64,0,Terrorism
1960-03-17 00:00:00,Northwest Airlines,Flight,Commercial,United States of America,North America,63,6,6,57,57,63,0,Technical Failure
1960-08-29 00:00:00,Air France,Landing (descent or approach),Commercial,Senegal,Africa,63,8,8,55,55,63,0,Unknown
1963-07-28 00:00:00,United Arab Airlines,Landing (descent or approach),Commercial,India,Asia,63,8,8,55,55,63,0,Weather
1968-03-05 00:00:00,Air France,Landing (descent or approach),Commercial,Guadeloupe,Central America,63,11,11,52,52,63,0,Human Factor
1971-10-02 00:00:00,British European Airways - BEA,Flight,Commercial,Belgium,Europe,63,8,8,55,55,63,0,Technical Failure
1973-05-11 00:00:00,Aeroflot - Russian International Airlines,Flight,Commercial,Kazakhstan,Asia,63,8,8,55,55,63,0,Unknown
1976-09-10 00:00:00,British Airways,Flight,Commercial,Croatia,Europe,63,9,9,54,54,63,0,Human Factor
1977-04-04 00:00:00,Southern Airways,Flight,Commercial,United States of America,North America,85,4,2,81,61,63,22,Weather
1979-08-29 00:00:00,Aeroflot - Russian International Airlines,Flight,Commercial,Russia,Asia,63,5,5,58,58,63,0,Technical Failure
1986-12-25 00:00:00,Iraqi Airways,Landing (descent or approach),Commercial,Saudi Arabia,Asia,106,15,3,91,60,63,43,Terrorism
1991-02-05 00:00:00,Hellenic Air Force - Elleniki Polemiki Aeroporia,Landing (descent or approach),Military / Government,Greece,Europe,63,5,5,58,58,63,0,Human Factor
1995-11-22 00:00:00,Sri Lanka Air Force,Landing (descent or approach),Military / Government,Sri Lanka,Asia,63,6,6,57,57,63,0,Terrorism
1999-08-31 00:00:00,Lineas Aéreas Privadas Argentinas - LAPA,Takeoff (climb),Commercial,Argentina,South America,100,5,3,95,60,63,37,Human Factor
1956-12-09 00:00:00,Trans-Canada Air Lines - TCAL,Flight,Commercial,Canada,North America,62,3,3,59,59,62,0,Technical Failure
1960-10-04 00:00:00,Eastern Airlines,Takeoff (climb),Commercial,United States of America,North America,72,5,3,67,59,62,10,Other
1969-12-03 00:00:00,Air France,Takeoff (climb),Commercial,Venezuela,South America,62,21,21,41,41,62,0,Terrorism
1973-03-19 00:00:00,Air Vietnam,Flight,Commercial,Vietnam,Asia,62,5,5,57,57,62,0,Other
1989-06-21 00:00:00,Peruvian Air Force - Fuerza Aérea del Perú,Flight,Military / Government,Peru,South America,62,5,5,57,57,62,0,Other
2016-03-19 00:00:00,FlyDubai,Landing (descent or approach),Commercial,Russia,Asia,62,7,7,55,55,62,0,Human Factor
2021-01-09 00:00:00,Sriwijaya Air,Takeoff (climb),Commercial,Indonesia,Asia,62,6,6,56,56,62,0,Unknown
1957-12-08 00:00:00,Aerolineas Argentinas,Flight,Commercial,Argentina,South America,61,6,6,55,55,61,0,Weather
1961-05-30 00:00:00,VIASA - Venezolana Internacional de Aviacion SA,Takeoff (climb),Commercial,Portugal,Europe,61,14,14,47,47,61,0,Unknown
1968-03-24 00:00:00,Aer Lingus,Flight,Commercial,Ireland,Europe,61,4,4,57,57,61,0,Unknown
1970-04-01 00:00:00,Royal Air Maroc - RAM,Landing (descent or approach),Commercial,Morocco,Africa,82,6,5,76,56,61,21,Human Factor
1972-11-28 00:00:00,Japan Airlines,Takeoff (climb),Commercial,Russia,Asia,76,14,9,62,52,61,15,Human Factor
1976-01-03 00:00:00,Aeroflot - Russian International Airlines,Takeoff (climb),Commercial,Russia,Asia,61,5,5,56,56,61,0,Technical Failure
1979-07-11 00:00:00,Garuda Indonesian Airways,Landing (descent or approach),Commercial,Indonesia,Asia,61,4,4,57,57,61,0,Human Factor
1999-02-24 00:00:00,China Southwest Airlines,Landing (descent or approach),Commercial,China,Asia,61,11,11,50,50,61,0,Technical Failure
1959-06-01 00:00:00,Aerolineas Nacionales - Costa Rica,Flight,Commercial,Nicaragua,Central America,60,5,5,55,55,60,0,Terrorism
1972-10-27 00:00:00,Air Inter,Flight,Commercial,France,Europe,68,5,5,63,55,60,8,Human Factor
1975-09-30 00:00:00,Malév Hungarian Airlines - Magyar Légiközlekedési Vallalat,Landing (descent or approach),Commercial,Lebanon,Asia,60,10,10,50,50,60,0,Unknown
1985-11-24 00:00:00,Egyptair,Parking,Commercial,Malta,Europe,98,6,0,92,60,60,38,Terrorism
1986-08-16 00:00:00,Sudan Airways,Takeoff (climb),Commercial,South Sudan,Africa,60,5,5,55,55,60,0,Terrorism
1995-03-31 00:00:00,TAROM - Transporturile Aeriene Române,Takeoff (climb),Commercial,Romania,Europe,60,11,11,49,49,60,0,Technical Failure
2005-07-16 00:00:00,Equatair,Takeoff (climb),Commercial,Equatorial Guinea,Africa,60,6,6,54,54,60,0,Human Factor
1945-10-16 00:00:00,United States Army Air Forces - USAAF,Landing (descent or approach),Military / Government,China,Asia,59,4,4,55,55,59,0,Human Factor
1956-10-10 00:00:00,United States Navy - USN,Flight,Military / Government,World,World,59,10,10,49,49,59,0,Unknown
1960-02-05 00:00:00,Lloyd Aéreo Boliviano - LAB Airlines,Takeoff (climb),Commercial,Bolivia,South America,59,4,4,55,55,59,0,Technical Failure
1961-12-17 00:00:00,Aeroflot - Russian International Airlines,Flight,Commercial,Russia,Asia,59,9,9,50,50,59,0,Human Factor
1965-08-24 00:00:00,United States Marine Corps,Takeoff (climb),Military / Government,China,Asia,71,6,4,65,55,59,12,Human Factor
1974-11-20 00:00:00,Lufthansa,Takeoff (climb),Commercial,Kenya,Africa,157,17,4,140,55,59,98,Human Factor
1976-08-15 00:00:00,SAETA - Sociedad Anonima Ecuatoriana de Transportes Aéreos,Flight,Commercial,Ecuador,South America,59,4,4,55,55,59,0,Human Factor
1977-12-02 00:00:00,Balkan Bulgarian Airlines,Landing (descent or approach),Commercial,Libya,Africa,165,6,0,159,59,59,106,Technical Failure
1979-02-12 00:00:00,Air Rhodesia,Takeoff (climb),Commercial,Zimbabwe,Africa,59,5,5,54,54,59,0,Terrorism
1979-03-17 00:00:00,Aeroflot - Russian International Airlines,Landing (descent or approach),Commercial,Russia,Asia,120,6,1,114,58,59,61,Human Factor
1950-11-13 00:00:00,Curtiss Reid Flying Services,Flight,Commercial,France,Europe,58,7,7,51,51,58,0,Human Factor
1953-07-12 00:00:00,Transocean Air Lines - TOA,Flight,Commercial,World,World,58,9,9,49,49,58,0,Weather
1955-07-27 00:00:00,El Al Israel Airlines,Flight,Commercial,Bulgaria,Europe,58,7,7,51,51,58,0,Terrorism
1956-06-30 00:00:00,United Airlines,Flight,Commercial,United States of America,North America,58,5,5,53,53,58,0,Human Factor
1957-07-16 00:00:00,KLM Royal Dutch Airlines - Koninklijke Luchtvaart Maatschappij,Takeoff (climb),Commercial,Indonesia,Asia,68,9,9,59,49,58,10,Unknown
1964-02-25 00:00:00,Eastern Airlines,Takeoff (climb),Commercial,United States of America,North America,58,7,7,51,51,58,0,Technical Failure
1965-11-08 00:00:00,American Airlines,Landing (descent or approach),Commercial,United States of America,North America,62,6,5,56,53,58,4,Human Factor
1985-02-01 00:00:00,Aeroflot - Russian International Airlines,Takeoff (climb),Commercial,Belarus,Europe,80,6,3,74,55,58,22,Weather
1992-07-14 00:00:00,Yemeni Air Force,Landing (descent or approach),Military / Government,Yemen,Asia,58,6,6,52,52,58,0,Unknown
1964-06-20 00:00:00,Civil Air Transport,Takeoff (climb),Commercial,Taiwan,Asia,57,5,5,52,52,57,0,Technical Failure
1968-09-28 00:00:00,Pan African Airlines,Landing (descent or approach),Commercial,Nigeria,Africa,57,4,4,53,53,57,0,Human Factor
1971-12-01 00:00:00,Aeroflot - Russian International Airlines,Landing (descent or approach),Commercial,Russia,Asia,57,4,4,53,53,57,0,Weather
1979-04-23 00:00:00,SAETA - Sociedad Anonima Ecuatoriana de Transportes Aéreos,Flight,Commercial,Ecuador,South America,57,5,5,52,52,57,0,Human Factor
1989-10-18 00:00:00,Soviet Air Force - Voyenno-vozdushnye sily CCCP,Landing (descent or approach),Military / Government,Azerbaijan,Asia,57,7,7,50,50,57,0,Technical Failure
1994-12-29 00:00:00,Turkish Airlines - THY Türk Hava Yollari,Landing (descent or approach),Commercial,Turkey,Asia,76,7,5,69,52,57,19,Human Factor
2000-11-15 00:00:00,Asa Pesada,Takeoff (climb),Commercial,Angola,Africa,57,5,5,52,52,57,0,Technical Failure
2007-11-30 00:00:00,AtlasJet Airlines,Landing (descent or approach),Commercial,Turkey,Asia,57,7,7,50,50,57,0,Human Factor
1951-12-16 00:00:00,Miami Airlines,Takeoff (climb),Commercial,United States of America,North America,56,4,4,52,52,56,0,Technical Failure
1966-01-15 00:00:00,Avianca,Takeoff (climb),Commercial,Colombia,South America,64,4,4,60,52,56,8,Human Factor
1973-08-18 00:00:00,Aeroflot - Russian International Airlines,Takeoff (climb),Commercial,Azerbaijan,Asia,64,4,2,60,54,56,8,Technical Failure
1992-12-21 00:00:00,Martinair Holland,Landing (descent or approach),Commercial,Portugal,Europe,340,13,2,327,54,56,284,Human Factor
1949-11-01 00:00:00,Eastern Airlines,Landing (descent or approach),Commercial,United States of America,North America,55,4,4,51,51,55,0,Human Factor
1950-08-31 00:00:00,Trans World Airlines - TWA,Flight,Commercial,Egypt,Africa,55,7,7,48,48,55,0,Technical Failure
1963-05-03 00:00:00,Air Afrique,Takeoff (climb),Commercial,Cameroon,Africa,55,7,7,48,48,55,0,Human Factor
1969-01-06 00:00:00,Continental Air Services,Flight,Commercial,Thailand,Asia,55,4,4,51,51,55,0,Unknown
1969-08-03 00:00:00,Aeroflot - Russian International Airlines,Flight,Commercial,Ukraine,Europe,55,4,4,51,51,55,0,Technical Failure
1980-04-12 00:00:00,Transbrasil,Landing (descent or approach),Commercial,Brazil,South America,58,8,8,50,47,55,3,Human Factor
1985-08-22 00:00:00,British Airtours,Takeoff (climb),Commercial,United Kingdom,Europe,137,6,2,131,53,55,82,Technical Failure
1989-09-08 00:00:00,Partnair,Flight,Commercial,Denmark,Europe,55,5,5,50,50,55,0,Human Factor
1993-04-26 00:00:00,Indian Airlines,Takeoff (climb),Commercial,India,Asia,118,6,2,112,53,55,63,Human Factor
1993-07-23 00:00:00,China Northwest Airlines,Takeoff (climb),Commercial,China,Asia,113,5,1,108,54,55,58,Human Factor
1998-09-29 00:00:00,Lionair,Flight,Commercial,Sri Lanka,Asia,55,7,7,48,48,55,0,Terrorism
2000-07-17 00:00:00,Alliance Air,Landing (descent or approach),Commercial,India,Asia,58,6,6,52,49,55,3,Human Factor
1959-09-24 00:00:00,Transports Aériens Intercontinentaux - TAI,Takeoff (climb),Commercial,France,Europe,65,9,9,56,45,54,11,Human Factor
1960-06-24 00:00:00,Real Aerovias,Landing (descent or approach),Commercial,Brazil,South America,54,5,5,49,49,54,0,Weather
1965-04-10 00:00:00,Royal Jordanian Airlines - ALIA,Takeoff (climb),Commercial,Syria,Asia,54,4,4,50,50,54,0,Technical Failure
1986-07-02 00:00:00,Aeroflot - Russian International Airlines,Flight,Commercial,Russia,Asia,92,6,2,86,52,54,38,Technical Failure
1987-01-13 00:00:00,Ethiopian Air Force - Ye Ityopya Ayer Hayl,Takeoff (climb),Military / Government,Eritrea,Africa,54,5,5,49,49,54,0,Technical Failure
1989-08-25 00:00:00,Pakistan International Airlines - PIA,Flight,Commercial,Pakistan,Asia,54,5,5,49,49,54,0,Human Factor
1989-10-26 00:00:00,China Airlines,Takeoff (climb),Commercial,Taiwan,Asia,54,7,7,47,47,54,0,Human Factor
2015-08-16 00:00:00,Trigana Air Service,Flight,Commercial,Indonesia,Asia,54,4,4,50,50,54,0,Human Factor
1947-02-15 00:00:00,Avianca,Flight,Commercial,Colombia,South America,53,5,5,48,48,53,0,Human Factor
1947-05-30 00:00:00,Eastern Airlines,Flight,Commercial,United States of America,North America,53,4,4,49,49,53,0,Unknown
1949-06-07 00:00:00,Strato Freight,Takeoff (climb),Commercial,Puerto Rico,Central America,81,6,1,75,52,53,28,Other
1951-03-23 00:00:00,United States Air Force - USAF,Flight,Military / Government,World,World,53,13,13,40,40,53,0,Technical Failure
1969-04-02 00:00:00,LOT Polish Airlines - Polskie Linie Lotnicze,Landing (descent or approach),Commercial,Poland,Europe,53,5,5,48,48,53,0,Human Factor
1976-12-25 00:00:00,Egyptair,Landing (descent or approach),Commercial,Thailand,Asia,53,9,9,44,44,53,0,Human Factor
1982-02-06 00:00:00,Republic of Korea Air Force,Landing (descent or approach),Military / Government,South Korea,Asia,53,6,6,47,47,53,0,Weather
1982-06-01 00:00:00,Republic of Korea Air Force,Takeoff (climb),Military / Government,South Korea,Asia,53,4,4,49,49,53,0,Unknown
1983-11-28 00:00:00,Nigeria Airways,Landing (descent or approach),Commercial,Nigeria,Africa,72,6,2,66,51,53,19,Human Factor
1987-06-11 00:00:00,Ariana Afghan Airlines,Takeoff (climb),Commercial,Afghanistan,Asia,55,5,5,50,48,53,2,Terrorism
1995-11-09 00:00:00,Líneas Aéreas del Estado - LADE,Flight,Military / Government,Argentina,South America,53,5,5,48,48,53,0,Weather
1996-05-03 00:00:00,Federal Air,Landing (descent or approach),Commercial,Sudan,Africa,53,5,5,48,48,53,0,Human Factor
1998-04-20 00:00:00,Transportes Aéreos Mercantiles Ecuatorianos - TAME,Takeoff (climb),Commercial,Colombia,South America,53,10,10,43,43,53,0,Human Factor
2004-11-21 00:00:00,China Yunnan Airlines,Takeoff (climb),Commercial,China,Asia,53,6,6,47,47,53,0,Human Factor
1947-10-24 00:00:00,United Airlines,Landing (descent or approach),Commercial,United States of America,North America,52,5,5,47,47,52,0,Human Factor
1948-08-01 00:00:00,Air France,Flight,Commercial,World,World,52,11,11,41,41,52,0,Technical Failure
1952-04-11 00:00:00,Pan American World Airways - PAA,Takeoff (climb),Commercial,Puerto Rico,Central America,69,5,0,64,52,52,17,Human Factor
1952-11-22 00:00:00,United States Air Force - USAF,Flight,Military / Government,United States of America,North America,52,11,11,41,41,52,0,Weather
1956-02-20 00:00:00,Transports Aériens Intercontinentaux - TAI,Landing (descent or approach),Commercial,Egypt,Africa,64,9,3,55,49,52,12,Human Factor
1961-03-28 00:00:00,CSA Czech Airlines - Československé Státní Aerolinie,Flight,Commercial,Germany,Europe,52,8,8,44,44,52,0,Technical Failure
1961-11-23 00:00:00,Aerolineas Argentinas,Takeoff (climb),Commercial,Brazil,South America,52,12,12,40,40,52,0,Human Factor
1965-07-08 00:00:00,Canadian Pacific Airlines - CP Air,Flight,Commercial,Canada,North America,52,6,6,46,46,52,0,Terrorism
1971-11-09 00:00:00,Royal Air Force - RAF,Takeoff (climb),Humanitarian,Italy,Europe,52,6,6,46,46,52,0,Technical Failure
1975-03-16 00:00:00,Líneas Aéreas del Estado - LADE,Landing (descent or approach),Commercial,Argentina,South America,52,5,5,47,47,52,0,Human Factor
1976-05-15 00:00:00,Aeroflot - Russian International Airlines,Flight,Commercial,Ukraine,Europe,52,6,6,46,46,52,0,Technical Failure
1985-09-04 00:00:00,Ariana Afghan Airlines,Takeoff (climb),Commercial,Afghanistan,Asia,52,5,5,47,47,52,0,Terrorism
1986-08-14 00:00:00,Honduran Air Force - Fuerza Aérea Hondureña,Landing (descent or approach),Military / Government,Honduras,Central America,52,6,6,46,46,52,0,Human Factor
1995-04-29 00:00:00,Helitours,Landing (descent or approach),Military / Government,Sri Lanka,Asia,52,3,3,49,49,52,0,Terrorism
1995-12-05 00:00:00,Azerbaijan Airlines - AZAL Airlines,Takeoff (climb),Commercial,Azerbaijan,Asia,82,6,2,76,50,52,30,Technical Failure
1944-10-11 00:00:00,German Air Force - Deutsche Luftwaffe,Flight,Military / Government,Norway,Europe,51,5,5,46,46,51,0,Technical Failure
1950-07-28 00:00:00,Panair do Brasil,Landing (descent or approach),Commercial,Brazil,South America,51,7,7,44,44,51,0,Human Factor
1959-01-16 00:00:00,Austral Lineas Aéreas,Landing (descent or approach),Commercial,Argentina,South America,52,5,5,47,46,51,1,Human Factor
1967-03-05 00:00:00,VARIG - Viação Aérea Rio Grandense,Landing (descent or approach),Commercial,Liberia,Africa,90,19,1,71,50,51,39,Human Factor
1968-12-12 00:00:00,Pan American World Airways - PAA,Landing (descent or approach),Commercial,Venezuela,South America,51,9,9,42,42,51,0,Human Factor
1973-12-16 00:00:00,Aeroflot - Russian International Airlines,Flight,Commercial,Russia,Asia,51,5,5,46,46,51,0,Technical Failure
1983-12-07 00:00:00,Iberia - Lineas Aéreas de Espana,Takeoff (climb),Commercial,Spain,Europe,93,9,1,84,50,51,42,Human Factor
1985-02-22 00:00:00,Air Mali,Takeoff (climb),Commercial,Mali,Africa,52,6,6,46,45,51,1,Technical Failure
1991-11-07 00:00:00,Yugavia,Landing (descent or approach),Commercial,Russia,Asia,51,4,4,47,47,51,0,Human Factor
1995-01-11 00:00:00,Intercontinental Colombia - Intercontinental de Aviación,Flight,Commercial,Colombia,South America,52,5,5,47,46,51,1,Technical Failure
1998-01-13 00:00:00,Afghan Taliban Forces,Flight,Military / Government,Pakistan,Asia,51,6,6,45,45,51,0,Technical Failure
2018-03-12 00:00:00,US-Bangla Airlines,Landing (descent or approach),Commercial,Nepal,Asia,71,4,4,67,47,51,20,Human Factor
1947-06-13 00:00:00,Pennsylvania Central Air Lines,Landing (descent or approach),Commercial,United States of America,North America,50,3,3,47,47,50,0,Human Factor
1951-06-30 00:00:00,United Airlines,Flight,Commercial,United States of America,North America,50,5,5,45,45,50,0,Human Factor
1951-08-24 00:00:00,United Airlines,Landing (descent or approach),Commercial,United States of America,North America,50,6,6,44,44,50,0,Human Factor
1952-04-29 00:00:00,Pan American World Airways - PAA,Flight,Commercial,Brazil,South America,50,9,9,41,41,50,0,Technical Failure
1956-02-18 00:00:00,Scottish Airlines,Takeoff (climb),Commercial,Malta,Europe,50,5,5,45,45,50,0,Technical Failure
1960-01-18 00:00:00,Capital Airlines,Flight,Commercial,United States of America,North America,50,6,6,44,44,50,0,Weather
1962-12-14 00:00:00,Panair do Brasil,Landing (descent or approach),Commercial,Brazil,South America,50,7,7,43,43,50,0,Unknown
1965-03-31 00:00:00,Iberia - Lineas Aéreas de Espana,Landing (descent or approach),Commercial,Morocco,Africa,53,5,5,48,45,50,3,Unknown
1966-11-13 00:00:00,All Nippon Airways,Landing (descent or approach),Commercial,Japan,Asia,50,5,5,45,45,50,0,Human Factor
1968-03-06 00:00:00,United States Air Force - USAF,Landing (descent or approach),Military / Government,Vietnam,Asia,50,5,5,45,45,50,0,Terrorism
1976-11-23 00:00:00,Olympic Airways,Landing (descent or approach),Commercial,Greece,Europe,50,4,4,46,46,50,0,Human Factor
1981-02-07 00:00:00,Soviet Navy - Voyenno-morskoy flot CCCP,Takeoff (climb),Military / Government,Russia,Asia,50,6,6,44,44,50,0,Human Factor
1981-07-20 00:00:00,Somali Airlines,Takeoff (climb),Commercial,Somalia,Africa,50,6,6,44,44,50,0,Weather
1981-08-27 00:00:00,Aeropesca Colombia,Flight,Commercial,Colombia,South America,50,6,6,44,44,50,0,Human Factor
1982-09-13 00:00:00,Spantax,Takeoff (climb),Commercial,Spain,Europe,394,13,3,381,47,50,344,Technical Failure
1984-01-10 00:00:00,Balkan Bulgarian Airlines,Landing (descent or approach),Commercial,Bulgaria,Europe,50,5,5,45,45,50,0,Human Factor
1984-09-21 00:00:00,Soviet Air Force - Voyenno-vozdushnye sily CCCP,Flight,Military / Government,Afghanistan,Asia,50,5,5,45,45,50,0,Terrorism
1987-01-03 00:00:00,VARIG - Viação Aérea Rio Grandense,Landing (descent or approach),Commercial,Ivory Coast,Africa,51,12,12,39,38,50,1,Human Factor
1987-06-26 00:00:00,Philippine Airlines - PAL,Landing (descent or approach),Commercial,Philippines,Asia,50,4,4,46,46,50,0,Human Factor
1994-06-29 00:00:00,Afghan Republican Air Force - Afghan Hanai Qurah,Flight,Military / Government,Afghanistan,Asia,70,5,5,65,45,50,20,Terrorism
1997-03-18 00:00:00,SAAK Stavropolskaya Aktsionernaya Aviakompania,Flight,Commercial,Russia,Asia,50,6,6,44,44,50,0,Human Factor
1999-06-03 00:00:00,Sudanese Air Force - Al Quwwat al-Jawwiya As-Sudaniya,Flight,Military / Government,Sudan,Africa,50,6,6,44,44,50,0,Unknown
2013-11-17 00:00:00,Tatarstan Airlines,Landing (descent or approach),Commercial,Russia,Asia,50,6,6,44,44,50,0,Human Factor
1964-04-17 00:00:00,Middle East Airlines - MEA,Landing (descent or approach),Commercial,Saudi Arabia,Asia,49,7,7,42,42,49,0,Human Factor
1964-11-23 00:00:00,Trans World Airlines - TWA,Takeoff (climb),Commercial,Italy,Europe,73,11,5,62,44,49,24,Technical Failure
1966-04-27 00:00:00,LANSA Peru - Lineas Aéreas Nacionales del Peru,Flight,Commercial,Peru,South America,49,6,6,43,43,49,0,Human Factor
1971-06-06 00:00:00,Hughes Air West,Flight,Commercial,United States of America,North America,49,5,5,44,44,49,0,Human Factor
1971-09-16 00:00:00,Malév Hungarian Airlines - Magyar Légiközlekedési Vallalat,Landing (descent or approach),Commercial,Ukraine,Europe,49,8,8,41,41,49,0,Technical Failure
1984-08-05 00:00:00,Biman Bangladesh Airlines,Landing (descent or approach),Commercial,Bangladesh,Asia,49,5,5,44,44,49,0,Human Factor
1987-10-11 00:00:00,Burma Airways,Landing (descent or approach),Commercial,Myanmar,Asia,49,4,4,45,45,49,0,Human Factor
1995-12-13 00:00:00,Banat Air,Takeoff (climb),Commercial,Italy,Europe,49,8,8,41,41,49,0,Human Factor
2000-10-31 00:00:00,ACA-Ancargo Air,Flight,Commercial,Angola,Africa,49,5,5,44,44,49,0,Terrorism
2006-08-27 00:00:00,Comair,Takeoff (climb),Commercial,United States of America,North America,50,3,2,47,47,49,1,Human Factor
2009-02-12 00:00:00,Continental Connection,Landing (descent or approach),Commercial,United States of America,North America,49,4,4,45,45,49,0,Human Factor
2013-10-16 00:00:00,Lao Airlines,Landing (descent or approach),Commercial,Laos,Asia,49,5,5,44,44,49,0,Human Factor
2014-06-14 00:00:00,Ukrainian Air Force - Povitryani Syly Ukrayini,Landing (descent or approach),Military / Government,Ukraine,Europe,49,9,9,40,40,49,0,Terrorism
2021-07-04 00:00:00,Philippine Air Force - Hukbong Himpapawid NG Pilipinas,Landing (descent or approach),Military / Government,Philippines,Asia,96,8,0,88,49,49,47,Unknown
1949-10-28 00:00:00,Air France,Landing (descent or approach),Commercial,Portugal,Europe,48,11,11,37,37,48,0,Technical Failure
1950-11-03 00:00:00,Air India,Flight,Commercial,France,Europe,48,8,8,40,40,48,0,Human Factor
1962-09-10 00:00:00,United States Air Force - USAF,Landing (descent or approach),Military / Government,United States of America,North America,44,4,4,40,44,48,-4,Human Factor
1968-08-09 00:00:00,British Eagle Airways - BEA,Flight,Commercial,Germany,Europe,48,4,4,44,44,48,0,Technical Failure
1969-01-05 00:00:00,Ariana Afghan Airlines,Landing (descent or approach),Commercial,United Kingdom,Europe,62,8,5,54,43,48,14,Human Factor
1971-11-12 00:00:00,Aeroflot - Russian International Airlines,Landing (descent or approach),Commercial,Ukraine,Europe,48,5,5,43,43,48,0,Human Factor
1973-05-31 00:00:00,Indian Airlines,Landing (descent or approach),Commercial,India,Asia,65,7,5,58,43,48,17,Human Factor
1974-08-14 00:00:00,Linea Aeropostal Venezolana - LAV,Landing (descent or approach),Commercial,Venezuela,South America,48,4,4,44,44,48,0,Weather
1976-12-17 00:00:00,Aeroflot - Russian International Airlines,Landing (descent or approach),Commercial,Ukraine,Europe,55,5,4,50,44,48,7,Human Factor
1978-03-25 00:00:00,Burma Airways,Takeoff (climb),Commercial,Myanmar,Asia,48,4,4,44,44,48,0,Technical Failure
1978-09-03 00:00:00,Air Rhodesia,Takeoff (climb),Commercial,Zimbabwe,Africa,56,4,4,52,44,48,8,Terrorism
1981-06-14 00:00:00,Aeroflot - Russian International Airlines,Flight,Commercial,Russia,Asia,48,4,4,44,44,48,0,Human Factor
1995-06-17 00:00:00,Angola Air Force - Força Aérea Nacional Angolana,Landing (descent or approach),Commercial,Angola,Africa,53,3,3,50,45,48,5,Human Factor
2014-07-23 00:00:00,TransAsia Airways,Landing (descent or approach),Commercial,Taiwan,Asia,58,4,4,54,44,48,10,Human Factor
1954-08-16 00:00:00,Air Vietnam,Landing (descent or approach),Humanitarian,Laos,Asia,55,4,1,51,46,47,8,Technical Failure
1958-04-06 00:00:00,Capital Airlines,Landing (descent or approach),Commercial,United States of America,North America,47,3,3,44,44,47,0,Weather
1958-04-21 00:00:00,United Airlines,Flight,Commercial,United States of America,North America,47,5,5,42,42,47,0,Human Factor
1968-09-03 00:00:00,Transportno Aviatsionno Bulgaro-Savetsko Obedinenie - TABSO,Landing (descent or approach),Commercial,Bulgaria,Europe,89,9,5,80,42,47,42,Human Factor
1970-02-21 00:00:00,Swissair,Flight,Commercial,Switzerland,Europe,47,9,9,38,38,47,0,Terrorism
1970-11-27 00:00:00,Capitol International Airways,Takeoff (climb),Commercial,United States of America,North America,229,10,1,219,46,47,182,Technical Failure
1974-08-11 00:00:00,Air Mali,Flight,Commercial,Burkina Faso,Africa,60,10,8,50,39,47,13,Technical Failure
1978-03-03 00:00:00,Linea Aeropostal Venezolana - LAV,Takeoff (climb),Commercial,Venezuela,South America,47,4,4,43,43,47,0,Technical Failure
1979-12-25 00:00:00,Soviet Air Force - Voyenno-vozdushnye sily CCCP,Flight,Military / Government,Afghanistan,Asia,47,9,9,38,38,47,0,Human Factor
1983-01-16 00:00:00,Turkish Airlines - THY Türk Hava Yollari,Landing (descent or approach),Commercial,Turkey,Asia,67,7,0,60,47,47,20,Weather
1989-01-08 00:00:00,British Midland Airways - BMA,Landing (descent or approach),Commercial,United Kingdom,Europe,126,8,0,118,47,47,79,Human Factor
1990-08-01 00:00:00,Aeroflot - Russian International Airlines,Landing (descent or approach),Commercial,Azerbaijan,Asia,47,4,4,43,43,47,0,Human Factor
1991-02-22 00:00:00,Angola Air Force - Força Aérea Nacional Angolana,Landing (descent or approach),Military / Government,Angola,Africa,47,4,4,43,43,47,0,Terrorism
1992-06-06 00:00:00,COPA Panama - Compania Panamena de Aviacion,Flight,Commercial,Panama,Central America,47,7,7,40,40,47,0,Technical Failure
1994-08-05 00:00:00,Russian Air Force - Voyenno-vozdushnye sily Rossii,Landing (descent or approach),Military / Government,Russia,Asia,47,6,6,41,41,47,0,Human Factor
2011-06-20 00:00:00,RusAir,Landing (descent or approach),Commercial,Russia,Asia,52,9,8,43,39,47,5,Human Factor
2016-12-07 00:00:00,Pakistan International Airlines - PIA,Flight,Commercial,Pakistan,Asia,47,5,5,42,42,47,0,Technical Failure
1950-06-13 00:00:00,Air France,Landing (descent or approach),Commercial,Bahrain,Asia,52,8,6,44,40,46,6,Human Factor
1950-12-08 00:00:00,Transports Aériens Intercontinentaux - TAI,Takeoff (climb),Commercial,Central African Republic,Africa,56,6,3,50,43,46,10,Human Factor
1952-09-10 00:00:00,SAM Colombia - Sociedad Aeronáutica de Medellín,Flight,Commercial,Panama,Central America,46,4,4,42,42,46,0,Unknown
1953-02-14 00:00:00,National Airlines,Flight,Commercial,United States of America,North America,46,5,5,41,41,46,0,Weather
1955-08-11 00:00:00,United States Air Force - USAF,Flight,Operational,Germany,Europe,46,5,5,41,41,46,0,Human Factor
1956-07-13 00:00:00,United States Air Force - USAF,Takeoff (climb),Military / Government,United States of America,North America,66,10,8,56,38,46,20,Weather
1964-05-08 00:00:00,Argentinian Air Force - Fuerza Aérea Argentina,Landing (descent or approach),Military / Government,Peru,South America,49,7,6,42,40,46,3,Human Factor
1966-01-25 00:00:00,United States Air Force - USAF,Takeoff (climb),Military / Government,Vietnam,Asia,46,4,4,42,42,46,0,Technical Failure
1966-01-28 00:00:00,Lufthansa,Landing (descent or approach),Commercial,Germany,Europe,46,4,4,42,42,46,0,Technical Failure
1977-11-21 00:00:00,Austral Lineas Aéreas,Landing (descent or approach),Commercial,Argentina,South America,79,5,5,74,41,46,33,Human Factor
1980-02-22 00:00:00,Indian Air Force - Bharatiya Vayu Sena,Takeoff (climb),Humanitarian,India,Asia,47,4,4,43,42,46,1,Human Factor
1982-12-09 00:00:00,Aeronor-Chile - Transportes Aero Norte-Sur,Landing (descent or approach),Commercial,Chile,South America,46,4,4,42,42,46,0,Human Factor
1985-03-28 00:00:00,SATENA - Servicio de Aeronavegacion a Territorios Nacionales,Landing (descent or approach),Commercial,Colombia,South America,46,6,6,40,40,46,0,Human Factor
1987-06-18 00:00:00,Peruvian Air Force - Fuerza Aérea del Perú,Landing (descent or approach),Military / Government,Peru,South America,46,6,6,40,40,46,0,Weather
1990-10-02 00:00:00,China Southern Airlines,Parking,Commercial,China,Asia,118,12,0,106,46,46,72,Terrorism
1990-11-14 00:00:00,Alitalia - Linee Aeree Italiane,Landing (descent or approach),Commercial,Switzerland,Europe,46,6,6,40,40,46,0,Technical Failure
1992-04-16 00:00:00,Kenya Air Force,Landing (descent or approach),Military / Government,Kenya,Africa,46,4,4,42,42,46,0,Technical Failure
2003-01-09 00:00:00,Transportes Aéreos Nacionales de la Selva - TANS,Landing (descent or approach),Commercial,Peru,South America,46,5,5,41,41,46,0,Human Factor
2004-08-24 00:00:00,Sibir Airlines,Flight,Commercial,Russia,Asia,46,8,8,38,38,46,0,Terrorism
2008-02-21 00:00:00,Santa Barbara Airlines,Takeoff (climb),Commercial,Venezuela,South America,46,3,3,43,43,46,0,Human Factor
1943-01-13 00:00:00,German Air Force - Deutsche Luftwaffe,Takeoff (climb),Humanitarian,Russia,Asia,81,6,5,75,40,45,36,Unknown
1945-10-30 00:00:00,United States Army Air Forces - USAAF,Takeoff (climb),Military / Government,China,Asia,50,4,3,46,42,45,5,Human Factor
1949-07-12 00:00:00,KLM Royal Dutch Airlines - Koninklijke Luchtvaart Maatschappij,Landing (descent or approach),Commercial,India,Asia,45,10,10,35,35,45,0,Human Factor
1952-03-22 00:00:00,KLM Royal Dutch Airlines - Koninklijke Luchtvaart Maatschappij,Landing (descent or approach),Commercial,Germany,Europe,47,10,9,37,36,45,2,Human Factor
1958-06-02 00:00:00,Aeronaves de Mexico,Takeoff (climb),Commercial,Mexico,Central America,45,7,7,38,38,45,0,Human Factor
1959-12-08 00:00:00,SAM Colombia - Sociedad Aeronáutica de Medellín,Flight,Commercial,World,World,45,3,3,42,42,45,0,Unknown
1961-11-01 00:00:00,Panair do Brasil,Landing (descent or approach),Commercial,Brazil,South America,88,9,7,79,38,45,43,Human Factor
1962-05-22 00:00:00,Continental Airlines,Flight,Commercial,United States of America,North America,45,8,8,37,37,45,0,Terrorism
1964-03-28 00:00:00,Alitalia - Linee Aeree Italiane,Landing (descent or approach),Commercial,Italy,Europe,45,5,5,40,40,45,0,Human Factor
1968-01-06 00:00:00,Aeroflot - Russian International Airlines,Flight,Commercial,Russia,Asia,45,6,6,39,39,45,0,Unknown
1969-04-16 00:00:00,WIGMO - Western International Ground Maintenance Organization,Landing (descent or approach),Commercial,Democratic Republic of Congo,Africa,45,3,3,42,42,45,0,Technical Failure
1969-09-12 00:00:00,Philippine Airlines - PAL,Landing (descent or approach),Commercial,Philippines,Asia,47,5,4,42,41,45,2,Human Factor
1970-04-01 00:00:00,Aeroflot - Russian International Airlines,Flight,Commercial,Russia,Asia,45,5,5,40,40,45,0,Other
1971-01-18 00:00:00,Balkan Bulgarian Airlines,Landing (descent or approach),Commercial,Switzerland,Europe,47,8,7,39,38,45,2,Human Factor
1976-06-01 00:00:00,Aeroflot - Russian International Airlines,Landing (descent or approach),Commercial,Equatorial Guinea,Africa,45,10,10,35,35,45,0,Human Factor
1976-06-05 00:00:00,Air Manila International,Takeoff (climb),Commercial,Guam Island,Asia,45,12,12,33,33,45,0,Human Factor
1979-03-14 00:00:00,Royal Jordanian Airlines - ALIA,Landing (descent or approach),Commercial,Qatar,Asia,64,15,4,49,41,45,19,Weather
1979-08-04 00:00:00,Indian Airlines,Landing (descent or approach),Commercial,India,Asia,45,5,5,40,40,45,0,Technical Failure
1987-06-21 00:00:00,Burma Airways,Flight,Commercial,Myanmar,Asia,45,4,4,41,41,45,0,Human Factor
1991-03-05 00:00:00,Linea Aeropostal Venezolana - LAV,Flight,Commercial,Venezuela,South America,45,5,5,40,40,45,0,Human Factor
1995-04-28 00:00:00,Helitours,Landing (descent or approach),Military / Government,Sri Lanka,Asia,45,3,3,42,42,45,0,Terrorism
1998-03-19 00:00:00,Ariana Afghan Airlines,Landing (descent or approach),Commercial,Afghanistan,Asia,45,10,10,35,35,45,0,Human Factor
2001-09-11 00:00:00,United Airlines,Flight,Commercial,United States of America,North America,45,7,7,38,38,45,0,Terrorism
2006-07-10 00:00:00,Pakistan International Airlines - PIA,Takeoff (climb),Commercial,Pakistan,Asia,45,4,4,41,41,45,0,Technical Failure
2012-05-09 00:00:00,Sukhoï,Flight,Operational,Indonesia,Asia,45,4,4,41,41,45,0,Human Factor
1945-05-23 00:00:00,United States Army Air Forces - USAAF,Flight,Humanitarian,France,Europe,44,4,4,40,40,44,0,Technical Failure
1945-11-03 00:00:00,United States Army Air Forces - USAAF,Flight,Military / Government,Bhutan,Asia,44,4,4,40,40,44,0,Human Factor
1947-10-26 00:00:00,Aktiebolaget Aerotransport - ABA,Landing (descent or approach),Commercial,Greece,Europe,44,8,8,36,36,44,0,Human Factor
1950-01-26 00:00:00,United States Air Force - USAF,Flight,Military / Government,Canada,North America,44,8,8,36,36,44,0,Weather
1952-11-14 00:00:00,United States Air Force - USAF,Landing (descent or approach),Military / Government,South Korea,Asia,44,7,7,37,37,44,0,Human Factor
1953-07-17 00:00:00,United States Navy - USN,Takeoff (climb),Military / Government,United States of America,North America,46,6,5,40,39,44,2,Human Factor
1953-10-14 00:00:00,SABENA - Société Anonyme Belge d'Exploitation de la Navigation Aérienne,Takeoff (climb),Commercial,Germany,Europe,44,4,4,40,40,44,0,Technical Failure
1955-11-01 00:00:00,United Airlines,Flight,Commercial,United States of America,North America,44,5,5,39,39,44,0,Terrorism
1957-11-08 00:00:00,Pan American World Airways - PAA,Flight,Commercial,World,World,44,8,8,36,36,44,0,Technical Failure
1960-12-16 00:00:00,Trans World Airlines - TWA,Landing (descent or approach),Commercial,United States of America,North America,44,6,6,38,38,44,0,Human Factor
1964-05-07 00:00:00,Pacific Air Lines,Flight,Commercial,United States of America,North America,44,3,3,41,41,44,0,Terrorism
1969-04-21 00:00:00,Indian Airlines,Landing (descent or approach),Commercial,India,Asia,44,4,4,40,40,44,0,Weather
1974-06-08 00:00:00,Aerolineas TAO,Landing (descent or approach),Commercial,Colombia,South America,44,6,6,38,38,44,0,Technical Failure
1977-03-03 00:00:00,Italian Air Force - Aeronautica Militare Italiana,Takeoff (climb),Military / Government,Italy,Europe,44,5,5,39,39,44,0,Human Factor
1978-02-10 00:00:00,Transporte Aéreo Militar de Uruguay - TAMU,Landing (descent or approach),Commercial,Uruguay,South America,44,4,4,40,40,44,0,Technical Failure
1980-04-27 00:00:00,Thai Airways International,Landing (descent or approach),Commercial,Thailand,Asia,53,4,4,49,40,44,9,Human Factor
1982-06-12 00:00:00,Transportes Aéreos Regionais da Bacia Amazônica - TABA,Landing (descent or approach),Commercial,Brazil,South America,44,4,4,40,40,44,0,Human Factor
1982-09-01 00:00:00,Aerolineas Condor,Flight,Commercial,Ecuador,South America,44,4,4,40,40,44,0,Human Factor
1983-12-24 00:00:00,Aeroflot - Russian International Airlines,Landing (descent or approach),Commercial,Russia,Asia,49,5,4,44,40,44,5,Human Factor
1986-03-30 00:00:00,Mozambique Air Force - Força Aérea de Moçambique,Landing (descent or approach),Military / Government,Mozambique,Africa,49,3,3,46,41,44,5,Technical Failure
1988-10-07 00:00:00,Shanxi Airlines,Takeoff (climb),Commercial,China,Asia,48,4,4,44,40,44,4,Technical Failure
1994-08-21 00:00:00,Royal Air Maroc - RAM,Flight,Commercial,Morocco,Africa,44,4,4,40,40,44,0,Human Factor
1997-07-11 00:00:00,Cubana de Aviación,Takeoff (climb),Commercial,Cuba,Central America,44,5,5,39,39,44,0,Technical Failure
2002-12-23 00:00:00,Aeromist Kharkov,Landing (descent or approach),Commercial,Iran,Asia,44,6,6,38,38,44,0,Human Factor
2004-08-24 00:00:00,Volga Aviaexpress,Flight,Commercial,Russia,Asia,44,9,9,35,35,44,0,Terrorism
2010-05-17 00:00:00,Pamir Airways,Flight,Commercial,Afghanistan,Asia,44,6,6,38,38,44,0,Human Factor
2010-08-24 00:00:00,Henan Airlines,Landing (descent or approach),Commercial,China,Asia,96,5,0,91,44,44,52,Human Factor
2011-09-07 00:00:00,Yak Service,Takeoff (climb),Commercial,Russia,Asia,45,8,7,37,37,44,1,Human Factor
1947-01-05 00:00:00,China National Aviation Corporation - CNAC,Landing (descent or approach),Commercial,China,Asia,43,5,5,38,38,43,0,Human Factor
1947-05-29 00:00:00,United Airlines,Takeoff (climb),Commercial,United States of America,North America,48,4,2,44,41,43,5,Human Factor
1948-06-17 00:00:00,United Airlines,Flight,Commercial,United States of America,North America,43,4,4,39,39,43,0,Other
1953-05-02 00:00:00,British Overseas Airways Corporation - BOAC,Takeoff (climb),Commercial,India,Asia,43,6,6,37,37,43,0,Weather
1957-11-15 00:00:00,Aquila Airways,Landing (descent or approach),Commercial,United Kingdom,Europe,58,8,8,50,35,43,15,Technical Failure
1963-02-12 00:00:00,Northwest Airlines,Flight,Commercial,United States of America,North America,43,8,8,35,35,43,0,Weather
1965-03-20 00:00:00,Aeroflot - Russian International Airlines,Landing (descent or approach),Commercial,Russia,Asia,47,5,1,42,42,43,4,Human Factor
1965-11-11 00:00:00,United Airlines,Landing (descent or approach),Commercial,United States of America,North America,91,6,0,85,43,43,48,Human Factor
1967-12-30 00:00:00,Aeroflot - Russian International Airlines,Landing (descent or approach),Commercial,Latvia,Europe,51,5,3,46,40,43,8,Technical Failure
1970-10-02 00:00:00,United States Air Force - USAF,Flight,Military / Government,Taiwan,Asia,43,6,6,37,37,43,0,Human Factor
1972-04-18 00:00:00,East African Airways,Takeoff (climb),Commercial,Ethiopia,Africa,107,11,8,96,35,43,64,Technical Failure
1972-12-08 00:00:00,United Airlines,Landing (descent or approach),Commercial,United States of America,North America,61,6,3,55,40,43,18,Human Factor
1980-01-24 00:00:00,Myanmar Air Force - Tatmadaw Lei,Landing (descent or approach),Military / Government,Myanmar,Asia,44,5,5,39,38,43,1,Technical Failure
1987-12-07 00:00:00,Pacific Southwest Airlines - PSA,Flight,Commercial,United States of America,North America,43,5,5,38,38,43,0,Terrorism
2004-02-10 00:00:00,Kish Air,Landing (descent or approach),Commercial,United Arab Emirates,Asia,46,6,6,40,37,43,3,Human Factor
2015-02-04 00:00:00,TransAsia Airways,Takeoff (climb),Commercial,Taiwan,Asia,58,5,4,53,39,43,15,Human Factor
1947-10-16 00:00:00,Société Aérienne du Littoral - SAL,Flight,Commercial,Spain,Europe,44,5,4,39,38,42,2,Technical Failure
1953-09-01 00:00:00,Air France,Flight,Commercial,France,Europe,42,9,9,33,33,42,0,Human Factor
1954-10-31 00:00:00,United States Navy - USN,Flight,Military / Government,World,World,42,21,21,21,21,42,0,Technical Failure
1959-11-16 00:00:00,National Airlines,Flight,Commercial,United States of America,North America,42,6,6,36,36,42,0,Unknown
1960-01-19 00:00:00,Scandinavian Airlines System - SAS,Landing (descent or approach),Commercial,Turkey,Asia,42,7,7,35,35,42,0,Human Factor
1966-08-06 00:00:00,Braniff Airways,Flight,Commercial,United States of America,North America,42,5,5,37,37,42,0,Weather
1967-07-19 00:00:00,Air Madagascar,Takeoff (climb),Commercial,Madagascar,Africa,75,5,3,70,39,42,33,Technical Failure
1970-11-29 00:00:00,United States Air Force - USAF,Landing (descent or approach),Military / Government,Vietnam,Asia,44,5,5,39,37,42,2,Human Factor
1973-08-27 00:00:00,Aerocondor de Colombia - Aerovias Condor,Takeoff (climb),Commercial,Colombia,South America,42,6,6,36,36,42,0,Human Factor
1975-01-30 00:00:00,Turkish Airlines - THY Türk Hava Yollari,Landing (descent or approach),Commercial,Turkey,Asia,42,4,4,38,38,42,0,Human Factor
1975-02-09 00:00:00,German Air Force - Deutsche Luftwaffe,Landing (descent or approach),Military / Government,Greece,Europe,42,5,5,37,37,42,0,Weather
1978-02-11 00:00:00,Pacific Western Airlines - PWA,Landing (descent or approach),Commercial,Canada,North America,49,5,4,44,38,42,7,Human Factor
1983-12-07 00:00:00,Aviaco - Aviacion y Comercio,Taxiing,Commercial,Spain,Europe,42,5,5,37,37,42,0,Human Factor
1987-12-08 00:00:00,Peruvian Navy - Aviación Naval,Landing (descent or approach),Commercial,Peru,South America,43,6,5,37,37,42,1,Human Factor
1989-07-23 00:00:00,Angola Air Force - Força Aérea Nacional Angolana,Landing (descent or approach),Military / Government,Angola,Africa,48,4,4,44,38,42,6,Terrorism
1995-09-21 00:00:00,MIAT Mongolian Airlines - Mongolyn Irgeniy Agaaryn Teever,Landing (descent or approach),Commercial,Mongolia,Asia,43,6,6,37,36,42,1,Human Factor
2000-06-22 00:00:00,Wuhan Airlines - Air Wuhan,Landing (descent or approach),Commercial,China,Asia,42,4,4,38,38,42,0,Weather
2006-01-19 00:00:00,Slovak Air Force - Letectva a Protivzdu Obrany-snej Slovenskej,Landing (descent or approach),Military / Government,Hungary,Europe,43,8,8,35,34,42,1,Human Factor
1945-09-08 00:00:00,Royal Air Force - RAF,Takeoff (climb),Humanitarian,Myanmar,Asia,41,4,4,37,37,41,0,Weather
1947-05-29 00:00:00,United States Army Air Forces - USAAF,Landing (descent or approach),Military / Government,Japan,Asia,41,8,8,33,33,41,0,Human Factor
1958-02-01 00:00:00,United States Air Force - USAF,Takeoff (climb),Military / Government,United States of America,North America,41,6,6,35,35,41,0,Human Factor
1965-07-06 00:00:00,Royal Air Force - RAF,Flight,Operational,United Kingdom,Europe,41,6,6,35,35,41,0,Technical Failure
1973-09-11 00:00:00,JAT Yugoslav Airlines - Jugoslovenski Aerotransport,Landing (descent or approach),Commercial,Montenegro,Europe,41,6,6,35,35,41,0,Human Factor
1991-11-26 00:00:00,Tatarstan Airlines,Landing (descent or approach),Commercial,Russia,Asia,41,4,4,37,37,41,0,Human Factor
1993-07-01 00:00:00,Merpati Nusantara Airlines - MNA,Landing (descent or approach),Commercial,Indonesia,Asia,43,4,4,39,37,41,2,Human Factor
1998-10-10 00:00:00,Congo Airlines,Takeoff (climb),Commercial,Democratic Republic of Congo,Africa,41,3,3,38,38,41,0,Terrorism
2015-11-04 00:00:00,Allied Services Limited,Takeoff (climb),Operational,South Sudan,Africa,43,6,6,37,35,41,2,Other
2019-05-05 00:00:00,Aeroflot - Russian International Airlines,Landing (descent or approach),Commercial,Russia,Asia,78,5,1,73,40,41,37,Human Factor
1943-06-14 00:00:00,United States Army Air Forces - USAAF,Takeoff (climb),Military / Government,Australia,Oceania,41,6,6,35,34,40,1,Unknown
1948-10-20 00:00:00,KLM Royal Dutch Airlines - Koninklijke Luchtvaart Maatschappij,Landing (descent or approach),Commercial,United Kingdom,Europe,40,10,10,30,30,40,0,Human Factor
1950-06-15 00:00:00,Air France,Landing (descent or approach),Commercial,Bahrain,Asia,53,8,3,45,37,40,13,Human Factor
1951-06-22 00:00:00,Pan American World Airways - PAA,Landing (descent or approach),Commercial,Liberia,Africa,40,6,6,34,34,40,0,Human Factor
1953-01-07 00:00:00,Associated Air Transport,Flight,Commercial,United States of America,North America,40,3,3,37,37,40,0,Weather
1956-02-17 00:00:00,United States Navy - USN,Landing (descent or approach),Military / Government,United States of America,North America,40,5,5,35,35,40,0,Human Factor
1957-04-07 00:00:00,VARIG - Viação Aérea Rio Grandense,Landing (descent or approach),Commercial,Brazil,South America,40,5,5,35,35,40,0,Technical Failure
1959-11-16 00:00:00,Aeroflot - Russian International Airlines,Landing (descent or approach),Commercial,Ukraine,Europe,40,8,8,32,32,40,0,Weather
1962-04-22 00:00:00,AVISPA - Aerovias Pilotos Associados de Medellín,Flight,Commercial,Colombia,South America,40,4,4,36,36,40,0,Human Factor
1963-09-12 00:00:00,Air Nautic,Flight,Commercial,France,Europe,40,4,4,36,36,40,0,Human Factor
1968-08-18 00:00:00,United Arab Airlines,Flight,Commercial,World,World,40,7,7,33,33,40,0,Unknown
1969-06-28 00:00:00,Aeroflot - Russian International Airlines,Takeoff (climb),Commercial,Kyrgyzstan,Asia,40,5,5,35,35,40,0,Human Factor
1971-04-15 00:00:00,Philippine Air Force - Hukbong Himpapawid NG Pilipinas,Takeoff (climb),Military / Government,Philippines,Asia,40,4,4,36,36,40,0,Technical Failure
1972-12-23 00:00:00,Braathens SAFE - South America %26 Far East,Landing (descent or approach),Commercial,Norway,Europe,45,3,3,42,37,40,5,Human Factor
1975-07-15 00:00:00,Aeroflot - Russian International Airlines,Landing (descent or approach),Commercial,Georgia,Asia,40,5,5,35,35,40,0,Human Factor
1976-01-21 00:00:00,CAAC - Civil Aviation Administration of China,Landing (descent or approach),Commercial,China,Asia,40,4,4,36,36,40,0,Unknown
1979-09-03 00:00:00,Aeroflot - Russian International Airlines,Landing (descent or approach),Commercial,Russia,Asia,43,6,5,37,35,40,3,Human Factor
1986-11-25 00:00:00,Afghan Republican Air Force - Afghan Hanai Qurah,Flight,Military / Government,Afghanistan,Asia,40,5,5,35,35,40,0,Terrorism
1987-03-30 00:00:00,Afghan Republican Air Force - Afghan Hanai Qurah,Flight,Military / Government,Pakistan,Asia,40,4,4,36,36,40,0,Terrorism
2000-03-30 00:00:00,Sri Lanka Air Force,Landing (descent or approach),Military / Government,Sri Lanka,Asia,40,4,4,36,36,40,0,Terrorism
2005-08-23 00:00:00,Transportes Aéreos Nacionales de la Selva - TANS,Landing (descent or approach),Commercial,Peru,South America,98,7,5,91,35,40,58,Human Factor
2006-06-03 00:00:00,Chinese Air Force - AFPLA - Chung-Kuo Shan Min Taie Fang Tsun Pu-Tai,Flight,Military / Government,China,Asia,40,5,5,35,35,40,0,Weather
2014-08-10 00:00:00,Sepahan Airlines,Takeoff (climb),Commercial,Iran,Asia,48,6,6,42,34,40,8,Technical Failure
1946-10-03 00:00:00,American Overseas Airlines,Takeoff (climb),Commercial,Canada,North America,39,8,8,31,31,39,0,Human Factor
1950-07-23 00:00:00,United States Air Force - USAF,Takeoff (climb),Military / Government,United States of America,North America,39,4,4,35,35,39,0,Technical Failure
1951-04-25 00:00:00,Cubana de Aviación,Flight,Commercial,United States of America,North America,39,5,5,34,34,39,0,Human Factor
1951-09-12 00:00:00,Société de Transports Aériens Alpes Provence - STAAP,Flight,Commercial,Spain,Europe,39,3,3,36,36,39,0,Technical Failure
1953-02-02 00:00:00,Skyways of London,Flight,Commercial,World,World,39,6,6,33,33,39,0,Unknown
1960-07-19 00:00:00,Belgian Air Force - Force Aérienne Belge - Belgische Luchtmacht,Flight,Military / Government,Democratic Republic of Congo,Africa,43,3,3,40,36,39,4,Technical Failure
1961-08-09 00:00:00,Cunard Eagle Airways,Flight,Commercial,Norway,Europe,39,3,3,36,36,39,0,Human Factor
1963-03-15 00:00:00,Lloyd Aéreo Boliviano - LAB Airlines,Flight,Commercial,Peru,South America,39,3,3,36,36,39,0,Human Factor
1964-07-09 00:00:00,United Airlines,Flight,Commercial,United States of America,North America,39,4,4,35,35,39,0,Technical Failure
1964-09-04 00:00:00,VASP - Viação Aérea de São Paulo,Flight,Commercial,Brazil,South America,39,5,5,34,34,39,0,Human Factor
1965-09-16 00:00:00,Air Vietnam,Takeoff (climb),Commercial,Vietnam,Asia,39,4,4,35,35,39,0,Terrorism
1968-12-02 00:00:00,Wien Consolidated Airlines,Flight,Commercial,United States of America,North America,39,3,3,36,36,39,0,Weather
1970-08-29 00:00:00,Indian Airlines,Takeoff (climb),Commercial,India,Asia,39,5,5,34,34,39,0,Human Factor
1972-01-21 00:00:00,SATENA - Servicio de Aeronavegacion a Territorios Nacionales,Flight,Commercial,Colombia,South America,39,4,4,35,35,39,0,Human Factor
1972-03-14 00:00:00,Republic of China Air Force,Flight,Humanitarian,Taiwan,Asia,39,6,6,33,33,39,0,Unknown
1973-01-21 00:00:00,Aeroflot - Russian International Airlines,Flight,Commercial,Russia,Asia,39,5,5,34,34,39,0,Unknown
1977-07-20 00:00:00,Aeroflot - Russian International Airlines,Takeoff (climb),Commercial,Russia,Asia,40,6,6,34,33,39,1,Human Factor
1988-08-15 00:00:00,Afghan Republican Air Force - Afghan Hanai Qurah,Landing (descent or approach),Military / Government,Afghanistan,Asia,39,4,4,35,35,39,0,Terrorism
1992-04-26 00:00:00,Islamic Republic of Iran Air Force,Flight,Commercial,Iran,Asia,39,4,4,35,35,39,0,Weather
1998-05-12 00:00:00,Mauritanian Air Force - Force Aérienne Islamique de Mauritanie,Takeoff (climb),Military / Government,Mauritania,Africa,42,7,7,35,32,39,3,Technical Failure
2018-03-06 00:00:00,Russian Air Force - Voyenno-vozdushnye sily Rossii,Landing (descent or approach),Military / Government,Syria,Asia,39,6,6,33,33,39,0,Unknown
1949-12-09 00:00:00,Civil Air Transport,Takeoff (climb),Commercial,China,Asia,38,5,5,33,33,38,0,Unknown
1950-12-19 00:00:00,United States Air Force - USAF,Flight,Military / Government,Philippines,Asia,38,7,7,31,31,38,0,Human Factor
1952-03-03 00:00:00,Air France,Takeoff (climb),Commercial,France,Europe,38,4,4,34,34,38,0,Technical Failure
1963-06-26 00:00:00,Belgian Air Force - Force Aérienne Belge - Belgische Luchtmacht,Flight,Military / Government,Germany,Europe,47,5,5,42,33,38,9,Terrorism
1964-12-11 00:00:00,South Vietnamese Air Force,Takeoff (climb),Military / Government,Vietnam,Asia,38,6,6,32,32,38,0,Unknown
1967-03-05 00:00:00,Lake Central Airlines,Flight,Commercial,United States of America,North America,38,3,3,35,35,38,0,Technical Failure
1969-01-18 00:00:00,United Airlines,Takeoff (climb),Commercial,United States of America,North America,38,6,6,32,32,38,0,Technical Failure
1970-03-14 00:00:00,Paraense Transportes Aéreos,Landing (descent or approach),Commercial,Brazil,South America,40,5,4,35,34,38,2,Human Factor
1973-07-23 00:00:00,Ozark Air Lines,Landing (descent or approach),Commercial,United States of America,North America,44,3,1,41,37,38,6,Human Factor
1974-01-01 00:00:00,Aerolinee Itavia,Landing (descent or approach),Commercial,Italy,Europe,42,4,3,38,35,38,4,Human Factor
1975-11-17 00:00:00,Aeroflot - Russian International Airlines,Flight,Commercial,Georgia,Asia,38,5,5,33,33,38,0,Human Factor
1977-07-24 00:00:00,Chilean Air Force - Fuerza Aérea de Chile,Landing (descent or approach),Military / Government,Chile,South America,82,7,7,75,31,38,44,Human Factor
1978-10-07 00:00:00,Aeroflot - Russian International Airlines,Takeoff (climb),Commercial,Russia,Asia,38,4,4,34,34,38,0,Weather
1983-06-07 00:00:00,Republic of China Air Force,Takeoff (climb),Military / Government,China,Asia,47,8,8,39,30,38,9,Technical Failure
1985-01-18 00:00:00,CAAC - Civil Aviation Administration of China,Landing (descent or approach),Commercial,China,Asia,41,7,7,34,31,38,3,Human Factor
1985-01-19 00:00:00,Cubana de Aviación,Takeoff (climb),Commercial,Cuba,Central America,38,5,5,33,33,38,0,Technical Failure
1986-03-02 00:00:00,Aeroflot - Russian International Airlines,Landing (descent or approach),Commercial,Russia,Asia,38,4,4,34,34,38,0,Technical Failure
1990-11-21 00:00:00,Bangkok Airways,Landing (descent or approach),Commercial,Thailand,Asia,38,5,5,33,33,38,0,Human Factor
1998-09-25 00:00:00,Paukn Air,Landing (descent or approach),Commercial,Morocco,Africa,38,4,4,34,34,38,0,Human Factor
2006-11-27 00:00:00,Islamic Revolutionary Guard Corps,Takeoff (climb),Military / Government,Iran,Asia,38,6,6,32,32,38,0,Technical Failure
2019-12-09 00:00:00,Chilean Air Force - Fuerza Aérea de Chile,Flight,Military / Government,World,World,38,17,17,21,21,38,0,Unknown
1945-02-07 00:00:00,United States Army Air Forces - USAAF,Flight,Military / Government,China,Asia,39,4,2,35,35,37,2,Technical Failure
1945-03-10 00:00:00,United States Army Air Forces - USAAF,Landing (descent or approach),Humanitarian,Philippines,Asia,37,7,7,30,30,37,0,Unknown
1948-04-18 00:00:00,Guinea Air Traders,Takeoff (climb),Commercial,Papua New Guinea,Oceania,37,4,4,33,33,37,0,Technical Failure
1948-08-29 00:00:00,Northwest Airlines,Flight,Commercial,United States of America,North America,37,4,4,33,33,37,0,Other
1951-07-21 00:00:00,Canadian Pacific Airlines - CP Air,Flight,Commercial,World,World,37,6,6,31,31,37,0,Unknown
1952-04-09 00:00:00,Japan Airlines,Flight,Commercial,Japan,Asia,37,4,4,33,33,37,0,Human Factor
1952-11-28 00:00:00,United States Air Force - USAF,Landing (descent or approach),Military / Government,United States of America,North America,39,7,7,32,30,37,2,Technical Failure
1952-12-06 00:00:00,Cubana de Aviación,Takeoff (climb),Commercial,Bermuda,North America,41,8,7,33,30,37,4,Unknown
1957-05-09 00:00:00,Aviaco - Aviacion y Comercio,Landing (descent or approach),Commercial,Spain,Europe,37,5,5,32,32,37,0,Human Factor
1960-01-21 00:00:00,Avianca,Landing (descent or approach),Commercial,Jamaica,Central America,46,7,2,39,35,37,9,Human Factor
1960-04-19 00:00:00,Lloyd Aéreo Colombiano - LACSA,Landing (descent or approach),Commercial,Colombia,South America,51,7,6,44,31,37,14,Human Factor
1960-11-07 00:00:00,AREA Ecuador - Aerovias Ecuatorianas,Landing (descent or approach),Commercial,Ecuador,South America,37,5,5,32,32,37,0,Human Factor
1961-09-17 00:00:00,Northwest Airlines,Takeoff (climb),Commercial,United States of America,North America,37,5,5,32,32,37,0,Human Factor
1963-05-03 00:00:00,Cruzeiro do Sul,Landing (descent or approach),Commercial,Brazil,South America,50,5,4,45,33,37,13,Human Factor
1965-07-25 00:00:00,Philippine Air Force - Hukbong Himpapawid NG Pilipinas,Flight,Military / Government,Philippines,Asia,37,7,7,30,30,37,0,Weather
1966-02-07 00:00:00,Indian Airlines,Flight,Commercial,India,Asia,37,4,4,33,33,37,0,Human Factor
1967-09-05 00:00:00,CSA Czech Airlines - Československé Státní Aerolinie,Takeoff (climb),Commercial,Canada,North America,69,8,4,61,33,37,32,Human Factor
1967-11-04 00:00:00,Iberia - Lineas Aéreas de Espana,Landing (descent or approach),Commercial,United Kingdom,Europe,37,7,7,30,30,37,0,Human Factor
1968-02-24 00:00:00,Royal Air Lao,Flight,Commercial,Laos,Asia,37,3,3,34,34,37,0,Technical Failure
1970-02-04 00:00:00,Aerolineas Argentinas,Takeoff (climb),Commercial,Argentina,South America,37,4,4,33,33,37,0,Weather
1970-09-02 00:00:00,Aeroflot - Russian International Airlines,Flight,Commercial,Ukraine,Europe,37,5,5,32,32,37,0,Unknown
1972-10-21 00:00:00,Olympic Airways,Landing (descent or approach),Commercial,Greece,Europe,53,4,1,49,36,37,16,Human Factor
1973-01-29 00:00:00,Egyptair,Landing (descent or approach),Commercial,Cyprus,Europe,37,7,7,30,30,37,0,Human Factor
1976-04-27 00:00:00,American Airlines,Landing (descent or approach),Commercial,United States of America,Central America,88,7,2,81,35,37,51,Human Factor
1980-08-26 00:00:00,Bouraq Indonesia Airlines,Landing (descent or approach),Commercial,Indonesia,Asia,37,6,6,31,31,37,0,Technical Failure
1986-05-01 00:00:00,Salvadorian Air Force - Fuerza Aérea Salvadoreña,Takeoff (climb),Military / Government,Salvador,Central America,37,4,4,33,33,37,0,Technical Failure
1987-10-15 00:00:00,Aero Trasporti Italiani - ATI,Flight,Commercial,Italy,Europe,37,3,3,34,34,37,0,Weather
1989-10-26 00:00:00,Soviet Air Force - Voyenno-vozdushnye sily CCCP,Landing (descent or approach),Military / Government,Russia,Asia,37,6,6,31,31,37,0,Human Factor
1992-12-13 00:00:00,Scibe-Airlift Zaïre,Landing (descent or approach),Commercial,Democratic Republic of Congo,Africa,37,6,6,31,31,37,0,Human Factor
1994-07-02 00:00:00,USAir - US Airways,Landing (descent or approach),Commercial,United States of America,North America,57,5,0,52,37,37,20,Human Factor
1996-11-12 00:00:00,Kazakhstan Airlines - Air Kazakhstan - Kazair,Flight,Commercial,India,Asia,37,10,10,27,27,37,0,Human Factor
1997-02-02 00:00:00,Angola Air Force - Força Aérea Nacional Angolana,Flight,Military / Government,Angola,Africa,37,4,4,33,33,37,0,Technical Failure
2004-01-13 00:00:00,Uzbekistan Airways - Uzbekistan Havo Jullary,Landing (descent or approach),Commercial,Uzbekistan,Asia,37,5,5,32,32,37,0,Human Factor
1942-12-14 00:00:00,Aeroflot - Russian International Airlines,Landing (descent or approach),Commercial,Uzbekistan,Asia,36,6,6,30,30,36,0,Human Factor
1951-11-13 00:00:00,United States Air Force - USAF,Flight,Military / Government,France,Europe,36,4,4,32,32,36,0,Weather
1952-01-19 00:00:00,Northwest Airlines,Landing (descent or approach),Commercial,Canada,North America,43,3,3,40,33,36,7,Technical Failure
1952-03-26 00:00:00,Aeroflot - Russian International Airlines,Landing (descent or approach),Commercial,Russia,Asia,36,4,4,32,32,36,0,Human Factor
1956-11-17 00:00:00,Aerolineas del Pacifico - ARPA,Flight,Commercial,Colombia,South America,36,3,3,33,33,36,0,Human Factor
1958-08-09 00:00:00,Central African Airways - CAA,Landing (descent or approach),Commercial,Libya,Africa,54,7,4,47,32,36,18,Human Factor
1958-11-09 00:00:00,Aero Topografica,Flight,Commercial,World,World,36,6,6,30,30,36,0,Technical Failure
1959-01-11 00:00:00,Lufthansa,Landing (descent or approach),Commercial,Brazil,South America,39,10,7,29,29,36,3,Human Factor
1965-10-27 00:00:00,British European Airways - BEA,Landing (descent or approach),Commercial,United Kingdom,Europe,36,6,6,30,30,36,0,Human Factor
1968-04-08 00:00:00,LADECO Airlines - Línea Aérea del Cobre,Landing (descent or approach),Commercial,Chile,South America,36,3,3,33,33,36,0,Technical Failure
1969-02-24 00:00:00,Far Eastern Air Transport - FAT,Flight,Commercial,Taiwan,Asia,36,4,4,32,32,36,0,Technical Failure
1970-04-21 00:00:00,Philippine Airlines - PAL,Flight,Commercial,Philippines,Asia,36,4,4,32,32,36,0,Other
1974-03-13 00:00:00,Sierra Pacific Airlines - SPA,Takeoff (climb),Commercial,United States of America,North America,36,4,4,32,32,36,0,Human Factor
1976-10-25 00:00:00,Taxi Aéreo El Venado,Takeoff (climb),Commercial,Colombia,South America,36,4,4,32,32,36,0,Technical Failure
1977-12-18 00:00:00,SATA - Société Anonyme de Transport Aérien Genève,Landing (descent or approach),Commercial,Portugal,Europe,57,5,1,52,35,36,21,Human Factor
1980-09-14 00:00:00,Zaire Air Force - Force Aérienne Zaïroise,Takeoff (climb),Military / Government,Democratic Republic of Congo,Africa,36,5,5,31,31,36,0,Technical Failure
1980-09-17 00:00:00,Zaire Air Force - Force Aérienne Zaïroise,Flight,Military / Government,Democratic Republic of Congo,Africa,36,2,2,34,34,36,0,Unknown
1982-02-03 00:00:00,French Air Force - Armée de l'Air,Flight,Humanitarian,Djibouti,Africa,36,4,4,32,32,36,0,Unknown
1987-02-09 00:00:00,Afghan Republican Air Force - Afghan Hanai Qurah,Takeoff (climb),Military / Government,Afghanistan,Asia,36,6,6,30,30,36,0,Terrorism
1988-05-06 00:00:00,Wideroe - Wideroe's Flyveselskap,Landing (descent or approach),Commercial,Norway,Europe,36,3,3,33,33,36,0,Human Factor
1995-07-18 00:00:00,Malagasy Air Force - Armée de l'Air Malgache,Landing (descent or approach),Humanitarian,Madagascar,Africa,36,6,6,30,30,36,0,Technical Failure
1997-04-23 00:00:00,Afghan Republican Air Force - Afghan Hanai Qurah,Flight,Military / Government,Afghanistan,Asia,36,4,4,32,32,36,0,Unknown
1998-08-24 00:00:00,Myanma Airways,Landing (descent or approach),Commercial,Myanmar,Asia,36,4,4,32,32,36,0,Human Factor
1935-05-18 00:00:00,Tupolev Industries - GKAP Tupolev OKB,Flight,Operational,Russia,Asia,35,2,2,33,33,35,0,Human Factor
1943-01-15 00:00:00,United States Army Air Forces - USAAF,Flight,Military / Government,Suriname,South America,35,10,10,25,25,35,0,Other
1947-08-28 00:00:00,Det Norske Luftfartselskap - DNL,Flight,Commercial,Norway,Europe,35,8,8,27,27,35,0,Human Factor
1948-12-21 00:00:00,Civil Air Transport,Landing (descent or approach),Commercial,China,Asia,35,7,7,28,28,35,0,Human Factor
1949-07-12 00:00:00,Standard Airlines,Landing (descent or approach),Commercial,United States of America,North America,48,4,3,44,32,35,13,Human Factor
1950-04-21 00:00:00,United States Air Force - USAF,Landing (descent or approach),Military / Government,Japan,Asia,35,8,8,27,27,35,0,Human Factor
1953-03-20 00:00:00,Transocean Air Lines - TOA,Landing (descent or approach),Commercial,United States of America,North America,35,5,5,30,30,35,0,Unknown
1954-01-10 00:00:00,British Overseas Airways Corporation - BOAC,Flight,Commercial,Italy,Europe,35,6,6,29,29,35,0,Technical Failure
1954-02-01 00:00:00,United States Air Force - USAF,Flight,Military / Government,Japan,Asia,35,5,5,30,30,35,0,Technical Failure
1954-04-08 00:00:00,Trans-Canada Air Lines - TCAL,Flight,Commercial,Canada,North America,35,4,4,31,31,35,0,Human Factor
1958-02-27 00:00:00,Silver City Airways,Flight,Commercial,United Kingdom,Europe,42,3,0,39,35,35,7,Human Factor
1960-02-25 00:00:00,United States Navy - USN,Landing (descent or approach),Military / Government,Brazil,South America,38,7,7,31,28,35,3,Human Factor
1960-04-22 00:00:00,Sobelair,Landing (descent or approach),Commercial,Democratic Republic of Congo,Africa,35,7,7,28,28,35,0,Human Factor
1967-04-11 00:00:00,Air Algérie,Landing (descent or approach),Commercial,Algeria,Africa,39,6,6,33,29,35,4,Human Factor
1967-06-17 00:00:00,United States Air Force - USAF,Takeoff (climb),Military / Government,Vietnam,Asia,56,7,0,49,35,35,21,Unknown
1968-08-10 00:00:00,Piedmont Airlines,Landing (descent or approach),Commercial,United States of America,North America,37,3,3,34,32,35,2,Human Factor
1969-02-18 00:00:00,Hawthorne Nevada Airlines,Flight,Commercial,United States of America,North America,35,3,3,32,32,35,0,Human Factor
1969-07-12 00:00:00,Royal Nepal Airlines,Flight,Commercial,Nepal,Asia,35,3,3,32,32,35,0,Human Factor
1969-07-26 00:00:00,Air Algérie,Flight,Commercial,Algeria,Africa,37,7,5,30,30,35,2,Technical Failure
1969-09-02 00:00:00,Royal Lao Air Force,Landing (descent or approach),Military / Government,Laos,Asia,35,4,4,31,31,35,0,Unknown
1969-09-08 00:00:00,SATENA - Servicio de Aeronavegacion a Territorios Nacionales,Flight,Commercial,Colombia,South America,35,3,3,32,32,35,0,Weather
1971-01-20 00:00:00,Peruvian Air Force - Fuerza Aérea del Perú,Flight,Military / Government,Peru,South America,35,5,5,30,30,35,0,Unknown
1972-11-04 00:00:00,Balkan Bulgarian Airlines,Landing (descent or approach),Commercial,Bulgaria,Europe,35,4,4,31,31,35,0,Human Factor
1977-04-10 00:00:00,Taxi Aéreo El Venado,Flight,Commercial,Colombia,South America,35,4,4,31,31,35,0,Human Factor
1983-05-06 00:00:00,Soviet Air Force - Voyenno-vozdushnye sily CCCP,Landing (descent or approach),Military / Government,Russia,Asia,37,6,6,31,29,35,2,Human Factor
1988-09-15 00:00:00,Ethiopian Airlines,Landing (descent or approach),Commercial,Ethiopia,Africa,104,6,0,98,35,35,69,Other
1993-12-26 00:00:00,Kuban Airlines - Kuban'skie Avialinii,Landing (descent or approach),Operational,Armenia,Asia,36,5,5,31,30,35,1,Human Factor
1996-04-03 00:00:00,United States Air Force - USAF,Landing (descent or approach),Military / Government,Croatia,Europe,35,6,6,29,29,35,0,Human Factor
1997-05-08 00:00:00,China Southern Airlines,Landing (descent or approach),Commercial,China,Asia,74,9,2,65,33,35,39,Human Factor
1999-12-10 00:00:00,SATA Air Açores,Flight,Commercial,Portugal,Europe,35,4,4,31,31,35,0,Human Factor
1944-09-22 00:00:00,United States Army Air Forces - USAAF,Takeoff (climb),Military / Government,Bahrain,Asia,34,4,4,30,30,34,0,Unknown
1945-02-04 00:00:00,United States Army Air Forces - USAAF,Flight,Military / Government,India,Asia,35,2,2,33,32,34,1,Technical Failure
1945-03-12 00:00:00,United States Army Air Forces - USAAF,Flight,Humanitarian,Philippines,Asia,34,4,4,30,30,34,0,Unknown
1949-08-06 00:00:00,Shell Company of Ecuador,Landing (descent or approach),Commercial,Ecuador,South America,34,3,3,31,31,34,0,Human Factor
1949-11-20 00:00:00,Aero-Holland,Landing (descent or approach),Humanitarian,Norway,Europe,35,4,4,31,30,34,1,Human Factor
1952-03-26 00:00:00,Soviet Air Force - Voyenno-vozdushnye sily CCCP,Takeoff (climb),Military / Government,Russia,Asia,34,4,4,30,30,34,0,Human Factor
1953-06-16 00:00:00,Aigle Azur,Flight,Commercial,Laos,Asia,34,5,5,29,29,34,0,Unknown
1956-11-24 00:00:00,Linee Aeree Italiane - LAI,Takeoff (climb),Commercial,France,Europe,35,10,10,25,24,34,1,Unknown
1957-05-01 00:00:00,Eagle Aviation - UK,Landing (descent or approach),Commercial,United Kingdom,Europe,35,5,5,30,29,34,1,Technical Failure
1959-09-29 00:00:00,Braniff International Airways,Flight,Commercial,United States of America,North America,34,6,6,28,28,34,0,Technical Failure
1960-01-06 00:00:00,National Airlines,Flight,Commercial,United States of America,North America,34,5,5,29,29,34,0,Terrorism
1960-02-26 00:00:00,Alitalia - Linee Aeree Italiane,Takeoff (climb),Commercial,Ireland,Europe,52,12,11,40,23,34,18,Technical Failure
1960-08-17 00:00:00,Aeroflot - Russian International Airlines,Flight,Commercial,Ukraine,Europe,34,7,7,27,27,34,0,Technical Failure
1961-10-07 00:00:00,Derby Aviation,Flight,Commercial,France,Europe,34,3,3,31,31,34,0,Human Factor
1963-05-12 00:00:00,United Arab Airlines,Takeoff (climb),Commercial,Egypt,Africa,34,6,6,28,28,34,0,Human Factor
1967-06-23 00:00:00,Mohawk Airlines,Takeoff (climb),Commercial,United States of America,North America,34,4,4,30,30,34,0,Technical Failure
1970-01-28 00:00:00,Aeroflot - Russian International Airlines,Landing (descent or approach),Commercial,Russia,Asia,34,4,4,30,30,34,0,Human Factor
1972-08-27 00:00:00,Linea Aeropostal Venezolana - LAV,Landing (descent or approach),Commercial,Venezuela,South America,34,3,3,31,31,34,0,Technical Failure
1976-01-20 00:00:00,Transportes Aéreos Mercantiles Ecuatorianos - TAME,Flight,Commercial,Ecuador,South America,42,6,6,36,28,34,8,Weather
1976-04-15 00:00:00,Yacimientos Petroliferos Fiscales Argentinas - YPFA,Landing (descent or approach),Commercial,Argentina,South America,34,3,3,31,31,34,0,Technical Failure
1977-09-27 00:00:00,Japan Airlines,Landing (descent or approach),Commercial,Malaysia,Asia,79,10,8,69,26,34,45,Human Factor
1980-09-12 00:00:00,Florida Commuter Airlines,Landing (descent or approach),Commercial,Bahamas,Central America,34,4,4,30,30,34,0,Unknown
1986-10-19 00:00:00,Mozambican Government,Landing (descent or approach),Military / Government,South Africa,Africa,44,9,8,35,26,34,10,Human Factor
1988-10-19 00:00:00,Vayudoot,Landing (descent or approach),Commercial,India,Asia,34,3,3,31,31,34,0,Human Factor
1988-11-19 00:00:00,Afghan Republican Air Force - Afghan Hanai Qurah,Flight,Military / Government,Pakistan,Asia,34,4,4,30,30,34,0,Terrorism
1989-08-03 00:00:00,Olympic Aviation,Landing (descent or approach),Commercial,Greece,Europe,34,3,3,31,31,34,0,Human Factor
1989-08-15 00:00:00,China Eastern Airlines,Takeoff (climb),Commercial,China,Asia,40,6,6,34,28,34,6,Technical Failure
1991-03-23 00:00:00,Aeroflot - Russian International Airlines,Landing (descent or approach),Commercial,Uzbekistan,Asia,63,4,4,59,30,34,29,Human Factor
1992-11-15 00:00:00,Aerocaribbean,Landing (descent or approach),Commercial,Dominican Republic,Central America,34,6,6,28,28,34,0,Human Factor
1995-09-15 00:00:00,Malaysian Airlines System - MAS,Landing (descent or approach),Commercial,Malaysia,Asia,53,4,2,49,32,34,19,Human Factor
1996-07-15 00:00:00,Belgian Air Force - Force Aérienne Belge - Belgische Luchtmacht,Landing (descent or approach),Military / Government,Netherlands,Europe,41,4,4,37,30,34,7,Other
2001-05-16 00:00:00,Turkish Air Force - Türk Hava Kuvvetleri,Flight,Military / Government,Turkey,Asia,34,6,6,28,28,34,0,Unknown
2007-01-09 00:00:00,Aeriantur-M,Landing (descent or approach),Commercial,Iraq,Asia,35,5,5,30,29,34,1,Human Factor
1949-06-23 00:00:00,KLM Royal Dutch Airlines - Koninklijke Luchtvaart Maatschappij,Flight,Commercial,Italy,Europe,33,11,11,22,22,33,0,Technical Failure
1951-07-12 00:00:00,Loide Aéreo Nacional,Landing (descent or approach),Commercial,Brazil,South America,33,5,5,28,28,33,0,Human Factor
1954-03-13 00:00:00,British Overseas Airways Corporation - BOAC,Landing (descent or approach),Commercial,Singapore,Asia,40,9,2,31,31,33,7,Human Factor
1958-08-12 00:00:00,All Nippon Airways,Flight,Commercial,Japan,Asia,33,5,5,28,28,33,0,Unknown
1960-11-23 00:00:00,Philippine Airlines - PAL,Flight,Commercial,Philippines,Asia,33,4,4,29,29,33,0,Human Factor
1962-12-19 00:00:00,LOT Polish Airlines - Polskie Linie Lotnicze,Landing (descent or approach),Commercial,Poland,Europe,33,5,5,28,28,33,0,Unknown
1963-07-13 00:00:00,Aeroflot - Russian International Airlines,Landing (descent or approach),Commercial,Russia,Asia,35,5,5,30,28,33,2,Technical Failure
1964-10-19 00:00:00,Soviet Air Force - Voyenno-vozdushnye sily CCCP,Landing (descent or approach),Military / Government,Serbia,Europe,33,11,11,22,22,33,0,Human Factor
1966-04-23 00:00:00,Aeroflot - Russian International Airlines,Flight,Commercial,Azerbaijan,Asia,33,5,5,28,28,33,0,Technical Failure
1973-12-17 00:00:00,Pan American World Airways - PAA,Parking,Commercial,Italy,Europe,177,11,0,166,33,33,144,Terrorism
1974-09-07 00:00:00,Garuda Indonesian Airways,Landing (descent or approach),Commercial,Indonesia,Asia,36,4,4,32,29,33,3,Human Factor
1974-12-29 00:00:00,TAROM - Transporturile Aeriene Române,Landing (descent or approach),Commercial,Romania,Europe,33,5,5,28,28,33,0,Human Factor
1974-12-29 00:00:00,TAROM - Transporturile Aeriene Române,Landing (descent or approach),Commercial,Romania,Europe,33,5,5,28,28,33,0,Human Factor
1975-02-03 00:00:00,Philippine Airlines - PAL,Takeoff (climb),Commercial,Philippines,Asia,33,4,4,29,29,33,0,Technical Failure
1981-09-18 00:00:00,Aeroflot - Russian International Airlines,Landing (descent or approach),Commercial,Russia,Asia,33,4,4,29,29,33,0,Human Factor
1988-10-17 00:00:00,Uganda Airlines,Landing (descent or approach),Commercial,Italy,Europe,52,7,7,45,26,33,19,Human Factor
1992-11-11 00:00:00,Russian Air Force - Voyenno-vozdushnye sily Rossii,Takeoff (climb),Military / Government,Russia,Asia,33,6,6,27,27,33,0,Other
1993-06-17 00:00:00,Tajikistan Airlines - Tajik Air,Flight,Commercial,Georgia,Asia,33,5,5,28,28,33,0,Weather
2004-05-14 00:00:00,Rico Linhas Aéreas - Rondonia Importaçao e Comercio,Landing (descent or approach),Commercial,Brazil,South America,33,3,3,30,30,33,0,Human Factor
2012-04-02 00:00:00,UTAir,Takeoff (climb),Commercial,Russia,Asia,43,4,4,39,29,33,10,Human Factor
2013-11-29 00:00:00,Linhas Aéreas de Moçambique - LAM,Flight,Commercial,Namibia,Africa,33,6,6,27,27,33,0,Human Factor
1943-06-09 00:00:00,Hamiata,Flight,Commercial,China,Asia,32,4,4,28,28,32,0,Weather
1944-07-31 00:00:00,Royal Air Force - RAF,Flight,Military / Government,Oman,Asia,32,5,5,27,27,32,0,Human Factor
1946-12-10 00:00:00,United States Navy - USN,Flight,Military / Government,United States of America,North America,32,3,3,29,29,32,0,Weather
1948-01-11 00:00:00,Dominicana de Aviación,Flight,Commercial,Dominican Republic,Central America,32,2,2,30,30,32,0,Human Factor
1948-01-28 00:00:00,Airline Transport Carriers,Flight,Commercial,United States of America,North America,32,3,3,29,29,32,0,Technical Failure
1948-07-04 00:00:00,Scandinavian Airlines System - SAS,Landing (descent or approach),Commercial,United Kingdom,Europe,32,7,7,25,25,32,0,Human Factor
1948-12-28 00:00:00,Airborne Transport,Flight,Commercial,World,World,32,3,3,29,29,32,0,Unknown
1949-08-13 00:00:00,Servicios Aéreos Tolima,Takeoff (climb),Commercial,Colombia,South America,32,3,3,29,29,32,0,Human Factor
1950-01-20 00:00:00,TAM Bolivia - Transporte Aéreo Militar Boliviano,Flight,Military / Government,Bolivia,South America,32,4,4,28,28,32,0,Human Factor
1956-06-24 00:00:00,British Overseas Airways Corporation - BOAC,Takeoff (climb),Commercial,Nigeria,Africa,45,7,3,38,29,32,13,Weather
1957-04-08 00:00:00,Air France,Takeoff (climb),Commercial,Algeria,Africa,32,5,5,27,27,32,0,Technical Failure
1958-04-07 00:00:00,AREA Ecuador - Aerovias Ecuatorianas,Flight,Commercial,Ecuador,South America,32,3,3,29,29,32,0,Human Factor
1959-07-15 00:00:00,Persian Air Services,Takeoff (climb),Commercial,Kuwait,Asia,32,5,5,27,27,32,0,Unknown
1959-08-19 00:00:00,Transair UK,Flight,Commercial,Spain,Europe,32,3,3,29,29,32,0,Human Factor
1959-12-22 00:00:00,VASP - Viação Aérea de São Paulo,Landing (descent or approach),Commercial,Brazil,South America,32,6,6,26,26,32,0,Human Factor
1960-02-26 00:00:00,Aeroflot - Russian International Airlines,Landing (descent or approach),Commercial,Ukraine,Europe,33,8,8,25,24,32,1,Weather
1961-12-31 00:00:00,Aeroflot - Russian International Airlines,Landing (descent or approach),Commercial,Russia,Asia,119,9,2,110,30,32,87,Human Factor
1962-05-08 00:00:00,Myanmar Air Force - Tatmadaw Lei,Flight,Military / Government,Myanmar,Asia,32,4,4,28,28,32,0,Technical Failure
1962-09-18 00:00:00,Aeroflot - Russian International Airlines,Flight,Commercial,Russia,Asia,32,5,5,27,27,32,0,Human Factor
1963-08-24 00:00:00,Aeroflot - Russian International Airlines,Flight,Commercial,Georgia,Asia,32,5,5,27,27,32,0,Human Factor
1964-10-09 00:00:00,TAROM - Transporturile Aeriene Române,Flight,Commercial,Romania,Europe,32,4,4,28,28,32,0,Weather
1965-11-11 00:00:00,Aeroflot - Russian International Airlines,Landing (descent or approach),Commercial,Russia,Asia,62,5,2,57,30,32,30,Human Factor
1965-12-07 00:00:00,Spantax,Takeoff (climb),Commercial,Spain,Europe,32,4,4,28,28,32,0,Unknown
1968-10-25 00:00:00,Northeast Airlines - USA,Landing (descent or approach),Commercial,United States of America,North America,42,3,2,39,30,32,10,Human Factor
1970-01-13 00:00:00,Polynesian Airline of Samoa - Polynesian Airlines,Takeoff (climb),Commercial,Samoa Islands (Western Samoa),Oceania,32,3,3,29,29,32,0,Weather
1970-10-02 00:00:00,Golden Eagle Aviation - USA,Flight,Commercial,United States of America,North America,40,3,2,37,30,32,8,Human Factor
1971-07-30 00:00:00,French Air Force - Armée de l'Air,Landing (descent or approach),Humanitarian,France,Europe,34,9,9,25,23,32,2,Technical Failure
1971-08-28 00:00:00,Malév Hungarian Airlines - Magyar Légiközlekedési Vallalat,Landing (descent or approach),Commercial,Denmark,Europe,34,9,9,25,23,32,2,Human Factor
1971-09-28 00:00:00,Cruzeiro do Sul,Takeoff (climb),Commercial,Brazil,South America,32,4,4,28,28,32,0,Technical Failure
1972-06-05 00:00:00,Air America,Landing (descent or approach),Commercial,Vietnam,Asia,32,3,3,29,29,32,0,Human Factor
1973-02-28 00:00:00,Aeroflot - Russian International Airlines,Takeoff (climb),Commercial,Kazakhstan,Asia,32,3,3,29,29,32,0,Unknown
1974-01-09 00:00:00,SATENA - Servicio de Aeronavegacion a Territorios Nacionales,Takeoff (climb),Commercial,Colombia,South America,32,3,3,29,29,32,0,Human Factor
1974-10-30 00:00:00,Panarctic Oils,Landing (descent or approach),Commercial,Canada,North America,34,4,2,30,30,32,2,Human Factor
1977-11-25 00:00:00,French Air Force - Armée de l'Air,Flight,Military / Government,France,Europe,32,4,4,28,28,32,0,Technical Failure
1981-07-27 00:00:00,AeroMéxico,Landing (descent or approach),Commercial,Mexico,Central America,66,6,2,60,30,32,34,Human Factor
1989-11-21 00:00:00,Aeroflot - Russian International Airlines,Landing (descent or approach),Commercial,Russia,Asia,40,5,5,35,27,32,8,Human Factor
1993-04-23 00:00:00,MIAT Mongolian Airlines - Mongolyn Irgeniy Agaaryn Teever,Flight,Commercial,Mongolia,Asia,32,6,6,26,26,32,0,Human Factor
1994-03-17 00:00:00,Islamic Republic of Iran Air Force,Flight,Military / Government,Azerbaijan,Asia,32,13,13,19,19,32,0,Terrorism
1996-09-25 00:00:00,Dutch Dakota Association,Flight,Commercial,Netherlands,Europe,32,6,6,26,26,32,0,Technical Failure
2011-04-04 00:00:00,Georgian Airways - Airzena Georgian Airlines,Landing (descent or approach),Humanitarian,Democratic Republic of Congo,Africa,33,4,4,29,28,32,1,Weather
2012-08-19 00:00:00,Alfa Airlines,Landing (descent or approach),Military / Government,Sudan,Africa,32,6,6,26,26,32,0,Human Factor
1943-12-19 00:00:00,United States Army Air Forces - USAAF,Flight,Military / Government,Australia,Oceania,31,4,4,27,27,31,0,Other
1945-04-23 00:00:00,United States Army Air Forces - USAAF,Flight,Military / Government,United Kingdom,Europe,31,5,5,26,26,31,0,Unknown
1945-08-05 00:00:00,United States Army Air Forces - USAAF,Flight,Humanitarian,Myanmar,Asia,31,4,4,27,27,31,0,Weather
1945-10-13 00:00:00,Royal Air Force - RAF,Takeoff (climb),Military / Government,Belgium,Europe,31,5,5,26,26,31,0,Human Factor
1946-09-20 00:00:00,China National Aviation Corporation - CNAC,Takeoff (climb),Commercial,China,Asia,31,3,3,28,28,31,0,Unknown
1946-12-25 00:00:00,China National Aviation Corporation - CNAC,Landing (descent or approach),Commercial,China,Asia,36,3,1,33,30,31,5,Human Factor
1948-01-30 00:00:00,British South American Airways - BSAA,Flight,Commercial,World,World,31,6,6,25,25,31,0,Technical Failure
1948-05-13 00:00:00,SABENA - Société Anonyme Belge d'Exploitation de la Navigation Aérienne,Landing (descent or approach),Commercial,Democratic Republic of Congo,Africa,32,7,7,25,24,31,1,Weather
1949-05-04 00:00:00,Avio Linee Italiane - ALI,Landing (descent or approach),Commercial,Italy,Europe,31,4,4,27,27,31,0,Human Factor
1950-12-15 00:00:00,AVENSA - Aerovias Venezolanas,Flight,Commercial,Venezuela,South America,31,3,3,28,28,31,0,Human Factor
1952-02-17 00:00:00,Hunting Air Travel,Flight,Commercial,Italy,Europe,31,5,5,26,26,31,0,Human Factor
1958-10-22 00:00:00,British European Airways - BEA,Flight,Commercial,Italy,Europe,31,5,5,26,26,31,0,Human Factor
1959-05-12 00:00:00,Capital Airlines,Flight,Commercial,United States of America,North America,31,4,4,27,27,31,0,Weather
1960-06-10 00:00:00,Aeroflot - Russian International Airlines,Flight,Commercial,Georgia,Asia,31,7,7,24,24,31,0,Human Factor
1960-09-07 00:00:00,Aerolineas Argentinas,Flight,Commercial,Uruguay,South America,31,6,6,25,25,31,0,Technical Failure
1960-09-26 00:00:00,Austrian Airlines,Landing (descent or approach),Commercial,Russia,Asia,37,6,5,31,26,31,6,Human Factor
1960-12-11 00:00:00,Argentinian Air Force - Fuerza Aérea Argentina,Flight,Military / Government,Argentina,South America,31,8,8,23,23,31,0,Human Factor
1962-04-06 00:00:00,Colombian Air Force - Fuerza Aérea Colombiana,Flight,Commercial,Colombia,South America,31,5,5,26,26,31,0,Weather
1963-06-16 00:00:00,TAROM - Transporturile Aeriene Române,Flight,Commercial,Hungary,Europe,31,4,4,27,27,31,0,Unknown
1963-10-18 00:00:00,Soviet Air Force - Voyenno-vozdushnye sily CCCP,Landing (descent or approach),Military / Government,Egypt,Africa,31,6,6,25,25,31,0,Human Factor
1964-02-21 00:00:00,Philippine Airlines - PAL,Flight,Commercial,Philippines,Asia,32,3,3,29,28,31,1,Human Factor
1964-11-20 00:00:00,Linjeflyg,Landing (descent or approach),Commercial,Sweden,Europe,43,4,2,39,29,31,12,Human Factor
1965-03-07 00:00:00,Aeroflot - Russian International Airlines,Flight,Commercial,Russia,Asia,31,4,4,27,27,31,0,Weather
1966-11-26 00:00:00,United States Air Force - USAF,Landing (descent or approach),Military / Government,Vietnam,Asia,31,6,6,25,25,31,0,Technical Failure
1969-04-15 00:00:00,United States Navy - USN,Flight,Military / Government,World,World,31,6,6,25,25,31,0,Terrorism
1970-12-31 00:00:00,Rousseau Aviation,Flight,Commercial,World,World,31,3,3,28,28,31,0,Unknown
1972-09-13 00:00:00,Nepalese Army,Flight,Humanitarian,Nepal,Asia,31,4,4,27,27,31,0,Human Factor
1972-12-08 00:00:00,Pakistan International Airlines - PIA,Flight,Commercial,Pakistan,Asia,31,5,5,26,26,31,0,Human Factor
1974-07-22 00:00:00,Hellenic Air Force - Elleniki Polemiki Aeroporia,Landing (descent or approach),Military / Government,Cyprus,Europe,32,4,4,28,27,31,1,Terrorism
1974-08-18 00:00:00,Zaire Air Force - Force Aérienne Zaïroise,Landing (descent or approach),Military / Government,Democratic Republic of Congo,Africa,31,7,7,24,24,31,0,Unknown
1979-09-14 00:00:00,Aero Trasporti Italiani - ATI,Landing (descent or approach),Commercial,Italy,Europe,31,4,4,27,27,31,0,Human Factor
1980-02-28 00:00:00,Guatemalan Air Force - Fuerza Aérea Guatemalteca,Flight,Military / Government,Guatemala,Central America,31,4,4,27,27,31,0,Unknown
1981-05-07 00:00:00,Austral Lineas Aéreas,Landing (descent or approach),Commercial,Argentina,South America,31,5,5,26,26,31,0,Weather
1981-08-24 00:00:00,Aeroflot - Russian International Airlines,Flight,Commercial,Russia,Asia,32,5,5,27,26,31,1,Human Factor
1985-09-06 00:00:00,Midwest Express Airlines,Takeoff (climb),Commercial,United States of America,North America,31,4,4,27,27,31,0,Technical Failure
1989-07-08 00:00:00,Soviet Air Force - Voyenno-vozdushnye sily CCCP,Landing (descent or approach),Military / Government,Vietnam,Asia,34,6,4,28,27,31,3,Human Factor
1992-02-09 00:00:00,Gambcrest,Landing (descent or approach),Commercial,Senegal,Africa,59,6,6,53,25,31,28,Human Factor
1992-10-18 00:00:00,Merpati Nusantara Airlines - MNA,Flight,Commercial,Indonesia,Asia,31,4,4,27,27,31,0,Human Factor
1994-02-25 00:00:00,Expresso Aéreo,Flight,Commercial,Peru,South America,31,5,5,26,26,31,0,Human Factor
1941-04-12 00:00:00,Hungarian Air Force - Magyar Honvédség Repülö Csapatai MHRC,Takeoff (climb),Military / Government,Hungary,Europe,30,3,3,27,27,30,0,Unknown
1945-05-06 00:00:00,United States Army Air Forces - USAAF,Landing (descent or approach),Humanitarian,United Kingdom,Europe,30,2,2,28,28,30,0,Human Factor
1945-05-09 00:00:00,Royal Air Force - RAF,Flight,Humanitarian,France,Europe,30,6,6,24,24,30,0,Unknown
1945-09-06 00:00:00,United States Army Air Forces - USAAF,Flight,Military / Government,Philippines,Asia,30,4,4,26,26,30,0,Unknown
1946-06-01 00:00:00,United States Army Air Forces - USAAF,Flight,Commercial,Italy,Europe,38,4,0,34,30,30,8,Technical Failure
1946-07-17 00:00:00,ANDESA - Aerovias Nacionales del Ecuador SA,Landing (descent or approach),Commercial,Ecuador,South America,30,4,4,26,26,30,0,Unknown
1948-03-12 00:00:00,Northwest Airlines,Flight,Commercial,United States of America,North America,30,6,6,24,24,30,0,Human Factor
1948-04-15 00:00:00,Pan American World Airways - PAA,Landing (descent or approach),Commercial,Ireland,Europe,31,10,10,21,20,30,1,Human Factor
1948-12-15 00:00:00,LANSA Colombia - Limitada Nacional de Servicio Aéreo,Takeoff (climb),Commercial,Colombia,South America,30,3,3,27,27,30,0,Technical Failure
1951-10-27 00:00:00,Guatemalan Air Force - Fuerza Aérea Guatemalteca,Takeoff (climb),Military / Government,Guatemala,Central America,32,5,5,27,25,30,2,Technical Failure
1952-11-22 00:00:00,Transportno Aviatsionno Bulgaro-Savetsko Obedinenie - TABSO,Flight,Commercial,Bulgaria,Europe,30,4,4,26,26,30,0,Human Factor
1953-04-16 00:00:00,Aigle Azur,Takeoff (climb),Humanitarian,Vietnam,Asia,30,3,3,27,27,30,0,Technical Failure
1954-08-09 00:00:00,Avianca,Takeoff (climb),Commercial,Portugal,Europe,30,9,9,21,21,30,0,Human Factor
1955-08-04 00:00:00,American Airlines,Landing (descent or approach),Commercial,United States of America,North America,30,3,3,27,27,30,0,Human Factor
1956-05-24 00:00:00,Aviateca,Flight,Commercial,Guatemala,Central America,31,3,3,28,27,30,1,Unknown
1959-12-13 00:00:00,Aeroflot - Russian International Airlines,Flight,Commercial,Uzbekistan,Asia,30,5,5,25,25,30,0,Human Factor
1964-01-09 00:00:00,Aerotransportes Litoral Argentino,Landing (descent or approach),Commercial,Argentina,South America,31,3,3,28,27,30,1,Technical Failure
1965-03-08 00:00:00,Aeroflot - Russian International Airlines,Takeoff (climb),Commercial,Russia,Asia,39,9,9,30,21,30,9,Technical Failure
1965-05-05 00:00:00,Iberia - Lineas Aéreas de Espana,Landing (descent or approach),Commercial,Spain,Europe,49,9,6,40,24,30,19,Human Factor
1965-07-07 00:00:00,Soviet Air Force - Voyenno-vozdushnye sily CCCP,Takeoff (climb),Military / Government,Egypt,Africa,31,9,8,22,22,30,1,Human Factor
1965-08-16 00:00:00,United Airlines,Landing (descent or approach),Commercial,United States of America,North America,30,6,6,24,24,30,0,Unknown
1965-09-17 00:00:00,Pan American World Airways - PAA,Flight,Commercial,Montserrat,Central America,30,9,9,21,21,30,0,Human Factor
1965-11-02 00:00:00,French Air Force - Armée de l'Air,Landing (descent or approach),Military / Government,Djibouti,Africa,30,5,5,25,25,30,0,Unknown
1966-01-22 00:00:00,Compagnie Haïtienne de Transports Aériens - COHATA,Takeoff (climb),Commercial,Haiti,Central America,35,7,7,28,23,30,5,Unknown
1966-03-18 00:00:00,United Arab Airlines,Landing (descent or approach),Commercial,Egypt,Africa,30,5,5,25,25,30,0,Human Factor
1966-11-22 00:00:00,Aden Airways,Flight,Commercial,Yemen,Asia,30,3,3,27,27,30,0,Terrorism
1970-08-06 00:00:00,Pakistan International Airlines - PIA,Takeoff (climb),Commercial,India,Asia,30,4,4,26,26,30,0,Weather
1972-03-19 00:00:00,Egyptair,Landing (descent or approach),Commercial,Yemen,Asia,30,5,5,25,25,30,0,Human Factor
1972-08-12 00:00:00,United States Air Force - USAF,Takeoff (climb),Military / Government,Vietnam,Asia,44,8,7,36,23,30,14,Terrorism
1977-07-14 00:00:00,Angola Air Force - Força Aérea Nacional Angolana,Takeoff (climb),Military / Government,Angola,Africa,30,5,5,25,25,30,0,Terrorism
1980-05-26 00:00:00,Nigerian Air Force,Flight,Military / Government,Nigeria,Africa,30,3,3,27,27,30,0,Weather
1983-05-05 00:00:00,Royal Thai Air Force - Kong Thap Akat Thai,Landing (descent or approach),Military / Government,Thailand,Asia,30,6,6,24,24,30,0,Unknown
1983-11-11 00:00:00,Soviet Air Force - Voyenno-vozdushnye sily CCCP,Flight,Military / Government,Russia,Asia,30,6,6,24,24,30,0,Unknown
1984-09-11 00:00:00,MMM Aero Services,Landing (descent or approach),Commercial,Democratic Republic of Congo,Africa,36,5,5,31,25,30,6,Technical Failure
1988-08-17 00:00:00,Pakistan Air Force - Pakistan Fiza'ya,Takeoff (climb),Military / Government,Pakistan,Asia,30,4,4,26,26,30,0,Technical Failure
1989-06-28 00:00:00,Somali Airlines,Takeoff (climb),Commercial,Somalia,Africa,30,7,7,23,23,30,0,Terrorism
1992-11-14 00:00:00,Vietnam Airlines,Landing (descent or approach),Commercial,Vietnam,Asia,31,6,6,25,24,30,1,Human Factor
1993-04-27 00:00:00,Zambia Air Force,Takeoff (climb),Commercial,Gabon,Africa,30,5,5,25,25,30,0,Technical Failure
1993-12-15 00:00:00,Philippine Air Force - Hukbong Himpapawid NG Pilipinas,Landing (descent or approach),Military / Government,Philippines,Asia,30,6,6,24,24,30,0,Human Factor
2001-05-17 00:00:00,Qeshm Airlines,Landing (descent or approach),Commercial,Iran,Asia,30,5,5,25,25,30,0,Human Factor
2004-08-21 00:00:00,Venezuelan Air Force - Fuerza Aérea Venezolana,Flight,Military / Government,Venezuela,South America,30,3,3,27,27,30,0,Human Factor
2008-06-10 00:00:00,Sudan Airways,Landing (descent or approach),Commercial,Sudan,Africa,214,11,1,203,29,30,184,Human Factor
2015-01-18 00:00:00,Syrian Arab Air Force,Landing (descent or approach),Military / Government,Syria,Asia,30,6,6,24,24,30,0,Human Factor
1940-11-08 00:00:00,Deutsche Lufthansa,Flight,Commercial,Germany,Europe,29,6,6,23,23,29,0,Weather
1945-09-18 00:00:00,Royal Australian Air Force - RAAF,Flight,Military / Government,Indonesia,Asia,29,6,6,23,23,29,0,Human Factor
1948-07-24 00:00:00,Rimouski Airlines,Landing (descent or approach),Commercial,Canada,North America,29,2,2,27,27,29,0,Human Factor
1950-06-26 00:00:00,Australian National Airways - ANA,Flight,Commercial,Australia,Oceania,29,5,5,24,24,29,0,Technical Failure
1951-02-03 00:00:00,Air France,Flight,Commercial,Cameroon,Africa,29,6,6,23,23,29,0,Human Factor
1951-03-21 00:00:00,LANSA Colombia - Limitada Nacional de Servicio Aéreo,Flight,Commercial,Colombia,South America,29,3,3,26,26,29,0,Unknown
1952-02-11 00:00:00,National Airlines,Takeoff (climb),Commercial,United States of America,North America,63,4,3,59,26,29,34,Technical Failure
1952-04-18 00:00:00,Robin Airlines,Landing (descent or approach),Commercial,United States of America,North America,29,3,3,26,26,29,0,Human Factor
1953-02-09 00:00:00,Egyptian Air Force and Air Defence Command,Landing (descent or approach),Military / Government,Egypt,Africa,40,5,5,35,24,29,11,Unknown
1954-09-27 00:00:00,Aeroflot - Russian International Airlines,Landing (descent or approach),Commercial,Russia,Asia,29,5,5,24,24,29,0,Human Factor
1954-12-04 00:00:00,Air Laos,Landing (descent or approach),Commercial,Laos,Asia,29,4,4,25,25,29,0,Weather
1955-02-13 00:00:00,SABENA - Société Anonyme Belge d'Exploitation de la Navigation Aérienne,Flight,Commercial,Italy,Europe,29,8,8,21,21,29,0,Human Factor
1960-06-10 00:00:00,Trans Australia Airlines - TAA,Landing (descent or approach),Commercial,Australia,Oceania,29,4,4,25,25,29,0,Human Factor
1960-09-22 00:00:00,United States Navy - USN,Flight,Military / Government,World,World,29,6,6,23,23,29,0,Technical Failure
1963-06-03 00:00:00,Indian Airlines,Flight,Commercial,India,Asia,29,4,4,25,25,29,0,Technical Failure
1964-11-15 00:00:00,Bonanza Airlines,Landing (descent or approach),Commercial,United States of America,North America,29,4,4,25,25,29,0,Human Factor
1965-03-22 00:00:00,Avianca,Flight,Commercial,Colombia,South America,29,3,3,26,26,29,0,Human Factor
1966-12-24 00:00:00,Avianca,Flight,Commercial,Colombia,South America,29,3,3,26,26,29,0,Human Factor
1968-05-28 00:00:00,Garuda Indonesian Airways,Takeoff (climb),Commercial,India,Asia,29,14,14,15,15,29,0,Human Factor
1972-10-13 00:00:00,Transporte Aéreo Militar de Uruguay - TAMU,Flight,Commercial,Chile,South America,45,4,4,41,25,29,16,Human Factor
1973-01-14 00:00:00,CAAC - Civil Aviation Administration of China,Landing (descent or approach),Commercial,China,Asia,29,7,7,22,22,29,0,Unknown
1973-08-08 00:00:00,Aeroflot - Russian International Airlines,Takeoff (climb),Commercial,Russia,Asia,3,3,1,0,28,29,-26,Human Factor
1974-05-23 00:00:00,Aeroflot - Russian International Airlines,Landing (descent or approach),Commercial,Ukraine,Europe,29,4,4,25,25,29,0,Human Factor
1976-11-04 00:00:00,Bali International Air Service,Landing (descent or approach),Commercial,Indonesia,Asia,38,5,4,33,25,29,9,Human Factor
1977-09-21 00:00:00,Malév Hungarian Airlines - Magyar Légiközlekedési Vallalat,Landing (descent or approach),Commercial,Romania,Europe,53,8,8,45,21,29,24,Human Factor
1977-12-13 00:00:00,National Jet Services,Takeoff (climb),Commercial,United States of America,North America,29,3,3,26,26,29,0,Human Factor
1979-12-22 00:00:00,Peruvian Air Force - Fuerza Aérea del Perú,Landing (descent or approach),Military / Government,Peru,South America,29,5,5,24,24,29,0,Weather
1980-06-08 00:00:00,TAAG Angola Airlines - Transportes Aéreos de Angola,Flight,Commercial,Angola,Africa,29,4,4,25,25,29,0,Terrorism
1980-06-12 00:00:00,Aeroflot - Russian International Airlines,Flight,Commercial,Tajikistan,Asia,29,4,4,25,25,29,0,Human Factor
1985-01-01 00:00:00,Eastern Airlines,Flight,Commercial,Bolivia,South America,29,10,10,19,19,29,0,Human Factor
1986-11-29 00:00:00,Soviet Air Force - Voyenno-vozdushnye sily CCCP,Takeoff (climb),Military / Government,Afghanistan,Asia,29,8,8,21,21,29,0,Terrorism
1987-12-14 00:00:00,Brazilian Air Force - Força Aérea Brasileira,Landing (descent or approach),Commercial,Brazil,South America,29,6,6,23,23,29,0,Human Factor
1988-04-10 00:00:00,Afghan Republican Air Force - Afghan Hanai Qurah,Landing (descent or approach),Military / Government,Afghanistan,Asia,29,6,6,23,23,29,0,Terrorism
1988-04-27 00:00:00,Angola Air Force - Força Aérea Nacional Angolana,Landing (descent or approach),Military / Government,Angola,Africa,29,3,3,26,26,29,0,Terrorism
1988-08-02 00:00:00,Hemus Air - Bulgarian Aviation Company,Takeoff (climb),Commercial,Bulgaria,Europe,37,4,3,33,26,29,8,Human Factor
1990-02-17 00:00:00,Zambia Air Force,Landing (descent or approach),Military / Government,Zambia,Africa,29,5,5,24,24,29,0,Unknown
1992-07-14 00:00:00,Russian Air Force - Voyenno-vozdushnye sily Rossii,Takeoff (climb),Military / Government,Azerbaijan,Asia,34,7,6,27,23,29,5,Unknown
1997-01-09 00:00:00,Comair,Landing (descent or approach),Commercial,United States of America,North America,29,3,3,26,26,29,0,Human Factor
2016-07-22 00:00:00,Indian Air Force - Bharatiya Vayu Sena,Flight,Military / Government,World,World,29,6,6,23,23,29,0,Unknown
1944-08-03 00:00:00,United States Army Air Forces - USAAF,Flight,Military / Government,United States of America,North America,28,4,4,24,24,28,0,Weather
1945-07-11 00:00:00,South African Air Force,Takeoff (climb),Military / Government,Kenya,Africa,28,4,4,24,24,28,0,Unknown
1945-11-11 00:00:00,Royal Air Force - RAF,Takeoff (climb),Military / Government,Libya,Africa,29,7,7,22,21,28,1,Technical Failure
1945-11-15 00:00:00,Royal Australian Air Force - RAAF,Flight,Military / Government,Papua New Guinea,Oceania,28,3,3,25,25,28,0,Human Factor
1945-12-03 00:00:00,Royal Air Force - RAF,Flight,Military / Government,France,Europe,28,5,5,23,23,28,0,Weather
1948-04-24 00:00:00,Aeroflot - Russian International Airlines,Landing (descent or approach),Commercial,Russia,Asia,29,4,4,25,24,28,1,Weather
1949-06-06 00:00:00,Brazilian Air Force - Força Aérea Brasileira,Takeoff (climb),Military / Government,Brazil,South America,28,6,6,22,22,28,0,Weather
1949-11-29 00:00:00,American Airlines,Landing (descent or approach),Commercial,United States of America,North America,46,5,2,41,26,28,18,Human Factor
1950-06-05 00:00:00,Westair Transport,Flight,Commercial,World,World,65,3,0,62,28,28,37,Technical Failure
1950-10-17 00:00:00,British European Airways - BEA,Landing (descent or approach),Commercial,United Kingdom,Europe,29,5,4,24,24,28,1,Technical Failure
1950-10-31 00:00:00,British European Airways - BEA,Landing (descent or approach),Commercial,United Kingdom,Europe,30,4,3,26,25,28,2,Human Factor
1951-12-30 00:00:00,United States Air Force - USAF,Flight,Military / Government,United States of America,North America,28,4,4,24,24,28,0,Human Factor
1953-09-16 00:00:00,American Airlines,Landing (descent or approach),Commercial,United States of America,North America,28,3,3,25,25,28,0,Human Factor
1953-11-03 00:00:00,Lloyd Aéreo Boliviano - LAB Airlines,Flight,Commercial,Bolivia,South America,28,3,3,25,25,28,0,Human Factor
1954-09-05 00:00:00,KLM Royal Dutch Airlines - Koninklijke Luchtvaart Maatschappij,Takeoff (climb),Commercial,Ireland,Europe,56,10,3,46,25,28,28,Human Factor
1954-12-25 00:00:00,British Overseas Airways Corporation - BOAC,Landing (descent or approach),Commercial,United Kingdom,Europe,36,11,4,25,24,28,8,Human Factor
1955-11-17 00:00:00,Peninsular Air Transport,Takeoff (climb),Commercial,United States of America,North America,74,4,1,70,27,28,46,Human Factor
1958-09-19 00:00:00,Aeroflot - Russian International Airlines,Flight,Commercial,Russia,Asia,28,4,4,24,24,28,0,Human Factor
1959-04-29 00:00:00,Iberia - Lineas Aéreas de Espana,Flight,Commercial,Spain,Europe,28,3,3,25,25,28,0,Human Factor
1959-10-23 00:00:00,Aeroflot - Russian International Airlines,Landing (descent or approach),Commercial,Russia,Asia,29,5,5,24,23,28,1,Human Factor
1960-12-22 00:00:00,Philippine Airlines - PAL,Takeoff (climb),Commercial,Philippines,Asia,38,3,2,35,26,28,10,Technical Failure
1961-09-23 00:00:00,Turkish Airlines - THY Türk Hava Yollari,Landing (descent or approach),Commercial,Turkey,Asia,29,4,4,25,24,28,1,Human Factor
1962-09-23 00:00:00,Flying Tiger Line,Flight,Commercial,World,World,76,8,5,68,23,28,48,Technical Failure
1964-03-08 00:00:00,Taxader Airlines - Taxi Aéreo de Santander,Landing (descent or approach),Commercial,Colombia,South America,28,3,3,25,25,28,0,Human Factor
1964-09-03 00:00:00,Royal Thai Air Force - Kong Thap Akat Thai,Landing (descent or approach),Operational,Thailand,Asia,33,3,3,30,25,28,5,Human Factor
1970-01-14 00:00:00,Faucett,Flight,Commercial,Peru,South America,28,4,4,24,24,28,0,Human Factor
1971-06-07 00:00:00,Allegheny Airlines,Landing (descent or approach),Commercial,United States of America,North America,31,3,2,28,26,28,3,Human Factor
1971-12-21 00:00:00,Balkan Bulgarian Airlines,Takeoff (climb),Commercial,Bulgaria,Europe,73,11,2,62,26,28,45,Human Factor
1972-08-16 00:00:00,Union of Burma Airways,Takeoff (climb),Commercial,Myanmar,Asia,31,4,4,27,24,28,3,Unknown
1978-11-21 00:00:00,Taxi Aéreo El Venado,Flight,Commercial,Venezuela,South America,28,3,3,25,25,28,0,Human Factor
1979-06-07 00:00:00,Indian Air Force - Bharatiya Vayu Sena,Takeoff (climb),Military / Government,India,Asia,28,7,7,21,21,28,0,Human Factor
1987-11-15 00:00:00,Continental Airlines,Takeoff (climb),Commercial,United States of America,North America,82,5,3,77,25,28,54,Human Factor
1990-01-27 00:00:00,Congolese Air Force - Force Aérienne Congolaise,Flight,Military / Government,Congo,Africa,28,5,5,23,23,28,0,Weather
1991-03-24 00:00:00,Indian Air Force - Bharatiya Vayu Sena,Takeoff (climb),Operational,India,Asia,28,3,3,25,25,28,0,Technical Failure
1991-12-22 00:00:00,Classic Wings,Flight,Commercial,Germany,Europe,32,3,3,29,25,28,4,Human Factor
1994-09-26 00:00:00,Cheremshanka Airlines,Landing (descent or approach),Commercial,Russia,Asia,28,4,4,24,24,28,0,Technical Failure
1994-12-17 00:00:00,Missionary Aviation Fellowship - MAF,Flight,Commercial,Papua New Guinea,Oceania,28,2,2,26,26,28,0,Human Factor
1997-07-17 00:00:00,Trigana Air Service,Landing (descent or approach),Commercial,Indonesia,Asia,50,5,5,45,23,28,22,Technical Failure
1998-03-29 00:00:00,Peruvian Air Force - Fuerza Aérea del Perú,Landing (descent or approach),Humanitarian,Peru,South America,55,5,0,50,28,28,27,Technical Failure
1998-05-25 00:00:00,MIAT Mongolian Airlines - Mongolyn Irgeniy Agaaryn Teever,Takeoff (climb),Commercial,Mongolia,Asia,28,2,2,26,26,28,0,Human Factor
1999-01-21 00:00:00,Nicaraguayan Air Force - Fuerza Aérea - Ejercito de Nicaragua,Landing (descent or approach),Military / Government,Nicaragua,Central America,28,7,7,21,21,28,0,Unknown
2002-07-04 00:00:00,Prestige Airlines,Landing (descent or approach),Operational,Central African Republic,Africa,30,9,8,21,20,28,2,Technical Failure
2005-03-16 00:00:00,Regional Airlines - Regionalnye Avialinii,Landing (descent or approach),Commercial,Russia,Asia,52,7,2,45,26,28,24,Human Factor
2006-09-01 00:00:00,Iran Airtour,Landing (descent or approach),Commercial,Iran,Asia,148,11,0,137,28,28,120,Technical Failure
2011-10-13 00:00:00,Airlines PNG,Landing (descent or approach),Commercial,Papua New Guinea,Oceania,32,4,1,28,27,28,4,Human Factor
2021-07-06 00:00:00,Petropavlosvk-Khamchatsky Air Enterprise,Landing (descent or approach),Commercial,Russia,Asia,28,6,6,22,22,28,0,Human Factor
1942-05-12 00:00:00,Aeroflot - Russian International Airlines,,Military / Government,Russia,Asia,27,5,5,22,22,27,0,Terrorism
1943-08-07 00:00:00,United States Army Air Forces - USAAF,Takeoff (climb),Military / Government,Australia,Oceania,27,4,4,23,23,27,0,Unknown
1944-07-26 00:00:00,United States Army Air Forces - USAAF,Landing (descent or approach),Military / Government,Solomon Islands,Oceania,27,6,6,21,21,27,0,Unknown
1945-03-03 00:00:00,United States Army Air Forces - USAAF,Landing (descent or approach),Military / Government,India,Asia,27,4,4,23,23,27,0,Unknown
1945-06-15 00:00:00,Royal Air Force - RAF,Flight,Military / Government,United Kingdom,Europe,27,5,5,22,22,27,0,Technical Failure
1945-11-22 00:00:00,Royal Air Force - RAF,Takeoff (climb),Military / Government,United Kingdom,Europe,27,5,5,22,22,27,0,Human Factor
1946-05-16 00:00:00,Viking Air Transport,Landing (descent or approach),Commercial,United States of America,North America,27,2,2,25,25,27,0,Human Factor
1946-09-18 00:00:00,SABENA - Société Anonyme Belge d'Exploitation de la Navigation Aérienne,Landing (descent or approach),Commercial,Canada,North America,44,7,6,37,21,27,17,Human Factor
1947-04-08 00:00:00,Linea Aeropostal Venezolana - LAV,Landing (descent or approach),Commercial,Venezuela,South America,27,3,3,24,24,27,0,Unknown
1948-12-23 00:00:00,Iberia - Lineas Aéreas de Espana,Flight,Commercial,Spain,Europe,27,3,3,24,24,27,0,Unknown
1949-02-08 00:00:00,Scandinavian Airlines System - SAS,Landing (descent or approach),Commercial,Sweden,Europe,27,4,4,23,23,27,0,Unknown
1950-12-13 00:00:00,Air India,Flight,Commercial,India,Asia,27,4,4,23,23,27,0,Human Factor
1951-09-29 00:00:00,Frigorifico Cooperativo Los Andes,Takeoff (climb),Commercial,Bolivia,South America,27,3,3,24,24,27,0,Unknown
1952-12-25 00:00:00,Iran Air,Landing (descent or approach),Commercial,Iran,Asia,29,5,5,24,22,27,2,Technical Failure
1953-01-05 00:00:00,British European Airways - BEA,Landing (descent or approach),Commercial,United Kingdom,Europe,35,4,3,31,24,27,8,Human Factor
1957-04-17 00:00:00,Royal Air Force - RAF,Takeoff (climb),Military / Government,Jordan,Asia,27,3,3,24,24,27,0,Weather
1957-10-01 00:00:00,Aeroflot - Russian International Airlines,Flight,Commercial,Russia,Asia,28,5,5,23,22,27,1,Human Factor
1957-10-03 00:00:00,Lebanese International Airways - LIA,Flight,Commercial,Lebanon,Asia,27,4,4,23,23,27,0,Technical Failure
1957-12-18 00:00:00,Aeroflot - Russian International Airlines,Flight,Commercial,Russia,Asia,27,5,5,22,22,27,0,Weather
1958-09-07 00:00:00,Aeroflot - Russian International Airlines,Flight,Commercial,Kazakhstan,Asia,27,5,5,22,22,27,0,Weather
1961-08-06 00:00:00,Malév Hungarian Airlines - Magyar Légiközlekedési Vallalat,Flight,Commercial,Hungary,Europe,27,4,4,23,23,27,0,Human Factor
1961-12-21 00:00:00,British European Airways - BEA,Takeoff (climb),Commercial,Turkey,Asia,34,7,7,27,20,27,7,Technical Failure
1962-07-22 00:00:00,Canadian Pacific Airlines - CP Air,Landing (descent or approach),Commercial,United States of America,North America,40,11,7,29,20,27,13,Human Factor
1962-11-10 00:00:00,Air Vietnam,Landing (descent or approach),Commercial,Vietnam,Asia,27,3,3,24,24,27,0,Human Factor
1963-03-02 00:00:00,Philippine Airlines - PAL,Flight,Commercial,Philippines,Asia,27,3,3,24,24,27,0,Human Factor
1968-12-27 00:00:00,North Central Airlines,Landing (descent or approach),Commercial,United States of America,North America,45,4,3,41,24,27,18,Human Factor
1969-09-21 00:00:00,Mexicana de Aviación,Landing (descent or approach),Commercial,Mexico,Central America,122,7,5,115,22,27,95,Human Factor
1972-01-26 00:00:00,JAT Yugoslav Airlines - Jugoslovenski Aerotransport,Flight,Commercial,Czech Republic,Europe,28,5,5,23,22,27,1,Terrorism
1972-10-30 00:00:00,Aero Trasporti Italiani - ATI,Landing (descent or approach),Commercial,Italy,Europe,27,5,5,22,22,27,0,Human Factor
1973-06-20 00:00:00,AeroMéxico,Landing (descent or approach),Commercial,Mexico,Central America,27,5,5,22,22,27,0,Human Factor
1973-11-17 00:00:00,Air Vietnam,Landing (descent or approach),Commercial,Vietnam,Asia,27,3,3,24,24,27,0,Human Factor
1974-08-12 00:00:00,Avianca,Flight,Commercial,Colombia,South America,27,3,3,24,24,27,0,Weather
1975-07-31 00:00:00,Far Eastern Air Transport - FAT,Landing (descent or approach),Commercial,Taiwan,Asia,75,5,0,70,27,27,48,Weather
1975-09-01 00:00:00,Interflug,Landing (descent or approach),Commercial,Germany,Europe,34,6,3,28,24,27,7,Human Factor
1982-03-19 00:00:00,United States Air Force - USAF,Flight,Operational,United States of America,North America,27,4,4,23,23,27,0,Other
1982-03-20 00:00:00,Garuda Indonesian Airways,Landing (descent or approach),Commercial,Indonesia,Asia,27,4,4,23,23,27,0,Weather
1982-04-13 00:00:00,United States Air Force - USAF,Flight,Military / Government,Turkey,Asia,27,8,8,19,19,27,0,Technical Failure
1988-01-24 00:00:00,Aeroflot - Russian International Airlines,Takeoff (climb),Commercial,Russia,Asia,31,4,4,27,23,27,4,Technical Failure
1990-01-13 00:00:00,Aeroflot - Russian International Airlines,Landing (descent or approach),Commercial,Russia,Asia,71,6,4,65,23,27,44,Technical Failure
1992-03-22 00:00:00,USAir - US Airways,Takeoff (climb),Commercial,United States of America,North America,51,4,2,47,25,27,24,Human Factor
1993-09-21 00:00:00,Transair Georgia Airlines,Landing (descent or approach),Commercial,Georgia,Asia,27,5,5,22,22,27,0,Terrorism
1998-02-12 00:00:00,Sudanese Air Force - Al Quwwat al-Jawwiya As-Sudaniya,Landing (descent or approach),Military / Government,South Sudan,Africa,57,7,3,50,24,27,30,Human Factor
2000-08-12 00:00:00,STAER Airlines,Flight,Commercial,Democratic Republic of Congo,Africa,27,6,6,21,21,27,0,Unknown
2001-11-19 00:00:00,IRS Aero,Flight,Commercial,Russia,Asia,27,9,9,18,18,27,0,Technical Failure
2005-05-25 00:00:00,Victoria Air - DRC,Flight,Commercial,Democratic Republic of Congo,Africa,27,5,5,22,22,27,0,Unknown
2012-12-25 00:00:00,Kazakhstan Border Guards,Flight,Military / Government,Kazakhstan,Asia,27,7,7,20,20,27,0,Human Factor
1941-12-26 00:00:00,Aeroflot - Russian International Airlines,Flight,Commercial,Kazakhstan,Asia,34,6,5,28,21,26,8,Human Factor
1943-01-17 00:00:00,United States Army Air Forces - USAAF,Flight,Military / Government,World,World,26,6,6,20,20,26,0,Unknown
1944-07-26 00:00:00,United States Army Air Forces - USAAF,Flight,Military / Government,World,World,26,6,6,20,20,26,0,Unknown
1945-09-06 00:00:00,Royal Air Force - RAF,Flight,Military / Government,Myanmar,Asia,26,3,3,23,23,26,0,Unknown
1945-09-29 00:00:00,Royal Air Force - RAF,Flight,Military / Government,Italy,Europe,26,7,7,19,19,26,0,Unknown
1945-10-07 00:00:00,Royal Air Force - RAF,Landing (descent or approach),Military / Government,France,Europe,26,6,6,20,20,26,0,Unknown
1945-11-01 00:00:00,United States Army Air Forces - USAAF,Flight,Military / Government,Germany,Europe,30,4,4,26,22,26,4,Human Factor
1945-11-23 00:00:00,Royal Air Force - RAF,Takeoff (climb),Military / Government,Indonesia,Asia,26,5,5,21,21,26,0,Technical Failure
1946-01-15 00:00:00,Royal Air Force - RAF,Flight,Military / Government,France,Europe,26,4,4,22,22,26,0,Human Factor
1946-03-19 00:00:00,United States Army Air Forces - USAAF,Flight,Military / Government,United States of America,North America,26,3,3,23,23,26,0,Technical Failure
1946-11-14 00:00:00,KLM Royal Dutch Airlines - Koninklijke Luchtvaart Maatschappij,Landing (descent or approach),Commercial,Netherlands,Europe,26,5,5,21,21,26,0,Human Factor
1947-01-28 00:00:00,China National Aviation Corporation - CNAC,Flight,Commercial,China,Asia,26,3,3,23,23,26,0,Unknown
1947-03-12 00:00:00,Royal Netherlands East Indies Air Force - ML-KNIL,Flight,Military / Government,Indonesia,Asia,26,2,2,24,24,26,0,Human Factor
1947-07-31 00:00:00,Chinese Air Force - AFPLA - Chung-Kuo Shan Min Taie Fang Tsun Pu-Tai,Flight,Military / Government,China,Asia,26,4,4,22,22,26,0,Unknown
1949-12-12 00:00:00,Pakistan Airways - Pak Air,Flight,Commercial,Pakistan,Asia,26,4,4,22,22,26,0,Human Factor
1950-05-24 00:00:00,LANSA Colombia - Limitada Nacional de Servicio Aéreo,Flight,Commercial,Colombia,South America,27,3,3,24,23,26,1,Unknown
1950-07-29 00:00:00,Compagnie Air Transport - CAT,Flight,Commercial,Algeria,Africa,26,4,4,22,22,26,0,Technical Failure
1950-09-20 00:00:00,United States Navy - USN,Takeoff (climb),Military / Government,Marshall Islands,Oceania,26,7,7,19,19,26,0,Human Factor
1951-04-02 00:00:00,Avianca,Landing (descent or approach),Commercial,Colombia,South America,26,3,3,23,23,26,0,Unknown
1951-12-29 00:00:00,Continental Charters,Flight,Commercial,United States of America,North America,40,4,3,36,23,26,14,Human Factor
1954-08-26 00:00:00,Aeroflot - Russian International Airlines,Landing (descent or approach),Commercial,Russia,Asia,27,5,5,22,21,26,1,Human Factor
1954-08-27 00:00:00,United States Air Force - USAF,Landing (descent or approach),Operational,United States of America,North America,27,4,3,23,23,26,1,Other
1954-12-18 00:00:00,Linee Aeree Italiane - LAI,Landing (descent or approach),Commercial,United States of America,North America,32,10,10,22,16,26,6,Human Factor
1955-03-08 00:00:00,Mexicana de Aviación,Landing (descent or approach),Commercial,Mexico,Central America,26,3,3,23,23,26,0,Unknown
1957-04-10 00:00:00,Real Aerovias,Flight,Commercial,Brazil,South America,30,4,3,26,23,26,4,Technical Failure
1958-03-07 00:00:00,United States Navy - USN,Landing (descent or approach),Military / Government,Japan,Asia,26,7,7,19,19,26,0,Human Factor
1959-04-17 00:00:00,Tigres Voladores,Flight,Commercial,Mexico,Central America,26,4,4,22,22,26,0,Other
1959-10-30 00:00:00,Piedmont Airlines,Landing (descent or approach),Commercial,United States of America,North America,27,3,3,24,23,26,1,Human Factor
1960-02-25 00:00:00,Real Aerovias,Landing (descent or approach),Commercial,Brazil,South America,26,4,4,22,22,26,0,Human Factor
1961-02-03 00:00:00,Garuda Indonesian Airways,Flight,Commercial,Indonesia,Asia,26,5,5,21,21,26,0,Unknown
1962-05-22 00:00:00,United States Navy - USN,Landing (descent or approach),Military / Government,Germany,Europe,26,4,4,22,22,26,0,Technical Failure
1962-07-19 00:00:00,United Arab Airlines,Flight,Commercial,Thailand,Asia,26,8,8,18,18,26,0,Human Factor
1965-04-14 00:00:00,British United Airways - BUA,Landing (descent or approach),Commercial,United Kingdom,Europe,27,4,3,23,23,26,1,Human Factor
1965-11-08 00:00:00,Aerolineas TAO,Flight,Commercial,Colombia,South America,36,5,3,31,23,26,10,Human Factor
1966-02-16 00:00:00,Aeroflot - Russian International Airlines,Flight,Commercial,Russia,Asia,26,8,8,18,18,26,0,Technical Failure
1966-06-29 00:00:00,Philippine Airlines - PAL,Flight,Commercial,Philippines,Asia,28,4,4,24,22,26,2,Human Factor
1967-11-30 00:00:00,United States Air Force - USAF,Flight,Military / Government,Vietnam,Asia,26,4,4,22,22,26,0,Human Factor
1968-11-25 00:00:00,Air America,Takeoff (climb),Commercial,Laos,Asia,28,3,3,25,23,26,2,Technical Failure
1968-12-31 00:00:00,MacRobertson Miller Airlines,Flight,Commercial,Australia,Oceania,26,4,4,22,22,26,0,Technical Failure
1968-12-31 00:00:00,SAESA - Servicios Aéreos Especiales,Flight,Commercial,Mexico,Central America,26,4,4,22,22,26,0,Unknown
1969-10-02 00:00:00,United States Navy - USN,Flight,Military / Government,Vietnam,Asia,26,5,5,21,21,26,0,Technical Failure
1974-01-07 00:00:00,Soviet Air Force - Voyenno-vozdushnye sily CCCP,Landing (descent or approach),Military / Government,Belarus,Europe,31,6,6,25,20,26,5,Weather
1975-03-12 00:00:00,Air Vietnam,Flight,Commercial,Vietnam,Asia,26,6,6,20,20,26,0,Terrorism
1978-10-23 00:00:00,Aeroflot - Russian International Airlines,Flight,Commercial,Ukraine,Europe,26,5,5,21,21,26,0,Weather
1980-03-20 00:00:00,CAAC - Civil Aviation Administration of China,Landing (descent or approach),Commercial,China,Asia,26,7,7,19,19,26,0,Unknown
1984-01-15 00:00:00,Ethiopian Air Force - Ye Ityopya Ayer Hayl,Landing (descent or approach),Military / Government,Eritrea,Africa,26,5,5,21,21,26,0,Terrorism
1984-02-16 00:00:00,Ethiopian Air Force - Ye Ityopya Ayer Hayl,Landing (descent or approach),Military / Government,Ethiopia,Africa,38,5,5,33,21,26,12,Terrorism
1985-09-22 00:00:00,Soviet Air Force - Voyenno-vozdushnye sily CCCP,Flight,Military / Government,Afghanistan,Asia,26,4,4,22,22,26,0,Terrorism
1989-02-03 00:00:00,Burma Airways,Takeoff (climb),Commercial,Myanmar,Asia,29,4,3,25,23,26,3,Human Factor
1998-05-25 00:00:00,Lao Aviation,Flight,Military / Government,Laos,Asia,26,4,4,22,22,26,0,Human Factor
2002-01-17 00:00:00,Petroproduccion - Unidad de Aviacion,Flight,Commercial,Colombia,South America,26,5,5,21,21,26,0,Human Factor
2020-09-25 00:00:00,Ukrainian Air Force - Povitryani Syly Ukrayini,Landing (descent or approach),Operational,Ukraine,Europe,27,7,7,20,19,26,1,Technical Failure
1940-08-31 00:00:00,Pennsylvania Central Air Lines,Flight,Commercial,United States of America,North America,25,4,4,21,21,25,0,Weather
1942-09-27 00:00:00,Air France,Flight,Commercial,Algeria,Africa,25,7,7,18,18,25,0,Unknown
1943-09-20 00:00:00,United States Army Air Forces - USAAF,Takeoff (climb),Military / Government,United States of America,North America,25,4,4,21,21,25,0,Human Factor
1943-11-23 00:00:00,United States Army Air Forces - USAAF,Flight,Military / Government,New Caledonia,Oceania,25,6,6,19,19,25,0,Unknown
1944-11-19 00:00:00,United States Army Air Forces - USAAF,Flight,Military / Government,United Kingdom,Europe,30,5,5,25,20,25,5,Weather
1945-03-16 00:00:00,United States Army Air Forces - USAAF,Landing (descent or approach),Military / Government,Philippines,Asia,25,3,3,22,22,25,0,Unknown
1945-04-20 00:00:00,United States Army Air Forces - USAAF,Flight,Military / Government,United States of America,North America,25,3,3,22,22,25,0,Weather
1945-04-21 00:00:00,Deutsche Lufthansa,Flight,Commercial,Germany,Europe,25,4,4,21,21,25,0,Technical Failure
1945-06-23 00:00:00,United States Army Air Forces - USAAF,Flight,Military / Government,Myanmar,Asia,25,2,2,23,23,25,0,Unknown
1945-09-10 00:00:00,United States Army Air Forces - USAAF,Flight,Military / Government,Taiwan,Asia,25,5,5,20,20,25,0,Weather
1945-10-04 00:00:00,Royal Air Force - RAF,Flight,Military / Government,France,Europe,25,6,6,19,19,25,0,Technical Failure
1945-11-30 00:00:00,United States Navy - USN,Flight,Military / Government,World,World,25,8,8,17,17,25,0,Unknown
1945-12-19 00:00:00,Royal Australian Air Force - RAAF,Flight,Military / Government,World,World,25,4,4,21,21,25,0,Unknown
1946-03-03 00:00:00,American Airlines,Flight,Commercial,United States of America,North America,25,3,3,22,22,25,0,Human Factor
1946-03-10 00:00:00,Australian National Airways - ANA,Takeoff (climb),Commercial,Australia,Oceania,25,4,4,21,21,25,0,Human Factor
1946-07-09 00:00:00,United States Army Air Forces - USAAF,Landing (descent or approach),Military / Government,United States of America,North America,25,8,8,17,17,25,0,Human Factor
1946-09-19 00:00:00,Royal Air Force - RAF,Flight,Military / Government,Libya,Africa,25,6,6,19,19,25,0,Weather
1946-09-27 00:00:00,Panair do Brasil,Flight,Commercial,Brazil,South America,25,3,3,22,22,25,0,Human Factor
1947-05-29 00:00:00,Flugfélag Íslands,Flight,Commercial,Iceland,Europe,25,4,4,21,21,25,0,Unknown
1947-10-31 00:00:00,Indian Air Force - Bharatiya Vayu Sena,Flight,Military / Government,India,Asia,25,3,3,22,22,25,0,Unknown
1947-12-23 00:00:00,Air Transport - Belgium,Takeoff (climb),Commercial,China,Asia,30,4,4,26,21,25,5,Technical Failure
1948-07-17 00:00:00,Cathay Pacific Airways,Takeoff (climb),Commercial,China,Asia,26,3,3,23,22,25,1,Terrorism
1949-05-13 00:00:00,Aeroflot - Russian International Airlines,Landing (descent or approach),Commercial,Russia,Asia,25,5,5,20,20,25,0,Weather
1950-07-27 00:00:00,United States Air Force - USAF,Flight,Military / Government,Japan,Asia,26,3,3,23,22,25,1,Weather
1950-07-30 00:00:00,Aeroflot - Russian International Airlines,Landing (descent or approach),Commercial,Kazakhstan,Asia,25,6,6,19,19,25,0,Technical Failure
1952-10-16 00:00:00,United States Air Force - USAF,Takeoff (climb),Military / Government,South Korea,Asia,25,4,4,21,21,25,0,Unknown
1953-09-28 00:00:00,Resort Airlines,Landing (descent or approach),Commercial,United States of America,North America,41,3,3,38,22,25,16,Human Factor
1954-04-03 00:00:00,Devlet Hava Yollari - DHY,Takeoff (climb),Commercial,Turkey,Asia,25,3,3,22,22,25,0,Other
1954-04-23 00:00:00,Aerolineas Argentinas,Flight,Commercial,Argentina,South America,25,4,4,21,21,25,0,Human Factor
1955-08-06 00:00:00,Aeroflot - Russian International Airlines,Landing (descent or approach),Commercial,Russia,Asia,25,5,5,20,20,25,0,Technical Failure
1956-11-15 00:00:00,Aerovias Guest,Flight,Commercial,Nicaragua,Central America,25,5,5,20,20,25,0,Technical Failure
1956-11-27 00:00:00,Linea Aeropostal Venezolana - LAV,Landing (descent or approach),Commercial,Venezuela,South America,25,7,7,18,18,25,0,Human Factor
1957-03-17 00:00:00,Philippine Air Force - Hukbong Himpapawid NG Pilipinas,Takeoff (climb),Military / Government,Philippines,Asia,26,5,5,21,20,25,1,Technical Failure
1958-08-15 00:00:00,Northeast Airlines - USA,Landing (descent or approach),Commercial,United States of America,North America,34,3,3,31,22,25,9,Human Factor
1959-01-18 00:00:00,Aeroflot - Russian International Airlines,Landing (descent or approach),Commercial,Russia,Asia,25,5,5,20,20,25,0,Terrorism
1959-12-01 00:00:00,Allegheny Airlines,Landing (descent or approach),Commercial,United States of America,North America,26,4,4,22,21,25,1,Human Factor
1960-03-19 00:00:00,SAM Colombia - Sociedad Aeronáutica de Medellín,Landing (descent or approach),Commercial,Colombia,South America,46,4,3,42,22,25,21,Human Factor
1961-01-03 00:00:00,Finnair,Landing (descent or approach),Commercial,Finland,Europe,25,3,3,22,22,25,0,Human Factor
1962-11-30 00:00:00,Eastern Airlines,Landing (descent or approach),Commercial,United States of America,North America,51,6,4,45,21,25,26,Human Factor
1962-12-29 00:00:00,Air Nautic,Flight,Commercial,France,Europe,25,3,3,22,22,25,0,Human Factor
1967-03-09 00:00:00,Trans World Airlines - TWA,Flight,Commercial,United States of America,North America,25,4,4,21,21,25,0,Human Factor
1967-03-10 00:00:00,United States Navy - USN,Flight,Military / Government,Vietnam,Asia,25,4,4,21,21,25,0,Unknown
1967-03-13 00:00:00,South African Airways -SAA - Suid Afrikaanse Lugdiens - SAL,Landing (descent or approach),Commercial,South Africa,Africa,25,5,5,20,20,25,0,Human Factor
1970-12-19 00:00:00,Soviet Air Force - Voyenno-vozdushnye sily CCCP,Landing (descent or approach),Military / Government,India,Asia,25,5,5,20,20,25,0,Technical Failure
1971-10-10 00:00:00,Aeroflot - Russian International Airlines,Takeoff (climb),Commercial,Russia,Asia,25,7,7,18,18,25,0,Terrorism
1971-11-21 00:00:00,China Airlines,Flight,Commercial,Taiwan,Asia,25,8,8,17,17,25,0,Terrorism
1972-04-12 00:00:00,VASP - Viação Aérea de São Paulo,Landing (descent or approach),Commercial,Brazil,South America,25,4,4,21,21,25,0,Human Factor
1972-08-28 00:00:00,Royal Australian Air Force - RAAF,Flight,Military / Government,Papua New Guinea,Oceania,29,3,3,26,22,25,4,Human Factor
1973-03-03 00:00:00,Balkan Bulgarian Airlines,Landing (descent or approach),Commercial,Russia,Asia,25,8,8,17,17,25,0,Weather
1973-04-30 00:00:00,Yemenia Yemen Airways,Flight,Military / Government,Yemen,Asia,25,3,3,22,22,25,0,Unknown
1975-09-24 00:00:00,Garuda Indonesian Airways,Landing (descent or approach),Commercial,Indonesia,Asia,61,4,4,57,21,25,36,Human Factor
1977-07-25 00:00:00,Honduran Air Force - Fuerza Aérea Hondureña,Takeoff (climb),Military / Government,Honduras,Central America,40,4,2,36,23,25,15,Technical Failure
1977-09-08 00:00:00,Burma Airways,Landing (descent or approach),Commercial,Myanmar,Asia,25,3,3,22,22,25,0,Human Factor
1982-12-24 00:00:00,CAAC - Civil Aviation Administration of China,Landing (descent or approach),Commercial,China,Asia,69,11,0,58,25,25,44,Technical Failure
1985-12-30 00:00:00,Nepalese Army,Landing (descent or approach),Military / Government,Nepal,Asia,25,3,3,22,22,25,0,Unknown
1988-08-08 00:00:00,Soviet Air Force - Voyenno-vozdushnye sily CCCP,Landing (descent or approach),Military / Government,Russia,Asia,50,5,5,45,20,25,25,Other
1988-12-10 00:00:00,Ariana Afghan Airlines,Flight,Commercial,Pakistan,Asia,25,4,4,21,21,25,0,Terrorism
1990-01-23 00:00:00,Venezuelan Navy - Armada Venezolana,Takeoff (climb),Military / Government,Venezuela,South America,25,3,3,22,22,25,0,Human Factor
1990-03-27 00:00:00,Angola Air Force - Força Aérea Nacional Angolana,Takeoff (climb),Military / Government,Angola,Africa,25,5,5,20,20,25,0,Terrorism
1991-03-03 00:00:00,United Airlines,Landing (descent or approach),Commercial,United States of America,North America,25,5,5,20,20,25,0,Technical Failure
2000-07-27 00:00:00,Royal Nepal Airlines,Flight,Commercial,Nepal,Asia,25,3,3,22,22,25,0,Human Factor
2004-11-30 00:00:00,Lion Air,Landing (descent or approach),Commercial,Indonesia,Asia,163,7,2,156,23,25,138,Human Factor
2011-05-07 00:00:00,Merpati Nusantara Airlines - MNA,Landing (descent or approach),Commercial,Indonesia,Asia,25,4,4,21,21,25,0,Human Factor
1943-02-22 00:00:00,Pan American World Airways - PAA,Landing (descent or approach),Commercial,Portugal,Europe,39,12,7,27,17,24,15,Human Factor
1943-10-19 00:00:00,Royal Canadian Air Force - RCAF,Flight,Military / Government,Canada,North America,24,4,4,20,20,24,0,Weather
1943-12-27 00:00:00,United States Navy - USN,Flight,Military / Government,World,World,24,3,3,21,21,24,0,Unknown
1944-02-10 00:00:00,American Airlines,Landing (descent or approach),Commercial,United States of America,North America,24,3,3,21,21,24,0,Unknown
1944-02-24 00:00:00,United States Army Air Forces - USAAF,Flight,Military / Government,Italy,Europe,24,3,3,21,21,24,0,Unknown
1944-10-15 00:00:00,Soviet Air Force - Voyenno-vozdushnye sily CCCP,Flight,Military / Government,Slovakia,Europe,24,4,4,20,20,24,0,Unknown
1944-10-18 00:00:00,United States Army Air Forces - USAAF,Flight,Military / Government,United Kingdom,Europe,24,5,5,19,19,24,0,Technical Failure
1944-11-04 00:00:00,Transcontinental %26 Western Air - TWA,Flight,Commercial,United States of America,North America,24,3,3,21,21,24,0,Weather
1945-01-10 00:00:00,American Airlines,Flight,Commercial,United States of America,North America,24,3,3,21,21,24,0,Human Factor
1945-02-13 00:00:00,United States Navy - USN,Takeoff (climb),Military / Government,United States of America,North America,24,3,3,21,21,24,0,Technical Failure
1945-03-27 00:00:00,United States Army Air Forces - USAAF,Flight,Military / Government,World,World,24,4,4,20,20,24,0,Unknown
1945-05-10 00:00:00,Royal Air Force - RAF,Landing (descent or approach),Military / Government,Norway,Europe,24,6,6,18,18,24,0,Weather
1945-06-07 00:00:00,Royal Air Force - RAF,Flight,Military / Government,Bangladesh,Asia,24,5,5,19,19,24,0,Weather
1945-11-09 00:00:00,United States Army Air Forces - USAAF,Flight,Military / Government,Italy,Europe,25,4,4,21,20,24,1,Weather
1946-02-05 00:00:00,United States Army Air Forces - USAAF,Flight,Military / Government,Philippines,Asia,24,4,4,20,20,24,0,Human Factor
1946-09-07 00:00:00,British South American Airways - BSAA,Takeoff (climb),Commercial,Gambia,Africa,24,4,4,20,20,24,0,Human Factor
1946-11-01 00:00:00,Compagnie de Transports Aériens du Languedoc-Roussillon - CTALR,Flight,Commercial,France,Europe,27,3,3,24,21,24,3,Weather
1946-12-04 00:00:00,Aeroflot - Russian International Airlines,Takeoff (climb),Commercial,Iran,Asia,24,3,3,21,21,24,0,Unknown
1946-12-10 00:00:00,United States Army Air Forces - USAAF,Takeoff (climb),Operational,Japan,Asia,24,5,5,19,19,24,0,Technical Failure
1948-12-21 00:00:00,CSA Czech Airlines - Československé Státní Aerolinie,Flight,Commercial,Greece,Europe,24,5,5,19,19,24,0,Terrorism
1949-03-12 00:00:00,French Air Force - Armée de l'Air,Flight,Military / Government,Vietnam,Asia,24,4,4,20,20,24,0,Terrorism
1949-08-19 00:00:00,British European Airways - BEA,Landing (descent or approach),Commercial,United Kingdom,Europe,32,3,3,29,21,24,8,Human Factor
1949-09-26 00:00:00,Mexicana de Aviación,Landing (descent or approach),Commercial,Mexico,Central America,24,3,3,21,21,24,0,Human Factor
1951-03-11 00:00:00,Pacific Overseas Airlines - POA,Takeoff (climb),Commercial,China,Asia,24,4,4,20,20,24,0,Human Factor
1952-08-12 00:00:00,Transportes Aéreos Nacional,Flight,Commercial,Brazil,South America,24,4,4,20,20,24,0,Technical Failure
1952-10-05 00:00:00,Aeroflot - Russian International Airlines,Landing (descent or approach),Commercial,Russia,Asia,24,5,5,19,19,24,0,Human Factor
1952-12-25 00:00:00,AVENSA - Aerovias Venezolanas,Takeoff (climb),Commercial,Venezuela,South America,24,3,3,21,21,24,0,Unknown
1954-11-16 00:00:00,Peruvian Air Force - Fuerza Aérea del Perú,Flight,Military / Government,Peru,South America,24,3,3,21,21,24,0,Human Factor
1957-07-01 00:00:00,Pakistan International Airlines - PIA,Takeoff (climb),Commercial,Bangladesh,Asia,24,4,4,20,20,24,0,Weather
1958-06-09 00:00:00,Aeroflot - Russian International Airlines,Landing (descent or approach),Commercial,Russia,Asia,24,4,4,20,20,24,0,Human Factor
1959-03-29 00:00:00,Indian Airlines,Flight,Commercial,India,Asia,24,4,4,20,20,24,0,Weather
1959-11-21 00:00:00,Ariana Afghan Airlines,Takeoff (climb),Commercial,Lebanon,Asia,27,5,5,22,19,24,3,Human Factor
1961-04-03 00:00:00,LAN Chile - Linea Aérea Nacional de Chile,Flight,Commercial,Chile,South America,24,4,4,20,20,24,0,Weather
1961-06-30 00:00:00,Transcontinental TSA,Landing (descent or approach),Commercial,Argentina,South America,35,5,2,30,22,24,11,Human Factor
1962-12-06 00:00:00,Taxader Airlines - Taxi Aéreo de Santander,Flight,Commercial,Colombia,South America,26,3,3,23,21,24,2,Human Factor
1965-01-02 00:00:00,Aeroflot - Russian International Airlines,Takeoff (climb),Commercial,Turkmenistan,Asia,24,2,2,22,22,24,0,Human Factor
1966-08-11 00:00:00,TAROM - Transporturile Aeriene Române,Flight,Commercial,Romania,Europe,24,4,4,20,20,24,0,Unknown
1966-09-22 00:00:00,ANSETT-ANA,Flight,Commercial,Australia,Oceania,24,4,4,20,20,24,0,Technical Failure
1967-06-30 00:00:00,Thai Airways International,Landing (descent or approach),Commercial,China,Asia,80,7,0,73,24,24,56,Human Factor
1967-10-08 00:00:00,United States Air Force - USAF,Takeoff (climb),Military / Government,Vietnam,Asia,24,5,5,19,19,24,0,Human Factor
1969-01-02 00:00:00,China Airlines,Flight,Commercial,Taiwan,Asia,24,5,5,19,19,24,0,Human Factor
1969-06-23 00:00:00,Aeroflot - Russian International Airlines,Flight,Commercial,Russia,Asia,24,5,5,19,19,24,0,Human Factor
1969-10-13 00:00:00,Aeroflot - Russian International Airlines,Landing (descent or approach),Commercial,Russia,Asia,56,4,2,52,22,24,32,Technical Failure
1971-06-13 00:00:00,United States Air Force - USAF,Flight,Military / Government,World,World,24,4,4,20,20,24,0,Technical Failure
1973-08-28 00:00:00,United States Air Force - USAF,Landing (descent or approach),Military / Government,Spain,Europe,25,8,7,17,17,24,1,Human Factor
1974-01-06 00:00:00,Aeroflot - Russian International Airlines,Landing (descent or approach),Commercial,Ukraine,Europe,24,6,6,18,18,24,0,Weather
1974-01-10 00:00:00,TAM Bolivia - Transporte Aéreo Militar Boliviano,Flight,Military / Government,Bolivia,South America,24,3,3,21,21,24,0,Weather
1976-02-09 00:00:00,Aeroflot - Russian International Airlines,Takeoff (climb),Commercial,Russia,Asia,114,10,9,104,15,24,90,Human Factor
1976-12-30 00:00:00,Faucett,Takeoff (climb),Commercial,Peru,South America,24,5,5,19,19,24,0,Unknown
1977-12-29 00:00:00,SAN Ecuador - Servicios Aéreos Nacionales,Landing (descent or approach),Commercial,Ecuador,South America,24,4,4,20,20,24,0,Human Factor
1981-05-21 00:00:00,Aero León,Flight,Commercial,Mexico,Central America,24,3,3,21,21,24,0,Human Factor
1982-02-09 00:00:00,Japan Airlines,Landing (descent or approach),Commercial,Japan,Asia,177,11,0,166,24,24,153,Human Factor
1984-08-04 00:00:00,Soviet Navy - Voyenno-morskoy flot CCCP,Flight,Military / Government,Pakistan,Asia,24,9,9,15,15,24,0,Weather
1988-03-04 00:00:00,Transport Aérien Transrégional - TAT,Flight,Commercial,France,Europe,24,3,3,21,21,24,0,Technical Failure
1988-04-12 00:00:00,United Air,Flight,Commercial,South Africa,Africa,24,3,3,21,21,24,0,Technical Failure
1989-03-10 00:00:00,Air Ontario,Takeoff (climb),Commercial,Canada,North America,69,4,3,65,21,24,45,Human Factor
1989-12-21 00:00:00,TAM Bolivia - Transporte Aéreo Militar Boliviano,Takeoff (climb),Military / Government,Bolivia,South America,28,10,8,18,16,24,4,Technical Failure
1990-05-10 00:00:00,Aviacsa - Aviacion de Chiapas,Landing (descent or approach),Commercial,Mexico,Central America,40,4,4,36,20,24,16,Human Factor
1992-07-20 00:00:00,Transair Georgia Airlines,Takeoff (climb),Operational,Georgia,Asia,24,8,8,16,16,24,0,Other
1993-08-26 00:00:00,Sakha Avia - Sakha Airlines,Landing (descent or approach),Commercial,Russia,Asia,24,2,2,22,22,24,0,Other
1995-09-22 00:00:00,United States Air Force - USAF,Takeoff (climb),Military / Government,United States of America,North America,24,4,4,20,20,24,0,Other
1997-09-13 00:00:00,German Air Force - Deutsche Luftwaffe,Flight,Military / Government,World,World,24,10,10,14,14,24,0,Human Factor
1998-09-02 00:00:00,PermTransAvia,Flight,Commercial,Angola,Africa,24,4,4,20,20,24,0,Terrorism
1999-11-12 00:00:00,Si Fly,Flight,Humanitarian,Kosovo,Europe,24,3,3,21,21,24,0,Human Factor
2000-04-19 00:00:00,Centrafricain Airlines,Takeoff (climb),Commercial,Democratic Republic of Congo,Africa,24,4,4,20,20,24,0,Other
2001-01-25 00:00:00,Rutaca - Rutas Aéreas,Landing (descent or approach),Commercial,Venezuela,South America,24,4,4,20,20,24,0,Technical Failure
2001-11-24 00:00:00,Crossair,Landing (descent or approach),Commercial,Switzerland,Europe,33,5,3,28,21,24,9,Human Factor
2009-02-07 00:00:00,Manaus Aerotáxi,Landing (descent or approach),Commercial,Brazil,South America,28,2,2,26,22,24,4,Other
2009-04-06 00:00:00,Indonesian Air Force - TNI-AU Tentara Nasional Indonesia - Angkatan Udara,Landing (descent or approach),Humanitarian,Indonesia,Asia,24,6,6,18,18,24,0,Unknown
1943-03-27 00:00:00,Royal Australian Air Force - RAAF,Takeoff (climb),Military / Government,Australia,Oceania,23,4,4,19,19,23,0,Human Factor
1943-06-08 00:00:00,United States Navy - USN,Takeoff (climb),Military / Government,New Caledonia,Oceania,23,3,3,20,20,23,0,Technical Failure
1944-05-18 00:00:00,United States Navy - USN,Flight,Military / Government,Solomon Islands,Oceania,23,3,3,20,20,23,0,Unknown
1944-09-24 00:00:00,Royal Air Force - RAF,Flight,Military / Government,Germany,Europe,23,3,3,20,20,23,0,Terrorism
1945-01-08 00:00:00,Pan American World Airways - PAA,Landing (descent or approach),Commercial,Trinidad and Tobago,Central America,30,6,3,24,20,23,7,Human Factor
1945-02-02 00:00:00,United States Army Air Forces - USAAF,Flight,Military / Government,Italy,Europe,26,4,3,22,20,23,3,Weather
1945-02-06 00:00:00,Royal Air Force - RAF,Flight,Military / Government,United Kingdom,Europe,23,4,4,19,19,23,0,Human Factor
1945-09-15 00:00:00,United States Army Air Forces - USAAF,Takeoff (climb),Military / Government,United States of America,North America,24,3,3,21,20,23,1,Technical Failure
1945-10-05 00:00:00,Royal Air Force - RAF,Takeoff (climb),Humanitarian,United Kingdom,Europe,23,5,5,18,18,23,0,Technical Failure
1946-06-09 00:00:00,United States Army Air Forces - USAAF,Landing (descent or approach),Military / Government,Panama,Central America,23,6,6,17,17,23,0,Human Factor
1946-11-16 00:00:00,United States Army Air Forces - USAAF,Landing (descent or approach),Military / Government,Japan,Asia,23,5,5,18,18,23,0,Unknown
1946-11-27 00:00:00,Lineas Aéreas Costarricenses - LACSA,Landing (descent or approach),Commercial,Costa Rica,Central America,23,3,3,20,20,23,0,Human Factor
1947-03-05 00:00:00,Aeroflot - Russian International Airlines,Flight,Commercial,Georgia,Asia,23,4,4,19,19,23,0,Human Factor
1947-03-14 00:00:00,Air France,Flight,Commercial,France,Europe,23,5,5,18,18,23,0,Human Factor
1947-11-27 00:00:00,Jugoslovenske Sovjet Transport Aviacija - JUSTA,Landing (descent or approach),Commercial,Montenegro,Europe,23,5,5,18,18,23,0,Human Factor
1947-12-10 00:00:00,United States Air Force - USAF,Takeoff (climb),Military / Government,Canada,North America,29,4,1,25,22,23,6,Human Factor
1947-12-27 00:00:00,Air India,Takeoff (climb),Commercial,Pakistan,Asia,23,4,4,19,19,23,0,Human Factor
1948-02-27 00:00:00,Brazilian Air Force - Força Aérea Brasileira,Landing (descent or approach),Military / Government,Brazil,South America,26,6,6,20,17,23,3,Unknown
1948-11-22 00:00:00,Aeroflot - Russian International Airlines,Landing (descent or approach),Commercial,Russia,Asia,26,5,5,21,18,23,3,Human Factor
1949-02-24 00:00:00,Cathay Pacific Airways,Landing (descent or approach),Commercial,China,Asia,23,4,4,19,19,23,0,Human Factor
1949-09-09 00:00:00,Canadian Pacific Airlines - CP Air,Flight,Commercial,Canada,North America,23,4,4,19,19,23,0,Terrorism
1950-07-07 00:00:00,United States Air Force - USAF,Flight,Military / Government,South Korea,Asia,23,5,5,18,18,23,0,Unknown
1950-09-26 00:00:00,United States Air Force - USAF,Takeoff (climb),Military / Government,Japan,Asia,51,8,5,43,18,23,28,Unknown
1951-05-06 00:00:00,United States Air Force - USAF,Landing (descent or approach),Military / Government,United States of America,North America,25,9,9,16,14,23,2,Weather
1951-10-17 00:00:00,Queen Charlotte Airlines,Flight,Commercial,Canada,North America,23,3,3,20,20,23,0,Human Factor
1951-11-17 00:00:00,Aeroflot - Russian International Airlines,Takeoff (climb),Commercial,Russia,Asia,23,4,4,19,19,23,0,Weather
1952-01-10 00:00:00,Aer Lingus,Flight,Commercial,United Kingdom,Europe,23,3,3,20,20,23,0,Human Factor
1952-01-22 00:00:00,American Airlines,Landing (descent or approach),Commercial,United States of America,North America,23,5,5,18,18,23,0,Human Factor
1953-03-18 00:00:00,United States Air Force - USAF,Flight,Military / Government,Canada,North America,23,5,5,18,18,23,0,Weather
1953-12-04 00:00:00,Aviaco - Aviacion y Comercio,Flight,Commercial,Spain,Europe,33,5,1,28,22,23,10,Weather
1954-01-11 00:00:00,Avianca,Landing (descent or approach),Commercial,Colombia,South America,23,4,4,19,19,23,0,Human Factor
1956-11-24 00:00:00,CSA Czech Airlines - Československé Státní Aerolinie,Takeoff (climb),Commercial,Switzerland,Europe,23,5,5,18,18,23,0,Unknown
1957-08-15 00:00:00,Aeroflot - Russian International Airlines,Landing (descent or approach),Commercial,Denmark,Europe,23,5,5,18,18,23,0,Human Factor
1958-02-06 00:00:00,British European Airways - BEA,Takeoff (climb),Commercial,Germany,Europe,44,6,2,38,21,23,21,Other
1958-10-14 00:00:00,Linea Aeropostal Venezolana - LAV,Flight,Commercial,Venezuela,South America,23,6,6,17,17,23,0,Human Factor
1959-03-10 00:00:00,Brazilian Air Force - Força Aérea Brasileira,Flight,Military / Government,Brazil,South America,23,4,4,19,19,23,0,Unknown
1960-07-20 00:00:00,Aeroflot - Russian International Airlines,Flight,Commercial,Russia,Asia,23,4,4,19,19,23,0,Weather
1960-09-29 00:00:00,United Arab Airlines,Flight,Commercial,Italy,Europe,23,6,6,17,17,23,0,Weather
1961-01-26 00:00:00,United States Air Force - USAF,Landing (descent or approach),Military / Government,Canada,North America,23,10,10,13,13,23,0,Technical Failure
1961-03-25 00:00:00,Brazilian Air Force - Força Aérea Brasileira,Landing (descent or approach),Commercial,Brazil,South America,28,6,2,22,21,23,5,Unknown
1962-02-25 00:00:00,AVENSA - Aerovias Venezolanas,Takeoff (climb),Commercial,Venezuela,South America,23,3,3,20,20,23,0,Human Factor
1962-05-09 00:00:00,Cruzeiro do Sul,Landing (descent or approach),Commercial,Brazil,South America,25,3,3,22,20,23,2,Human Factor
1962-07-15 00:00:00,Vietnam People's Air Force,Takeoff (climb),Military / Government,Vietnam,Asia,27,2,2,25,21,23,4,Unknown
1962-11-22 00:00:00,Portuguese Air Force - Força Aerea Portuguesa,Takeoff (climb),Military / Government,São Tomé and Principe,Africa,37,4,4,33,19,23,14,Other
1962-11-26 00:00:00,VASP - Viação Aérea de São Paulo,Flight,Commercial,Brazil,South America,23,5,5,18,18,23,0,Human Factor
1963-07-03 00:00:00,New Zealand National Airways,Flight,Commercial,New Zealand,Oceania,23,3,3,20,20,23,0,Weather
1965-02-13 00:00:00,Aeroflot - Russian International Airlines,Flight,Commercial,Azerbaijan,Asia,23,4,4,19,19,23,0,Human Factor
1966-01-01 00:00:00,Aeroflot - Russian International Airlines,Flight,Commercial,Russia,Asia,23,5,5,18,18,23,0,Technical Failure
1967-04-17 00:00:00,Imperial Iranian Air Force,Flight,Military / Government,Iran,Asia,23,9,9,14,14,23,0,Weather
1968-10-20 00:00:00,United States Air Force - USAF,Flight,Military / Government,Vietnam,Asia,23,12,12,11,11,23,0,Technical Failure
1970-01-12 00:00:00,Hellenic Air Force - Elleniki Polemiki Aeroporia,Flight,Humanitarian,Greece,Europe,27,5,4,22,19,23,4,Weather
1970-03-16 00:00:00,United States Navy - USN,Landing (descent or approach),Military / Government,Vietnam,Asia,31,6,6,25,17,23,8,Human Factor
1970-05-02 00:00:00,ALM Antillean Airlines - Antillaanse Luchtvaart Maatschappij,Landing (descent or approach),Commercial,United States of America,Central America,63,6,1,57,22,23,40,Technical Failure
1970-07-18 00:00:00,Soviet Air Force - Voyenno-vozdushnye sily CCCP,Flight,Humanitarian,World,World,23,8,8,15,15,23,0,Unknown
1972-01-06 00:00:00,SAESA - Servicios Aéreos Especiales,Takeoff (climb),Commercial,Mexico,Central America,23,5,5,18,18,23,0,Other
1972-02-11 00:00:00,Royal Air Lao,Flight,Commercial,Laos,Asia,23,6,6,17,17,23,0,Terrorism
1973-06-01 00:00:00,Cruzeiro do Sul,Landing (descent or approach),Commercial,Brazil,South America,23,7,7,16,16,23,0,Unknown
1975-01-08 00:00:00,SATENA - Servicio de Aeronavegacion a Territorios Nacionales,Flight,Commercial,Colombia,South America,23,4,4,19,19,23,0,Unknown
1975-08-15 00:00:00,Aeroflot - Russian International Airlines,Landing (descent or approach),Commercial,Turkmenistan,Asia,38,4,2,34,21,23,15,Weather
1976-08-28 00:00:00,United States Air Force - USAF,Landing (descent or approach),Military / Government,Greenland,Europe,27,8,7,19,16,23,4,Human Factor
1981-02-26 00:00:00,United States Air Force - USAF,Flight,Military / Government,Philippines,Asia,24,9,8,15,15,23,1,Unknown
1982-02-07 00:00:00,Indian Air Force - Bharatiya Vayu Sena,Landing (descent or approach),Military / Government,India,Asia,23,5,5,18,18,23,0,Weather
1982-05-09 00:00:00,Alyemda Yemen Airlines,Landing (descent or approach),Commercial,Yemen,Asia,49,4,2,45,21,23,26,Unknown
1983-03-11 00:00:00,AVENSA - Aerovias Venezolanas,Landing (descent or approach),Commercial,Venezuela,South America,50,5,1,45,22,23,27,Human Factor
1983-06-02 00:00:00,Air Canada,Landing (descent or approach),Commercial,United States of America,North America,46,5,0,41,23,23,23,Technical Failure
1983-07-01 00:00:00,Air Koryo - Chosonminhang Korean Airways,Landing (descent or approach),Commercial,Guinea,Africa,23,6,6,17,17,23,0,Human Factor
1984-03-16 00:00:00,Lloyd Aéreo Boliviano - LAB Airlines,Flight,Commercial,Bolivia,South America,23,3,3,20,20,23,0,Human Factor
1985-01-23 00:00:00,ACES Colombia - Aerolineas Centrales de Colombia,Flight,Commercial,Colombia,South America,23,3,3,20,20,23,0,Human Factor
1985-11-25 00:00:00,Soviet Air Force - Voyenno-vozdushnye sily CCCP,Flight,Military / Government,Angola,Africa,23,8,8,15,15,23,0,Terrorism
1986-06-10 00:00:00,Air Sinai,Landing (descent or approach),Commercial,Egypt,Africa,26,5,5,21,18,23,3,Human Factor
1987-04-04 00:00:00,Garuda Indonesian Airways,Landing (descent or approach),Commercial,Indonesia,Asia,45,8,4,37,19,23,22,Weather
1990-01-15 00:00:00,SANSA - Servicios Aéreos Nacionales,Takeoff (climb),Commercial,Costa Rica,Central America,23,3,3,20,20,23,0,Human Factor
1991-04-05 00:00:00,Atlantic Southeast Airlines - ASA,Landing (descent or approach),Commercial,United States of America,North America,23,3,3,20,20,23,0,Other
1994-10-29 00:00:00,Aero-Nika,Landing (descent or approach),Operational,Russia,Asia,23,9,9,14,14,23,0,Human Factor
1996-11-27 00:00:00,Russian Air Force - Voyenno-vozdushnye sily Rossii,Takeoff (climb),Operational,Russia,Asia,23,10,10,13,13,23,0,Other
1997-02-01 00:00:00,Air Sénégal - SONATRA Société Nationale de Transports Aériens,Takeoff (climb),Commercial,Senegal,Africa,52,3,3,49,20,23,29,Human Factor
1997-06-06 00:00:00,Bazair,Takeoff (climb),Commercial,Democratic Republic of Congo,Africa,23,3,3,20,20,23,0,Technical Failure
1997-12-06 00:00:00,Russian Air Force - Voyenno-vozdushnye sily Rossii,Takeoff (climb),Military / Government,Russia,Asia,23,8,8,15,15,23,0,Technical Failure
2002-08-30 00:00:00,Rico Linhas Aéreas - Rondonia Importaçao e Comercio,Landing (descent or approach),Commercial,Brazil,South America,31,3,3,28,20,23,8,Human Factor
2005-12-23 00:00:00,Azerbaijan Airlines - AZAL Airlines,Takeoff (climb),Commercial,Azerbaijan,Asia,23,5,5,18,18,23,0,Technical Failure
2016-02-24 00:00:00,Tara Air,Flight,Commercial,Nepal,Asia,23,3,3,20,20,23,0,Human Factor
1941-08-10 00:00:00,Royal Air Force - RAF,Takeoff (climb),Military / Government,United Kingdom,Europe,22,3,3,19,19,22,0,Human Factor
1941-08-14 00:00:00,Royal Air Force - RAF,Takeoff (climb),Military / Government,United Kingdom,Europe,22,4,4,18,18,22,0,Human Factor
1942-01-16 00:00:00,Transcontinental %26 Western Air - TWA,Flight,Commercial,United States of America,North America,22,3,3,19,19,22,0,Human Factor
1942-02-28 00:00:00,British Overseas Airways Corporation - BOAC,Flight,Humanitarian,World,World,22,4,4,18,18,22,0,Terrorism
1942-10-01 00:00:00,United States Army Air Forces - USAAF,Flight,Military / Government,Puerto Rico,Central America,22,5,5,17,17,22,0,Human Factor
1944-02-05 00:00:00,United States Navy - USN,Takeoff (climb),Military / Government,Solomon Islands,Oceania,22,2,2,20,20,22,0,Unknown
1944-06-06 00:00:00,United States Army Air Forces - USAAF,Flight,Military / Government,France,Europe,22,4,4,18,18,22,0,Terrorism
1944-06-06 00:00:00,United States Army Air Forces - USAAF,Flight,Military / Government,France,Europe,22,5,5,17,17,22,0,Terrorism
1944-06-06 00:00:00,Royal Air Force - RAF,Flight,Military / Government,France,Europe,23,4,4,19,18,22,1,Terrorism
1944-06-06 00:00:00,United States Army Air Forces - USAAF,Flight,Military / Government,France,Europe,22,4,4,18,18,22,0,Terrorism
1944-07-27 00:00:00,United States Army Air Forces - USAAF,Flight,Military / Government,United Kingdom,Europe,22,5,5,17,17,22,0,Human Factor
1944-11-27 00:00:00,United States Navy - USN,Flight,Military / Government,Brazil,South America,22,3,3,19,19,22,0,Technical Failure
1945-03-31 00:00:00,Brazilian Air Force - Força Aérea Brasileira,Landing (descent or approach),Military / Government,Brazil,South America,22,2,2,20,20,22,0,Human Factor
1945-09-07 00:00:00,Eastern Airlines,Landing (descent or approach),Commercial,United States of America,North America,22,3,3,19,19,22,0,Technical Failure
1945-10-15 00:00:00,Royal Air Force - RAF,Takeoff (climb),Military / Government,Singapore,Asia,22,5,5,17,17,22,0,Unknown
1946-01-14 00:00:00,Aeroflot - Russian International Airlines,Flight,Commercial,Russia,Asia,22,5,5,17,17,22,0,Weather
1946-06-08 00:00:00,Royal Air Force - RAF,Flight,Military / Government,Nigeria,Africa,22,4,4,18,18,22,0,Other
1946-07-25 00:00:00,Royal Air Force - RAF,Takeoff (climb),Military / Government,Myanmar,Asia,22,4,4,18,18,22,0,Weather
1946-09-03 00:00:00,Air France,Takeoff (climb),Commercial,Denmark,Europe,22,5,5,17,17,22,0,Technical Failure
1947-01-26 00:00:00,KLM Royal Dutch Airlines - Koninklijke Luchtvaart Maatschappij,Takeoff (climb),Commercial,Denmark,Europe,22,6,6,16,16,22,0,Human Factor
1947-05-16 00:00:00,Aeroflot - Russian International Airlines,Landing (descent or approach),Commercial,Russia,Asia,22,5,5,17,17,22,0,Human Factor
1949-02-10 00:00:00,Faucett,Landing (descent or approach),Commercial,Peru,South America,22,3,3,19,19,22,0,Human Factor
1949-02-24 00:00:00,Peruvian Air Force - Fuerza Aérea del Perú,Takeoff (climb),Military / Government,Peru,South America,26,4,2,22,20,22,4,Technical Failure
1949-06-06 00:00:00,TAE National Greek Airlines,Landing (descent or approach),Commercial,Greece,Europe,22,4,4,18,18,22,0,Weather
1950-07-09 00:00:00,Aigle Azur,Takeoff (climb),Commercial,Morocco,Africa,29,4,4,25,18,22,7,Unknown
1950-07-17 00:00:00,Indian National Airways - INA,Flight,Commercial,India,Asia,22,4,4,18,18,22,0,Weather
1951-04-06 00:00:00,Southwest Airways,Landing (descent or approach),Commercial,United States of America,North America,22,3,3,19,19,22,0,Human Factor
1951-12-23 00:00:00,Misrair,Landing (descent or approach),Commercial,Iran,Asia,22,4,4,18,18,22,0,Weather
1953-10-27 00:00:00,Aeroflot - Russian International Airlines,Takeoff (climb),Commercial,Russia,Asia,32,5,5,27,17,22,10,Human Factor
1954-06-19 00:00:00,Mexican Air Force - Fuerza Aérea Mexicana,Flight,Military / Government,Mexico,Central America,22,7,7,15,15,22,0,Unknown
1955-07-14 00:00:00,Lineas Aéreas Unidas,Landing (descent or approach),Commercial,Mexico,Central America,22,3,3,19,19,22,0,Human Factor
1955-07-17 00:00:00,Braniff International Airways,Landing (descent or approach),Commercial,United States of America,North America,43,5,2,38,20,22,21,Human Factor
1956-01-18 00:00:00,CSA Czech Airlines - Československé Státní Aerolinie,Landing (descent or approach),Commercial,Slovakia,Europe,26,4,4,22,18,22,4,Human Factor
1956-04-01 00:00:00,Trans World Airlines - TWA,Takeoff (climb),Commercial,United States of America,North America,36,3,1,33,21,22,14,Human Factor
1957-02-22 00:00:00,United States Air Force - USAF,Takeoff (climb),Military / Government,South Korea,Asia,159,10,3,149,19,22,137,Technical Failure
1958-02-20 00:00:00,United States Navy - USN,Flight,Military / Government,World,World,22,5,5,17,17,22,0,Unknown
1960-10-29 00:00:00,Arctic Pacific Airlines,Takeoff (climb),Commercial,United States of America,North America,48,3,2,45,20,22,26,Human Factor
1962-03-27 00:00:00,Cubana de Aviación,Takeoff (climb),Commercial,Cuba,Central America,22,4,4,18,18,22,0,Unknown
1963-11-08 00:00:00,Finnair,Landing (descent or approach),Commercial,Finland,Europe,25,3,2,22,20,22,3,Human Factor
1964-03-04 00:00:00,Indian Air Force - Bharatiya Vayu Sena,Takeoff (climb),Military / Government,India,Asia,22,5,5,17,17,22,0,Technical Failure
1965-03-26 00:00:00,Pakistan International Airlines - PIA,Flight,Commercial,Pakistan,Asia,26,4,4,22,18,22,4,Unknown
1967-02-16 00:00:00,Garuda Indonesian Airways,Landing (descent or approach),Commercial,Indonesia,Asia,92,8,0,84,22,22,70,Human Factor
1968-04-30 00:00:00,Pakistan Air Force - Pakistan Fiza'ya,Flight,Military / Government,Pakistan,Asia,22,4,4,18,18,22,0,Weather
1969-09-01 00:00:00,Aeroflot - Russian International Airlines,Landing (descent or approach),Commercial,Russia,Asia,27,5,5,22,17,22,5,Human Factor
1971-09-06 00:00:00,Paninternational,Takeoff (climb),Commercial,Germany,Europe,121,6,1,115,21,22,99,Technical Failure
1971-10-23 00:00:00,South Vietnamese Air Force,Landing (descent or approach),Military / Government,Vietnam,Asia,23,3,3,20,19,22,1,Weather
1972-05-21 00:00:00,DTA Angola Airlines - Direcção dos Transportes Aéreos,Landing (descent or approach),Commercial,Angola,Africa,25,6,5,19,17,22,3,Human Factor
1973-02-21 00:00:00,Aerolineas Urraca,Flight,Commercial,Panama,Central America,28,3,3,25,19,22,6,Human Factor
1977-01-15 00:00:00,Skyline Sweden,Landing (descent or approach),Commercial,Sweden,Europe,22,3,3,19,19,22,0,Weather
1982-11-29 00:00:00,ACES Colombia - Aerolineas Centrales de Colombia,Flight,Commercial,Colombia,South America,22,2,2,20,20,22,0,Human Factor
1987-01-02 00:00:00,Spanish Air Force - Ejército del Aire,Takeoff (climb),Military / Government,Equatorial Guinea,Africa,22,4,4,18,18,22,0,Technical Failure
1988-06-12 00:00:00,Austral Lineas Aéreas,Landing (descent or approach),Commercial,Argentina,South America,22,6,6,16,16,22,0,Human Factor
1989-04-10 00:00:00,Uni Air International,Flight,Commercial,France,Europe,22,3,3,19,19,22,0,Human Factor
1989-09-15 00:00:00,Merpati Nusantara Airlines - MNA,Landing (descent or approach),Commercial,Indonesia,Asia,22,3,3,19,19,22,0,Human Factor
1989-09-15 00:00:00,Merpati Nusantara Airlines - MNA,Landing (descent or approach),Commercial,Indonesia,Asia,22,3,3,19,19,22,0,Human Factor
1990-06-06 00:00:00,Transportes Aéreos Regionais da Bacia Amazônica - TABA,Landing (descent or approach),Commercial,Brazil,South America,42,3,2,39,20,22,20,Human Factor
1991-01-10 00:00:00,Venezuelan Navy - Armada Venezolana,Flight,Military / Government,Venezuela,South America,23,3,3,20,19,22,1,Human Factor
1991-02-01 00:00:00,USAir - US Airways,Landing (descent or approach),Commercial,United States of America,North America,89,6,2,83,20,22,67,Human Factor
1991-02-14 00:00:00,Transportes Aéreos Mercantiles Ecuatorianos - TAME,Flight,Commercial,Ecuador,South America,22,2,2,20,20,22,0,Human Factor
1995-09-09 00:00:00,SATENA - Servicio de Aeronavegacion a Territorios Nacionales,Landing (descent or approach),Commercial,Colombia,South America,22,4,4,18,18,22,0,Human Factor
1996-12-24 00:00:00,Indian Air Force - Bharatiya Vayu Sena,Flight,Military / Government,India,Asia,22,5,5,17,17,22,0,Technical Failure
1997-09-12 00:00:00,TMK Air Commuter - Société de Transports et Messageries au Kivu,Flight,Commercial,Democratic Republic of Congo,Africa,22,2,2,20,20,22,0,Human Factor
1999-12-25 00:00:00,Cubana de Aviación,Landing (descent or approach),Commercial,Venezuela,South America,22,12,12,10,10,22,0,Human Factor
2000-01-13 00:00:00,Sirte Oil Company,Landing (descent or approach),Commercial,Libya,Africa,41,3,1,38,21,22,19,Human Factor
2001-02-01 00:00:00,Angola Air Force - Força Aérea Nacional Angolana,Landing (descent or approach),Military / Government,Angola,Africa,22,5,5,17,17,22,0,Terrorism
2007-06-25 00:00:00,PMT Air - Progress Multitrade Company,Landing (descent or approach),Commercial,Cambodia,Asia,22,6,6,16,16,22,0,Human Factor
2010-12-15 00:00:00,Tara Air,Flight,Commercial,Nepal,Asia,22,3,3,19,19,22,0,Human Factor
2011-05-18 00:00:00,SOL Lineas Aéreas,Flight,Commercial,Argentina,South America,22,3,3,19,19,22,0,Weather
2016-03-15 00:00:00,Ecuadorian Air Force - Fuerza Aérea Ecuatoriana,Flight,Humanitarian,Ecuador,South America,22,3,3,19,19,22,0,Unknown
2022-05-29 00:00:00,Tara Air,Flight,Commercial,Nepal,Asia,22,3,3,19,19,22,0,Human Factor
1942-07-01 00:00:00,United States Army Air Forces - USAAF,Flight,Military / Government,United States of America,North America,21,2,2,19,19,21,0,Human Factor
1943-12-24 00:00:00,Royal Air Force - RAF,Flight,Military / Government,World,World,21,12,12,9,9,21,0,Terrorism
1944-11-27 00:00:00,United States Army Air Forces - USAAF,Flight,Military / Government,World,World,21,2,2,19,19,21,0,Unknown
1945-01-15 00:00:00,United States Navy - USN,Takeoff (climb),Military / Government,Philippines,Asia,21,5,5,16,16,21,0,Unknown
1945-05-05 00:00:00,United States Army Air Forces - USAAF,Takeoff (climb),Military / Government,Papua New Guinea,Oceania,21,6,6,15,15,21,0,Human Factor
1945-05-30 00:00:00,United States Army Air Forces - USAAF,Flight,Military / Government,Ivory Coast,Africa,21,3,3,18,18,21,0,Unknown
1945-09-14 00:00:00,Royal Air Force - RAF,Flight,Military / Government,United Kingdom,Europe,21,7,7,14,14,21,0,Technical Failure
1946-01-31 00:00:00,United Airlines,Flight,Commercial,United States of America,North America,21,3,3,18,18,21,0,Human Factor
1946-04-22 00:00:00,TACA International Airlines - Transportes Aéreos Centro Americanos,Takeoff (climb),Commercial,Nicaragua,Central America,21,3,3,18,18,21,0,Unknown
1946-09-16 00:00:00,Royal Canadian Air Force - RCAF,Landing (descent or approach),Military / Government,Canada,North America,21,3,3,18,18,21,0,Human Factor
1946-10-06 00:00:00,Royal Air Force - RAF,Flight,Military / Government,World,World,21,6,6,15,15,21,0,Unknown
1946-12-23 00:00:00,Flota Aerea Mercante Argentina - FAMA,Landing (descent or approach),Commercial,Brazil,South America,21,6,6,15,15,21,0,Human Factor
1947-01-14 00:00:00,Mexican Air Force - Fuerza Aérea Mexicana,Takeoff (climb),Military / Government,Mexico,Central America,21,4,4,17,17,21,0,Technical Failure
1947-02-21 00:00:00,Chinese Air Force - AFPLA - Chung-Kuo Shan Min Taie Fang Tsun Pu-Tai,Landing (descent or approach),Military / Government,China,Asia,21,4,4,17,17,21,0,Weather
1947-11-18 00:00:00,Trafik-Turist-Transportflyg,Flight,Commercial,Italy,Europe,25,4,4,21,17,21,4,Human Factor
1948-11-26 00:00:00,Pakistan Airways - Pak Air,Flight,Commercial,Pakistan,Asia,21,5,5,16,16,21,0,Human Factor
1949-03-10 00:00:00,Queensland Airlines,Takeoff (climb),Commercial,Australia,Oceania,21,3,3,18,18,21,0,Other
1949-08-21 00:00:00,Royal Canadian Air Force - RCAF,Flight,Military / Government,Canada,North America,21,7,7,14,14,21,0,Weather
1950-11-07 00:00:00,Northwest Airlines,Landing (descent or approach),Commercial,United States of America,North America,21,4,4,17,17,21,0,Human Factor
1950-11-23 00:00:00,New Tribes Mission,Flight,Humanitarian,United States of America,North America,21,3,3,18,18,21,0,Human Factor
1951-04-08 00:00:00,United States Air Force - USAF,Landing (descent or approach),Military / Government,United States of America,North America,21,3,3,18,18,21,0,Technical Failure
1953-07-27 00:00:00,Soviet Navy - Voyenno-morskoy flot CCCP,Flight,Military / Government,China,Asia,21,6,6,15,15,21,0,Terrorism
1953-09-01 00:00:00,Regina Cargo Airlines,Flight,Commercial,United States of America,North America,21,2,2,19,19,21,0,Human Factor
1953-10-19 00:00:00,Petróleos Mexicanos,Takeoff (climb),Commercial,Mexico,Central America,21,3,3,18,18,21,0,Unknown
1954-01-02 00:00:00,Ariana Afghan Airlines,Flight,Commercial,Afghanistan,Asia,21,3,3,18,18,21,0,Weather
1954-04-08 00:00:00,South African Airways -SAA - Suid Afrikaanse Lugdiens - SAL,Flight,Commercial,Italy,Europe,21,7,7,14,14,21,0,Technical Failure
1954-08-23 00:00:00,KLM Royal Dutch Airlines - Koninklijke Luchtvaart Maatschappij,Landing (descent or approach),Commercial,Netherlands,Europe,21,9,9,12,12,21,0,Unknown
1954-10-24 00:00:00,United States Air Force - USAF,Flight,Military / Government,Italy,Europe,21,3,3,18,18,21,0,Human Factor
1955-10-02 00:00:00,Faucett,Flight,Commercial,Peru,South America,35,5,5,30,16,21,14,Technical Failure
1955-12-09 00:00:00,Aeroflot - Russian International Airlines,Flight,Commercial,Russia,Asia,21,5,5,16,16,21,0,Weather
1956-07-03 00:00:00,Czech Air Force - Ceské Vojenské Letectvo,Flight,Military / Government,Slovakia,Europe,21,6,6,15,15,21,0,Weather
1956-12-22 00:00:00,Linee Aeree Italiane - LAI,Flight,Commercial,Italy,Europe,21,4,4,17,17,21,0,Human Factor
1957-10-28 00:00:00,Iberia - Lineas Aéreas de Espana,Landing (descent or approach),Commercial,Spain,Europe,21,4,4,17,17,21,0,Technical Failure
1958-05-15 00:00:00,Pakistan International Airlines - PIA,Takeoff (climb),Commercial,India,Asia,38,6,4,32,17,21,17,Human Factor
1958-06-16 00:00:00,Cruzeiro do Sul,Landing (descent or approach),Commercial,Brazil,South America,26,5,5,21,16,21,5,Weather
1958-12-04 00:00:00,Aviaco - Aviacion y Comercio,Flight,Commercial,Spain,Europe,21,5,5,16,16,21,0,Weather
1958-12-23 00:00:00,Aeroflot - Russian International Airlines,Landing (descent or approach),Commercial,Uzbekistan,Asia,21,6,6,15,15,21,0,Human Factor
1958-12-30 00:00:00,VASP - Viação Aérea de São Paulo,Takeoff (climb),Commercial,Brazil,South America,37,4,4,33,17,21,16,Human Factor
1961-01-24 00:00:00,Garuda Indonesian Airways,Flight,Commercial,Indonesia,Asia,21,5,5,16,16,21,0,Human Factor
1962-11-23 00:00:00,Malév Hungarian Airlines - Magyar Légiközlekedési Vallalat,Landing (descent or approach),Commercial,France,Europe,21,8,8,13,13,21,0,Unknown
1966-02-16 00:00:00,Aeroflot - Russian International Airlines,Takeoff (climb),Commercial,Russia,Asia,66,19,13,47,8,21,45,Human Factor
1967-07-06 00:00:00,Philippine Airlines - PAL,Flight,Commercial,Philippines,Asia,21,4,4,17,17,21,0,Human Factor
1967-11-03 00:00:00,Sadia Transportes Aéreos,Landing (descent or approach),Commercial,Brazil,South America,25,5,3,20,18,21,4,Human Factor
1968-02-16 00:00:00,Civil Air Transport,Landing (descent or approach),Commercial,Taiwan,Asia,63,11,3,52,18,21,42,Human Factor
1970-09-03 00:00:00,Aeroflot - Russian International Airlines,Flight,Commercial,Tajikistan,Asia,21,3,3,18,18,21,0,Human Factor
1971-01-21 00:00:00,French Air Force - Armée de l'Air,Flight,Military / Government,France,Europe,21,8,8,13,13,21,0,Human Factor
1971-12-09 00:00:00,Indian Airlines,Flight,Commercial,India,Asia,31,4,4,27,17,21,10,Human Factor
1972-07-29 00:00:00,Avianca,Flight,Commercial,Colombia,South America,21,3,3,18,18,21,0,Human Factor
1975-08-03 00:00:00,Nicaraguayan Air Force - Fuerza Aérea - Ejercito de Nicaragua,Flight,Commercial,Salvador,Central America,21,3,3,18,18,21,0,Technical Failure
1977-04-19 00:00:00,Soviet Air Force - Voyenno-vozdushnye sily CCCP,Landing (descent or approach),Military / Government,Estonia,Europe,21,6,6,15,15,21,0,Human Factor
1978-09-14 00:00:00,Philippine Air Force - Hukbong Himpapawid NG Pilipinas,Landing (descent or approach),Military / Government,Philippines,Asia,28,4,2,24,19,21,7,Weather
1979-12-18 00:00:00,SATENA - Servicio de Aeronavegacion a Territorios Nacionales,Flight,Commercial,Colombia,South America,21,5,5,16,16,21,0,Human Factor
1981-05-06 00:00:00,United States Air Force - USAF,Flight,Operational,United States of America,North America,21,17,17,4,4,21,0,Technical Failure
1981-09-02 00:00:00,Taxi Aéreo El Venado,Takeoff (climb),Commercial,Colombia,South America,22,2,2,20,19,21,1,Other
1982-03-26 00:00:00,Aeropesca Colombia,Flight,Commercial,Colombia,South America,21,6,6,15,15,21,0,Unknown
1983-04-19 00:00:00,Aeroflot - Russian International Airlines,Flight,Commercial,Armenia,Asia,21,4,4,17,17,21,0,Human Factor
1984-12-19 00:00:00,Peruvian Air Force - Fuerza Aérea del Perú,Takeoff (climb),Commercial,Peru,South America,21,3,3,18,18,21,0,Other
1985-01-22 00:00:00,United States Air Force - USAF,Landing (descent or approach),Military / Government,Honduras,Central America,21,5,5,16,16,21,0,Human Factor
1986-01-29 00:00:00,Aero California,Landing (descent or approach),Commercial,Mexico,Central America,21,3,3,18,18,21,0,Human Factor
1988-02-08 00:00:00,NFD Luftverkehrs - Nürnberger Flugdienst,Landing (descent or approach),Commercial,Germany,Europe,21,2,2,19,19,21,0,Weather
1989-06-17 00:00:00,Interflug,Takeoff (climb),Commercial,Germany,Europe,113,10,0,103,21,21,92,Unknown
1990-05-18 00:00:00,Aerolift Philippines,Takeoff (climb),Commercial,Philippines,Asia,21,2,2,19,19,21,0,Technical Failure
1994-07-19 00:00:00,Alas Chiricanas,Takeoff (climb),Commercial,Panama,Central America,21,3,3,18,18,21,0,Terrorism
1994-10-14 00:00:00,Brazilian Air Force - Força Aérea Brasileira,Flight,Military / Government,Brazil,South America,21,6,6,15,15,21,0,Other
1999-10-29 00:00:00,Pakistan Navy - Pākistān Bāhrí'a,Flight,Military / Government,Pakistan,Asia,21,21,21,0,0,21,0,Unknown
2001-03-03 00:00:00,Florida National Guard,Flight,Military / Government,United States of America,North America,21,3,3,18,18,21,0,Weather
2003-01-08 00:00:00,USAir Express - US Airways Express,Takeoff (climb),Commercial,United States of America,North America,21,2,2,19,19,21,0,Human Factor
2003-08-24 00:00:00,Tropical Airways,Takeoff (climb),Commercial,Haiti,Central America,21,2,2,19,19,21,0,Technical Failure
2007-03-07 00:00:00,Garuda Indonesian Airways,Landing (descent or approach),Commercial,Indonesia,Asia,140,7,1,133,20,21,119,Human Factor
2007-10-04 00:00:00,El Sam Airlift,Takeoff (climb),Operational,Democratic Republic of Congo,Africa,22,5,4,17,17,21,1,Technical Failure
2008-05-02 00:00:00,Flex Air,Flight,Military / Government,South Sudan,Africa,21,2,2,19,19,21,0,Technical Failure
2010-11-05 00:00:00,JS Air,Takeoff (climb),Commercial,Pakistan,Asia,21,2,2,19,19,21,0,Technical Failure
2011-09-02 00:00:00,Chilean Air Force - Fuerza Aérea de Chile,Landing (descent or approach),Military / Government,Chile,South America,21,4,4,17,17,21,0,Weather
2013-01-29 00:00:00,SCAT Airlines,Landing (descent or approach),Commercial,Kazakhstan,Asia,21,5,5,16,16,21,0,Human Factor
2020-08-07 00:00:00,Air India Express,Landing (descent or approach),Commercial,India,Asia,190,6,2,184,19,21,169,Human Factor
1938-07-14 00:00:00,Ala Littoria,Flight,Commercial,World,World,20,4,4,16,16,20,0,Unknown
1938-10-10 00:00:00,SABENA - Société Anonyme Belge d'Exploitation de la Navigation Aérienne,Flight,Commercial,Germany,Europe,20,4,4,16,16,20,0,Technical Failure
1941-10-30 00:00:00,American Airlines,Landing (descent or approach),Commercial,Canada,North America,20,4,4,16,16,20,0,Human Factor
1942-03-03 00:00:00,United States Army Air Forces - USAAF,Takeoff (climb),Military / Government,Australia,Oceania,21,2,2,19,18,20,1,Terrorism
1942-05-19 00:00:00,Linee Aeree Transcontinentali Italiane - LATI,Takeoff (climb),Commercial,Italy,Europe,20,4,4,16,16,20,0,Unknown
1942-11-17 00:00:00,Krasnoyarskie Vozhdushnye Trassy - KVT,Takeoff (climb),Commercial,Russia,Asia,20,4,4,16,16,20,0,Weather
1943-06-07 00:00:00,United States Army Air Forces - USAAF,Landing (descent or approach),Military / Government,United States of America,North America,20,4,4,16,16,20,0,Weather
1943-07-03 00:00:00,Royal Air Force - RAF,Flight,Military / Government,United Kingdom,Europe,20,4,4,16,16,20,0,Technical Failure
1943-07-24 00:00:00,Regia Aeronautica,Flight,Military / Government,Italy,Europe,20,4,4,16,16,20,0,Terrorism
1943-07-28 00:00:00,American Airlines,Flight,Commercial,United States of America,North America,22,4,4,18,16,20,2,Weather
1943-09-22 00:00:00,United States Army Air Forces - USAAF,Takeoff (climb),Military / Government,India,Asia,20,3,3,17,17,20,0,Unknown
1943-10-22 00:00:00,United States Army Air Forces - USAAF,Flight,Operational,United States of America,North America,31,5,5,26,15,20,11,Human Factor
1944-06-06 00:00:00,United States Army Air Forces - USAAF,Flight,Military / Government,France,Europe,20,4,4,16,16,20,0,Terrorism
1944-08-28 00:00:00,United States Army Air Forces - USAAF,Landing (descent or approach),Military / Government,United Kingdom,Europe,20,6,6,14,14,20,0,Weather
1944-09-07 00:00:00,Royal Netherlands East Indies Air Force - ML-KNIL,Flight,Military / Government,Australia,Oceania,20,4,4,16,16,20,0,Unknown
1944-11-01 00:00:00,United States Army Air Forces - USAAF,Flight,Military / Government,France,Europe,20,5,5,15,15,20,0,Weather
1944-11-10 00:00:00,Central Air Transport - China,Landing (descent or approach),Commercial,China,Asia,20,3,3,17,17,20,0,Unknown
1945-02-19 00:00:00,Royal Air Force - RAF,Takeoff (climb),Military / Government,United Kingdom,Europe,21,4,3,17,17,20,1,Human Factor
1945-02-23 00:00:00,United States Army Air Forces - USAAF,Landing (descent or approach),Military / Government,Indonesia,Asia,20,4,4,16,16,20,0,Unknown
1945-04-14 00:00:00,Pennsylvania Central Air Lines,Landing (descent or approach),Commercial,United States of America,North America,20,3,3,17,17,20,0,Human Factor
1945-05-10 00:00:00,Royal Air Force - RAF,Landing (descent or approach),Military / Government,Norway,Europe,20,6,6,14,14,20,0,Weather
1945-05-13 00:00:00,United States Army Air Forces - USAAF,Flight,Military / Government,Indonesia,Asia,23,4,4,19,16,20,3,Unknown
1945-06-06 00:00:00,United States Army Air Forces - USAAF,Flight,Military / Government,Austria,Europe,20,5,5,15,15,20,0,Unknown
1945-08-21 00:00:00,French Air Force - Armée de l'Air,Flight,Humanitarian,France,Europe,20,5,5,15,15,20,0,Technical Failure
1945-09-24 00:00:00,Royal New Zealand Air Force - RNZAF,Flight,Military / Government,World,World,20,4,4,16,16,20,0,Unknown
1945-09-28 00:00:00,United States Army Air Forces - USAAF,Flight,Military / Government,China,Asia,20,3,3,17,17,20,0,Unknown
1945-11-11 00:00:00,United States Army Air Forces - USAAF,Flight,Military / Government,Italy,Europe,20,4,4,16,16,20,0,Human Factor
1946-03-17 00:00:00,Chinese Air Force - AFPLA - Chung-Kuo Shan Min Taie Fang Tsun Pu-Tai,Landing (descent or approach),Military / Government,China,Asia,20,4,4,16,16,20,0,Weather
1946-09-05 00:00:00,Trans-Luxury Airlines - TLA,Landing (descent or approach),Commercial,United States of America,North America,21,3,3,18,17,20,1,Human Factor
1947-08-06 00:00:00,United States Navy - USN,Flight,Military / Government,World,World,20,5,5,15,15,20,0,Unknown
1947-11-28 00:00:00,United States Air Force - USAF,Flight,Military / Government,Italy,Europe,20,5,5,15,15,20,0,Weather
1947-12-11 00:00:00,United States Air Force - USAF,Landing (descent or approach),Military / Government,United States of America,North America,20,4,4,16,16,20,0,Unknown
1948-03-02 00:00:00,SABENA - Société Anonyme Belge d'Exploitation de la Navigation Aérienne,Landing (descent or approach),Commercial,United Kingdom,Europe,22,3,3,19,17,20,2,Human Factor
1948-03-07 00:00:00,Polyarnaya Aviatsiya,Flight,Commercial,Russia,Asia,20,6,6,14,14,20,0,Human Factor
1948-07-29 00:00:00,Aviación del Litoral Fluvial Argentino - ALFA,Landing (descent or approach),Commercial,Argentina,South America,24,6,6,18,14,20,4,Human Factor
1949-01-17 00:00:00,United States Air Force - USAF,Flight,Military / Government,United Kingdom,Europe,20,4,4,16,16,20,0,Weather
1949-12-01 00:00:00,Real Aerovias,Flight,Commercial,Brazil,South America,22,4,4,18,16,20,2,Human Factor
1951-01-31 00:00:00,Flugfélag Íslands,Landing (descent or approach),Commercial,Iceland,Europe,20,3,3,17,17,20,0,Weather
1951-12-27 00:00:00,Aeroflot - Russian International Airlines,Flight,Commercial,Russia,Asia,20,6,6,14,14,20,0,Technical Failure
1952-11-15 00:00:00,United States Air Force - USAF,Flight,Military / Government,United States of America,North America,20,5,5,15,15,20,0,Human Factor
1953-05-27 00:00:00,Aeroflot - Russian International Airlines,Flight,Commercial,Russia,Asia,20,4,4,16,16,20,0,Human Factor
1954-03-04 00:00:00,United States Air Force - USAF,Flight,Military / Government,France,Europe,20,2,2,18,18,20,0,Weather
1954-07-02 00:00:00,Brazilian Air Force - Força Aérea Brasileira,Takeoff (climb),Military / Government,Brazil,South America,20,4,4,16,16,20,0,Technical Failure
1955-05-18 00:00:00,East African Airways,Flight,Commercial,Tanzania,Africa,20,4,4,16,16,20,0,Human Factor
1955-08-11 00:00:00,United States Air Force - USAF,Flight,Operational,Germany,Europe,20,5,5,15,15,20,0,Human Factor
1957-02-01 00:00:00,Northeast Airlines - USA,Takeoff (climb),Commercial,United States of America,North America,101,6,0,95,20,20,81,Human Factor
1957-03-14 00:00:00,British European Airways - BEA,Landing (descent or approach),Commercial,United Kingdom,Europe,20,5,5,15,15,20,0,Technical Failure
1958-03-24 00:00:00,Indian Airlines,Landing (descent or approach),Commercial,Nepal,Asia,20,4,4,16,16,20,0,Human Factor
1958-10-15 00:00:00,TAM Bolivia - Transporte Aéreo Militar Boliviano,Flight,Military / Government,Bolivia,South America,20,3,3,17,17,20,0,Unknown
1959-09-23 00:00:00,VASP - Viação Aérea de São Paulo,Takeoff (climb),Commercial,Brazil,South America,20,4,4,16,16,20,0,Unknown
1960-07-10 00:00:00,Gulf Aviation - Oman,Landing (descent or approach),Commercial,United Arab Emirates,Asia,20,4,4,16,16,20,0,Unknown
1960-08-17 00:00:00,French Navy,Flight,Military / Government,Morocco,Africa,20,5,5,15,15,20,0,Technical Failure
1960-12-17 00:00:00,United States Air Force - USAF,Landing (descent or approach),Military / Government,Germany,Europe,20,7,7,13,13,20,0,Human Factor
1961-06-12 00:00:00,KLM Royal Dutch Airlines - Koninklijke Luchtvaart Maatschappij,Landing (descent or approach),Commercial,Egypt,Africa,36,7,3,29,17,20,16,Human Factor
1962-05-24 00:00:00,Aeroflot - Russian International Airlines,Takeoff (climb),Commercial,Russia,Asia,21,4,4,17,16,20,1,Technical Failure
1963-06-10 00:00:00,Union of Burma Airways,Flight,Commercial,China,Asia,20,5,5,15,15,20,0,Unknown
1964-02-27 00:00:00,Fuji Airlines,Landing (descent or approach),Commercial,Japan,Asia,42,5,2,37,18,20,22,Technical Failure
1966-01-23 00:00:00,Soviet Navy - Voyenno-morskoy flot CCCP,Landing (descent or approach),Military / Government,Russia,Asia,20,4,4,16,16,20,0,Unknown
1967-06-15 00:00:00,Brazilian Air Force - Força Aérea Brasileira,Flight,Military / Government,Brazil,South America,25,5,5,20,15,20,5,Technical Failure
1967-12-22 00:00:00,Peruvian Air Force - Fuerza Aérea del Perú,Flight,Military / Government,Peru,South America,27,3,3,24,17,20,7,Unknown
1968-12-24 00:00:00,Allegheny Airlines,Landing (descent or approach),Commercial,United States of America,North America,47,6,3,41,17,20,27,Human Factor
1969-06-29 00:00:00,Indian Air Force - Bharatiya Vayu Sena,Takeoff (climb),Military / Government,India,Asia,20,4,4,16,16,20,0,Unknown
1969-09-14 00:00:00,VASP - Viação Aérea de São Paulo,Landing (descent or approach),Commercial,Brazil,South America,20,6,6,14,14,20,0,Technical Failure
1970-02-04 00:00:00,TAROM - Transporturile Aeriene Române,Flight,Commercial,Romania,Europe,21,6,6,15,14,20,1,Human Factor
1972-01-21 00:00:00,Lineas Aéreas La Urraca,Takeoff (climb),Commercial,Colombia,South America,20,5,5,15,15,20,0,Other
1972-10-23 00:00:00,Soviet Air Force - Voyenno-vozdushnye sily CCCP,Landing (descent or approach),Military / Government,Russia,Asia,20,6,6,14,14,20,0,Human Factor
1974-05-02 00:00:00,ATESA - Aero Taxis Ecuatorianos,Flight,Commercial,Ecuador,South America,25,3,2,22,18,20,5,Human Factor
1974-09-18 00:00:00,Brazilian Air Force - Força Aérea Brasileira,Landing (descent or approach),Military / Government,Brazil,South America,21,3,3,18,17,20,1,Unknown
1975-11-25 00:00:00,Israeli Air Force - Heyl Ha'avir,Flight,Military / Government,Egypt,Africa,20,9,9,11,11,20,0,Human Factor
1977-09-14 00:00:00,United States Air Force - USAF,Takeoff (climb),Operational,United States of America,North America,20,5,5,15,15,20,0,Human Factor
1979-08-28 00:00:00,Republic of China Air Force,Flight,Military / Government,Taiwan,Asia,20,5,5,15,15,20,0,Human Factor
1980-11-24 00:00:00,Colombian Government,Flight,Military / Government,Colombia,South America,20,4,4,16,16,20,0,Human Factor
1982-08-14 00:00:00,Nicaraguayan Air Force - Fuerza Aérea - Ejercito de Nicaragua,Takeoff (climb),Military / Government,Nicaragua,Central America,22,2,2,20,18,20,2,Unknown
1986-06-18 00:00:00,Grand Canyon Airlines,Flight,Commercial,United States of America,North America,20,2,2,18,18,20,0,Human Factor
1988-02-27 00:00:00,Aeroflot - Russian International Airlines,Landing (descent or approach),Commercial,Russia,Asia,51,6,3,45,17,20,31,Human Factor
1988-08-31 00:00:00,Transporte Aéreo Federal,Flight,Commercial,Mexico,Central America,20,2,2,18,18,20,0,Human Factor
1989-10-28 00:00:00,Aloha Island Air,Landing (descent or approach),Commercial,United States of America,North America,20,2,2,18,18,20,0,Human Factor
1990-02-13 00:00:00,TAM Bolivia - Transporte Aéreo Militar Boliviano,Flight,Military / Government,Bolivia,South America,38,5,2,33,18,20,18,Unknown
1990-04-18 00:00:00,Aeroperlas,Takeoff (climb),Commercial,Panama,Central America,22,3,3,19,17,20,2,Other
1990-04-20 00:00:00,Zaire Air Force - Force Aérienne Zaïroise,Takeoff (climb),Military / Government,Democratic Republic of Congo,Africa,24,6,6,18,14,20,4,Technical Failure
1991-02-20 00:00:00,LAN Chile - Linea Aérea Nacional de Chile,Landing (descent or approach),Commercial,Chile,South America,73,7,0,66,20,20,53,Human Factor
1991-11-16 00:00:00,Soviet Air Force - Voyenno-vozdushnye sily CCCP,Landing (descent or approach),Military / Government,Russia,Asia,22,7,7,15,13,20,2,Human Factor
1995-12-07 00:00:00,Air Saint-Martin,Flight,Commercial,Haiti,Central America,20,2,2,18,18,20,0,Human Factor
1996-04-05 00:00:00,Kras Air - Krasnoyarsk Avia - Krasnoyarskie Avialinii,Landing (descent or approach),Operational,Russia,Asia,20,9,9,11,11,20,0,Human Factor
1996-07-09 00:00:00,Milne Bay Air - MBA,Landing (descent or approach),Commercial,Papua New Guinea,Oceania,20,2,2,18,18,20,0,Weather
2002-11-06 00:00:00,Luxair,Landing (descent or approach),Commercial,Luxembourg,Europe,22,3,2,19,18,20,2,Human Factor
2003-11-29 00:00:00,Congolese Air Force - Force Aérienne de la République Démocratique du Congo,Takeoff (climb),Military / Government,Democratic Republic of Congo,Africa,24,6,6,18,14,20,4,Technical Failure
2005-12-19 00:00:00,Chalk's Ocean Airways,Flight,Commercial,United States of America,North America,20,2,2,18,18,20,0,Technical Failure
2006-02-11 00:00:00,Sudanese Air Force - Al Quwwat al-Jawwiya As-Sudaniya,Landing (descent or approach),Military / Government,South Sudan,Africa,20,7,7,13,13,20,0,Technical Failure
2007-08-09 00:00:00,Air Moorea,Takeoff (climb),Commercial,French Polynesia,Oceania,20,1,1,19,19,20,0,Technical Failure
2008-01-23 00:00:00,Polish Air Force - Polska Wojska Lotnicze i Obrony Powietrznej,Landing (descent or approach),Military / Government,Poland,Europe,20,4,4,16,16,20,0,Human Factor
2010-08-25 00:00:00,Filair,Landing (descent or approach),Commercial,Democratic Republic of Congo,Africa,21,3,3,18,17,20,1,Human Factor
2018-08-04 00:00:00,JU-Air,Flight,Commercial,Switzerland,Europe,20,3,3,17,17,20,0,Human Factor
2018-09-09 00:00:00,South West Aviation,Landing (descent or approach),Commercial,South Sudan,Africa,23,3,3,20,17,20,3,Human Factor
1937-10-17 00:00:00,United Airlines,Flight,Commercial,United States of America,North America,19,3,3,16,16,19,0,Human Factor
1938-04-30 00:00:00,Ala Littoria,Flight,Commercial,Italy,Europe,19,5,5,14,14,19,0,Human Factor
1942-09-24 00:00:00,British Overseas Airways Corporation - BOAC,Flight,Commercial,Senegal,Africa,19,6,6,13,13,19,0,Technical Failure
1943-01-21 00:00:00,Pan American World Airways - PAA,Landing (descent or approach),Commercial,United States of America,North America,19,9,9,10,10,19,0,Human Factor
1943-02-09 00:00:00,Royal Air Force - RAF,Landing (descent or approach),Military / Government,Canada,North America,21,6,6,15,13,19,2,Technical Failure
1943-11-05 00:00:00,British Overseas Airways Corporation - BOAC,Flight,Commercial,Libya,Africa,19,9,9,10,10,19,0,Technical Failure
1943-11-16 00:00:00,United States Army Air Forces - USAAF,Flight,Military / Government,Australia,Oceania,19,4,4,15,15,19,0,Weather
1943-12-19 00:00:00,Royal Air Force - RAF,Flight,Military / Government,World,World,19,19,19,0,0,19,0,Unknown
1944-04-28 00:00:00,United States Navy - USN,Flight,Military / Government,United States of America,North America,23,3,3,20,16,19,4,Unknown
1944-06-06 00:00:00,United States Army Air Forces - USAAF,Flight,Military / Government,France,Europe,23,4,4,19,15,19,4,Terrorism
1944-07-08 00:00:00,United States Army Air Forces - USAAF,Flight,Military / Government,Indonesia,Asia,19,5,5,14,14,19,0,Unknown
1944-09-18 00:00:00,United States Army Air Forces - USAAF,Flight,Military / Government,United States of America,North America,19,3,3,16,16,19,0,Unknown
1944-10-07 00:00:00,United States Navy - USN,Flight,Military / Government,Solomon Islands,Oceania,19,3,3,16,16,19,0,Unknown
1945-03-14 00:00:00,Royal Air Force - RAF,Takeoff (climb),Military / Government,Portugal,Europe,19,5,5,14,14,19,0,Unknown
1945-08-28 00:00:00,United States Army Air Forces - USAAF,Flight,Military / Government,World,World,19,5,5,14,14,19,0,Weather
1945-09-11 00:00:00,Royal Australian Air Force - RAAF,Takeoff (climb),Military / Government,Papua New Guinea,Oceania,19,3,3,16,16,19,0,Weather
1945-12-08 00:00:00,United States Army Air Forces - USAAF,Landing (descent or approach),Military / Government,United States of America,North America,23,2,2,21,17,19,4,Human Factor
1946-03-23 00:00:00,United States Army Air Forces - USAAF,Flight,Military / Government,Philippines,Asia,24,3,3,21,16,19,5,Human Factor
1946-09-04 00:00:00,Air France,Takeoff (climb),Commercial,France,Europe,26,5,4,21,15,19,7,Technical Failure
1946-09-25 00:00:00,Royal Air Force - RAF,Takeoff (climb),Military / Government,China,Asia,19,5,5,14,14,19,0,Weather
1946-12-25 00:00:00,China National Aviation Corporation - CNAC,Landing (descent or approach),Commercial,China,Asia,30,3,2,27,17,19,11,Human Factor
1947-01-25 00:00:00,China National Aviation Corporation - CNAC,Flight,Commercial,China,Asia,19,3,3,16,16,19,0,Unknown
1947-02-01 00:00:00,Air France,Landing (descent or approach),Commercial,Portugal,Europe,20,5,5,15,14,19,1,Human Factor
1948-02-10 00:00:00,KLM Royal Dutch Airlines - Koninklijke Luchtvaart Maatschappij,Takeoff (climb),Commercial,Indonesia,Asia,19,4,4,15,15,19,0,Technical Failure
1948-02-21 00:00:00,Latécoère Industries,Flight,Operational,France,Europe,19,8,8,11,11,19,0,Weather
1948-03-27 00:00:00,Indian National Airways - INA,Flight,Commercial,France,Europe,19,4,4,15,15,19,0,Human Factor
1948-10-02 00:00:00,Det Norske Luftfartselskap - DNL,Landing (descent or approach),Commercial,Norway,Europe,45,7,3,38,16,19,26,Weather
1948-12-21 00:00:00,MVD - Ministerstvo Vnutrennikh Del,Flight,Military / Government,Russia,Asia,19,7,7,12,12,19,0,Human Factor
1950-06-07 00:00:00,Soviet Air Force - Voyenno-vozdushnye sily CCCP,Landing (descent or approach),Military / Government,Russia,Asia,19,6,6,13,13,19,0,Human Factor
1952-11-07 00:00:00,United States Air Force - USAF,Flight,Military / Government,United States of America,North America,19,5,5,14,14,19,0,Human Factor
1953-01-15 00:00:00,Royal Air Force - RAF,Flight,Military / Government,Italy,Europe,19,3,3,16,16,19,0,Weather
1953-01-26 00:00:00,Linee Aeree Italiane - LAI,Takeoff (climb),Commercial,Italy,Europe,19,3,3,16,16,19,0,Technical Failure
1953-05-17 00:00:00,Delta Airlines,Flight,Commercial,United States of America,North America,20,3,3,17,16,19,1,Weather
1953-08-05 00:00:00,United States Air Force - USAF,Flight,Military / Government,World,World,23,23,19,0,0,19,4,Technical Failure
1953-10-29 00:00:00,British Commonwealth Pacific Airlines - BCPA,Landing (descent or approach),Commercial,United States of America,North America,19,8,8,11,11,19,0,Human Factor
1954-05-31 00:00:00,Transportes Aéreos Nacional,Flight,Commercial,Brazil,South America,19,4,4,15,15,19,0,Human Factor
1954-10-28 00:00:00,Aeroflot - Russian International Airlines,Flight,Commercial,Russia,Asia,19,6,6,13,13,19,0,Human Factor
1954-12-08 00:00:00,Hellenic Air Force - Elleniki Polemiki Aeroporia,Takeoff (climb),Military / Government,Greece,Europe,19,3,3,16,16,19,0,Unknown
1956-02-24 00:00:00,Syrian Airways,Takeoff (climb),Commercial,Syria,Asia,19,3,3,16,16,19,0,Technical Failure
1956-03-31 00:00:00,Royal Thai Air Force - Kong Thap Akat Thai,Takeoff (climb),Military / Government,Thailand,Asia,19,2,2,17,17,19,0,Unknown
1957-03-18 00:00:00,Lloyd Aéreo Boliviano - LAB Airlines,Flight,Commercial,Bolivia,South America,19,3,3,16,16,19,0,Unknown
1957-12-23 00:00:00,United States Navy - USN,Flight,Operational,United States of America,North America,23,4,4,19,15,19,4,Human Factor
1958-09-02 00:00:00,United States Air Force - USAF,Flight,Military / Government,World,World,19,7,7,12,12,19,0,Technical Failure
1958-10-09 00:00:00,United States Air Force - USAF,Flight,Military / Government,United States of America,North America,19,5,5,14,14,19,0,Other
1959-10-30 00:00:00,Olympic Airways,Flight,Commercial,Greece,Europe,19,3,3,16,16,19,0,Technical Failure
1962-08-23 00:00:00,Taxader Airlines - Taxi Aéreo de Santander,Takeoff (climb),Commercial,Colombia,South America,32,3,2,29,17,19,13,Human Factor
1963-06-16 00:00:00,Chilean Air Force - Fuerza Aérea de Chile,Flight,Military / Government,Chile,South America,20,3,3,17,16,19,1,Unknown
1963-08-17 00:00:00,Fujita Airlines - Fujita Koku Kabushiki Kaisha,Takeoff (climb),Commercial,Japan,Asia,19,3,3,16,16,19,0,Unknown
1966-11-11 00:00:00,United States Air Force - USAF,Flight,Military / Government,World,World,19,4,4,15,15,19,0,Technical Failure
1967-04-27 00:00:00,Fokker Aircraft,Takeoff (climb),Operational,Philippines,Asia,19,3,3,16,16,19,0,Human Factor
1968-01-10 00:00:00,United States Navy - USN,Flight,Military / Government,United States of America,North America,19,7,7,12,12,19,0,Weather
1968-03-09 00:00:00,GLAM - Groupe de Liaisons Aériennes Ministérielles,Takeoff (climb),Military / Government,La Reunion,Africa,20,12,12,8,7,19,1,Human Factor
1968-10-20 00:00:00,Cruzeiro do Sul,Takeoff (climb),Commercial,Brazil,South America,19,3,3,16,16,19,0,Technical Failure
1969-02-07 00:00:00,Philippine Air Force - Hukbong Himpapawid NG Pilipinas,Flight,Military / Government,Philippines,Asia,19,3,3,16,16,19,0,Unknown
1969-03-05 00:00:00,Prinair - Puerto Rico International Airlines,Landing (descent or approach),Commercial,Puerto Rico,Central America,19,2,2,17,17,19,0,Human Factor
1969-06-05 00:00:00,United States Air Force - USAF,Flight,Military / Government,World,World,19,5,5,14,14,19,0,Unknown
1970-12-07 00:00:00,TAROM - Transporturile Aeriene Române,Landing (descent or approach),Commercial,Romania,Europe,27,7,3,20,16,19,8,Human Factor
1971-10-17 00:00:00,Aerolineas TAO,Takeoff (climb),Commercial,Colombia,South America,21,4,4,17,15,19,2,Other
1972-02-05 00:00:00,TAC Colombia - Transportes Aéreos del Cesar,Landing (descent or approach),Commercial,Colombia,South America,19,4,4,15,15,19,0,Human Factor
1974-06-27 00:00:00,Cambodia Air Commercial,Takeoff (climb),Commercial,Cambodia,Asia,39,6,2,33,17,19,20,Human Factor
1975-11-20 00:00:00,Aeroflot - Russian International Airlines,Landing (descent or approach),Commercial,Ukraine,Europe,50,4,1,46,18,19,31,Human Factor
1976-03-02 00:00:00,TAM Bolivia - Transporte Aéreo Militar Boliviano,Flight,Military / Government,Bolivia,South America,22,4,4,18,15,19,3,Unknown
1977-03-01 00:00:00,Alyemda Yemen Airlines,Takeoff (climb),Commercial,Yemen,Asia,20,3,3,17,16,19,1,Technical Failure
1978-09-09 00:00:00,Lineas Aéreas del Centro,Flight,Commercial,Mexico,Central America,21,2,1,19,18,19,2,Unknown
1981-07-24 00:00:00,Air Madagascar,Flight,Commercial,Madagascar,Africa,19,2,2,17,17,19,0,Weather
1983-03-10 00:00:00,Bakhtar Afghan Airlines,Flight,Commercial,Afghanistan,Asia,19,2,2,17,17,19,0,Human Factor
1986-05-18 00:00:00,French Navy,Flight,Military / Government,Djibouti,Africa,19,15,15,4,4,19,0,Human Factor
1989-01-31 00:00:00,United States Air Force - USAF,Takeoff (climb),Operational,United States of America,North America,19,7,7,12,12,19,0,Human Factor
1990-01-25 00:00:00,Airfast Indonesia,Flight,Commercial,Indonesia,Asia,19,3,3,16,16,19,0,Human Factor
1991-08-17 00:00:00,Soviet Air Force - Voyenno-vozdushnye sily CCCP,Landing (descent or approach),Military / Government,Kazakhstan,Asia,19,8,8,11,11,19,0,Human Factor
1992-07-05 00:00:00,Sri Lanka Air Force,Flight,Military / Government,Sri Lanka,Asia,19,6,6,13,13,19,0,Terrorism
1993-07-31 00:00:00,Everest Air,Landing (descent or approach),Commercial,Nepal,Asia,19,3,3,16,16,19,0,Human Factor
2000-05-21 00:00:00,Executive Airlines - 1986,Landing (descent or approach),Commercial,United States of America,North America,19,2,2,17,17,19,0,Human Factor
2000-07-08 00:00:00,Aerocaribe - Aerovias Caribe,Flight,Commercial,Mexico,Central America,19,2,2,17,17,19,0,Human Factor
2001-03-24 00:00:00,Air Caraïbes,Landing (descent or approach),Commercial,Saint-Barthélemy,Central America,19,2,2,17,17,19,0,Human Factor
2001-09-12 00:00:00,Aero Ferinco,Takeoff (climb),Commercial,Mexico,Central America,19,3,3,16,16,19,0,Technical Failure
2002-11-11 00:00:00,Laoag International Airline,Takeoff (climb),Commercial,Philippines,Asia,34,5,1,29,18,19,15,Technical Failure
2004-06-08 00:00:00,Gabon Express,Landing (descent or approach),Commercial,Gabon,Africa,30,4,1,26,18,19,11,Technical Failure
2006-03-31 00:00:00,Transportes Especiais Aéreos %26 Malotes - TEAM,Flight,Commercial,Brazil,South America,19,2,2,17,17,19,0,Human Factor
2008-04-03 00:00:00,Blue Wing Airlines,Landing (descent or approach),Commercial,Suriname,South America,19,2,2,17,17,19,0,Unknown
2011-09-25 00:00:00,Buddha Air,Landing (descent or approach),Commercial,Nepal,Asia,19,3,3,16,16,19,0,Human Factor
2012-09-28 00:00:00,Sita Air,Takeoff (climb),Commercial,Nepal,Asia,19,3,3,16,16,19,0,Human Factor
2019-11-24 00:00:00,Busy Bee Congo,Takeoff (climb),Commercial,Democratic Republic of Congo,Africa,19,2,2,17,17,19,0,Unknown
1938-10-25 00:00:00,Australian National Airways - ANA,Landing (descent or approach),Commercial,Australia,Oceania,18,4,4,14,14,18,0,Human Factor
1940-11-08 00:00:00,VASP - Viação Aérea de São Paulo,Takeoff (climb),Commercial,Brazil,South America,18,4,4,14,14,18,0,Human Factor
1941-06-21 00:00:00,Manchurian Air Lines,Flight,Commercial,World,World,18,3,3,15,15,18,0,Unknown
1943-02-07 00:00:00,United States Army Air Forces - USAAF,Landing (descent or approach),Military / Government,Kiribati,Oceania,21,5,4,16,14,18,3,Technical Failure
1943-02-15 00:00:00,Royal Air Force - RAF,Flight,Military / Government,United Kingdom,Europe,18,4,4,14,14,18,0,Unknown
1943-05-15 00:00:00,United States Army Air Forces - USAAF,Flight,Military / Government,United States of America,North America,18,3,3,15,15,18,0,Weather
1943-08-27 00:00:00,VASP - Viação Aérea de São Paulo,Takeoff (climb),Commercial,Brazil,South America,21,4,4,17,14,18,3,Unknown
1943-11-19 00:00:00,United States Navy - USN,Flight,Military / Government,Brazil,South America,18,4,4,14,14,18,0,Unknown
1943-12-13 00:00:00,United States Navy - USN,Flight,Military / Government,United States of America,North America,18,18,18,0,0,18,0,Unknown
1944-08-30 00:00:00,Panair do Brasil,Landing (descent or approach),Commercial,Brazil,South America,18,4,4,14,14,18,0,Human Factor
1944-09-21 00:00:00,Panair do Brasil,Flight,Commercial,Brazil,South America,18,4,4,14,14,18,0,Technical Failure
1945-01-18 00:00:00,United States Army Air Forces - USAAF,Takeoff (climb),Military / Government,France,Europe,22,4,4,18,14,18,4,Unknown
1945-04-20 00:00:00,Deutsche Lufthansa,Flight,Commercial,Germany,Europe,20,3,3,17,15,18,2,Terrorism
1946-01-09 00:00:00,Chinese Air Force - AFPLA - Chung-Kuo Shan Min Taie Fang Tsun Pu-Tai,Flight,Operational,China,Asia,18,3,3,15,15,18,0,Human Factor
1946-01-09 00:00:00,Chinese Air Force - AFPLA - Chung-Kuo Shan Min Taie Fang Tsun Pu-Tai,Flight,Operational,China,Asia,18,3,3,15,15,18,0,Human Factor
1946-06-29 00:00:00,Royal Air Force - RAF,Flight,Military / Government,Malaysia,Asia,18,3,3,15,15,18,0,Weather
1947-01-12 00:00:00,Eastern Airlines,Flight,Commercial,United States of America,North America,19,3,3,16,15,18,1,Human Factor
1947-05-18 00:00:00,Philippine Air Force - Hukbong Himpapawid NG Pilipinas,Flight,Military / Government,Philippines,Asia,18,7,7,11,11,18,0,Human Factor
1947-10-26 00:00:00,Pan American World Airways - PAA,Landing (descent or approach),Commercial,United States of America,North America,18,5,5,13,13,18,0,Weather
1948-01-07 00:00:00,Coastal Air Lines,Flight,Commercial,United States of America,North America,27,2,1,25,17,18,9,Technical Failure
1948-07-29 00:00:00,Civil Air Transport,Takeoff (climb),Commercial,China,Asia,24,4,3,20,15,18,6,Unknown
1948-10-25 00:00:00,Aeroflot - Russian International Airlines,Flight,Commercial,Russia,Asia,18,4,4,14,14,18,0,Human Factor
1949-07-02 00:00:00,MacRobertson Miller Airlines,Takeoff (climb),Commercial,Australia,Oceania,18,4,4,14,14,18,0,Human Factor
1949-07-09 00:00:00,French Navy,Flight,Military / Government,Morocco,Africa,18,3,3,15,15,18,0,Unknown
1949-09-19 00:00:00,French Air Force - Armée de l'Air,Landing (descent or approach),Military / Government,Congo,Africa,18,7,7,11,11,18,0,Human Factor
1951-11-15 00:00:00,LOT Polish Airlines - Polskie Linie Lotnicze,Takeoff (climb),Commercial,Poland,Europe,18,3,3,15,15,18,0,Human Factor
1952-08-26 00:00:00,Pakistan Air Force - Pakistan Fiza'ya,Flight,Military / Government,Pakistan,Asia,18,4,4,14,14,18,0,Technical Failure
1953-02-03 00:00:00,Air Outre Mer,Flight,Commercial,Vietnam,Asia,18,3,3,15,15,18,0,Terrorism
1953-05-09 00:00:00,Air India,Takeoff (climb),Commercial,India,Asia,18,5,5,13,13,18,0,Human Factor
1953-06-14 00:00:00,Aeroflot - Russian International Airlines,Flight,Commercial,Georgia,Asia,18,6,6,12,12,18,0,Weather
1954-03-19 00:00:00,United States Air Force - USAF,Flight,Military / Government,United States of America,North America,18,6,6,12,12,18,0,Human Factor
1954-03-25 00:00:00,Aeronaves de Mexico,Landing (descent or approach),Commercial,Mexico,Central America,18,3,3,15,15,18,0,Human Factor
1955-06-18 00:00:00,Tigres Voladores,Takeoff (climb),Commercial,Mexico,Central America,39,3,0,36,18,18,21,Technical Failure
1956-07-16 00:00:00,Aerolineas Argentinas,Landing (descent or approach),Commercial,Argentina,South America,18,4,4,14,14,18,0,Human Factor
1957-03-05 00:00:00,Royal Air Force - RAF,Landing (descent or approach),Military / Government,United Kingdom,Europe,22,5,3,17,15,18,4,Human Factor
1960-04-14 00:00:00,Royal Thai Air Force - Kong Thap Akat Thai,Takeoff (climb),Military / Government,Taiwan,Asia,18,8,8,10,10,18,0,Unknown
1960-07-11 00:00:00,United States Air Force - USAF,Landing (descent or approach),Humanitarian,Ecuador,South America,18,4,4,14,14,18,0,Human Factor
1960-09-02 00:00:00,Aeroflot - Russian International Airlines,Flight,Commercial,Russia,Asia,18,5,5,13,13,18,0,Human Factor
1961-05-24 00:00:00,United States Air Force - USAF,Takeoff (climb),Military / Government,United States of America,North America,22,6,6,16,12,18,4,Technical Failure
1962-02-04 00:00:00,Faucett,Flight,Commercial,Peru,South America,18,3,3,15,15,18,0,Technical Failure
1962-10-12 00:00:00,Iberia - Lineas Aéreas de Espana,Landing (descent or approach),Commercial,Spain,Europe,18,4,4,14,14,18,0,Technical Failure
1963-03-20 00:00:00,Kingdom of Saudi Arabia,Flight,Military / Government,Italy,Europe,18,8,8,10,10,18,0,Human Factor
1963-09-11 00:00:00,Indian Airlines,Flight,Commercial,India,Asia,18,5,5,13,13,18,0,Unknown
1964-04-21 00:00:00,French Air Force - Armée de l'Air,Takeoff (climb),Military / Government,Central African Republic,Africa,37,3,3,34,15,18,19,Weather
1966-10-01 00:00:00,West Coast Airlines,Landing (descent or approach),Commercial,United States of America,North America,18,5,5,13,13,18,0,Human Factor
1967-06-11 00:00:00,Saudi Arabian Airlines - SAUDIA,Landing (descent or approach),Commercial,Saudi Arabia,Asia,18,4,4,14,14,18,0,Unknown
1968-04-10 00:00:00,Aerovias Rojas,Landing (descent or approach),Commercial,Mexico,Central America,18,4,4,14,14,18,0,Unknown
1969-04-25 00:00:00,United States Air Force - USAF,Takeoff (climb),Operational,Thailand,Asia,18,4,4,14,14,18,0,Weather
1970-01-25 00:00:00,Comisión Federal de Electricidad,Landing (descent or approach),Commercial,Mexico,Central America,19,4,4,15,14,18,1,Human Factor
1972-04-16 00:00:00,Aero Trasporti Italiani - ATI,Flight,Commercial,Italy,Europe,18,3,3,15,15,18,0,Weather
1972-05-04 00:00:00,Aeroflot - Russian International Airlines,Landing (descent or approach),Commercial,Russia,Asia,18,4,4,14,14,18,0,Weather
1972-08-12 00:00:00,Indian Airlines,Landing (descent or approach),Commercial,India,Asia,18,4,4,14,14,18,0,Human Factor
1973-02-28 00:00:00,Polish Air Force - Polska Wojska Lotnicze i Obrony Powietrznej,Landing (descent or approach),Military / Government,Poland,Europe,18,5,5,13,13,18,0,Weather
1973-07-04 00:00:00,Aeroflot - Russian International Airlines,Landing (descent or approach),Commercial,Russia,Asia,18,5,5,13,13,18,0,Human Factor
1974-03-08 00:00:00,Pathet Lao Airlines,Landing (descent or approach),Commercial,Vietnam,Asia,18,3,3,15,15,18,0,Unknown
1976-08-28 00:00:00,United States Air Force - USAF,Flight,Military / Government,United Kingdom,Europe,18,4,4,14,14,18,0,Weather
1976-09-09 00:00:00,Aeroflot - Russian International Airlines,Flight,Commercial,Russia,Asia,18,4,4,14,14,18,0,Human Factor
1976-09-09 00:00:00,Aeroflot - Russian International Airlines,Flight,Commercial,Russia,Asia,18,4,4,14,14,18,0,Human Factor
1977-06-03 00:00:00,Brazilian Air Force - Força Aérea Brasileira,Takeoff (climb),Military / Government,Brazil,South America,18,2,2,16,16,18,0,Unknown
1978-08-14 00:00:00,Aeropesca Colombia,Flight,Commercial,Colombia,South America,18,3,3,15,15,18,0,Technical Failure
1978-11-05 00:00:00,Nile Delta Air Services,Takeoff (climb),Commercial,Egypt,Africa,18,3,3,15,15,18,0,Unknown
1979-02-08 00:00:00,TAM Brasil - Taxi Aéreo Marilia - Transportes Aéreos Regionais,Flight,Commercial,Brazil,South America,18,2,2,16,16,18,0,Technical Failure
1980-03-14 00:00:00,United States Air Force - USAF,Landing (descent or approach),Military / Government,Turkey,Asia,18,6,6,12,12,18,0,Technical Failure
1981-03-10 00:00:00,French Navy,Takeoff (climb),Military / Government,Comoros Islands,Africa,18,4,4,14,14,18,0,Technical Failure
1981-05-22 00:00:00,Transportes Aéreos Mercantiles Ecuatorianos - TAME,Landing (descent or approach),Military / Government,Ecuador,South America,18,2,2,16,16,18,0,Weather
1981-11-08 00:00:00,AeroMéxico,Flight,Commercial,Mexico,Central America,18,6,6,12,12,18,0,Technical Failure
1982-01-07 00:00:00,Aeroflot - Russian International Airlines,Flight,Commercial,Russia,Asia,18,2,2,16,16,18,0,Human Factor
1984-02-28 00:00:00,United States Air Force - USAF,Flight,Military / Government,Spain,Europe,18,9,9,9,9,18,0,Human Factor
1984-04-18 00:00:00,Votec Taxi Aéreo,Landing (descent or approach),Commercial,Brazil,South America,18,2,2,16,16,18,0,Human Factor
1984-06-28 00:00:00,TAM Brasil - Taxi Aéreo Marilia - Transportes Aéreos Regionais,Landing (descent or approach),Commercial,Brazil,South America,18,2,2,16,16,18,0,Human Factor
1987-10-21 00:00:00,Soviet Air Force - Voyenno-vozdushnye sily CCCP,Takeoff (climb),Military / Government,Afghanistan,Asia,19,6,6,13,12,18,1,Human Factor
1987-11-23 00:00:00,Ryan Air,Landing (descent or approach),Commercial,United States of America,North America,21,2,2,19,16,18,3,Human Factor
1989-11-10 00:00:00,Lesotho Defence Force,Flight,Military / Government,Lesotho,Africa,18,2,2,16,16,18,0,Human Factor
1990-08-21 00:00:00,Republic of China Air Force,Flight,Military / Government,Taiwan,Asia,18,2,2,16,16,18,0,Weather
1993-12-01 00:00:00,Northwest Airlink,Landing (descent or approach),Commercial,United States of America,North America,18,2,2,16,16,18,0,Human Factor
1993-12-13 00:00:00,Lao Aviation,Landing (descent or approach),Commercial,Laos,Asia,18,2,2,16,16,18,0,Human Factor
1998-08-21 00:00:00,Lumbini Airways,Flight,Commercial,Nepal,Asia,18,3,3,15,15,18,0,Unknown
1999-03-07 00:00:00,Indian Air Force - Bharatiya Vayu Sena,Landing (descent or approach),Military / Government,India,Asia,18,4,4,14,14,18,0,Human Factor
1999-08-07 00:00:00,Guarda Costeira de Cabo Verde - Airwing,Flight,Commercial,Cabo Verde,Africa,18,2,2,16,16,18,0,Human Factor
1999-11-09 00:00:00,Transportes Aéreos Ejecutivos - TAESA,Takeoff (climb),Commercial,Mexico,Central America,18,5,5,13,13,18,0,Human Factor
2001-03-29 00:00:00,Avjet,Landing (descent or approach),Commercial,United States of America,North America,18,3,3,15,15,18,0,Human Factor
2001-12-02 00:00:00,Federal Border Guard Aviation Command,Flight,Operational,Russia,Asia,18,9,9,9,9,18,0,Technical Failure
2002-08-22 00:00:00,Shangri-La Air,Landing (descent or approach),Commercial,Nepal,Asia,18,2,2,16,16,18,0,Human Factor
2008-06-26 00:00:00,Indonesian Air Force - TNI-AU Tentara Nasional Indonesia - Angkatan Udara,Flight,Military / Government,Indonesia,Asia,18,5,5,13,13,18,0,Human Factor
2008-10-08 00:00:00,Yeti Airlines,Landing (descent or approach),Commercial,Nepal,Asia,19,3,2,16,16,18,1,Human Factor
2011-09-29 00:00:00,Nusantara Buana Air,Flight,Commercial,Indonesia,Asia,18,2,2,16,16,18,0,Human Factor
2014-02-16 00:00:00,Nepal Airlines,Flight,Commercial,Nepal,Asia,18,3,3,15,15,18,0,Human Factor
2018-08-30 00:00:00,Ethiopian Airlines,Landing (descent or approach),Commercial,Ethiopia,Africa,18,3,3,15,15,18,0,Unknown
2020-01-02 00:00:00,Sudanese Air Force - Al Quwwat al-Jawwiya As-Sudaniya,Takeoff (climb),Military / Government,Sudan,Africa,18,7,7,11,11,18,0,Unknown
1922-04-08 00:00:00,Private Chinese,Flight,Specialised Services,China,Asia,17,17,17,0,0,17,0,Unknown
1936-01-14 00:00:00,American Airlines,Flight,Commercial,United States of America,North America,17,3,3,14,14,17,0,Human Factor
1938-03-23 00:00:00,Regia Aeronautica,Flight,Military / Government,Spain,Europe,17,17,17,0,0,17,0,Terrorism
1938-04-12 00:00:00,Regia Aeronautica,Flight,Military / Government,Spain,Europe,17,17,17,0,0,17,0,Terrorism
1938-08-13 00:00:00,CSA Czech Airlines - Československé Státní Aerolinie,Landing (descent or approach),Commercial,Germany,Europe,17,4,4,13,13,17,0,Human Factor
1940-04-17 00:00:00,German Air Force - Deutsche Luftwaffe,Flight,Military / Government,Norway,Europe,17,5,5,12,12,17,0,Unknown
1940-11-04 00:00:00,Lloyd Aéreo Boliviano - LAB Airlines,Landing (descent or approach),Commercial,Bolivia,South America,17,3,3,14,14,17,0,Human Factor
1942-05-01 00:00:00,United Airlines,Landing (descent or approach),Commercial,United States of America,North America,17,3,3,14,14,17,0,Human Factor
1942-10-22 00:00:00,Deutsche Lufthansa,Flight,Commercial,Serbia,Europe,17,3,3,14,14,17,0,Human Factor
1942-11-10 00:00:00,United States Army Air Forces - USAAF,Flight,Military / Government,Papua New Guinea,Oceania,23,4,3,19,14,17,6,Weather
1942-12-15 00:00:00,Western Airlines,Flight,Commercial,United States of America,North America,19,4,4,15,13,17,2,Human Factor
1943-06-01 00:00:00,British Overseas Airways Corporation - BOAC,Flight,Commercial,World,World,17,4,4,13,13,17,0,Terrorism
1943-06-16 00:00:00,British Overseas Airways Corporation - BOAC,Landing (descent or approach),Military / Government,Sudan,Africa,17,3,3,14,14,17,0,Technical Failure
1943-08-14 00:00:00,Nucleo Comunicazioni Avio Linee,Takeoff (climb),Commercial,Greece,Europe,17,4,4,13,13,17,0,Unknown
1943-09-19 00:00:00,Aeroflot - Russian International Airlines,Landing (descent or approach),Commercial,Russia,Asia,17,5,5,12,12,17,0,Human Factor
1944-07-23 00:00:00,United States Navy - USN,Flight,Military / Government,Papua New Guinea,Oceania,17,2,2,15,15,17,0,Unknown
1944-08-08 00:00:00,Pan American World Airways - PAA,Takeoff (climb),Commercial,Cuba,Central America,31,5,0,26,17,17,14,Human Factor
1944-11-06 00:00:00,United States Navy - USN,Landing (descent or approach),Military / Government,United States of America,North America,17,3,3,14,14,17,0,Human Factor
1944-11-11 00:00:00,United States Army Air Forces - USAAF,Flight,Military / Government,World,World,17,6,6,11,11,17,0,Unknown
1944-12-25 00:00:00,United States Army Air Forces - USAAF,Flight,Military / Government,United States of America,North America,17,4,4,13,13,17,0,Human Factor
1945-02-23 00:00:00,American Airlines,Flight,Commercial,United States of America,North America,22,3,2,19,15,17,5,Human Factor
1945-03-19 00:00:00,United States Navy - USN,Flight,Military / Government,World,World,17,5,5,12,12,17,0,Unknown
1945-06-14 00:00:00,United States Army Air Forces - USAAF,Landing (descent or approach),Military / Government,United States of America,North America,18,3,3,15,14,17,1,Weather
1945-09-05 00:00:00,Royal Air Force - RAF,Takeoff (climb),Military / Government,France,Europe,24,4,4,20,13,17,7,Unknown
1945-12-18 00:00:00,Royal Air Force - RAF,Landing (descent or approach),Military / Government,Norway,Europe,17,4,4,13,13,17,0,Technical Failure
1946-01-18 00:00:00,Eastern Airlines,Flight,Commercial,United States of America,North America,17,3,3,14,14,17,0,Technical Failure
1946-03-28 00:00:00,Royal Air Force - RAF,Takeoff (climb),Military / Government,Myanmar,Asia,21,4,4,17,13,17,4,Technical Failure
1946-04-08 00:00:00,United States Army Air Forces - USAAF,Flight,Military / Government,China,Asia,17,4,4,13,13,17,0,Unknown
1947-01-22 00:00:00,Avianca,Flight,Commercial,Colombia,South America,17,4,4,13,13,17,0,Human Factor
1948-08-19 00:00:00,United States Air Force - USAF,Takeoff (climb),Operational,United States of America,North America,17,4,4,13,13,17,0,Technical Failure
1948-10-21 00:00:00,French Air Force - Armée de l'Air,Flight,Military / Government,United Kingdom,Europe,17,5,5,12,12,17,0,Unknown
1948-11-04 00:00:00,Pacific Alaska Air Express,Flight,Commercial,United States of America,North America,17,2,2,15,15,17,0,Unknown
1949-07-22 00:00:00,French Air Force - Armée de l'Air,Flight,Military / Government,Morocco,Africa,17,9,9,8,8,17,0,Unknown
1949-12-10 00:00:00,Civil Air Transport,Landing (descent or approach),Commercial,China,Asia,50,5,0,45,17,17,33,Unknown
1949-12-16 00:00:00,Mexicana de Aviación,Flight,Commercial,Mexico,Central America,17,4,4,13,13,17,0,Human Factor
1950-12-30 00:00:00,Aerolineas Argentinas,Takeoff (climb),Commercial,Argentina,South America,18,5,5,13,12,17,1,Technical Failure
1951-10-15 00:00:00,South African Airways -SAA - Suid Afrikaanse Lugdiens - SAL,Flight,Commercial,South Africa,Africa,17,4,4,13,13,17,0,Human Factor
1952-03-24 00:00:00,Société Algérienne des Transports Tropicaux - SATT,Takeoff (climb),Commercial,Mali,Africa,21,3,3,18,14,17,4,Human Factor
1952-05-09 00:00:00,Garuda Indonesian Airways,Flight,Commercial,World,World,17,3,3,14,14,17,0,Unknown
1953-06-17 00:00:00,Panair do Brasil,Landing (descent or approach),Commercial,Brazil,South America,17,7,7,10,10,17,0,Human Factor
1954-06-09 00:00:00,United States Navy - USN,Flight,Military / Government,Japan,Asia,17,4,4,13,13,17,0,Human Factor
1954-12-31 00:00:00,Aeroflot - Russian International Airlines,Takeoff (climb),Commercial,Russia,Asia,17,3,3,14,14,17,0,Unknown
1955-12-21 00:00:00,Eastern Airlines,Landing (descent or approach),Commercial,United States of America,North America,17,5,5,12,12,17,0,Human Factor
1956-02-12 00:00:00,Hellenic Air Force - Elleniki Polemiki Aeroporia,Flight,Military / Government,Greece,Europe,17,4,4,13,13,17,0,Unknown
1956-03-02 00:00:00,United States Air Force - USAF,Flight,Military / Government,World,World,17,17,17,0,0,17,0,Technical Failure
1957-03-04 00:00:00,Japan Air Self-Defense Force - Kōkū Jieitai,Takeoff (climb),Military / Government,Japan,Asia,17,2,2,15,15,17,0,Unknown
1958-09-02 00:00:00,United States Air Force - USAF,Flight,Military / Government,Armenia,Asia,17,6,6,11,11,17,0,Terrorism
1958-11-01 00:00:00,Cubana de Aviación,Landing (descent or approach),Commercial,Cuba,Central America,20,4,4,16,13,17,3,Terrorism
1959-03-01 00:00:00,Brazilian Air Force - Força Aérea Brasileira,Flight,Military / Government,Brazil,South America,17,5,5,12,12,17,0,Unknown
1960-12-28 00:00:00,Aeroflot - Russian International Airlines,Landing (descent or approach),Operational,Russia,Asia,17,13,13,4,4,17,0,Weather
1961-07-11 00:00:00,United Airlines,Landing (descent or approach),Commercial,United States of America,North America,122,7,0,115,17,17,105,Technical Failure
1961-10-10 00:00:00,Royal Air Force - RAF,Takeoff (climb),Military / Government,Libya,Africa,37,3,1,34,16,17,20,Technical Failure
1961-11-10 00:00:00,Portuguese Air Force - Força Aerea Portuguesa,Landing (descent or approach),Military / Government,Angola,Africa,17,3,3,14,14,17,0,Human Factor
1962-11-23 00:00:00,United Airlines,Flight,Commercial,United States of America,North America,17,4,4,13,13,17,0,Other
1964-12-08 00:00:00,Aerolineas Abaroa - ALAS,Flight,Commercial,Bolivia,South America,17,4,4,13,13,17,0,Terrorism
1965-09-14 00:00:00,Ethiopian Airlines,Landing (descent or approach),Commercial,Ethiopia,Africa,17,3,3,14,14,17,0,Unknown
1966-01-01 00:00:00,Garuda Indonesian Airways,Landing (descent or approach),Commercial,Indonesia,Asia,17,4,4,13,13,17,0,Human Factor
1966-01-01 00:00:00,Garuda Indonesian Airways,Landing (descent or approach),Commercial,Indonesia,Asia,17,4,4,13,13,17,0,Human Factor
1966-12-18 00:00:00,Aerocondor de Colombia - Aerovias Condor,Landing (descent or approach),Commercial,Colombia,South America,59,7,4,52,13,17,42,Human Factor
1967-04-26 00:00:00,Avianca,Takeoff (climb),Commercial,Colombia,South America,18,3,2,15,15,17,1,Unknown
1968-10-31 00:00:00,Brazilian Air Force - Força Aérea Brasileira,Flight,Military / Government,Brazil,South America,17,2,2,15,15,17,0,Unknown
1969-12-10 00:00:00,Aeroflot - Russian International Airlines,Takeoff (climb),Commercial,Russia,Asia,17,5,5,12,12,17,0,Other
1970-02-19 00:00:00,Air Congo,Flight,Commercial,Democratic Republic of Congo,Africa,17,3,3,14,14,17,0,Unknown
1970-04-25 00:00:00,Italian Air Force - Aeronautica Militare Italiana,Takeoff (climb),Military / Government,Italy,Europe,19,7,7,12,10,17,2,Technical Failure
1970-04-30 00:00:00,United States Air Force - USAF,Flight,Operational,Uruguay,South America,17,4,4,13,13,17,0,Human Factor
1971-06-27 00:00:00,Lake Riverside Estates,Takeoff (climb),Commercial,United States of America,North America,24,3,2,21,15,17,7,Human Factor
1972-07-11 00:00:00,Royal Norwegian Air Force - Kongelige Norske Luftforsvaret,Flight,Military / Government,Norway,Europe,17,2,2,15,15,17,0,Human Factor
1972-07-29 00:00:00,Avianca,Flight,Commercial,Colombia,South America,17,3,3,14,14,17,0,Human Factor
1973-12-23 00:00:00,Aeroflot - Russian International Airlines,Takeoff (climb),Commercial,Ukraine,Europe,17,6,6,11,11,17,0,Technical Failure
1976-05-09 00:00:00,Imperial Iranian Air Force,Flight,Military / Government,Spain,Europe,17,10,10,7,7,17,0,Weather
1976-07-03 00:00:00,Myanmar Air Force - Tatmadaw Lei,Flight,Military / Government,Myanmar,Asia,17,3,3,14,14,17,0,Unknown
1977-12-09 00:00:00,Aeroflot - Russian International Airlines,Takeoff (climb),Commercial,Russia,Asia,23,5,4,18,13,17,6,Unknown
1978-02-10 00:00:00,Columbia Pacific Airlines,Takeoff (climb),Commercial,United States of America,North America,17,2,2,15,15,17,0,Human Factor
1979-03-29 00:00:00,Québecair,Takeoff (climb),Commercial,Canada,North America,24,3,3,21,14,17,7,Technical Failure
1979-05-30 00:00:00,Downeast Airlines,Landing (descent or approach),Commercial,United States of America,North America,18,2,2,16,15,17,1,Human Factor
1979-07-31 00:00:00,Dan-Air Services,Takeoff (climb),Commercial,United Kingdom,Europe,47,3,2,44,15,17,30,Human Factor
1981-05-29 00:00:00,Egyptian Air Force and Air Defence Command,Takeoff (climb),Military / Government,Egypt,Africa,17,6,6,11,11,17,0,Unknown
1981-10-06 00:00:00,NLM - Nederlandse Luchtvaart Maatschappij,Takeoff (climb),Commercial,Netherlands,Europe,17,4,4,13,13,17,0,Weather
1982-06-22 00:00:00,Air India,Landing (descent or approach),Commercial,India,Asia,111,10,2,101,15,17,94,Human Factor
1985-01-23 00:00:00,Aires Colombia - Aerovias de Integracion Regional,Flight,Commercial,Colombia,South America,17,2,2,15,15,17,0,Human Factor
1985-06-23 00:00:00,Transportes Aéreos Regionais da Bacia Amazônica - TABA,Landing (descent or approach),Commercial,Brazil,South America,17,2,2,15,15,17,0,Technical Failure
1985-09-29 00:00:00,Air Carriers Express Services,Takeoff (climb),Humanitarian,United States of America,North America,17,1,1,16,16,17,0,Technical Failure
1986-03-22 00:00:00,Indian Air Force - Bharatiya Vayu Sena,Landing (descent or approach),Military / Government,India,Asia,17,3,3,14,14,17,0,Unknown
1986-07-10 00:00:00,Air Force of Zimbabwe,Takeoff (climb),Military / Government,Mozambique,Africa,22,4,3,18,14,17,5,Technical Failure
1987-12-30 00:00:00,Merpati Nusantara Airlines - MNA,Takeoff (climb),Commercial,Indonesia,Asia,17,3,3,14,14,17,0,Unknown
1988-03-01 00:00:00,Comair - South Africa,Landing (descent or approach),Commercial,South Africa,Africa,17,2,2,15,15,17,0,Terrorism
1988-04-19 00:00:00,Aeroflot - Russian International Airlines,Flight,Commercial,Russia,Asia,17,2,2,15,15,17,0,Human Factor
1991-10-25 00:00:00,Bali International Air Service,Flight,Commercial,Indonesia,Asia,17,2,2,15,15,17,0,Technical Failure
1993-11-15 00:00:00,Aviastar,Flight,Operational,Iran,Asia,17,14,14,3,3,17,0,Human Factor
1994-04-06 00:00:00,Transportes Aéreos Mercantiles Ecuatorianos - TAME,Flight,Commercial,Ecuador,South America,17,3,3,14,14,17,0,Human Factor
1994-06-26 00:00:00,Air Ivoire,Landing (descent or approach),Commercial,Ivory Coast,Africa,17,3,3,14,14,17,0,Human Factor
1996-05-10 00:00:00,Aero Servicios Empresariales,Landing (descent or approach),Commercial,Mexico,Central America,19,3,3,16,14,17,2,Weather
1996-12-17 00:00:00,Russian Air Force - Voyenno-vozdushnye sily Rossii,Takeoff (climb),Military / Government,Russia,Asia,17,6,6,11,11,17,0,Human Factor
1999-06-17 00:00:00,Airlink Papua New Guinea,Landing (descent or approach),Commercial,Papua New Guinea,Oceania,17,2,2,15,15,17,0,Human Factor
1999-07-24 00:00:00,Air Fiji,Flight,Commercial,Fiji Islands,Oceania,17,2,2,15,15,17,0,Human Factor
1999-08-14 00:00:00,Yemeni Air Force,Landing (descent or approach),Military / Government,Yemen,Asia,17,17,17,0,0,17,0,Unknown
1999-12-07 00:00:00,Asian Spirit,Flight,Commercial,Philippines,Asia,17,2,2,15,15,17,0,Human Factor
2002-02-21 00:00:00,Russian Navy - Voyenno-morskoy Flot Rossii,Landing (descent or approach),Military / Government,Russia,Asia,20,8,6,12,11,17,3,Human Factor
2002-03-14 00:00:00,Aerotaxi,Flight,Commercial,Cuba,Central America,17,4,4,13,13,17,0,Technical Failure
2003-02-20 00:00:00,Pakistan Air Force - Pakistan Fiza'ya,Landing (descent or approach),Military / Government,Pakistan,Asia,17,8,8,9,9,17,0,Human Factor
2005-04-12 00:00:00,GT Air,Flight,Commercial,Indonesia,Asia,17,3,3,14,14,17,0,Human Factor
2006-08-03 00:00:00,Tracep,Landing (descent or approach),Commercial,Democratic Republic of Congo,Africa,17,3,3,14,14,17,0,Human Factor
2007-10-08 00:00:00,Nacional de Aviacion,Flight,Commercial,Colombia,South America,17,2,2,15,15,17,0,Human Factor
2008-09-01 00:00:00,Air Serv International,Landing (descent or approach),Humanitarian,Democratic Republic of Congo,Africa,17,2,2,15,15,17,0,Human Factor
2010-09-13 00:00:00,Conviasa - Consorcio Venezolano de Industrias Aeronáuticas y Servicios Aéreos,Landing (descent or approach),Commercial,Venezuela,South America,51,4,3,47,14,17,34,Technical Failure
2011-09-14 00:00:00,Angola Air Force - Força Aérea Nacional Angolana,Takeoff (climb),Military / Government,Angola,Africa,23,4,0,19,17,17,6,Unknown
1930-01-19 00:00:00,Maddux Airlines,Flight,Commercial,United States of America,North America,16,2,2,14,14,16,0,Weather
1932-02-23 00:00:00,Aeroflot - Russian International Airlines,Landing (descent or approach),Commercial,Russia,Asia,16,3,3,13,13,16,0,Technical Failure
1941-01-10 00:00:00,Linee Aeree Transcontinentali Italiane - LATI,Flight,Commercial,World,World,16,4,4,12,12,16,0,Unknown
1941-08-27 00:00:00,Colombian Air Force - Fuerza Aérea Colombiana,Takeoff (climb),Military / Government,Colombia,South America,16,3,3,13,13,16,0,Technical Failure
1942-04-22 00:00:00,German Air Force - Deutsche Luftwaffe,Flight,Military / Government,Norway,Europe,16,4,4,12,12,16,0,Weather
1942-08-15 00:00:00,United States Army Air Forces - USAAF,Flight,Military / Government,United States of America,North America,19,2,2,17,14,16,3,Weather
1943-06-30 00:00:00,British Overseas Airways Corporation - BOAC,Takeoff (climb),Military / Government,Sudan,Africa,16,3,3,13,13,16,0,Other
1943-07-04 00:00:00,Royal Air Force - RAF,Takeoff (climb),Military / Government,United Kingdom,Europe,17,6,5,11,11,16,1,Technical Failure
1943-08-02 00:00:00,United Airlines,Takeoff (climb),Humanitarian,New Zealand,Oceania,30,5,3,25,13,16,14,Human Factor
1944-02-21 00:00:00,Deutsche Lufthansa,Flight,Commercial,Greece,Europe,16,3,3,13,13,16,0,Technical Failure
1944-04-06 00:00:00,United States Navy - USN,Flight,Military / Government,World,World,30,3,0,27,16,16,14,Technical Failure
1944-06-03 00:00:00,Royal Air Force - RAF,Landing (descent or approach),Military / Government,Morocco,Africa,17,4,4,13,12,16,1,Human Factor
1944-10-14 00:00:00,United States Army Air Forces - USAAF,Landing (descent or approach),Military / Government,Italy,Europe,16,3,3,13,13,16,0,Unknown
1944-11-29 00:00:00,TACA International Airlines - Transportes Aéreos Centro Americanos,Takeoff (climb),Commercial,Honduras,Central America,16,2,2,14,14,16,0,Technical Failure
1944-12-07 00:00:00,Aeroflot - Russian International Airlines,Flight,Commercial,Ukraine,Europe,16,5,5,11,11,16,0,Human Factor
1944-12-07 00:00:00,United States Army Air Forces - USAAF,Flight,Military / Government,World,World,16,4,4,12,12,16,0,Unknown
1945-08-11 00:00:00,Mexicana de Aviación,Landing (descent or approach),Commercial,Mexico,Central America,16,3,3,13,13,16,0,Human Factor
1945-09-07 00:00:00,Royal Air Force - RAF,Flight,Military / Government,Myanmar,Asia,16,4,4,12,12,16,0,Weather
1945-10-15 00:00:00,French Air Force - Armée de l'Air,Takeoff (climb),Military / Government,France,Europe,20,5,5,15,11,16,4,Technical Failure
1945-11-13 00:00:00,Australian National Airways - ANA,Landing (descent or approach),Military / Government,Philippines,Asia,17,3,3,14,13,16,1,Human Factor
1945-12-04 00:00:00,Aeroflot - Russian International Airlines,Landing (descent or approach),Commercial,Russia,Asia,16,4,4,12,12,16,0,Weather
1946-10-10 00:00:00,Air Océan,Flight,Commercial,Morocco,Africa,16,5,5,11,11,16,0,Human Factor
1947-02-15 00:00:00,Corrieri Aerei Militari - CAM,Flight,Commercial,Italy,Europe,16,6,6,10,10,16,0,Unknown
1947-04-19 00:00:00,United States Army Air Forces - USAAF,Takeoff (climb),Military / Government,Marshall Islands,Oceania,16,16,16,0,0,16,0,Unknown
1947-11-19 00:00:00,Brazilian Air Force - Força Aérea Brasileira,Flight,Military / Government,Brazil,South America,16,16,16,0,0,16,0,Unknown
1948-01-06 00:00:00,Air France,Landing (descent or approach),Commercial,France,Europe,16,5,5,11,11,16,0,Unknown
1948-07-07 00:00:00,Aigle Azur,Flight,Commercial,Vietnam,Asia,16,3,3,13,13,16,0,Unknown
1948-08-24 00:00:00,United States Air Force - USAF,Landing (descent or approach),Military / Government,United States of America,North America,20,20,16,0,0,16,4,Technical Failure
1950-01-19 00:00:00,Spanish Air Force - Ejército del Aire,Landing (descent or approach),Military / Government,Spain,Europe,16,3,3,13,13,16,0,Human Factor
1950-05-18 00:00:00,United States Air Force - USAF,Landing (descent or approach),Military / Government,Portugal,Europe,16,16,16,0,0,16,0,Technical Failure
1950-07-13 00:00:00,United States Air Force - USAF,Flight,Operational,United States of America,North America,16,16,16,0,0,16,0,Unknown
1950-09-04 00:00:00,Robinson Airlines,Takeoff (climb),Commercial,United States of America,North America,23,3,3,20,13,16,7,Technical Failure
1951-01-20 00:00:00,Peruvian Air Force - Fuerza Aérea del Perú,Flight,Military / Government,Peru,South America,16,3,3,13,13,16,0,Unknown
1951-03-02 00:00:00,Mid-Continent Airlines,Landing (descent or approach),Commercial,United States of America,North America,25,4,3,21,13,16,9,Human Factor
1951-04-09 00:00:00,Siamese Airways,Landing (descent or approach),Commercial,China,Asia,16,5,5,11,11,16,0,Human Factor
1951-11-21 00:00:00,Deccan Airways,Landing (descent or approach),Commercial,India,Asia,17,4,4,13,12,16,1,Human Factor
1951-12-07 00:00:00,United States Air Force - USAF,Takeoff (climb),Military / Government,Portugal,Europe,16,16,16,0,0,16,0,Weather
1952-02-04 00:00:00,SABENA - Société Anonyme Belge d'Exploitation de la Navigation Aérienne,Flight,Commercial,Democratic Republic of Congo,Africa,16,3,3,13,13,16,0,Technical Failure
1953-03-14 00:00:00,Orient Airways,Flight,Commercial,India,Asia,16,5,5,11,11,16,0,Human Factor
1953-07-29 00:00:00,United States Air Force - USAF,Flight,Military / Government,Russia,Asia,17,17,16,0,0,16,1,Terrorism
1954-01-06 00:00:00,Royal Air Force - RAF,Takeoff (climb),Military / Government,United Kingdom,Europe,17,4,4,13,12,16,1,Human Factor
1954-01-14 00:00:00,Philippine Airlines - PAL,Landing (descent or approach),Commercial,Italy,Europe,16,7,7,9,9,16,0,Weather
1954-04-13 00:00:00,Société Indochinoise de Liaisons Aériennes - SILA,Takeoff (climb),Commercial,Laos,Asia,23,2,2,21,14,16,7,Unknown
1955-02-19 00:00:00,Trans World Airlines - TWA,Takeoff (climb),Commercial,United States of America,North America,16,3,3,13,13,16,0,Human Factor
1955-04-11 00:00:00,Air India,Flight,Commercial,Indonesia,Asia,19,8,5,11,11,16,3,Terrorism
1955-06-16 00:00:00,Panair do Brasil,Landing (descent or approach),Commercial,Paraguay,South America,24,10,7,14,9,16,8,Human Factor
1955-09-10 00:00:00,France Hydro,Flight,Commercial,Cameroon,Africa,16,8,8,8,8,16,0,Technical Failure
1956-09-10 00:00:00,United States Air Force - USAF,Flight,Other,World,World,16,16,16,0,0,16,0,Unknown
1956-10-29 00:00:00,Egyptian Air Force and Air Defence Command,Flight,Military / Government,World,World,16,4,4,12,12,16,0,Terrorism
1957-01-23 00:00:00,Lineas Aéreas de Nicaragua - LANICA,Flight,Commercial,Nicaragua,Central America,16,3,3,13,13,16,0,Unknown
1957-05-13 00:00:00,Líneas Aéreas del Estado - LADE,Landing (descent or approach),Military / Government,Argentina,South America,16,3,3,13,13,16,0,Human Factor
1957-07-16 00:00:00,United States Air Force - USAF,Flight,Military / Government,Taiwan,Asia,16,7,7,9,9,16,0,Unknown
1957-10-29 00:00:00,United States Air Force - USAF,Flight,Military / Government,United States of America,North America,16,4,4,12,12,16,0,Human Factor
1958-02-15 00:00:00,United States Air Force - USAF,Takeoff (climb),Military / Government,Italy,Europe,16,2,2,14,14,16,0,Unknown
1958-04-14 00:00:00,Aviaco - Aviacion y Comercio,Landing (descent or approach),Commercial,Spain,Europe,16,2,2,14,14,16,0,Human Factor
1958-12-30 00:00:00,Polyarnaya Aviatsiya,Landing (descent or approach),Commercial,Russia,Asia,17,5,5,12,11,16,1,Human Factor
1959-09-24 00:00:00,Reeve Aleutian Airways - RAA,Landing (descent or approach),Commercial,United States of America,North America,16,5,5,11,11,16,0,Human Factor
1961-04-24 00:00:00,Aeroflot - Russian International Airlines,Flight,Commercial,Armenia,Asia,19,2,0,17,16,16,3,Human Factor
1961-09-17 00:00:00,Transair Sweden,Landing (descent or approach),Humanitarian,Zambia,Africa,16,5,5,11,11,16,0,Human Factor
1965-03-23 00:00:00,Royal Canadian Air Force - RCAF,Flight,Operational,World,World,16,14,14,2,2,16,0,Unknown
1965-06-27 00:00:00,United States Air Force - USAF,Landing (descent or approach),Military / Government,Vietnam,Asia,16,2,2,14,14,16,0,Terrorism
1965-07-11 00:00:00,United States Air Force - USAF,Flight,Military / Government,World,World,19,4,3,15,13,16,3,Technical Failure
1965-12-11 00:00:00,Fiji Airways,Landing (descent or approach),Commercial,Fiji Islands,Oceania,19,2,2,17,14,16,3,Human Factor
1967-06-24 00:00:00,Saudi Arabian Airlines - SAUDIA,Flight,Commercial,Saudi Arabia,Asia,17,3,3,14,13,16,1,Technical Failure
1967-07-25 00:00:00,Vehu Akat,Landing (descent or approach),Commercial,Laos,Asia,16,3,3,13,13,16,0,Human Factor
1967-10-24 00:00:00,China Airlines,Flight,Commercial,Vietnam,Asia,16,3,3,13,13,16,0,Unknown
1968-01-27 00:00:00,Air Comores,Landing (descent or approach),Commercial,Comoros Islands,Africa,16,2,2,14,14,16,0,Human Factor
1969-03-20 00:00:00,Avion Airways,Landing (descent or approach),Commercial,United States of America,North America,27,3,3,24,13,16,11,Human Factor
1969-08-05 00:00:00,United States Navy - USN,Flight,Military / Government,Chile,South America,16,4,4,12,12,16,0,Unknown
1969-08-26 00:00:00,Aeroflot - Russian International Airlines,Landing (descent or approach),Commercial,Russia,Asia,101,7,0,94,16,16,85,Human Factor
1971-01-02 00:00:00,United Arab Airlines,Landing (descent or approach),Commercial,Libya,Africa,16,8,8,8,8,16,0,Human Factor
1971-04-28 00:00:00,Brazilian Air Force - Força Aérea Brasileira,Landing (descent or approach),Military / Government,Brazil,South America,85,7,0,78,16,16,69,Technical Failure
1971-10-21 00:00:00,Chicago %26 Southern Airlines,Landing (descent or approach),Commercial,United States of America,North America,16,2,2,14,14,16,0,Human Factor
1972-03-03 00:00:00,Mohawk Airlines,Landing (descent or approach),Commercial,United States of America,North America,48,4,2,44,14,16,32,Human Factor
1973-08-22 00:00:00,Avianca,Landing (descent or approach),Commercial,Colombia,South America,17,3,3,14,13,16,1,Human Factor
1975-03-21 00:00:00,United States Air Force - USAF,Flight,Military / Government,United States of America,North America,16,4,4,12,12,16,0,Human Factor
1977-06-21 00:00:00,United States Navy - USN,Takeoff (climb),Military / Government,United States of America,North America,16,4,4,12,12,16,0,Human Factor
1978-03-02 00:00:00,Nigeria Airways,Landing (descent or approach),Commercial,Nigeria,Africa,16,5,5,11,11,16,0,Human Factor
1978-10-06 00:00:00,United States Navy - USN,Landing (descent or approach),Military / Government,Chile,South America,16,8,8,8,8,16,0,Unknown
1979-11-19 00:00:00,Ecuadorian Air Force - Fuerza Aérea Ecuatoriana,Takeoff (climb),Military / Government,Ecuador,South America,16,2,2,14,14,16,0,Unknown
1979-12-23 00:00:00,Douglas Airways,Landing (descent or approach),Commercial,Papua New Guinea,Oceania,16,2,2,14,14,16,0,Unknown
1982-12-23 00:00:00,Aeroflot - Russian International Airlines,Takeoff (climb),Operational,Russia,Asia,16,4,4,12,12,16,0,Human Factor
1986-05-03 00:00:00,Air Lanka,Parking,Commercial,Sri Lanka,Asia,150,22,0,128,16,16,134,Terrorism
1987-01-30 00:00:00,Air Reconnaissance Unit,Takeoff (climb),Military / Government,Liberia,Africa,18,2,2,16,14,16,2,Unknown
1987-12-21 00:00:00,Air Littoral,Landing (descent or approach),Commercial,France,Europe,16,3,3,13,13,16,0,Human Factor
1988-01-02 00:00:00,Condor Flugdienst,Landing (descent or approach),Commercial,Turkey,Asia,16,5,5,11,11,16,0,Human Factor
1988-01-31 00:00:00,Panamanian Air Force - Fuerza Aérea Panameña,Flight,Military / Government,Panama,Central America,16,2,2,14,14,16,0,Unknown
1988-09-07 00:00:00,Afghan Republican Air Force - Afghan Hanai Qurah,Flight,Military / Government,Afghanistan,Asia,16,4,4,12,12,16,0,Terrorism
1989-05-08 00:00:00,Holmstroem Air,Landing (descent or approach),Commercial,Sweden,Europe,16,2,2,14,14,16,0,Human Factor
1989-08-07 00:00:00,RRC Air Service,Flight,Humanitarian,Ethiopia,Africa,16,3,3,13,13,16,0,Human Factor
1990-09-11 00:00:00,Faucett,Flight,Operational,World,World,16,6,6,10,10,16,0,Technical Failure
1990-11-18 00:00:00,SATENA - Servicio de Aeronavegacion a Territorios Nacionales,Flight,Commercial,Colombia,South America,16,4,4,12,12,16,0,Human Factor
1991-11-29 00:00:00,Brazilian Air Force - Força Aérea Brasileira,Landing (descent or approach),Military / Government,Brazil,South America,16,3,3,13,13,16,0,Human Factor
1992-04-22 00:00:00,Perris Valley Aviation,Takeoff (climb),Humanitarian,United States of America,North America,22,2,2,20,14,16,6,Other
1993-01-09 00:00:00,Bouraq Indonesia Airlines,Landing (descent or approach),Commercial,Indonesia,Asia,44,5,4,39,12,16,28,Technical Failure
1996-12-07 00:00:00,Dirgantara Air Service,Landing (descent or approach),Commercial,Indonesia,Asia,17,2,2,15,14,16,1,Technical Failure
1997-08-10 00:00:00,Formosa Airlines,Landing (descent or approach),Commercial,Taiwan,Asia,16,2,2,14,14,16,0,Human Factor
1998-01-27 00:00:00,Myanma Airways,Takeoff (climb),Commercial,Myanmar,Asia,45,4,1,41,15,16,29,Human Factor
1999-07-20 00:00:00,La Costeña,Flight,Commercial,Nicaragua,Central America,16,2,2,14,14,16,0,Human Factor
1999-08-10 00:00:00,Pakistan Navy - Pākistān Bāhrí'a,Flight,Military / Government,India,Asia,16,16,16,0,0,16,0,Terrorism
1999-12-21 00:00:00,AOM French Airlines,Landing (descent or approach),Commercial,Guatemala,Central America,314,18,8,296,8,16,298,Human Factor
2001-03-17 00:00:00,SAL Express,Landing (descent or approach),Commercial,Angola,Africa,17,2,2,15,14,16,1,Human Factor
2001-12-16 00:00:00,Heliandes,Takeoff (climb),Commercial,Colombia,South America,16,2,2,14,14,16,0,Human Factor
2002-08-29 00:00:00,Vostok Aviakompania - East Air,Landing (descent or approach),Commercial,Russia,Asia,16,2,2,14,14,16,0,Human Factor
2004-12-10 00:00:00,Venezuelan National Guard - Guardia Nacional Bolivariana de Venezuela,Flight,Military / Government,Venezuela,South America,16,3,3,13,13,16,0,Human Factor
2005-08-06 00:00:00,Tuninter,Flight,Commercial,Italy,Europe,39,4,2,35,14,16,23,Human Factor
2009-07-25 00:00:00,Aria Air,Landing (descent or approach),Commercial,Iran,Asia,173,17,11,156,5,16,157,Human Factor
2011-07-13 00:00:00,NOAR Linhas Aéreas,Takeoff (climb),Commercial,Brazil,South America,16,2,2,14,14,16,0,Technical Failure
2013-10-03 00:00:00,Associated Aviation,Takeoff (climb),Commercial,Nigeria,Africa,20,7,7,13,9,16,4,Human Factor
2014-05-17 00:00:00,Laotian Government,Landing (descent or approach),Military / Government,Laos,Asia,17,6,6,11,10,16,1,Unknown
2017-07-10 00:00:00,United States Marine Corps,Flight,Military / Government,United States of America,North America,16,8,8,8,8,16,0,Technical Failure
2021-10-10 00:00:00,DOSAAF,Takeoff (climb),Humanitarian,Russia,Asia,22,2,2,20,14,16,6,Technical Failure
1933-03-28 00:00:00,Imperial Airways,Flight,Commercial,Belgium,Europe,15,3,3,12,12,15,0,Other
1933-11-21 00:00:00,Kalinin Industries,Flight,Specialised Services,Ukraine,Europe,20,20,15,0,0,15,5,Technical Failure
1936-12-09 00:00:00,KLM Royal Dutch Airlines - Koninklijke Luchtvaart Maatschappij,Takeoff (climb),Commercial,United Kingdom,Europe,17,4,3,13,12,15,2,Human Factor
1937-07-28 00:00:00,KLM Royal Dutch Airlines - Koninklijke Luchtvaart Maatschappij,Takeoff (climb),Commercial,Belgium,Europe,15,4,4,11,11,15,0,Technical Failure
1938-07-29 00:00:00,Pan American World Airways - PAA,Flight,Commercial,World,World,15,9,9,6,6,15,0,Unknown
1938-08-18 00:00:00,Macchi Aeronautica,Flight,Specialised Services,Italy,Europe,15,2,2,13,13,15,0,Unknown
1938-09-15 00:00:00,Dai Nippon Airlines,Flight,Commercial,Japan,Asia,15,2,2,13,13,15,0,Unknown
1940-05-10 00:00:00,German Air Force - Deutsche Luftwaffe,Flight,Military / Government,Netherlands,Europe,15,3,3,12,12,15,0,Terrorism
1940-05-26 00:00:00,German Air Force - Deutsche Luftwaffe,Flight,Military / Government,Norway,Europe,15,4,4,11,11,15,0,Terrorism
1940-08-23 00:00:00,Liniile Aeriene Române Exploatate cu Statul - LARES,Flight,Commercial,Romania,Europe,15,3,3,12,12,15,0,Human Factor
1941-01-08 00:00:00,South African Air Force,Flight,Military / Government,Tanzania,Africa,15,4,4,11,11,15,0,Unknown
1941-09-01 00:00:00,Air France,Takeoff (climb),Commercial,France,Europe,17,3,3,14,12,15,2,Technical Failure
1942-09-28 00:00:00,Panair do Brasil,Flight,Commercial,Brazil,South America,15,4,4,11,11,15,0,Human Factor
1942-10-18 00:00:00,Royal Air Force - RAF,Landing (descent or approach),Military / Government,United Kingdom,Europe,15,6,6,9,9,15,0,Unknown
1943-06-04 00:00:00,Royal New Zealand Air Force - RNZAF,Flight,Military / Government,World,World,15,7,7,8,8,15,0,Unknown
1943-11-26 00:00:00,Qantas Airways - Queensland and Northern Territory Aerial Services,Takeoff (climb),Military / Government,Papua New Guinea,Oceania,15,4,4,11,11,15,0,Human Factor
1944-06-12 00:00:00,United States Navy - USN,Flight,Military / Government,Solomon Islands,Oceania,15,3,3,12,12,15,0,Unknown
1944-06-15 00:00:00,United States Army Air Forces - USAAF,Flight,Military / Government,India,Asia,15,4,4,11,11,15,0,Unknown
1944-08-15 00:00:00,Royal Air Force - RAF,Flight,Operational,United Kingdom,Europe,15,15,15,0,0,15,0,Unknown
1944-09-11 00:00:00,United States Army Air Forces - USAAF,Landing (descent or approach),Military / Government,France,Europe,15,3,3,12,12,15,0,Unknown
1944-10-16 00:00:00,Deutsche Lufthansa,Flight,Commercial,Norway,Europe,15,3,3,12,12,15,0,Human Factor
1945-02-01 00:00:00,Royal Air Force - RAF,Flight,Military / Government,Italy,Europe,15,4,4,11,11,15,0,Human Factor
1945-02-15 00:00:00,Navegação Aérea Brasileira - NAB,Flight,Commercial,Brazil,South America,15,4,4,11,11,15,0,Unknown
1945-05-17 00:00:00,Royal Australian Air Force - RAAF,Flight,Military / Government,Timor Leste,Asia,15,10,10,5,5,15,0,Unknown
1945-06-13 00:00:00,United States Army Air Forces - USAAF,Flight,Military / Government,United Kingdom,Europe,15,9,9,6,6,15,0,Technical Failure
1945-07-04 00:00:00,Royal Air Force - RAF,Flight,Military / Government,World,World,15,4,4,11,11,15,0,Unknown
1945-10-30 00:00:00,United States Army Air Forces - USAAF,Flight,Military / Government,Italy,Europe,15,15,15,0,0,15,0,Human Factor
1946-11-13 00:00:00,Empresa Commercial Aéreas de Veracruz,Flight,Commercial,Mexico,Central America,15,3,3,12,12,15,0,Unknown
1947-04-17 00:00:00,South African Air Force,Flight,Military / Government,Sudan,Africa,15,4,4,11,11,15,0,Unknown
1947-04-28 00:00:00,Trans-Canada Air Lines - TCAL,Landing (descent or approach),Commercial,Canada,North America,15,3,3,12,12,15,0,Human Factor
1947-10-09 00:00:00,French Air Force - Armée de l'Air,Flight,Military / Government,Vietnam,Asia,16,4,4,12,11,15,1,Terrorism
1948-09-30 00:00:00,Aeroflot - Russian International Airlines,Takeoff (climb),Commercial,Kazakhstan,Asia,15,4,4,11,11,15,0,Human Factor
1949-01-26 00:00:00,United States Air Force - USAF,Flight,Military / Government,World,World,15,15,15,0,0,15,0,Unknown
1949-03-18 00:00:00,New Zealand National Airways,Landing (descent or approach),Commercial,New Zealand,Oceania,15,2,2,13,13,15,0,Human Factor
1949-07-30 00:00:00,Eastern Airlines,Flight,Commercial,United States of America,North America,15,3,3,12,12,15,0,Human Factor
1950-03-25 00:00:00,Devlet Hava Yollari - DHY,Landing (descent or approach),Commercial,Turkey,Asia,15,4,4,11,11,15,0,Unknown
1950-05-02 00:00:00,Avianca,Flight,Commercial,Ecuador,South America,15,3,3,12,12,15,0,Unknown
1950-06-09 00:00:00,New Tribes Mission,Flight,Humanitarian,Colombia,South America,15,3,3,12,12,15,0,Human Factor
1950-11-26 00:00:00,Indonesian Air Force - TNI-AU Tentara Nasional Indonesia - Angkatan Udara,Flight,Military / Government,Indonesia,Asia,27,3,3,24,12,15,12,Human Factor
1950-12-19 00:00:00,French Air Force - Armée de l'Air,Flight,Operational,Vietnam,Asia,15,2,2,13,13,15,0,Human Factor
1950-12-19 00:00:00,French Air Force - Armée de l'Air,Flight,Operational,Vietnam,Asia,15,2,2,13,13,15,0,Human Factor
1952-04-15 00:00:00,United States Air Force - USAF,Takeoff (climb),Operational,United States of America,North America,17,17,15,0,0,15,2,Human Factor
1953-10-31 00:00:00,Aeroflot - Russian International Airlines,Landing (descent or approach),Commercial,Ukraine,Europe,16,5,5,11,10,15,1,Human Factor
1954-02-18 00:00:00,French Navy,Flight,Military / Government,Tunisia,Africa,15,4,4,11,11,15,0,Human Factor
1955-05-25 00:00:00,United States Air Force - USAF,Flight,Operational,United States of America,North America,15,15,15,0,0,15,0,Weather
1955-09-22 00:00:00,British Overseas Airways Corporation - BOAC,Landing (descent or approach),Commercial,Libya,Africa,47,7,2,40,13,15,32,Human Factor
1955-10-31 00:00:00,United States Navy - USN,Takeoff (climb),Military / Government,Panama,Central America,16,16,15,0,0,15,1,Technical Failure
1956-08-29 00:00:00,Canadian Pacific Airlines - CP Air,Landing (descent or approach),Commercial,United States of America,North America,22,8,4,14,11,15,7,Human Factor
1957-03-09 00:00:00,Avianca,Flight,Commercial,Colombia,South America,15,3,3,12,12,15,0,Human Factor
1957-11-06 00:00:00,Bristol Aeroplane Company,Landing (descent or approach),Specialised Services,United Kingdom,Europe,15,4,4,11,11,15,0,Technical Failure
1958-02-19 00:00:00,Réseau Aérien Interinsulaire - RAI,Landing (descent or approach),Commercial,French Polynesia,Oceania,26,3,3,23,12,15,11,Human Factor
1958-03-27 00:00:00,United States Air Force - USAF,Flight,Military / Government,United States of America,North America,15,10,10,5,5,15,0,Human Factor
1958-05-31 00:00:00,Air France,Flight,Commercial,Algeria,Africa,15,3,3,12,12,15,0,Unknown
1958-06-27 00:00:00,United States Air Force - USAF,Takeoff (climb),Military / Government,United States of America,North America,15,7,7,8,8,15,0,Human Factor
1959-03-05 00:00:00,TACA International Airlines - Transportes Aéreos Centro Americanos,Takeoff (climb),Commercial,Nicaragua,Central America,19,4,2,15,13,15,4,Technical Failure
1959-11-07 00:00:00,United States Air Force - USAF,Takeoff (climb),Military / Government,Taiwan,Asia,15,4,4,11,11,15,0,Unknown
1960-12-07 00:00:00,Real Aerovias,Flight,Commercial,Brazil,South America,15,2,2,13,13,15,0,Technical Failure
1961-09-26 00:00:00,Chinese Air Force - AFPLA - Chung-Kuo Shan Min Taie Fang Tsun Pu-Tai,Flight,Military / Government,China,Asia,15,5,5,10,10,15,0,Unknown
1961-11-30 00:00:00,ANSETT-ANA,Takeoff (climb),Commercial,Australia,Oceania,15,4,4,11,11,15,0,Weather
1962-03-08 00:00:00,United States Air Force - USAF,Flight,Military / Government,France,Europe,15,13,13,2,2,15,0,Unknown
1962-05-12 00:00:00,Eastern Provincial Airways - EPA,Landing (descent or approach),Commercial,Greenland,Europe,21,3,0,18,15,15,6,Technical Failure
1962-08-20 00:00:00,Panair do Brasil,Takeoff (climb),Commercial,Brazil,South America,105,11,1,94,14,15,90,Technical Failure
1963-07-01 00:00:00,VARIG - Viação Aérea Rio Grandense,Landing (descent or approach),Commercial,Brazil,South America,18,3,2,15,13,15,3,Human Factor
1963-08-12 00:00:00,Air Inter,Landing (descent or approach),Commercial,France,Europe,16,4,4,12,11,15,1,Weather
1963-09-02 00:00:00,Air America,Flight,Military / Government,Laos,Asia,16,3,3,13,12,15,1,Unknown
1964-04-12 00:00:00,Aden Airways,Landing (descent or approach),Commercial,Somalia,Africa,15,3,3,12,12,15,0,Unknown
1964-05-05 00:00:00,United States Army,Takeoff (climb),Military / Government,Vietnam,Asia,15,4,4,11,11,15,0,Technical Failure
1967-03-12 00:00:00,Aeroflot - Russian International Airlines,Flight,Commercial,Russia,Asia,20,4,4,16,11,15,5,Technical Failure
1967-04-08 00:00:00,Republic of Korea Air Force,Takeoff (climb),Military / Government,South Korea,Asia,15,3,3,12,12,15,0,Technical Failure
1967-04-25 00:00:00,United States Air Force - USAF,Flight,Military / Government,United States of America,North America,16,4,4,12,11,15,1,Technical Failure
1969-01-13 00:00:00,Scandinavian Airlines System - SAS,Landing (descent or approach),Commercial,United States of America,North America,45,9,3,36,12,15,30,Human Factor
1971-03-26 00:00:00,Jamair,Flight,Commercial,India,Asia,15,4,4,11,11,15,0,Human Factor
1973-07-07 00:00:00,Vietnam People's Air Force,Takeoff (climb),Military / Government,Vietnam,Asia,36,2,2,34,13,15,21,Technical Failure
1973-09-04 00:00:00,Aeroflot - Russian International Airlines,Landing (descent or approach),Commercial,Russia,Asia,15,3,3,12,12,15,0,Human Factor
1974-03-15 00:00:00,Sterling Airways,Taxiing,Commercial,Iran,Asia,96,4,0,92,15,15,81,Technical Failure
1974-05-24 00:00:00,Aeroflot - Russian International Airlines,Flight,Commercial,Kazakhstan,Asia,15,2,2,13,13,15,0,Human Factor
1975-02-27 00:00:00,VASP - Viação Aérea de São Paulo,Takeoff (climb),Commercial,Brazil,South America,15,2,2,13,13,15,0,Technical Failure
1975-11-18 00:00:00,Aviateca,Flight,Commercial,Guatemala,Central America,22,4,4,18,11,15,7,Weather
1976-09-26 00:00:00,United States Air Force - USAF,Flight,Military / Government,United States of America,North America,20,5,3,15,12,15,5,Technical Failure
1977-05-07 00:00:00,Aeroflot - Russian International Airlines,Flight,Commercial,Russia,Asia,15,2,2,13,13,15,0,Human Factor
1978-09-03 00:00:00,Air Guinée,Landing (descent or approach),Commercial,Guinea,Africa,17,8,7,9,8,15,2,Unknown
1978-10-03 00:00:00,Finnish Air Force - Suomen Ilmavoimat,Takeoff (climb),Military / Government,Finland,Europe,15,3,3,12,12,15,0,Technical Failure
1978-11-18 00:00:00,Air Guadeloupe,Landing (descent or approach),Commercial,Guadeloupe,Central America,20,1,1,19,14,15,5,Human Factor
1981-11-26 00:00:00,Aeroflot - Russian International Airlines,Takeoff (climb),Commercial,Russia,Asia,15,3,3,12,12,15,0,Human Factor
1982-03-11 00:00:00,Wideroe - Wideroe's Flyveselskap,Flight,Commercial,Norway,Europe,15,2,2,13,13,15,0,Other
1982-06-17 00:00:00,MRP - Ministerstvo Radioelektronnoi Promyshlennosti,Landing (descent or approach),Military / Government,Russia,Asia,16,6,5,10,10,15,1,Human Factor
1982-11-29 00:00:00,TAAG Angola Airlines - Transportes Aéreos de Angola,Flight,Commercial,Angola,Africa,15,6,6,9,9,15,0,Human Factor
1984-08-24 00:00:00,Wings West Airlines,Takeoff (climb),Commercial,United States of America,North America,15,2,2,13,13,15,0,Human Factor
1984-12-22 00:00:00,Royal Nepal Airlines,Landing (descent or approach),Commercial,Nepal,Asia,23,3,3,20,12,15,8,Human Factor
1985-05-03 00:00:00,Soviet Air Force - Voyenno-vozdushnye sily CCCP,Flight,Military / Government,Ukraine,Europe,15,6,6,9,9,15,0,Human Factor
1987-09-13 00:00:00,Soviet Air Force - Voyenno-vozdushnye sily CCCP,Landing (descent or approach),Military / Government,Afghanistan,Asia,15,4,4,11,11,15,0,Terrorism
1987-12-13 00:00:00,Philippine Airlines - PAL,Landing (descent or approach),Commercial,Philippines,Asia,15,4,4,11,11,15,0,Human Factor
1988-02-27 00:00:00,Talia Airways,Landing (descent or approach),Operational,Cyprus,Europe,15,6,6,9,9,15,0,Human Factor
1989-10-20 00:00:00,Aeroflot - Russian International Airlines,Landing (descent or approach),Operational,Armenia,Asia,15,10,10,5,5,15,0,Human Factor
1990-02-05 00:00:00,Helicol Colombia - Helicopteros Nacionales de Colombia,Landing (descent or approach),Commercial,Colombia,South America,15,4,4,11,11,15,0,Human Factor
1991-07-09 00:00:00,Aero Chasqui,Takeoff (climb),Commercial,Peru,South America,15,2,2,13,13,15,0,Terrorism
1991-09-27 00:00:00,Solomon Airlines,Flight,Commercial,Solomon Islands,Oceania,15,2,2,13,13,15,0,Human Factor
1991-11-11 00:00:00,Nordeste Linhas Aéreas Regionais,Takeoff (climb),Commercial,Brazil,South America,15,3,3,12,12,15,0,Technical Failure
1992-10-19 00:00:00,Komi Avia,Takeoff (climb),Commercial,Russia,Asia,16,2,2,14,13,15,1,Technical Failure
1994-12-13 00:00:00,American Eagle,Landing (descent or approach),Commercial,United States of America,North America,20,2,2,18,13,15,5,Human Factor
1995-06-24 00:00:00,Harka Air Services,Landing (descent or approach),Commercial,Nigeria,Africa,80,6,0,74,15,15,65,Human Factor
1995-07-12 00:00:00,Milne Bay Air - MBA,Takeoff (climb),Commercial,Papua New Guinea,Oceania,15,2,2,13,13,15,0,Technical Failure
1997-03-12 00:00:00,Von Haaf Air,Landing (descent or approach),Operational,Angola,Africa,15,4,4,11,11,15,0,Human Factor
1997-04-19 00:00:00,Merpati Nusantara Airlines - MNA,Landing (descent or approach),Commercial,Indonesia,Asia,53,5,4,48,11,15,38,Technical Failure
1999-09-05 00:00:00,Necon Air,Landing (descent or approach),Commercial,Nepal,Asia,15,5,5,10,10,15,0,Human Factor
2005-02-22 00:00:00,Indonesian National Police - Kepolisian Negara Republik Indonesia,Landing (descent or approach),Military / Government,Indonesia,Asia,18,4,4,14,11,15,3,Technical Failure
2005-05-07 00:00:00,Aero-Tropics Air Services,Landing (descent or approach),Commercial,Australia,Oceania,15,2,2,13,13,15,0,Human Factor
2006-10-19 00:00:00,Uzbekistan Airways - Uzbekistan Havo Jullary,Landing (descent or approach),Humanitarian,Uzbekistan,Asia,15,2,2,13,13,15,0,Human Factor
2009-08-02 00:00:00,Merpati Nusantara Airlines - MNA,Flight,Commercial,Indonesia,Asia,15,3,3,12,12,15,0,Human Factor
2012-05-14 00:00:00,Agni Air,Landing (descent or approach),Commercial,Nepal,Asia,21,3,2,18,13,15,6,Human Factor
2012-10-07 00:00:00,AZZA Air Transport,Flight,Commercial,Sudan,Africa,22,6,4,16,11,15,7,Technical Failure
2018-09-17 00:00:00,Russian Air Force - Voyenno-vozdushnye sily Rossii,Flight,Military / Government,Syria,Asia,15,15,15,0,0,15,0,Terrorism
2019-01-14 00:00:00,Islamic Republic of Iran Air Force,Landing (descent or approach),Operational,Iran,Asia,16,16,15,0,0,15,1,Human Factor
1919-08-02 00:00:00,Caproni Trasporti,Flight,Commercial,Italy,Europe,14,2,2,12,12,14,0,Technical Failure
1922-03-31 00:00:00,Chinese Government,Landing (descent or approach),Military / Government,China,Asia,14,2,2,12,12,14,0,Unknown
1928-12-03 00:00:00,Syndicato Condor,Flight,Commercial,Brazil,South America,14,5,5,9,9,14,0,Technical Failure
1929-03-17 00:00:00,Colonial Western Airways,Takeoff (climb),Commercial,United States of America,North America,15,2,1,13,13,14,1,Technical Failure
1936-03-26 00:00:00,Mexicana de Aviación,Flight,Commercial,Mexico,Central America,14,4,4,10,10,14,0,Human Factor
1937-08-02 00:00:00,Panagra - Pan American-Grace Airways,Landing (descent or approach),Commercial,Panama,Central America,14,3,3,11,11,14,0,Human Factor
1938-02-13 00:00:00,Ala Littoria,Flight,Commercial,World,World,14,4,4,10,10,14,0,Unknown
1938-07-22 00:00:00,LOT Polish Airlines - Polskie Linie Lotnicze,Flight,Commercial,Romania,Europe,14,2,2,12,12,14,0,Weather
1938-08-24 00:00:00,China National Aviation Corporation - CNAC,Flight,Commercial,China,Asia,18,4,2,14,12,14,4,Terrorism
1938-11-04 00:00:00,Jersey Airways,Takeoff (climb),Commercial,United Kingdom,Europe,14,1,1,13,13,14,0,Human Factor
1939-08-13 00:00:00,Pan American World Airways - PAA,Landing (descent or approach),Commercial,Brazil,South America,16,4,4,12,10,14,2,Technical Failure
1940-03-16 00:00:00,Ala Littoria,Flight,Commercial,Italy,Europe,14,4,4,10,10,14,0,Human Factor
1941-02-21 00:00:00,Royal Air Force - RAF,Flight,Military / Government,World,World,14,14,14,0,0,14,0,Unknown
1941-10-30 00:00:00,Northwest Airlines,Landing (descent or approach),Commercial,United States of America,North America,15,3,2,12,12,14,1,Weather
1941-11-14 00:00:00,Aeroflot - Russian International Airlines,Flight,Military / Government,Russia,Asia,14,6,6,8,8,14,0,Human Factor
1942-08-25 00:00:00,Royal Air Force - RAF,Flight,Military / Government,United Kingdom,Europe,15,4,4,11,10,14,1,Human Factor
1943-01-22 00:00:00,Panagra - Pan American-Grace Airways,Flight,Commercial,Peru,South America,15,4,4,11,10,14,1,Human Factor
1943-05-03 00:00:00,United States Army Air Forces - USAAF,Landing (descent or approach),Military / Government,Iceland,Europe,15,7,6,8,8,14,1,Human Factor
1943-08-18 00:00:00,Royal Australian Air Force - RAAF,Flight,Operational,Australia,Oceania,16,8,6,8,8,14,2,Unknown
1943-10-20 00:00:00,United States Army Air Forces - USAAF,Flight,Military / Government,World,World,14,6,6,8,8,14,0,Unknown
1943-10-29 00:00:00,United States Army Air Forces - USAAF,Landing (descent or approach),Operational,United States of America,North America,20,5,4,15,10,14,6,Technical Failure
1943-12-18 00:00:00,Aeroflot - Russian International Airlines,Landing (descent or approach),Military / Government,Russia,Asia,14,5,5,9,9,14,0,Human Factor
1944-02-16 00:00:00,United States Navy - USN,Flight,Military / Government,World,World,14,2,2,12,12,14,0,Unknown
1944-04-25 00:00:00,United States Army Air Forces - USAAF,Takeoff (climb),Military / Government,United Kingdom,Europe,14,5,5,9,9,14,0,Human Factor
1944-07-25 00:00:00,Linea Aeropostal Venezolana - LAV,Landing (descent or approach),Commercial,Venezuela,South America,14,2,2,12,12,14,0,Unknown
1944-11-03 00:00:00,United States Army Air Forces - USAAF,Flight,Operational,United States of America,North America,14,14,14,0,0,14,0,Human Factor
1944-11-06 00:00:00,German Air Force - Deutsche Luftwaffe,Flight,Military / Government,Norway,Europe,14,3,3,11,11,14,0,Human Factor
1945-03-10 00:00:00,United States Navy - USN,Flight,Military / Government,World,World,14,14,14,0,0,14,0,Unknown
1945-03-27 00:00:00,Royal Air Force - RAF,Flight,Military / Government,World,World,14,7,7,7,7,14,0,Unknown
1945-05-31 00:00:00,United States Navy - USN,Flight,Military / Government,Japan,Asia,14,14,14,0,0,14,0,Terrorism
1945-07-02 00:00:00,Royal Australian Air Force - RAAF,Flight,Military / Government,Indonesia,Asia,14,14,14,0,0,14,0,Terrorism
1945-07-13 00:00:00,Royal Canadian Air Force - RCAF,Flight,Military / Government,Canada,North America,14,7,7,7,7,14,0,Unknown
1945-07-23 00:00:00,United States Army Air Forces - USAAF,Flight,Military / Government,United Kingdom,Europe,14,5,5,9,9,14,0,Technical Failure
1945-08-30 00:00:00,Royal Air Force - RAF,Flight,Military / Government,France,Europe,14,4,4,10,10,14,0,Weather
1945-10-23 00:00:00,Royal Air Force - RAF,Flight,Military / Government,Bangladesh,Asia,14,2,2,12,12,14,0,Weather
1945-10-31 00:00:00,United States Navy - USN,Flight,Military / Government,United States of America,North America,14,14,14,0,0,14,0,Unknown
1945-12-03 00:00:00,United States Army Air Forces - USAAF,Flight,Military / Government,Argentina,South America,14,5,5,9,9,14,0,Unknown
1947-06-19 00:00:00,Pan American World Airways - PAA,Flight,Commercial,Syria,Asia,36,10,7,26,7,14,22,Technical Failure
1947-07-13 00:00:00,Burke Air Transport,Flight,Commercial,United States of America,North America,36,3,2,33,12,14,22,Technical Failure
1947-07-21 00:00:00,Argentinian Air Force - Fuerza Aérea Argentina,Takeoff (climb),Military / Government,Argentina,South America,19,4,3,15,11,14,5,Unknown
1947-09-19 00:00:00,United States Air Force - USAF,Landing (descent or approach),Military / Government,Peru,South America,14,5,5,9,9,14,0,Technical Failure
1948-03-15 00:00:00,Agencia Interamericana de Aviación - AIDA Colombia,Landing (descent or approach),Commercial,Colombia,South America,15,3,3,12,11,14,1,Human Factor
1948-04-05 00:00:00,British European Airways - BEA,Landing (descent or approach),Commercial,Germany,Europe,14,4,4,10,10,14,0,Human Factor
1948-07-01 00:00:00,Private Mexican,Flight,Commercial,Mexico,Central America,14,2,2,12,12,14,0,Weather
1949-01-02 00:00:00,Seattle Air Charter,Takeoff (climb),Commercial,United States of America,North America,30,3,3,27,11,14,16,Human Factor
1949-04-29 00:00:00,Aeroflot - Russian International Airlines,Flight,Commercial,Russia,Asia,24,6,3,18,11,14,10,Human Factor
1949-08-25 00:00:00,Aeroflot - Russian International Airlines,Flight,Commercial,Russia,Asia,14,5,5,9,9,14,0,Human Factor
1950-01-24 00:00:00,Société Aérienne Transatlantique - SAT,Landing (descent or approach),Commercial,Madagascar,Africa,14,3,3,11,11,14,0,Human Factor
1951-01-17 00:00:00,Linee Aeree Italiane - LAI,Landing (descent or approach),Commercial,Italy,Europe,17,5,4,12,10,14,3,Weather
1951-01-28 00:00:00,Royal Air Force - RAF,Flight,Military / Government,Taiwan,Asia,14,7,7,7,7,14,0,Human Factor
1951-01-31 00:00:00,Portuguese Air Force - Aeronáutica Militar,Landing (descent or approach),Military / Government,Portugal,Europe,14,3,3,11,11,14,0,Unknown
1951-06-29 00:00:00,JAT Yugoslav Airlines - Jugoslovenski Aerotransport,Flight,Commercial,Croatia,Europe,14,3,3,11,11,14,0,Weather
1951-09-13 00:00:00,United States Air Force - USAF,Landing (descent or approach),Military / Government,South Korea,Asia,14,14,14,0,0,14,0,Unknown
1951-09-19 00:00:00,United States Air Force - USAF,Flight,Military / Government,World,World,14,14,14,0,0,14,0,Technical Failure
1951-09-27 00:00:00,United States Air Force - USAF,Landing (descent or approach),Military / Government,Japan,Asia,14,14,14,0,0,14,0,Human Factor
1952-01-23 00:00:00,United States Air Force - USAF,Flight,Military / Government,North Korea,Asia,14,14,14,0,0,14,0,Technical Failure
1952-06-10 00:00:00,United States Air Force - USAF,Flight,Military / Government,North Korea,Asia,14,14,14,0,0,14,0,Terrorism
1952-08-08 00:00:00,United States Navy - USN,Landing (descent or approach),Military / Government,Japan,Asia,14,4,4,10,10,14,0,Human Factor
1952-10-08 00:00:00,Royal Air Force - RAF,Flight,Operational,United Kingdom,Europe,14,14,14,0,0,14,0,Unknown
1952-10-14 00:00:00,Aerovias Brasil,Flight,Commercial,Brazil,South America,18,4,4,14,10,14,4,Human Factor
1952-12-26 00:00:00,Hellenic Air Force - Elleniki Polemiki Aeroporia,Takeoff (climb),Military / Government,South Korea,Asia,14,5,5,9,9,14,0,Unknown
1953-11-10 00:00:00,United States Navy - USN,Flight,Military / Government,South Korea,Asia,14,10,10,4,4,14,0,Unknown
1954-04-13 00:00:00,Chilean Air Force - Fuerza Aérea de Chile,Takeoff (climb),Commercial,Chile,South America,14,5,5,9,9,14,0,Unknown
1954-06-27 00:00:00,United States Air Force - USAF,Flight,Military / Government,United States of America,North America,14,7,7,7,7,14,0,Human Factor
1955-03-06 00:00:00,United States Air Force - USAF,Flight,Military / Government,Taiwan,Asia,14,5,5,9,9,14,0,Human Factor
1955-11-17 00:00:00,United States Air Force - USAF,Flight,Military / Government,United States of America,North America,14,4,4,10,10,14,0,Human Factor
1956-05-15 00:00:00,Indian Airlines,Landing (descent or approach),Commercial,Nepal,Asia,33,3,3,30,11,14,19,Human Factor
1956-12-08 00:00:00,Agencia Interamericana de Aviación - AIDA Colombia,Flight,Commercial,Colombia,South America,16,5,4,11,10,14,2,Technical Failure
1957-01-11 00:00:00,Líneas Aéreas del Estado - LADE,Takeoff (climb),Military / Government,Argentina,South America,32,3,0,29,14,14,18,Human Factor
1957-06-23 00:00:00,Queen Charlotte Airlines,Landing (descent or approach),Commercial,Canada,North America,18,3,2,15,12,14,4,Technical Failure
1958-04-05 00:00:00,CAAC - Civil Aviation Administration of China,Flight,Commercial,China,Asia,14,5,5,9,9,14,0,Unknown
1958-09-05 00:00:00,Loide Aéreo Nacional,Landing (descent or approach),Commercial,Brazil,South America,18,4,2,14,12,14,4,Human Factor
1959-02-17 00:00:00,Turkish Airlines - THY Türk Hava Yollari,Landing (descent or approach),Military / Government,United Kingdom,Europe,24,8,5,16,9,14,10,Human Factor
1959-06-23 00:00:00,Avianca,Flight,Commercial,Peru,South America,14,4,4,10,10,14,0,Human Factor
1960-03-20 00:00:00,Republic of China Air Force,Landing (descent or approach),Military / Government,South Korea,Asia,14,3,3,11,11,14,0,Unknown
1960-06-14 00:00:00,Pacific Northern Airlines - PNA,Flight,Commercial,United States of America,North America,14,5,5,9,9,14,0,Human Factor
1960-12-04 00:00:00,Aeroflot - Russian International Airlines,Flight,Commercial,Russia,Asia,14,5,5,9,9,14,0,Technical Failure
1961-04-18 00:00:00,United States Air Force - USAF,Takeoff (climb),Military / Government,China,Asia,15,3,3,12,11,14,1,Unknown
1961-11-06 00:00:00,Republic of China Air Force,Flight,Military / Government,China,Asia,14,14,14,0,0,14,0,Terrorism
1961-12-29 00:00:00,Garuda Indonesian Airways,Landing (descent or approach),Commercial,Indonesia,Asia,14,3,3,11,11,14,0,Unknown
1962-01-08 00:00:00,Republic of China Air Force,Flight,Military / Government,World,World,14,14,14,0,0,14,0,Unknown
1963-01-30 00:00:00,United States Navy - USN,Flight,Operational,World,World,14,4,4,10,10,14,0,Unknown
1963-02-01 00:00:00,Middle East Airlines - MEA,Landing (descent or approach),Commercial,Turkey,Asia,14,3,3,11,11,14,0,Human Factor
1963-06-19 00:00:00,Republic of China Air Force,Flight,Military / Government,China,Asia,14,14,14,0,0,14,0,Terrorism
1965-08-28 00:00:00,United States Air Force - USAF,Landing (descent or approach),Military / Government,Colombia,South America,14,2,2,12,12,14,0,Unknown
1966-10-04 00:00:00,United States Army,Landing (descent or approach),Military / Government,Vietnam,Asia,32,4,4,28,10,14,18,Human Factor
1967-10-20 00:00:00,Aeroflot - Russian International Airlines,Takeoff (climb),Commercial,Russia,Asia,20,2,2,18,12,14,6,Human Factor
1967-12-14 00:00:00,United States Air Force - USAF,Flight,Military / Government,United States of America,North America,14,14,14,0,0,14,0,Human Factor
1968-01-04 00:00:00,Aeroflot - Russian International Airlines,Flight,Commercial,Russia,Asia,14,2,2,12,12,14,0,Human Factor
1968-03-08 00:00:00,Air Manila International,Flight,Commercial,Philippines,Asia,14,4,4,10,10,14,0,Weather
1968-07-21 00:00:00,Aeroflot - Russian International Airlines,Flight,Commercial,Kyrgyzstan,Asia,14,2,2,12,12,14,0,Human Factor
1968-08-03 00:00:00,Aeroflot - Russian International Airlines,Landing (descent or approach),Commercial,Russia,Asia,14,2,2,12,12,14,0,Human Factor
1969-07-06 00:00:00,Air South,Flight,Commercial,United States of America,North America,14,2,2,12,12,14,0,Technical Failure
1969-08-26 00:00:00,Aeroflot - Russian International Airlines,Flight,Commercial,Russia,Asia,14,3,3,11,11,14,0,Human Factor
1969-11-19 00:00:00,Mohawk Airlines,Landing (descent or approach),Commercial,United States of America,North America,14,3,3,11,11,14,0,Human Factor
1970-02-12 00:00:00,Lineas Aéreas La Urraca,Flight,Commercial,Colombia,South America,14,4,4,10,10,14,0,Technical Failure
1970-08-12 00:00:00,China Airlines,Landing (descent or approach),Commercial,Taiwan,Asia,31,5,2,26,12,14,17,Weather
1971-01-22 00:00:00,Aeroflot - Russian International Airlines,Landing (descent or approach),Operational,Russia,Asia,14,12,12,2,2,14,0,Weather
1971-09-22 00:00:00,Aeroflot - Russian International Airlines,Flight,Commercial,Russia,Asia,14,2,2,12,12,14,0,Human Factor
1972-03-28 00:00:00,United States Air Force - USAF,Flight,Military / Government,Laos,Asia,14,14,14,0,0,14,0,Terrorism
1972-06-03 00:00:00,United States Navy - USN,Flight,Military / Government,Morocco,Africa,14,4,4,10,10,14,0,Unknown
1972-08-11 00:00:00,Aeroflot - Russian International Airlines,Landing (descent or approach),Commercial,Ukraine,Europe,19,2,2,17,12,14,5,Other
1972-12-21 00:00:00,United States Air Force - USAF,Flight,Military / Government,Laos,Asia,16,4,4,12,10,14,2,Terrorism
1973-03-08 00:00:00,United States Army,Flight,Operational,United States of America,North America,14,3,3,11,11,14,0,Other
1974-11-01 00:00:00,Aeroflot - Russian International Airlines,Landing (descent or approach),Commercial,Russia,Asia,14,2,2,12,12,14,0,Human Factor
1977-05-07 00:00:00,Aeroflot - Russian International Airlines,Flight,Commercial,Russia,Asia,14,2,2,12,12,14,0,Human Factor
1978-08-26 00:00:00,Burma Airways,Takeoff (climb),Commercial,Myanmar,Asia,14,2,2,12,12,14,0,Other
1978-10-27 00:00:00,Aeroflot - Russian International Airlines,Landing (descent or approach),Commercial,Russia,Asia,16,2,1,14,13,14,2,Human Factor
1979-01-24 00:00:00,Air Algérie,Landing (descent or approach),Commercial,Algeria,Africa,23,3,0,20,14,14,9,Human Factor
1979-10-07 00:00:00,Swissair,Landing (descent or approach),Commercial,Greece,Europe,154,10,0,144,14,14,140,Human Factor
1980-11-18 00:00:00,Korean Air,Landing (descent or approach),Commercial,South Korea,Asia,226,13,6,213,8,14,212,Human Factor
1981-04-28 00:00:00,Airfast Indonesia,Landing (descent or approach),Commercial,Indonesia,Asia,17,4,4,13,10,14,3,Technical Failure
1982-05-03 00:00:00,Algerian Government,Flight,Military / Government,Iran,Asia,14,4,4,10,10,14,0,Terrorism
1982-10-17 00:00:00,M. H. Yarter,Takeoff (climb),Humanitarian,United States of America,North America,14,1,1,13,13,14,0,Human Factor
1982-11-01 00:00:00,Aeroflot - Russian International Airlines,Flight,Humanitarian,Russia,Asia,14,2,2,12,12,14,0,Human Factor
1983-04-30 00:00:00,United States Navy - USN,Landing (descent or approach),Military / Government,United States of America,North America,15,6,6,9,8,14,1,Technical Failure
1983-06-16 00:00:00,United States Navy - USN,Flight,Operational,United States of America,North America,14,4,4,10,10,14,0,Human Factor
1984-11-20 00:00:00,Transportes Aéreos Mercantiles Ecuatorianos - TAME,Takeoff (climb),Commercial,Ecuador,South America,14,2,2,12,12,14,0,Unknown
1985-07-11 00:00:00,Soviet Air Force - Voyenno-vozdushnye sily CCCP,Takeoff (climb),Military / Government,Afghanistan,Asia,14,6,6,8,8,14,0,Terrorism
1985-09-23 00:00:00,Henson Airlines,Landing (descent or approach),Commercial,United States of America,North America,14,2,2,12,12,14,0,Human Factor
1985-10-11 00:00:00,Aeroflot - Russian International Airlines,Flight,Commercial,Georgia,Asia,14,4,4,10,10,14,0,Human Factor
1986-10-14 00:00:00,Aeroflot - Russian International Airlines,Takeoff (climb),Commercial,Russia,Asia,14,2,2,12,12,14,0,Human Factor
1987-02-06 00:00:00,Talair,Landing (descent or approach),Commercial,Papua New Guinea,Oceania,17,2,2,15,12,14,3,Weather
1987-05-06 00:00:00,SASCO Air Lines,Takeoff (climb),Commercial,South Sudan,Africa,14,2,2,12,12,14,0,Terrorism
1987-05-20 00:00:00,Yacimientos Petroliferos Fiscales Bolivianos - YPFB,Landing (descent or approach),Commercial,Bolivia,South America,16,3,3,13,11,14,2,Weather
1987-12-03 00:00:00,Cooper Skybird Aircharters,Flight,Commercial,Rwanda,Africa,14,2,2,12,12,14,0,Unknown
1988-08-31 00:00:00,Delta Airlines,Takeoff (climb),Commercial,United States of America,North America,108,7,2,101,12,14,94,Human Factor
1988-11-30 00:00:00,Aero Club Libya,Landing (descent or approach),Commercial,Libya,Africa,14,2,2,12,12,14,0,Human Factor
1991-01-31 00:00:00,United States Air Force - USAF,Flight,Military / Government,Saudi Arabia,Asia,14,14,14,0,0,14,0,Terrorism
1991-03-21 00:00:00,United States Navy - USN,Flight,Military / Government,World,World,14,14,14,0,0,14,0,Human Factor
1991-09-03 00:00:00,Airtech Rajawali Udara,Flight,Commercial,Malaysia,Asia,20,2,2,18,12,14,6,Technical Failure
1991-09-11 00:00:00,Continental Express,Flight,Commercial,United States of America,North America,14,3,3,11,11,14,0,Human Factor
1992-08-27 00:00:00,Salvadorian Air Force - Fuerza Aérea Salvadoreña,Flight,Humanitarian,Salvador,Central America,14,4,4,10,10,14,0,Technical Failure
1992-10-08 00:00:00,Wuhan Airlines - Air Wuhan,Flight,Commercial,China,Asia,35,7,5,28,9,14,21,Technical Failure
1992-10-30 00:00:00,Yuri Petrov Airlines,Landing (descent or approach),Operational,Russia,Asia,14,5,5,9,9,14,0,Technical Failure
1993-01-31 00:00:00,Pan Malaysian Air Transport,Flight,Commercial,Indonesia,Asia,14,3,3,11,11,14,0,Human Factor
1995-01-10 00:00:00,Merpati Nusantara Airlines - MNA,Flight,Commercial,Indonesia,Asia,14,4,4,10,10,14,0,Weather
1996-01-18 00:00:00,Federal Government of Nigeria,Landing (descent or approach),Military / Government,Nigeria,Africa,14,4,4,10,10,14,0,Human Factor
1996-11-01 00:00:00,Transportes Aéreos Profesionales Guatemalteca,Landing (descent or approach),Commercial,Guatemala,Central America,14,2,2,12,12,14,0,Unknown
1996-11-14 00:00:00,Komi Avia,Flight,Commercial,Russia,Asia,15,2,1,13,13,14,1,Human Factor
1996-11-30 00:00:00,ACES Colombia - Aerolineas Centrales de Colombia,Takeoff (climb),Commercial,Colombia,South America,15,2,2,13,12,14,1,Human Factor
1997-04-16 00:00:00,Niger Air Force - Forces aériennes nigériennes,Landing (descent or approach),Military / Government,Niger,Africa,14,4,4,10,10,14,0,Technical Failure
1998-07-30 00:00:00,Proteus Airlines,Flight,Commercial,France,Europe,14,2,2,12,12,14,0,Human Factor
1998-12-26 00:00:00,Transafrik,Takeoff (climb),Humanitarian,Angola,Africa,14,4,4,10,10,14,0,Terrorism
1999-02-02 00:00:00,Savanair,Landing (descent or approach),Operational,Angola,Africa,14,4,4,10,10,14,0,Technical Failure
2000-07-02 00:00:00,Philippine Air Force - Hukbong Himpapawid NG Pilipinas,Landing (descent or approach),Military / Government,Philippines,Asia,15,4,4,11,10,14,1,Technical Failure
2000-08-06 00:00:00,Chilean Air Force - Fuerza Aérea de Chile,Flight,Military / Government,Chile,South America,14,4,4,10,10,14,0,Weather
2001-04-04 00:00:00,Sudanese Air Force - Al Quwwat al-Jawwiya As-Sudaniya,Takeoff (climb),Military / Government,South Sudan,Africa,30,4,0,26,14,14,16,Weather
2002-05-07 00:00:00,Egyptair,Landing (descent or approach),Commercial,Tunisia,Africa,63,8,3,55,11,14,49,Human Factor
2002-07-28 00:00:00,Pulkovo Aviation Enterprise,Takeoff (climb),Operational,Russia,Asia,16,16,14,0,0,14,2,Technical Failure
2003-07-19 00:00:00,Ryan Blake Air Charter,Flight,Commercial,Kenya,Africa,14,2,2,12,12,14,0,Human Factor
2006-04-10 00:00:00,Kenya Air Force,Landing (descent or approach),Military / Government,Kenya,Africa,17,2,2,15,12,14,3,Human Factor
2006-09-02 00:00:00,Royal Air Force - RAF,Flight,Military / Government,Afghanistan,Asia,14,14,14,0,0,14,0,Technical Failure
2007-08-26 00:00:00,Great Lakes Business Company,Landing (descent or approach),Operational,Democratic Republic of Congo,Africa,15,3,3,12,11,14,1,Technical Failure
2008-01-04 00:00:00,Transaven - Transporte Aéreo Venezuela,Flight,Commercial,Venezuela,South America,14,2,2,12,12,14,0,Technical Failure
2009-03-22 00:00:00,Eagle Cap Leasing,Landing (descent or approach),Business,United States of America,North America,14,1,1,13,13,14,0,Human Factor
2009-05-22 00:00:00,Santa Coloma Investimento e Participações,Landing (descent or approach),Business,Brazil,South America,14,2,2,12,12,14,0,Human Factor
2010-08-24 00:00:00,Agni Air,Landing (descent or approach),Commercial,Nepal,Asia,14,2,2,12,12,14,0,Technical Failure
2011-02-14 00:00:00,Central American Airways,Flight,Commercial,Honduras,Central America,14,2,2,12,12,14,0,Human Factor
2013-10-14 00:00:00,Aeroservicio Guerrero,Flight,Commercial,Mexico,Central America,14,1,1,13,13,14,0,Human Factor
2019-03-09 00:00:00,Laser Aéreo,Flight,Commercial,Colombia,South America,14,3,3,11,11,14,0,Technical Failure
2022-02-26 00:00:00,AB Aviation,Flight,Commercial,Comoros Islands,Africa,14,2,2,12,12,14,0,Unknown
1935-07-20 00:00:00,KLM Royal Dutch Airlines - Koninklijke Luchtvaart Maatschappij,Flight,Commercial,Switzerland,Europe,13,4,4,9,9,13,0,Weather
1936-01-14 00:00:00,Colombian Air Force - Fuerza Aérea Colombiana,Landing (descent or approach),Military / Government,Colombia,South America,19,3,3,16,10,13,6,Technical Failure
1936-01-17 00:00:00,Lloyd Aéreo Boliviano - LAB Airlines,Flight,Commercial,Bolivia,South America,13,3,3,10,10,13,0,Unknown
1937-03-25 00:00:00,Transcontinental %26 Western Air - TWA,Landing (descent or approach),Commercial,United States of America,North America,13,3,3,10,10,13,0,Weather
1938-10-01 00:00:00,Deutsche Lufthansa,Flight,Commercial,Italy,Europe,13,3,3,10,10,13,0,Human Factor
1941-06-27 00:00:00,German Air Force - Deutsche Luftwaffe,Flight,Military / Government,Norway,Europe,14,4,3,10,10,13,1,Weather
1941-10-28 00:00:00,Deutsche Lufthansa,Flight,Commercial,Bulgaria,Europe,13,3,3,10,10,13,0,Unknown
1942-01-30 00:00:00,British Overseas Airways Corporation - BOAC,Landing (descent or approach),Commercial,Indonesia,Asia,18,4,2,14,11,13,5,Terrorism
1942-03-14 00:00:00,China National Aviation Corporation - CNAC,Takeoff (climb),Commercial,China,Asia,17,3,3,14,10,13,4,Other
1942-07-20 00:00:00,Royal Air Force - RAF,Flight,Military / Government,United Kingdom,Europe,13,3,3,10,10,13,0,Weather
1942-07-25 00:00:00,Royal Air Force - RAF,Flight,Military / Government,World,World,13,13,13,0,0,13,0,Unknown
1942-08-22 00:00:00,KLM Royal Dutch Airlines - Koninklijke Luchtvaart Maatschappij,Takeoff (climb),Commercial,Trinidad and Tobago,Central America,13,3,3,10,10,13,0,Unknown
1942-10-22 00:00:00,Royal Air Force - RAF,Takeoff (climb),Military / Government,Egypt,Africa,13,3,3,10,10,13,0,Human Factor
1942-12-20 00:00:00,Canadian Pacific Airlines - CP Air,Flight,Commercial,Canada,North America,13,3,3,10,10,13,0,Technical Failure
1943-01-09 00:00:00,British Overseas Airways Corporation - BOAC,Landing (descent or approach),Commercial,Portugal,Europe,15,6,5,9,8,13,2,Technical Failure
1943-04-22 00:00:00,Qantas Airways - Queensland and Northern Territory Aerial Services,Landing (descent or approach),Commercial,Papua New Guinea,Oceania,31,4,2,27,11,13,18,Human Factor
1943-06-25 00:00:00,United States Navy - USN,Flight,Operational,United States of America,North America,13,13,13,0,0,13,0,Unknown
1943-07-19 00:00:00,United States Army Air Forces - USAAF,Flight,Military / Government,United States of America,North America,13,13,13,0,0,13,0,Weather
1943-09-07 00:00:00,Royal Australian Air Force - RAAF,Landing (descent or approach),Military / Government,Australia,Oceania,19,10,7,9,6,13,6,Unknown
1943-10-22 00:00:00,Aktiebolaget Aerotransport - ABA,Flight,Commercial,Sweden,Europe,15,3,3,12,10,13,2,Terrorism
1943-11-21 00:00:00,United States Army Air Forces - USAAF,Flight,Military / Government,Australia,Oceania,13,4,4,9,9,13,0,Weather
1943-12-29 00:00:00,United States Army Air Forces - USAAF,Flight,Operational,United States of America,North America,13,13,13,0,0,13,0,Human Factor
1944-01-29 00:00:00,United States Army Air Forces - USAAF,Flight,Military / Government,United Kingdom,Europe,13,13,13,0,0,13,0,Human Factor
1944-02-23 00:00:00,DETA Mozambique Airlines - Direcção de Exploração dos Transportes Aéreos,Takeoff (climb),Commercial,Mozambique,Africa,13,4,4,9,9,13,0,Unknown
1944-12-28 00:00:00,Royal Air Force - RAF,Parking,Military / Government,United Kingdom,Europe,0,0,13,0,0,13,-13,Terrorism
1945-02-23 00:00:00,United States Army Air Forces - USAAF,Takeoff (climb),Military / Government,Morocco,Africa,30,4,0,26,13,13,17,Unknown
1945-03-09 00:00:00,United States Navy - USN,Flight,Specialised Services,Japan,Asia,15,15,13,0,0,13,2,Terrorism
1945-03-31 00:00:00,United States Army Air Forces - USAAF,Flight,Military / Government,United Kingdom,Europe,14,14,13,0,0,13,1,Unknown
1945-04-19 00:00:00,United States Navy - USN,Takeoff (climb),Military / Government,Australia,Oceania,13,2,2,11,11,13,0,Weather
1945-06-27 00:00:00,Royal Air Force - RAF,Flight,Military / Government,Bangladesh,Asia,13,5,5,8,8,13,0,Weather
1945-07-14 00:00:00,United States Army Air Forces - USAAF,Takeoff (climb),Operational,United States of America,North America,14,14,13,0,0,13,1,Unknown
1945-07-25 00:00:00,United States Army Air Forces - USAAF,Flight,Operational,United States of America,North America,13,13,13,0,0,13,0,Weather
1945-08-01 00:00:00,United States Army Air Forces - USAAF,Flight,Military / Government,World,World,25,5,1,20,12,13,12,Technical Failure
1945-08-28 00:00:00,United States Army Air Forces - USAAF,Takeoff (climb),Specialised Services,Japan,Asia,13,13,13,0,0,13,0,Technical Failure
1945-09-05 00:00:00,United States Navy - USN,Flight,Operational,United States of America,North America,13,13,13,0,0,13,0,Human Factor
1945-10-20 00:00:00,China National Aviation Corporation - CNAC,Flight,Commercial,China,Asia,13,6,6,7,7,13,0,Unknown
1945-12-05 00:00:00,United States Navy - USN,Flight,Military / Government,World,World,13,13,13,0,0,13,0,Human Factor
1946-03-27 00:00:00,Royal Air Force - RAF,Takeoff (climb),Military / Government,Singapore,Asia,21,4,2,17,11,13,8,Human Factor
1946-05-10 00:00:00,United States Navy - USN,Flight,Operational,United States of America,North America,13,13,13,0,0,13,0,Human Factor
1946-05-22 00:00:00,Det Norske Luftfartselskap - DNL,Takeoff (climb),Commercial,Norway,Europe,14,3,3,11,10,13,1,Technical Failure
1946-07-13 00:00:00,Central Air Transport - China,Takeoff (climb),Commercial,China,Asia,49,6,2,43,11,13,36,Technical Failure
1946-07-18 00:00:00,United States Army Air Forces - USAAF,Flight,Military / Government,United States of America,North America,13,3,3,10,10,13,0,Weather
1946-10-17 00:00:00,National Air Transport Service - NATS,Landing (descent or approach),Commercial,United States of America,North America,13,3,3,10,10,13,0,Human Factor
1946-11-05 00:00:00,Aeroflot - Russian International Airlines,Landing (descent or approach),Commercial,Russia,Asia,26,4,0,22,13,13,13,Weather
1947-03-08 00:00:00,Royal Air Force - RAF,Flight,Military / Government,Italy,Europe,13,3,3,10,10,13,0,Human Factor
1947-07-01 00:00:00,Air France,Flight,Commercial,Cameroon,Africa,13,3,3,10,10,13,0,Human Factor
1947-07-01 00:00:00,Air France,Flight,Commercial,Cameroon,Africa,13,3,3,10,10,13,0,Human Factor
1947-11-21 00:00:00,TARS - Transporturile Aeriene Româno-Sovietice,Flight,Commercial,Czech Republic,Europe,26,5,5,21,8,13,13,Human Factor
1947-11-27 00:00:00,Columbia Air Cargo,Landing (descent or approach),Commercial,United States of America,North America,13,2,2,11,11,13,0,Human Factor
1947-11-28 00:00:00,GLAM - Groupe de Liaisons Aériennes Ministérielles,Flight,Military / Government,Algeria,Africa,13,4,4,9,9,13,0,Human Factor
1948-05-15 00:00:00,Mercury Aviation,Flight,Commercial,South Africa,Africa,13,5,5,8,8,13,0,Human Factor
1948-08-12 00:00:00,United States Air Force - USAF,Takeoff (climb),Military / Government,United States of America,North America,21,4,4,17,9,13,8,Unknown
1948-08-31 00:00:00,SABENA - Société Anonyme Belge d'Exploitation de la Navigation Aérienne,Landing (descent or approach),Commercial,Democratic Republic of Congo,Africa,13,4,4,9,9,13,0,Unknown
1948-09-02 00:00:00,Australian National Airways - ANA,Flight,Commercial,Australia,Oceania,13,3,3,10,10,13,0,Human Factor
1948-09-06 00:00:00,Royal Norwegian Air Force - Kongelige Norske Luftforsvaret,Flight,Military / Government,Norway,Europe,15,9,9,6,4,13,2,Human Factor
1948-10-23 00:00:00,New Zealand National Airways,Flight,Commercial,New Zealand,Oceania,13,3,3,10,10,13,0,Weather
1948-11-03 00:00:00,United States Air Force - USAF,Flight,Military / Government,United Kingdom,Europe,13,13,13,0,0,13,0,Human Factor
1948-12-31 00:00:00,Pan African Air Charter,Flight,Commercial,Italy,Europe,13,5,5,8,8,13,0,Human Factor
1949-01-16 00:00:00,Dalmia Jain Airways,Flight,Commercial,India,Asia,13,4,4,9,9,13,0,Human Factor
1949-05-05 00:00:00,Philippine Airlines - PAL,Flight,Commercial,Philippines,Asia,13,3,3,10,10,13,0,Terrorism
1949-07-21 00:00:00,Aeroflot - Russian International Airlines,Flight,Commercial,Russia,Asia,14,6,5,8,8,13,1,Technical Failure
1950-04-11 00:00:00,United States Air Force - USAF,Takeoff (climb),Operational,United States of America,North America,13,13,13,0,0,13,0,Unknown
1950-05-30 00:00:00,Aerovias Brasil,Flight,Commercial,Brazil,South America,15,4,4,11,9,13,2,Weather
1951-04-27 00:00:00,United States Air Force - USAF,Flight,Operational,United States of America,North America,17,17,13,0,0,13,4,Human Factor
1951-11-27 00:00:00,Lineas Aéreas Unidas,Takeoff (climb),Commercial,Mexico,Central America,21,3,2,18,11,13,8,Other
1952-01-31 00:00:00,United States Air Force - USAF,Flight,Military / Government,World,World,13,13,13,0,0,13,0,Unknown
1952-02-07 00:00:00,United States Air Force - USAF,Takeoff (climb),Military / Government,Japan,Asia,13,13,13,0,0,13,0,Unknown
1952-07-11 00:00:00,Brazilian Air Force - Força Aérea Brasileira,Flight,Military / Government,Brazil,South America,33,5,1,28,12,13,20,Technical Failure
1952-07-22 00:00:00,United States Air Force - USAF,Flight,Military / Government,South Korea,Asia,13,13,13,0,0,13,0,Technical Failure
1952-08-07 00:00:00,United States Navy - USN,Flight,Military / Government,Philippines,Asia,13,13,13,0,0,13,0,Technical Failure
1952-10-22 00:00:00,Orient Airways,Flight,Commercial,India,Asia,13,3,3,10,10,13,0,Technical Failure
1952-11-17 00:00:00,Chinese Air Force - AFPLA - Chung-Kuo Shan Min Taie Fang Tsun Pu-Tai,Takeoff (climb),Military / Government,North Korea,Asia,20,4,4,16,9,13,7,Unknown
1952-12-01 00:00:00,United States Air Force - USAF,Flight,Military / Government,United States of America,North America,13,3,3,10,10,13,0,Human Factor
1952-12-22 00:00:00,Hellenic Air Force - Elleniki Polemiki Aeroporia,Taxiing,Humanitarian,South Korea,Asia,13,5,5,8,8,13,0,Human Factor
1953-01-16 00:00:00,United States Air Force - USAF,Landing (descent or approach),Military / Government,Canada,North America,14,3,3,11,10,13,1,Human Factor
1953-03-29 00:00:00,Central African Airways - CAA,Flight,Commercial,Tanzania,Africa,13,5,5,8,8,13,0,Human Factor
1953-04-10 00:00:00,Caribbean International Airways,Takeoff (climb),Commercial,Jamaica,Central America,14,3,3,11,10,13,1,Technical Failure
1953-07-07 00:00:00,United States Air Force - USAF,Landing (descent or approach),Military / Government,South Korea,Asia,13,13,13,0,0,13,0,Unknown
1953-11-12 00:00:00,Líneas Aéreas del Estado - LADE,Landing (descent or approach),Military / Government,Argentina,South America,13,5,5,8,8,13,0,Human Factor
1953-12-12 00:00:00,Indian Airlines,Takeoff (climb),Commercial,India,Asia,14,4,3,10,10,13,1,Technical Failure
1954-01-12 00:00:00,CSA Czech Airlines - Československé Státní Aerolinie,Takeoff (climb),Commercial,Czech Republic,Europe,18,4,4,14,9,13,5,Human Factor
1954-10-06 00:00:00,United States Air Force - USAF,Flight,Operational,United States of America,North America,17,17,13,0,0,13,4,Unknown
1955-01-12 00:00:00,Trans World Airlines - TWA,Takeoff (climb),Commercial,United States of America,North America,13,3,3,10,10,13,0,Human Factor
1955-01-17 00:00:00,United States Navy - USN,Flight,Military / Government,Canada,North America,13,6,6,7,7,13,0,Technical Failure
1955-02-05 00:00:00,West African Airways Corporation,Flight,Commercial,Nigeria,Africa,13,3,3,10,10,13,0,Technical Failure
1955-03-20 00:00:00,American Airlines,Landing (descent or approach),Commercial,United States of America,North America,35,3,2,32,11,13,22,Human Factor
1955-08-26 00:00:00,Cruzeiro do Sul,Flight,Commercial,Brazil,South America,13,4,4,9,9,13,0,Human Factor
1958-09-09 00:00:00,United States Air Force - USAF,Takeoff (climb),Military / Government,United States of America,North America,20,2,2,18,11,13,7,Technical Failure
1960-04-28 00:00:00,Linea Aeropostal Venezolana - LAV,Landing (descent or approach),Commercial,Venezuela,South America,13,3,3,10,10,13,0,Terrorism
1961-05-29 00:00:00,Royal Air Force - RAF,Flight,Operational,Singapore,Asia,13,5,5,8,8,13,0,Technical Failure
1962-01-27 00:00:00,Aeroflot - Russian International Airlines,Takeoff (climb),Operational,Russia,Asia,14,14,13,0,0,13,1,Technical Failure
1962-05-17 00:00:00,United States Air Force - USAF,Landing (descent or approach),Military / Government,Kenya,Africa,13,6,6,7,7,13,0,Weather
1962-09-04 00:00:00,Ashland Oil %26 Refining Company,Flight,Business,United States of America,North America,13,2,2,11,11,13,0,Technical Failure
1962-10-10 00:00:00,CSA Czech Airlines - Československé Státní Aerolinie,Landing (descent or approach),Commercial,Czech Republic,Europe,42,4,3,38,10,13,29,Human Factor
1962-12-26 00:00:00,United States Navy - USN,Flight,Military / Government,World,World,13,13,13,0,0,13,0,Unknown
1963-01-31 00:00:00,Aeroflot - Russian International Airlines,Flight,Commercial,Armenia,Asia,13,2,2,11,11,13,0,Unknown
1963-08-08 00:00:00,South African Air Force,Flight,Operational,South Africa,Africa,13,13,13,0,0,13,0,Weather
1963-08-10 00:00:00,Royal Danish Air Force - Flyvevåbnet,Flight,Military / Government,Greenland,Europe,13,6,6,7,7,13,0,Human Factor
1964-02-18 00:00:00,Indian Air Force - Bharatiya Vayu Sena,Flight,Military / Government,India,Asia,13,3,3,10,10,13,0,Unknown
1964-06-11 00:00:00,Republic of China Air Force,Flight,Military / Government,China,Asia,13,13,13,0,0,13,0,Unknown
1964-12-04 00:00:00,United States Navy - USN,Flight,Military / Government,Philippines,Asia,13,4,4,9,9,13,0,Technical Failure
1965-08-12 00:00:00,Paraense Transportes Aéreos,Flight,Commercial,Brazil,South America,13,4,4,9,9,13,0,Technical Failure
1965-10-18 00:00:00,International Commission for Supervision and Control,Landing (descent or approach),Commercial,Vietnam,Asia,13,4,4,9,9,13,0,Terrorism
1965-11-27 00:00:00,Edde Airlines,Flight,Commercial,United States of America,North America,13,4,4,9,9,13,0,Human Factor
1966-07-04 00:00:00,TAM Bolivia - Transporte Aéreo Militar Boliviano,Flight,Military / Government,Bolivia,South America,13,3,3,10,10,13,0,Unknown
1967-03-13 00:00:00,French Navy,Flight,Military / Government,France,Europe,13,13,13,0,0,13,0,Unknown
1967-12-21 00:00:00,Royal Air Force - RAF,Flight,Operational,United Kingdom,Europe,13,11,11,2,2,13,0,Weather
1968-01-17 00:00:00,United States Air Force - USAF,Takeoff (climb),Military / Government,United States of America,North America,13,5,5,8,8,13,0,Human Factor
1968-08-02 00:00:00,Alitalia - Linee Aeree Italiane,Landing (descent or approach),Commercial,Italy,Europe,95,10,0,85,13,13,82,Human Factor
1968-10-03 00:00:00,United States Air Force - USAF,Takeoff (climb),Military / Government,Vietnam,Asia,13,4,4,9,9,13,0,Human Factor
1969-02-05 00:00:00,United States Air Force - USAF,Flight,Military / Government,Philippines,Asia,14,4,4,10,9,13,1,Human Factor
1969-08-19 00:00:00,Air America,Takeoff (climb),Commercial,Laos,Asia,13,1,1,12,12,13,0,Terrorism
1970-05-04 00:00:00,United States Air Force - USAF,Takeoff (climb),Military / Government,United States of America,North America,14,3,3,11,10,13,1,Unknown
1970-06-01 00:00:00,CSA Czech Airlines - Československé Státní Aerolinie,Landing (descent or approach),Commercial,Libya,Africa,13,10,10,3,3,13,0,Human Factor
1971-01-25 00:00:00,Linea Aeropostal Venezolana - LAV,Takeoff (climb),Commercial,Venezuela,South America,47,4,1,43,12,13,34,Unknown
1972-12-21 00:00:00,Air Guadeloupe,Landing (descent or approach),Commercial,Netherlands,Central America,13,2,2,11,11,13,0,Unknown
1973-02-06 00:00:00,Aeroflot - Russian International Airlines,Flight,Commercial,Kazakhstan,Asia,13,2,2,11,11,13,0,Human Factor
1973-02-28 00:00:00,Merpati Nusantara Airlines - MNA,Flight,Commercial,Indonesia,Asia,13,2,2,11,11,13,0,Unknown
1974-12-04 00:00:00,Aeroflot - Russian International Airlines,Takeoff (climb),Commercial,Russia,Asia,13,2,2,11,11,13,0,Human Factor
1975-01-05 00:00:00,Argentinian Air Force - Fuerza Aérea Argentina,Flight,Military / Government,Argentina,South America,13,3,3,10,10,13,0,Terrorism
1975-03-17 00:00:00,Aeroflot - Russian International Airlines,Takeoff (climb),Commercial,Russia,Asia,15,3,2,12,11,13,2,Human Factor
1975-04-15 00:00:00,Aeroflot - Russian International Airlines,Takeoff (climb),Commercial,Russia,Asia,14,2,1,12,12,13,1,Human Factor
1976-01-15 00:00:00,Taxi Aéreo El Venado,Flight,Commercial,Colombia,South America,13,3,3,10,10,13,0,Human Factor
1976-05-23 00:00:00,Philippine Airlines - PAL,Parking,Commercial,Philippines,Asia,87,5,0,82,13,13,74,Terrorism
1977-03-29 00:00:00,Merpati Nusantara Airlines - MNA,Flight,Commercial,Indonesia,Asia,23,3,2,20,11,13,10,Human Factor
1977-09-06 00:00:00,Alaska Aeronautical Industries,Flight,Commercial,United States of America,North America,13,2,2,11,11,13,0,Human Factor
1977-11-03 00:00:00,Servicios Aéreos Martinez Leon,Landing (descent or approach),Commercial,Mexico,Central America,13,2,2,11,11,13,0,Other
1977-12-11 00:00:00,United States Navy - USN,Flight,Military / Government,Spain,Europe,13,4,4,9,9,13,0,Human Factor
1978-05-17 00:00:00,Japan Maritime Self-Defense Force - Kaijō Jieitai,Flight,Military / Government,Japan,Asia,13,13,13,0,0,13,0,Unknown
1978-09-01 00:00:00,Aeroflot - Russian International Airlines,Flight,Commercial,Russia,Asia,13,2,2,11,11,13,0,Weather
1979-01-15 00:00:00,Aeroflot - Russian International Airlines,Landing (descent or approach),Commercial,Belarus,Europe,14,5,5,9,8,13,1,Human Factor
1980-01-23 00:00:00,Pelita Air Service,Flight,Commercial,Indonesia,Asia,13,3,3,10,10,13,0,Human Factor
1980-02-21 00:00:00,Advance Airlines,Landing (descent or approach),Commercial,Australia,Oceania,13,1,1,12,12,13,0,Technical Failure
1980-06-02 00:00:00,Lloyd Aéreo Boliviano - LAB Airlines,Landing (descent or approach),Commercial,Bolivia,South America,13,3,3,10,10,13,0,Unknown
1980-06-12 00:00:00,Air Wisconsin,Flight,Commercial,United States of America,North America,15,2,2,13,11,13,2,Technical Failure
1980-07-07 00:00:00,Mexican Government,Takeoff (climb),Humanitarian,Mexico,Central America,13,2,2,11,11,13,0,Unknown
1980-11-12 00:00:00,United States Air Force - USAF,Landing (descent or approach),Military / Government,Egypt,Africa,13,6,6,7,7,13,0,Unknown
1981-04-17 00:00:00,Air US,Flight,Commercial,United States of America,North America,13,2,2,11,11,13,0,Human Factor
1981-12-18 00:00:00,ACES Colombia - Aerolineas Centrales de Colombia,Landing (descent or approach),Commercial,Colombia,South America,13,2,2,11,11,13,0,Human Factor
1983-11-18 00:00:00,Enrique Elías Miller,Landing (descent or approach),Business,Mexico,Central America,13,2,2,11,11,13,0,Technical Failure
1984-01-02 00:00:00,Royal Jordanian Air Force,Flight,Military / Government,Jordan,Asia,13,2,2,11,11,13,0,Unknown
1984-12-06 00:00:00,Provincetown-Boston Airline - PBA,Takeoff (climb),Commercial,United States of America,North America,13,2,2,11,11,13,0,Technical Failure
1986-02-16 00:00:00,China Airlines,Landing (descent or approach),Commercial,Taiwan,Asia,13,7,7,6,6,13,0,Unknown
1986-04-27 00:00:00,ACES Colombia - Aerolineas Centrales de Colombia,Flight,Commercial,Colombia,South America,13,2,2,11,11,13,0,Human Factor
1986-05-24 00:00:00,Malagasy Air Force - Armée de l'Air Malgache,Landing (descent or approach),Military / Government,Madagascar,Africa,13,3,3,10,10,13,0,Unknown
1986-08-04 00:00:00,LIAT - The Caribbean Airline,Landing (descent or approach),Commercial,Saint Vincent and Grenadines,Central America,13,2,2,11,11,13,0,Unknown
1986-10-03 00:00:00,Eastindo - East Indonesia Air Taxi %26 Charter Service,Landing (descent or approach),Commercial,Indonesia,Asia,13,3,3,10,10,13,0,Human Factor
1986-10-23 00:00:00,Pakistan International Airlines - PIA,Landing (descent or approach),Commercial,Pakistan,Asia,54,5,4,49,9,13,41,Human Factor
1990-08-29 00:00:00,United States Air Force - USAF,Takeoff (climb),Military / Government,Germany,Europe,17,8,8,9,5,13,4,Technical Failure
1991-03-21 00:00:00,United States Navy - USN,Flight,Military / Government,World,World,13,13,13,0,0,13,0,Human Factor
1991-05-09 00:00:00,Merpati Nusantara Airlines - MNA,Landing (descent or approach),Commercial,Indonesia,Asia,13,5,5,8,8,13,0,Human Factor
1991-05-15 00:00:00,ADES Colombia - Aerolineas del Este,Landing (descent or approach),Operational,Colombia,South America,14,3,2,11,11,13,1,Technical Failure
1991-05-23 00:00:00,Aeroflot - Russian International Airlines,Landing (descent or approach),Commercial,Russia,Asia,181,7,0,174,13,13,168,Human Factor
1991-07-10 00:00:00,L'Express Airlines,Landing (descent or approach),Commercial,United States of America,North America,15,2,1,13,12,13,2,Weather
1991-09-17 00:00:00,Antonov Design Bureau,Takeoff (climb),Operational,Russia,Asia,13,6,6,7,7,13,0,Human Factor
1993-11-21 00:00:00,Aerovias Guatemala,Landing (descent or approach),Commercial,Guatemala,Central America,13,1,1,12,12,13,0,Human Factor
1994-02-24 00:00:00,Pulkovo Aviation Enterprise,Landing (descent or approach),Operational,Russia,Asia,13,6,6,7,7,13,0,Weather
1995-06-16 00:00:00,Nikolayevski Aviation Enterprise,Flight,Commercial,Russia,Asia,14,2,2,12,11,13,1,Human Factor
1997-08-21 00:00:00,Afghan Antitaliban Alliance,Landing (descent or approach),Military / Government,Afghanistan,Asia,15,6,6,9,7,13,2,Human Factor
1998-03-18 00:00:00,Formosa Airlines,Takeoff (climb),Commercial,Taiwan,Asia,13,5,5,8,8,13,0,Human Factor
1998-08-26 00:00:00,TechAviaService,Flight,Operational,Angola,Africa,13,5,5,8,8,13,0,Technical Failure
1998-11-11 00:00:00,Vilyui,Takeoff (climb),Operational,Russia,Asia,13,7,7,6,6,13,0,Weather
2000-07-25 00:00:00,Royal Jordanian Air Force,Flight,Operational,Jordan,Asia,13,7,7,6,6,13,0,Technical Failure
2001-07-12 00:00:00,Overtec,Takeoff (climb),Operational,Venezuela,South America,13,2,2,11,11,13,0,Technical Failure
2002-09-14 00:00:00,ROSTO,Takeoff (climb),Humanitarian,Russia,Asia,14,1,1,13,12,13,1,Technical Failure
2003-11-17 00:00:00,Sarit Airlines,Landing (descent or approach),Operational,South Sudan,Africa,13,7,7,6,6,13,0,Unknown
2004-10-19 00:00:00,American Connection,Landing (descent or approach),Commercial,United States of America,North America,15,2,2,13,11,13,2,Human Factor
2005-04-28 00:00:00,Peruvian Armed Forces - Ejército del Perú,Flight,Operational,Peru,South America,13,2,2,11,11,13,0,Unknown
2005-05-18 00:00:00,Zambia Air Force,Takeoff (climb),Military / Government,Zambia,Africa,13,5,5,8,8,13,0,Unknown
2005-09-09 00:00:00,Air Kasai,Flight,Commercial,Congo,Africa,13,4,4,9,9,13,0,Unknown
2006-09-17 00:00:00,Nigerian Air Force,Landing (descent or approach),Military / Government,Nigeria,Africa,18,3,2,15,11,13,5,Human Factor
2007-05-24 00:00:00,Peruvian Air Force - Fuerza Aérea del Perú,Landing (descent or approach),Military / Government,Peru,South America,20,3,3,17,10,13,7,Human Factor
2008-01-19 00:00:00,Gira Globo Lda Aeronautica,Flight,Business,Angola,Africa,13,2,2,11,11,13,0,Human Factor
2009-06-08 00:00:00,Indian Air Force - Bharatiya Vayu Sena,Flight,Military / Government,India,Asia,13,7,7,6,6,13,0,Unknown
2009-08-11 00:00:00,Airlines PNG,Landing (descent or approach),Commercial,Papua New Guinea,Oceania,13,2,2,11,11,13,0,Human Factor
2012-06-11 00:00:00,Avia-Zov,Flight,Business,Russia,Asia,13,1,1,12,12,13,0,Human Factor
2016-12-03 00:00:00,Indonesian National Police - Kepolisian Negara Republik Indonesia,Flight,Military / Government,Indonesia,Asia,13,5,5,8,8,13,0,Unknown
2016-12-18 00:00:00,Indonesian Air Force - TNI-AU Tentara Nasional Indonesia - Angkatan Udara,Landing (descent or approach),Military / Government,Indonesia,Asia,13,12,12,1,1,13,0,Unknown
2019-05-05 00:00:00,Compañía de Aviación y Logística Empresarial S.A.P.I.,Flight,Commercial,Mexico,Central America,13,2,2,11,11,13,0,Weather
2019-06-03 00:00:00,Indian Air Force - Bharatiya Vayu Sena,Flight,Military / Government,India,Asia,13,8,8,5,5,13,0,Unknown
1930-08-22 00:00:00,CSA Czech Airlines - Československé Státní Aerolinie,Flight,Commercial,Czech Republic,Europe,13,2,2,11,10,12,1,Human Factor
1934-07-27 00:00:00,Swissair,Flight,Commercial,Germany,Europe,12,3,3,9,9,12,0,Technical Failure
1935-06-26 00:00:00,Aeroflot - Russian International Airlines,Flight,Commercial,Russia,Asia,12,3,3,9,9,12,0,Human Factor
1935-10-07 00:00:00,United Airlines,Landing (descent or approach),Commercial,United States of America,North America,12,3,3,9,9,12,0,Human Factor
1935-11-09 00:00:00,Imperial Airways,Parking,Commercial,Italy,Europe,13,3,3,10,9,12,1,Technical Failure
1935-12-31 00:00:00,Imperial Airways,Landing (descent or approach),Commercial,Egypt,Africa,13,4,3,9,9,12,1,Technical Failure
1936-04-07 00:00:00,Transcontinental %26 Western Air - TWA,Flight,Commercial,United States of America,North America,14,3,2,11,10,12,2,Human Factor
1936-12-27 00:00:00,United Airlines,Landing (descent or approach),Commercial,United States of America,North America,12,3,3,9,9,12,0,Human Factor
1937-01-26 00:00:00,SABENA - Société Anonyme Belge d'Exploitation de la Navigation Aérienne,Landing (descent or approach),Commercial,Algeria,Africa,12,4,4,8,8,12,0,Unknown
1938-08-10 00:00:00,Malert - Magyar-Szoviet Legiforgalmi Tarseaag,Takeoff (climb),Commercial,Hungary,Europe,12,3,3,9,9,12,0,Weather
1938-11-26 00:00:00,Deutsche Lufthansa,Takeoff (climb),Commercial,Gambia,Africa,15,3,3,12,9,12,3,Technical Failure
1941-01-18 00:00:00,Malert - Magyar-Szoviet Legiforgalmi Tarseaag,Takeoff (climb),Commercial,Romania,Europe,16,3,3,13,9,12,4,Unknown
1941-02-06 00:00:00,Trans-Canada Air Lines - TCAL,Landing (descent or approach),Commercial,Canada,North America,12,3,3,9,9,12,0,Human Factor
1941-06-27 00:00:00,German Air Force - Deutsche Luftwaffe,Flight,Military / Government,Norway,Europe,12,5,5,7,7,12,0,Unknown
1941-11-02 00:00:00,United States Navy - USN,Landing (descent or approach),Military / Government,Iceland,Europe,12,12,12,0,0,12,0,Human Factor
1942-02-06 00:00:00,Royal Air Force - RAF,Flight,Military / Government,Ireland,Europe,12,12,12,0,0,12,0,Unknown
1942-04-21 00:00:00,Guinea Airways,Flight,Military / Government,Australia,Oceania,12,2,2,10,10,12,0,Technical Failure
1942-06-03 00:00:00,United States Navy - USN,Flight,Military / Government,World,World,12,12,12,0,0,12,0,Unknown
1942-06-18 00:00:00,Aeroflot - Russian International Airlines,Takeoff (climb),Commercial,Russia,Asia,21,4,3,17,9,12,9,Technical Failure
1942-06-19 00:00:00,United States Navy - USN,Landing (descent or approach),Military / Government,Trinidad and Tobago,Central America,12,12,12,0,0,12,0,Unknown
1942-08-18 00:00:00,United States Navy - USN,Flight,Operational,United States of America,North America,12,12,12,0,0,12,0,Unknown
1942-08-23 00:00:00,United States Army Air Forces - USAAF,Flight,Military / Government,United Kingdom,Europe,13,4,4,9,8,12,1,Human Factor
1942-10-23 00:00:00,American Airlines,Flight,Commercial,United States of America,North America,12,3,3,9,9,12,0,Human Factor
1942-12-05 00:00:00,United States Army Air Forces - USAAF,Flight,Military / Government,United States of America,North America,12,12,12,0,0,12,0,Unknown
1942-12-18 00:00:00,United States Army Air Forces - USAAF,Flight,Military / Government,Australia,Oceania,12,5,5,7,7,12,0,Human Factor
1942-12-19 00:00:00,South African Air Force,Takeoff (climb),Military / Government,Kenya,Africa,12,4,4,8,8,12,0,Technical Failure
1943-01-02 00:00:00,Royal Air Force - RAF,Flight,Military / Government,Egypt,Africa,12,12,12,0,0,12,0,Unknown
1943-04-18 00:00:00,Japan Air Self-Defense Force - Kōkū Jieitai,Flight,Military / Government,Papua New Guinea,Oceania,12,8,8,4,4,12,0,Terrorism
1943-05-15 00:00:00,United States Navy - USN,Flight,Military / Government,Solomon Islands,Oceania,12,12,12,0,0,12,0,Unknown
1943-08-03 00:00:00,United States Navy - USN,Flight,Military / Government,World,World,12,12,12,0,0,12,0,Terrorism
1943-08-06 00:00:00,United States Navy - USN,Flight,Military / Government,Trinidad and Tobago,Central America,12,12,12,0,0,12,0,Unknown
1943-10-16 00:00:00,United States Army Air Forces - USAAF,Flight,Military / Government,Canada,North America,17,17,12,0,0,12,5,Unknown
1943-11-10 00:00:00,Royal Air Force - RAF,Flight,Military / Government,World,World,12,8,8,4,4,12,0,Terrorism
1943-11-13 00:00:00,German Air Force - Deutsche Luftwaffe,Flight,Military / Government,Greece,Europe,12,12,12,0,0,12,0,Terrorism
1943-11-30 00:00:00,Royal Air Force - RAF,Takeoff (climb),Military / Government,United Kingdom,Europe,12,12,12,0,0,12,0,Other
1943-12-05 00:00:00,United States Army Air Forces - USAAF,Flight,Military / Government,Spain,Europe,12,12,12,0,0,12,0,Human Factor
1943-12-29 00:00:00,United States Army Air Forces - USAAF,Flight,Operational,United States of America,North America,12,12,12,0,0,12,0,Human Factor
1944-05-24 00:00:00,Royal Canadian Air Force - RCAF,Flight,Military / Government,World,World,12,12,12,0,0,12,0,Terrorism
1944-05-26 00:00:00,China National Aviation Corporation - CNAC,Flight,Operational,China,Asia,12,2,2,10,10,12,0,Weather
1944-06-12 00:00:00,Royal Air Force - RAF,Flight,Military / Government,World,World,12,12,12,0,0,12,0,Terrorism
1944-06-21 00:00:00,United States Navy - USN,Flight,Military / Government,World,World,12,12,12,0,0,12,0,Terrorism
1944-07-09 00:00:00,German Air Force - Deutsche Luftwaffe,Flight,Military / Government,France,Europe,12,4,4,8,8,12,0,Unknown
1944-07-19 00:00:00,United States Army Air Forces - USAAF,Flight,Operational,United States of America,North America,12,12,12,0,0,12,0,Technical Failure
1944-09-24 00:00:00,United States Army Air Forces - USAAF,Flight,Operational,United States of America,North America,12,4,4,8,8,12,0,Human Factor
1944-11-12 00:00:00,United States Army Air Forces - USAAF,Landing (descent or approach),Military / Government,Canada,North America,18,4,4,14,8,12,6,Human Factor
1944-12-25 00:00:00,United States Army Air Forces - USAAF,Landing (descent or approach),Military / Government,United States of America,North America,27,4,4,23,8,12,15,Unknown
1944-12-30 00:00:00,Transport Aérien Militaire,Takeoff (climb),Military / Government,Algeria,Africa,12,3,3,9,9,12,0,Unknown
1945-01-27 00:00:00,Royal New Zealand Air Force - RNZAF,Flight,Specialised Services,Fiji Islands,Oceania,18,6,4,12,8,12,6,Human Factor
1945-02-12 00:00:00,United States Army Air Forces - USAAF,Flight,Military / Government,World,World,12,12,12,0,0,12,0,Technical Failure
1945-03-14 00:00:00,Royal Air Force - RAF,Flight,Military / Government,Ireland,Europe,12,12,12,0,0,12,0,Human Factor
1945-03-23 00:00:00,Royal Australian Air Force - RAAF,Takeoff (climb),Military / Government,Australia,Oceania,12,12,12,0,0,12,0,Unknown
1945-03-30 00:00:00,United States Navy - USN,Flight,Military / Government,World,World,12,12,12,0,0,12,0,Terrorism
1945-04-05 00:00:00,Royal Air Force - RAF,Flight,Military / Government,World,World,12,12,12,0,0,12,0,Technical Failure
1945-04-06 00:00:00,United States Army Air Forces - USAAF,Flight,Military / Government,Norway,Europe,12,12,12,0,0,12,0,Unknown
1945-05-16 00:00:00,Spanish Air Force - Ejército del Aire,Takeoff (climb),Military / Government,Spain,Europe,12,12,12,0,0,12,0,Technical Failure
1945-06-21 00:00:00,United States Army Air Forces - USAAF,Flight,Specialised Services,Papua New Guinea,Oceania,12,4,4,8,8,12,0,Unknown
1945-06-30 00:00:00,United States Army Air Forces - USAAF,Flight,Operational,United States of America,North America,12,12,12,0,0,12,0,Human Factor
1945-07-05 00:00:00,Royal Australian Air Force - RAAF,Flight,Military / Government,Indonesia,Asia,12,12,12,0,0,12,0,Terrorism
1945-07-09 00:00:00,United States Navy - USN,Flight,Operational,World,World,12,12,12,0,0,12,0,Other
1945-07-27 00:00:00,Royal Australian Air Force - RAAF,Flight,Military / Government,Indonesia,Asia,12,12,12,0,0,12,0,Terrorism
1945-07-30 00:00:00,United States Army Air Forces - USAAF,Flight,Specialised Services,United States of America,North America,12,12,12,0,0,12,0,Unknown
1945-08-01 00:00:00,Lineas Aéreas Mexicanas - LAMSA,Landing (descent or approach),Commercial,Mexico,Central America,12,3,3,9,9,12,0,Technical Failure
1945-08-08 00:00:00,United States Navy - USN,Flight,Military / Government,Japan,Asia,12,12,12,0,0,12,0,Terrorism
1945-08-08 00:00:00,United States Navy - USN,Flight,Military / Government,Japan,Asia,12,12,12,0,0,12,0,Terrorism
1945-09-12 00:00:00,United States Navy - USN,Takeoff (climb),Military / Government,Japan,Asia,12,12,12,0,0,12,0,Human Factor
1945-09-29 00:00:00,French Air Force - Armée de l'Air,Landing (descent or approach),Military / Government,France,Europe,12,6,6,6,6,12,0,Human Factor
1945-10-16 00:00:00,United States Army Air Forces - USAAF,Flight,Military / Government,World,World,17,6,6,11,6,12,5,Technical Failure
1945-11-08 00:00:00,United States Navy - USN,Takeoff (climb),Operational,United States of America,North America,12,12,12,0,0,12,0,Human Factor
1945-11-25 00:00:00,United States Army Air Forces - USAAF,Flight,Military / Government,Philippines,Asia,12,12,12,0,0,12,0,Unknown
1946-04-30 00:00:00,Royal Air Force - RAF,Flight,Military / Government,Pakistan,Asia,12,3,3,9,9,12,0,Unknown
1946-12-02 00:00:00,French Air Force - Armée de l'Air,Flight,Military / Government,France,Europe,12,4,4,8,8,12,0,Weather
1946-12-14 00:00:00,Far East Air Transport,Landing (descent or approach),Commercial,Philippines,Asia,14,3,2,11,10,12,2,Weather
1946-12-24 00:00:00,Western Airlines,Flight,Commercial,United States of America,North America,12,3,3,9,9,12,0,Human Factor
1947-01-25 00:00:00,Spencer Airways,Takeoff (climb),Commercial,United Kingdom,Europe,23,5,1,18,11,12,11,Human Factor
1947-02-26 00:00:00,Royal Air Force - RAF,Flight,Military / Government,China,Asia,12,3,3,9,9,12,0,Weather
1947-06-13 00:00:00,French Air Force - Armée de l'Air,Flight,Military / Government,Vietnam,Asia,12,3,3,9,9,12,0,Unknown
1947-06-15 00:00:00,United States Army Air Forces - USAAF,Flight,Operational,United States of America,North America,12,12,12,0,0,12,0,Human Factor
1948-02-13 00:00:00,Det Danske Luftfartselskab - DDL,Landing (descent or approach),Commercial,Germany,Europe,21,4,4,17,8,12,9,Technical Failure
1948-02-23 00:00:00,Commercial Airways - Philippines,Takeoff (climb),Commercial,Philippines,Asia,12,3,3,9,9,12,0,Unknown
1948-03-10 00:00:00,Delta Airlines,Takeoff (climb),Commercial,United States of America,North America,13,4,4,9,8,12,1,Human Factor
1948-05-09 00:00:00,United States Navy - USN,Flight,Military / Government,Bahamas,Central America,12,12,12,0,0,12,0,Unknown
1948-07-15 00:00:00,Brazilian Air Force - Força Aérea Brasileira,Flight,Military / Government,Brazil,South America,12,12,12,0,0,12,0,Unknown
1948-08-12 00:00:00,United States Navy - USN,Landing (descent or approach),Military / Government,Northern Mariana Islands,Oceania,12,12,12,0,0,12,0,Human Factor
1948-11-03 00:00:00,United States Navy - USN,Landing (descent or approach),Military / Government,United States of America,North America,12,12,12,0,0,12,0,Unknown
1949-08-09 00:00:00,Royal Air Force - RAF,Landing (descent or approach),Military / Government,Somalia,Africa,12,9,9,3,3,12,0,Human Factor
1949-10-13 00:00:00,United States Air Force - USAF,Takeoff (climb),Operational,United Kingdom,Europe,12,12,12,0,0,12,0,Technical Failure
1949-11-26 00:00:00,LANSA Colombia - Limitada Nacional de Servicio Aéreo,Takeoff (climb),Commercial,Colombia,South America,12,3,3,9,9,12,0,Unknown
1950-03-23 00:00:00,United States Air Force - USAF,Flight,Operational,United States of America,North America,14,14,12,0,0,12,2,Technical Failure
1950-03-28 00:00:00,Société d'Exploitation du Matériel Aéronautique Français,Flight,Specialised Services,France,Europe,12,12,12,0,0,12,0,Technical Failure
1950-04-10 00:00:00,Pakistan Air Force - Pakistan Fiza'ya,Flight,Military / Government,India,Asia,12,12,12,0,0,12,0,Unknown
1950-07-18 00:00:00,DTA Angola Airlines - Direcção dos Transportes Aéreos,Flight,Commercial,Angola,Africa,12,3,3,9,9,12,0,Human Factor
1950-07-30 00:00:00,Sociedade Anônima Viação Aérea Gaúcha - SAVAG,Flight,Commercial,Brazil,South America,12,2,2,10,10,12,0,Human Factor
1950-08-05 00:00:00,United States Air Force - USAF,Takeoff (climb),Military / Government,United States of America,North America,20,20,12,0,0,12,8,Human Factor
1950-08-25 00:00:00,Royal Air Force - RAF,Flight,Military / Government,Malaysia,Asia,12,7,7,5,5,12,0,Human Factor
1950-11-05 00:00:00,United States Navy - USN,Flight,Military / Government,World,World,12,12,12,0,0,12,0,Unknown
1951-01-12 00:00:00,United Airways - South Africa,Flight,Commercial,South Africa,Africa,12,2,2,10,10,12,0,Weather
1951-03-25 00:00:00,Aeroflot - Russian International Airlines,Flight,Commercial,Russia,Asia,13,4,4,9,8,12,1,Human Factor
1951-03-29 00:00:00,United States Air Force - USAF,Flight,Military / Government,World,World,12,12,12,0,0,12,0,Terrorism
1951-04-12 00:00:00,United States Air Force - USAF,Flight,Military / Government,North Korea,Asia,12,12,12,0,0,12,0,Terrorism
1951-06-15 00:00:00,United States Navy - USN,Landing (descent or approach),Military / Government,Japan,Asia,12,12,12,0,0,12,0,Human Factor
1951-08-12 00:00:00,United States Navy - USN,Landing (descent or approach),Operational,United States of America,North America,12,12,12,0,0,12,0,Human Factor
1951-10-15 00:00:00,United States Air Force - USAF,Flight,Military / Government,World,World,12,3,3,9,9,12,0,Unknown
1951-10-22 00:00:00,JAT Yugoslav Airlines - Jugoslovenski Aerotransport,Landing (descent or approach),Commercial,Macedonia,Europe,12,3,3,9,9,12,0,Unknown
1951-10-31 00:00:00,United States Air Force - USAF,Flight,Military / Government,Japan,Asia,15,15,12,0,0,12,3,Technical Failure
1952-01-14 00:00:00,United States Navy - USN,Takeoff (climb),Military / Government,Japan,Asia,12,12,12,0,0,12,0,Technical Failure
1952-03-29 00:00:00,TACA International Airlines - Transportes Aéreos Centro Americanos,Landing (descent or approach),Commercial,Venezuela,South America,12,3,3,9,9,12,0,Human Factor
1952-06-10 00:00:00,United States Air Force - USAF,Flight,Military / Government,North Korea,Asia,13,13,12,0,0,12,1,Terrorism
1952-08-30 00:00:00,United States Air Force - USAF,Landing (descent or approach),Military / Government,South Korea,Asia,12,12,12,0,0,12,0,Unknown
1952-09-23 00:00:00,French Navy,Takeoff (climb),Military / Government,Vietnam,Asia,13,13,12,0,0,12,1,Unknown
1952-11-19 00:00:00,United States Air Force - USAF,Flight,Military / Government,North Korea,Asia,14,14,12,0,0,12,2,Terrorism
1953-01-13 00:00:00,United States Air Force - USAF,Flight,Operational,United States of America,North America,12,12,12,0,0,12,0,Unknown
1953-07-02 00:00:00,United States Navy - USN,Landing (descent or approach),Military / Government,United States of America,North America,12,12,12,0,0,12,0,Technical Failure
1954-01-10 00:00:00,United Producing Company,Landing (descent or approach),Business,United States of America,North America,12,2,2,10,10,12,0,Weather
1954-08-22 00:00:00,Braniff International Airways,Landing (descent or approach),Commercial,United States of America,North America,19,3,2,16,10,12,7,Weather
1954-09-28 00:00:00,United States Navy - USN,Takeoff (climb),Military / Government,Philippines,Asia,12,12,12,0,0,12,0,Other
1955-04-18 00:00:00,Union Aéromaritime de Transport - UAT,Landing (descent or approach),Commercial,Cameroon,Africa,12,3,3,9,9,12,0,Human Factor
1955-09-01 00:00:00,United States Air Force - USAF,Landing (descent or approach),Military / Government,United States of America,North America,12,5,5,7,7,12,0,Technical Failure
1955-09-02 00:00:00,Union of Burma Airways,Flight,Commercial,Myanmar,Asia,12,3,3,9,9,12,0,Human Factor
1956-08-08 00:00:00,Union of Burma Airways,Flight,Commercial,Myanmar,Asia,22,4,3,18,9,12,10,Unknown
1956-09-24 00:00:00,United States Air Force - USAF,Flight,Military / Government,United States of America,North America,12,2,2,10,10,12,0,Human Factor
1956-12-09 00:00:00,Aeroflot - Russian International Airlines,Flight,Commercial,Russia,Asia,12,5,5,7,7,12,0,Human Factor
1956-12-31 00:00:00,United States Air Force - USAF,Landing (descent or approach),Military / Government,Saudi Arabia,Asia,38,7,0,31,12,12,26,Human Factor
1957-03-13 00:00:00,Colombian Air Force - Fuerza Aérea Colombiana,Flight,Military / Government,Colombia,South America,12,4,4,8,8,12,0,Unknown
1957-05-08 00:00:00,Spanish Air Force - Ejército del Aire,Landing (descent or approach),Military / Government,Morocco,Africa,14,3,3,11,9,12,2,Technical Failure
1957-08-29 00:00:00,SAHSA - Servicios Aéreos de Honduras SA,Takeoff (climb),Commercial,Honduras,Central America,12,3,3,9,9,12,0,Unknown
1957-09-15 00:00:00,Northeast Airlines - USA,Landing (descent or approach),Commercial,United States of America,North America,24,3,2,21,10,12,12,Human Factor
1958-08-13 00:00:00,Argentinian Air Force - Fuerza Aérea Argentina,Takeoff (climb),Military / Government,Argentina,South America,12,3,3,9,9,12,0,Unknown
1958-11-07 00:00:00,Aeroflot - Russian International Airlines,Landing (descent or approach),Commercial,Ukraine,Europe,12,5,5,7,7,12,0,Human Factor
1959-04-23 00:00:00,Air Charter Ltd London,Flight,Operational,Turkey,Asia,12,12,12,0,0,12,0,Human Factor
1959-05-13 00:00:00,Transportes Aéreos Peruanas - TAPSA,Flight,Commercial,Peru,South America,12,3,3,9,9,12,0,Unknown
1959-05-29 00:00:00,Chinese Air Force - AFPLA - Chung-Kuo Shan Min Taie Fang Tsun Pu-Tai,Flight,Military / Government,China,Asia,12,12,12,0,0,12,0,Terrorism
1960-05-15 00:00:00,Balair - Switzerland,Flight,Commercial,Sudan,Africa,12,10,10,2,2,12,0,Human Factor
1960-10-28 00:00:00,Northwest Airlines,Landing (descent or approach),Commercial,United States of America,North America,12,4,4,8,8,12,0,Human Factor
1960-12-10 00:00:00,Aeroflot - Russian International Airlines,Flight,Commercial,Kazakhstan,Asia,12,2,2,10,10,12,0,Human Factor
1961-03-09 00:00:00,Linea Aeropostal Venezolana - LAV,Flight,Commercial,Venezuela,South America,12,4,4,8,8,12,0,Human Factor
1962-01-12 00:00:00,United States Navy - USN,Flight,Military / Government,Greenland,Europe,12,12,12,0,0,12,0,Unknown
1962-05-06 00:00:00,Channel Airways,Flight,Commercial,United Kingdom,Europe,18,3,3,15,9,12,6,Human Factor
1962-08-02 00:00:00,United States Navy - USN,Flight,Military / Government,Philippines,Asia,12,12,12,0,0,12,0,Human Factor
1962-09-03 00:00:00,Japan Maritime Self-Defense Force - Kaijō Jieitai,,Military / Government,Japan,Asia,12,12,12,0,0,12,0,Human Factor
1963-01-11 00:00:00,Escadrille Aérienne de Recherche et de Sauvetage - EARS,Flight,Military / Government,France,Europe,12,12,12,0,0,12,0,Unknown
1963-01-14 00:00:00,Aeroflot - Russian International Airlines,Takeoff (climb),Commercial,Russia,Asia,25,4,4,21,8,12,13,Human Factor
1963-03-05 00:00:00,Aeroflot - Russian International Airlines,Landing (descent or approach),Commercial,Turkmenistan,Asia,54,11,8,43,4,12,42,Human Factor
1963-04-14 00:00:00,Flugfélag Íslands,Landing (descent or approach),Commercial,Norway,Europe,12,4,4,8,8,12,0,Unknown
1963-12-19 00:00:00,Cuban Air Force - Fuerzas Armadas Revolucionaras,Landing (descent or approach),Military / Government,Cuba,Central America,12,4,4,8,8,12,0,Terrorism
1963-12-27 00:00:00,Air America,Flight,Military / Government,Thailand,Asia,12,3,3,9,9,12,0,Unknown
1964-11-24 00:00:00,United States Navy - USN,Flight,Military / Government,United States of America,North America,12,12,12,0,0,12,0,Unknown
1965-04-25 00:00:00,Aeroflot - Russian International Airlines,Flight,Commercial,Russia,Asia,12,2,2,10,10,12,0,Human Factor
1966-04-10 00:00:00,Donald Aircraft,Takeoff (climb),Business,Mexico,Central America,12,1,1,11,11,12,0,Other
1966-11-26 00:00:00,SATENA - Servicio de Aeronavegacion a Territorios Nacionales,Takeoff (climb),Commercial,Colombia,South America,13,3,3,10,9,12,1,Unknown
1967-02-28 00:00:00,Philippine Airlines - PAL,Landing (descent or approach),Commercial,Philippines,Asia,19,4,4,15,8,12,7,Other
1967-04-28 00:00:00,United States Navy - USN,Flight,Military / Government,Japan,Asia,12,4,4,8,8,12,0,Unknown
1967-05-02 00:00:00,Salvadorian Air Force - Fuerza Aérea Salvadoreña,Flight,Military / Government,Salvador,Central America,12,4,4,8,8,12,0,Unknown
1967-05-11 00:00:00,Aeroflot - Russian International Airlines,Flight,Commercial,Kazakhstan,Asia,12,2,2,10,10,12,0,Human Factor
1968-01-16 00:00:00,United States Navy - USN,Landing (descent or approach),Military / Government,Japan,Asia,12,4,4,8,8,12,0,Human Factor
1968-02-06 00:00:00,United States Navy - USN,Flight,Military / Government,Vietnam,Asia,12,12,12,0,0,12,0,Technical Failure
1968-04-01 00:00:00,United States Navy - USN,Flight,Military / Government,Vietnam,Asia,12,12,12,0,0,12,0,Terrorism
1968-12-26 00:00:00,Exportada de Sal SA - ESSA,Flight,Commercial,Mexico,Central America,12,2,2,10,10,12,0,Unknown
1969-01-16 00:00:00,Air America,Flight,Commercial,Vietnam,Asia,12,3,3,9,9,12,0,Unknown
1969-03-08 00:00:00,United States Air Force - USAF,Landing (descent or approach),Military / Government,Taiwan,Asia,12,12,12,0,0,12,0,Human Factor
1969-11-13 00:00:00,Aeroflot - Russian International Airlines,Landing (descent or approach),Operational,Russia,Asia,12,9,9,3,3,12,0,Weather
1970-02-04 00:00:00,French Navy,Takeoff (climb),Military / Government,France,Europe,12,12,12,0,0,12,0,Unknown
1971-01-15 00:00:00,Soviet Navy - Voyenno-morskoy flot CCCP,Flight,Military / Government,World,World,12,12,12,0,0,12,0,Technical Failure
1971-02-17 00:00:00,TAM Bolivia - Transporte Aéreo Militar Boliviano,Takeoff (climb),Military / Government,Bolivia,South America,12,4,4,8,8,12,0,Unknown
1971-05-06 00:00:00,Apache Airlines,Flight,Commercial,United States of America,North America,12,2,2,10,10,12,0,Technical Failure
1972-06-18 00:00:00,United States Air Force - USAF,Flight,Military / Government,Vietnam,Asia,15,15,12,0,0,12,3,Terrorism
1972-12-05 00:00:00,United States Air Force - USAF,Flight,Operational,United States of America,North America,12,12,12,0,0,12,0,Human Factor
1973-02-28 00:00:00,Peruvian Air Force - Fuerza Aérea del Perú,Landing (descent or approach),Military / Government,Peru,South America,12,4,4,8,8,12,0,Human Factor
1973-12-07 00:00:00,Aeroflot - Russian International Airlines,Landing (descent or approach),Commercial,Russia,Asia,75,7,5,68,7,12,63,Human Factor
1974-01-06 00:00:00,Air East,Landing (descent or approach),Commercial,United States of America,North America,17,2,1,15,11,12,5,Human Factor
1974-01-17 00:00:00,Cessnyca,Flight,Commercial,Colombia,South America,12,3,3,9,9,12,0,Unknown
1975-01-09 00:00:00,Golden West Airlines,Landing (descent or approach),Commercial,United States of America,North America,12,2,2,10,10,12,0,Human Factor
1975-01-16 00:00:00,Aeroflot - Russian International Airlines,Flight,Commercial,Laos,Asia,12,4,4,8,8,12,0,Human Factor
1975-03-07 00:00:00,Aeroflot - Russian International Airlines,Flight,Commercial,Russia,Asia,15,2,2,13,10,12,3,Human Factor
1976-08-09 00:00:00,Spanish Air Force - Ejército del Aire,Flight,Military / Government,Spain,Europe,32,4,0,28,12,12,20,Technical Failure
1977-01-14 00:00:00,Northern Thunderbird Air - NT Air,Landing (descent or approach),Commercial,Canada,North America,12,3,3,9,9,12,0,Unknown
1977-06-20 00:00:00,Transporte Aéreo Militar de Uruguay - TAMU,Landing (descent or approach),Military / Government,Uruguay,South America,15,2,2,13,10,12,3,Human Factor
1978-01-28 00:00:00,Sociedad Aérea del Caqueta - Sadelca Colombia,Landing (descent or approach),Commercial,Colombia,South America,12,4,4,8,8,12,0,Weather
1978-08-25 00:00:00,Webber Airlines,Flight,Commercial,United States of America,North America,12,1,1,11,11,12,0,Unknown
1978-10-04 00:00:00,Brazilian Air Force - Força Aérea Brasileira,Landing (descent or approach),Military / Government,Brazil,South America,12,12,12,0,0,12,0,Unknown
1979-03-14 00:00:00,CAAC - Civil Aviation Administration of China,Takeoff (climb),Operational,China,Asia,12,12,12,0,0,12,0,Human Factor
1979-05-27 00:00:00,Mauritanian Air Force - Force Aérienne Islamique de Mauritanie,Takeoff (climb),Military / Government,Senegal,Africa,12,4,4,8,8,12,0,Unknown
1979-09-14 00:00:00,Butler Aircraft Company,Flight,Business,United States of America,North America,12,2,2,10,10,12,0,Human Factor
1981-04-28 00:00:00,Aeroflot - Russian International Airlines,Flight,Commercial,Russia,Asia,12,2,2,10,10,12,0,Human Factor
1982-07-03 00:00:00,Air Affaires Gabon,Flight,Commercial,Gabon,Africa,12,2,2,10,10,12,0,Unknown
1982-07-28 00:00:00,Last Days Ministries,Takeoff (climb),Business,United States of America,North America,12,1,1,11,11,12,0,Human Factor
1983-08-28 00:00:00,R. R. Moore %26 Company,Flight,Commercial,Australia,Oceania,12,1,1,11,11,12,0,Unknown
1983-10-10 00:00:00,Argentinian Air Force - Fuerza Aérea Argentina,Takeoff (climb),Military / Government,Argentina,South America,12,3,3,9,9,12,0,Unknown
1984-02-27 00:00:00,Japan Maritime Self-Defense Force - Kaijō Jieitai,Flight,Military / Government,World,World,12,12,12,0,0,12,0,Unknown
1984-05-15 00:00:00,Gobierno de Tierra del Fuego,Landing (descent or approach),Military / Government,Argentina,South America,12,2,2,10,10,12,0,Human Factor
1987-05-28 00:00:00,Guatemalan Air Force - Fuerza Aérea Guatemalteca,Takeoff (climb),Military / Government,Guatemala,Central America,12,5,5,7,7,12,0,Unknown
1987-08-13 00:00:00,Afghan Republican Air Force - Afghan Hanai Qurah,Flight,Military / Government,Afghanistan,Asia,12,5,5,7,7,12,0,Terrorism
1988-02-19 00:00:00,AVAir - Air Virginia,Takeoff (climb),Commercial,United States of America,North America,12,2,2,10,10,12,0,Human Factor
1988-10-25 00:00:00,AeroPeru,Takeoff (climb),Commercial,Peru,South America,69,4,1,65,11,12,57,Human Factor
1989-06-27 00:00:00,Formosa Airlines,Takeoff (climb),Commercial,Taiwan,Asia,13,2,2,11,10,12,1,Technical Failure
1989-09-03 00:00:00,VARIG - Viação Aérea Rio Grandense,Flight,Commercial,Brazil,South America,54,6,0,48,12,12,42,Human Factor
1989-10-10 00:00:00,Transportes Aéreos Unidos de la Selva Amazonica - TAUSA,Takeoff (climb),Commercial,Peru,South America,12,1,1,11,11,12,0,Unknown
1990-09-20 00:00:00,Government of the State of Pernambuco,Takeoff (climb),Military / Government,Brazil,South America,12,2,2,10,10,12,0,Human Factor
1991-02-01 00:00:00,SkyWest Airlines - USA,Takeoff (climb),Commercial,United States of America,North America,12,2,2,10,10,12,0,Human Factor
1991-09-04 00:00:00,Conoco,Landing (descent or approach),Business,Malaysia,Asia,12,3,3,9,9,12,0,Human Factor
1992-02-03 00:00:00,Nordeste Linhas Aéreas Regionais,Flight,Commercial,Brazil,South America,12,2,2,10,10,12,0,Human Factor
1992-09-07 00:00:00,EXA,Takeoff (climb),Humanitarian,United States of America,North America,12,1,1,11,11,12,0,Human Factor
1993-10-01 00:00:00,Argentinian Air Force - Fuerza Aérea Argentina,Flight,Military / Government,Argentina,South America,13,3,3,10,9,12,1,Unknown
1993-11-13 00:00:00,China Northern Airlines,Landing (descent or approach),Commercial,China,Asia,102,10,4,92,8,12,90,Human Factor
1994-04-06 00:00:00,Rwandese Government,Landing (descent or approach),Military / Government,Rwanda,Africa,12,3,3,9,9,12,0,Terrorism
1994-06-18 00:00:00,Merpati Nusantara Airlines - MNA,Landing (descent or approach),Commercial,Indonesia,Asia,12,5,5,7,7,12,0,Human Factor
1994-06-18 00:00:00,Transportes Aéreos Ejecutivos - TAESA,Landing (descent or approach),Commercial,United States of America,North America,12,2,2,10,10,12,0,Human Factor
1995-01-05 00:00:00,Islamic Republic of Iran Air Force,Takeoff (climb),Military / Government,Iran,Asia,12,2,2,10,10,12,0,Technical Failure
1995-05-24 00:00:00,Knight Air,Landing (descent or approach),Commercial,United Kingdom,Europe,12,3,3,9,9,12,0,Technical Failure
1996-06-20 00:00:00,Namco,Landing (descent or approach),Business,Nigeria,Africa,12,4,4,8,8,12,0,Human Factor
1996-08-19 00:00:00,Spair Air Transport Corporation - Aviatransportnaya Korporatsie Spair,Landing (descent or approach),Operational,Serbia,Europe,12,10,10,2,2,12,0,Human Factor
1996-11-19 00:00:00,United Express,Landing (descent or approach),Commercial,United States of America,North America,12,2,2,10,10,12,0,Human Factor
1998-07-29 00:00:00,Selva Táxi Aéreo,Flight,Commercial,Brazil,South America,27,3,1,24,11,12,15,Other
1999-09-01 00:00:00,Northern Air,Flight,Commercial,Tanzania,Africa,12,1,1,11,11,12,0,Human Factor
2006-11-17 00:00:00,Trigana Air Service,Flight,Commercial,Indonesia,Asia,12,3,3,9,9,12,0,Human Factor
2008-12-15 00:00:00,Línea Aérea Puertorriqueña,Flight,Commercial,Turks and Caicos Islands,Central America,12,1,1,11,11,12,0,Unknown
2010-07-05 00:00:00,Romanian Air Force - Fortele Aeriene Române,Takeoff (climb),Humanitarian,Romania,Europe,14,4,4,10,8,12,2,Unknown
2010-08-03 00:00:00,Katekavia,Landing (descent or approach),Commercial,Russia,Asia,15,4,1,11,11,12,3,Human Factor
2010-12-28 00:00:00,Russian Air Force - Voyenno-vozdushnye sily Rossii,Flight,Operational,Russia,Asia,12,12,12,0,0,12,0,Unknown
2011-08-20 00:00:00,First Air,Landing (descent or approach),Commercial,Canada,North America,15,4,4,11,8,12,3,Human Factor
2016-04-13 00:00:00,Sunbird Aviation,Landing (descent or approach),Commercial,Papua New Guinea,Oceania,12,1,1,11,11,12,0,Human Factor
2017-09-30 00:00:00,Congolese Air Force - Force Aérienne de la République Démocratique du Congo,Flight,Military / Government,Democratic Republic of Congo,Africa,12,6,6,6,6,12,0,Technical Failure
2017-12-31 00:00:00,NatureAir,Takeoff (climb),Commercial,Costa Rica,Central America,12,2,2,10,10,12,0,Human Factor
2018-01-29 00:00:00,Chinese Air Force - AFPLA - Chung-Kuo Shan Min Taie Fang Tsun Pu-Tai,Flight,Operational,China,Asia,12,5,5,7,7,12,0,Unknown
2019-12-27 00:00:00,Bek Air,Takeoff (climb),Commercial,Kazakhstan,Asia,98,5,1,93,11,12,86,Human Factor
2021-06-10 00:00:00,Myanmar Air Force - Tatmadaw Lei,Landing (descent or approach),Military / Government,Myanmar,Asia,16,2,1,14,11,12,4,Unknown
1934-10-19 00:00:00,Holyman's Airways,Flight,Commercial,Australia,Oceania,11,2,2,9,9,11,0,Unknown
1935-01-31 00:00:00,Deruluft - Deutsch-Russische Luftverkehrs Gesellschaft,Flight,Commercial,Poland,Europe,11,3,3,8,8,11,0,Weather
1935-12-10 00:00:00,SABENA - Société Anonyme Belge d'Exploitation de la Navigation Aérienne,Landing (descent or approach),Commercial,United Kingdom,Europe,11,4,4,7,7,11,0,Human Factor
1936-11-01 00:00:00,Deutsche Lufthansa,Flight,Commercial,Germany,Europe,15,3,3,12,8,11,4,Human Factor
1937-02-09 00:00:00,United Airlines,Landing (descent or approach),Commercial,United States of America,North America,11,3,3,8,8,11,0,Human Factor
1937-11-16 00:00:00,SABENA - Société Anonyme Belge d'Exploitation de la Navigation Aérienne,Landing (descent or approach),Commercial,Belgium,Europe,11,3,3,8,8,11,0,Human Factor
1938-08-12 00:00:00,Mexicana de Aviación,Flight,Commercial,Mexico,Central America,11,3,3,8,8,11,0,Weather
1940-02-29 00:00:00,SCADTA - Sociedad Colombo-Alemana de Transportes Aéreos,Flight,Commercial,Colombia,South America,11,2,2,9,9,11,0,Human Factor
1940-08-22 00:00:00,Aeroput,Flight,Commercial,Croatia,Europe,11,2,2,9,9,11,0,Unknown
1941-12-21 00:00:00,Royal Air Force - RAF,Takeoff (climb),Military / Government,United Kingdom,Europe,15,15,11,0,0,11,4,Unknown
1942-01-20 00:00:00,Royal Australian Air Force - RAAF,Takeoff (climb),Military / Government,Indonesia,Asia,11,4,4,7,7,11,0,Other
1942-02-25 00:00:00,German Air Force - Deutsche Luftwaffe,Flight,Military / Government,Poland,Europe,11,3,3,8,8,11,0,Weather
1942-06-07 00:00:00,Royal Air Force - RAF,Flight,Specialised Services,United Kingdom,Europe,11,5,5,6,6,11,0,Technical Failure
1942-06-09 00:00:00,United States Army Air Forces - USAAF,Takeoff (climb),Military / Government,New Zealand,Oceania,11,9,9,2,2,11,0,Unknown
1942-07-24 00:00:00,United States Army Air Forces - USAAF,Flight,Military / Government,Chad,Africa,11,11,11,0,0,11,0,Technical Failure
1942-08-11 00:00:00,United States Army Air Forces - USAAF,Flight,Military / Government,United Kingdom,Europe,11,8,8,3,3,11,0,Unknown
1942-08-16 00:00:00,United States Army Air Forces - USAAF,Flight,Specialised Services,Australia,Oceania,11,11,11,0,0,11,0,Technical Failure
1942-08-22 00:00:00,Royal Air Force - RAF,Landing (descent or approach),Military / Government,United Kingdom,Europe,12,12,11,0,0,11,1,Unknown
1942-10-03 00:00:00,American Export Airlines,Takeoff (climb),Commercial,Canada,North America,37,11,5,26,6,11,26,Human Factor
1942-11-11 00:00:00,United States Navy - USN,Flight,Military / Government,United States of America,North America,11,11,11,0,0,11,0,Technical Failure
1942-11-26 00:00:00,Royal Air Force - RAF,Takeoff (climb),Military / Government,United Kingdom,Europe,11,11,11,0,0,11,0,Technical Failure
1942-12-19 00:00:00,Royal Air Force - RAF,Flight,Military / Government,World,World,11,7,7,4,4,11,0,Unknown
1942-12-30 00:00:00,United States Army Air Forces - USAAF,Flight,Operational,United States of America,North America,11,11,11,0,0,11,0,Technical Failure
1943-01-04 00:00:00,Royal Air Force - RAF,Landing (descent or approach),Military / Government,Egypt,Africa,11,2,2,9,9,11,0,Weather
1943-01-18 00:00:00,United States Army Air Forces - USAAF,Flight,Military / Government,United States of America,North America,11,11,11,0,0,11,0,Technical Failure
1943-01-29 00:00:00,Royal Air Force - RAF,Landing (descent or approach),Military / Government,United Kingdom,Europe,19,4,0,15,11,11,8,Technical Failure
1943-02-18 00:00:00,Boeing Airplane Company,Landing (descent or approach),Specialised Services,United States of America,North America,11,11,11,0,0,11,0,Technical Failure
1943-02-28 00:00:00,Royal Australian Air Force - RAAF,Flight,Military / Government,Australia,Oceania,11,11,11,0,0,11,0,Technical Failure
1943-03-29 00:00:00,United States Army Air Forces - USAAF,Flight,Operational,United States of America,North America,11,11,11,0,0,11,0,Unknown
1943-04-12 00:00:00,United States Army Air Forces - USAAF,Takeoff (climb),Military / Government,Papua New Guinea,Oceania,11,11,11,0,0,11,0,Technical Failure
1943-05-25 00:00:00,Royal Air Force - RAF,Flight,Military / Government,Ireland,Europe,11,11,11,0,0,11,0,Unknown
1943-08-15 00:00:00,United States Army Air Forces - USAAF,Flight,Military / Government,World,World,11,11,11,0,0,11,0,Unknown
1943-09-05 00:00:00,United States Army Air Forces - USAAF,Flight,Operational,United States of America,North America,11,4,4,7,7,11,0,Weather
1943-09-10 00:00:00,United States Army Air Forces - USAAF,Flight,Operational,World,World,11,11,11,0,0,11,0,Human Factor
1943-09-10 00:00:00,United States Army Air Forces - USAAF,Flight,Operational,World,World,11,11,11,0,0,11,0,Human Factor
1943-10-15 00:00:00,American Airlines,Flight,Commercial,United States of America,North America,11,3,3,8,8,11,0,Weather
1943-10-23 00:00:00,United States Army Air Forces - USAAF,Takeoff (climb),Military / Government,United Kingdom,Europe,11,11,11,0,0,11,0,Unknown
1943-11-13 00:00:00,Royal Air Force - RAF,Flight,Military / Government,Ireland,Europe,11,11,11,0,0,11,0,Technical Failure
1943-11-18 00:00:00,United States Army Air Forces - USAAF,Flight,Military / Government,United States of America,North America,11,11,11,0,0,11,0,Unknown
1943-11-20 00:00:00,United States Army Air Forces - USAAF,Flight,Military / Government,Papua New Guinea,Oceania,11,11,11,0,0,11,0,Unknown
1943-11-20 00:00:00,Royal Canadian Air Force - RCAF,Flight,Military / Government,World,World,11,11,11,0,0,11,0,Terrorism
1943-12-22 00:00:00,United States Army Air Forces - USAAF,Takeoff (climb),Military / Government,United States of America,North America,12,8,7,4,4,11,1,Unknown
1944-01-06 00:00:00,Royal Air Force - RAF,Flight,Military / Government,World,World,11,11,11,0,0,11,0,Terrorism
1944-01-20 00:00:00,LAN Chile - Linea Aérea Nacional de Chile,Takeoff (climb),Humanitarian,Argentina,South America,11,3,3,8,8,11,0,Unknown
1944-01-29 00:00:00,United States Army Air Forces - USAAF,Flight,Military / Government,United Kingdom,Europe,11,11,11,0,0,11,0,Human Factor
1944-04-16 00:00:00,United States Army Air Forces - USAAF,Flight,Military / Government,Papua New Guinea,Oceania,11,11,11,0,0,11,0,Unknown
1944-04-16 00:00:00,United States Army Air Forces - USAAF,Flight,Military / Government,Papua New Guinea,Oceania,11,11,11,0,0,11,0,Unknown
1944-05-26 00:00:00,United States Army Air Forces - USAAF,Flight,Military / Government,China,Asia,11,11,11,0,0,11,0,Unknown
1944-06-12 00:00:00,Royal Air Force - RAF,Flight,Military / Government,World,World,11,11,11,0,0,11,0,Terrorism
1944-06-28 00:00:00,United States Army Air Forces - USAAF,Flight,Operational,United States of America,North America,11,11,11,0,0,11,0,Technical Failure
1944-07-06 00:00:00,Royal Canadian Air Force - RCAF,Takeoff (climb),Operational,Canada,North America,11,2,2,9,9,11,0,Unknown
1944-08-29 00:00:00,British Overseas Airways Corporation - BOAC,Flight,Commercial,Sweden,Europe,15,3,3,12,8,11,4,Human Factor
1944-09-18 00:00:00,United States Army Air Forces - USAAF,Flight,Military / Government,Netherlands,Europe,27,4,3,23,8,11,16,Terrorism
1944-10-30 00:00:00,United States Army Air Forces - USAAF,Flight,Military / Government,United Kingdom,Europe,11,5,5,6,6,11,0,Terrorism
1944-11-11 00:00:00,United States Army Air Forces - USAAF,Landing (descent or approach),Military / Government,United States of America,North America,11,2,2,9,9,11,0,Human Factor
1944-11-11 00:00:00,United States Army Air Forces - USAAF,Flight,Military / Government,World,World,11,11,11,0,0,11,0,Unknown
1944-11-13 00:00:00,United States Army Air Forces - USAAF,Takeoff (climb),Operational,United States of America,North America,11,2,2,9,9,11,0,Unknown
1944-11-29 00:00:00,British Overseas Airways Corporation - BOAC,Flight,Commercial,Kenya,Africa,11,4,4,7,7,11,0,Unknown
1944-12-10 00:00:00,United States Army Air Forces - USAAF,Flight,Military / Government,United Kingdom,Europe,11,7,7,4,4,11,0,Human Factor
1944-12-11 00:00:00,United States Army Air Forces - USAAF,Flight,Military / Government,France,Europe,11,11,11,0,0,11,0,Unknown
1945-01-09 00:00:00,Royal Canadian Air Force - RCAF,Flight,Operational,Canada,North America,11,11,11,0,0,11,0,Unknown
1945-01-23 00:00:00,Royal Australian Air Force - RAAF,Flight,Military / Government,Indonesia,Asia,11,11,11,0,0,11,0,Terrorism
1945-02-05 00:00:00,United States Army Air Forces - USAAF,Flight,Military / Government,Italy,Europe,11,11,11,0,0,11,0,Unknown
1945-02-28 00:00:00,United States Army Air Forces - USAAF,Flight,Military / Government,Italy,Europe,11,11,11,0,0,11,0,Terrorism
1945-03-22 00:00:00,United States Navy - USN,Flight,Operational,United States of America,North America,11,11,11,0,0,11,0,Technical Failure
1945-04-19 00:00:00,Aeroflot - Russian International Airlines,Flight,Commercial,Poland,Europe,13,6,6,7,5,11,2,Human Factor
1945-04-20 00:00:00,Royal Air Force - RAF,Flight,Military / Government,Denmark,Europe,11,11,11,0,0,11,0,Human Factor
1945-04-27 00:00:00,United States Army Air Forces - USAAF,Flight,Military / Government,United States of America,North America,11,5,5,6,6,11,0,Unknown
1945-05-04 00:00:00,United States Army Air Forces - USAAF,Flight,Military / Government,Palau,Asia,11,11,11,0,0,11,0,Terrorism
1945-05-20 00:00:00,Royal Australian Air Force - RAAF,Takeoff (climb),Military / Government,Australia,Oceania,11,11,11,0,0,11,0,Other
1945-05-21 00:00:00,Royal Australian Air Force - RAAF,Flight,Military / Government,Indonesia,Asia,11,11,11,0,0,11,0,Unknown
1945-06-01 00:00:00,Royal Canadian Air Force - RCAF,Flight,Operational,Canada,North America,11,11,11,0,0,11,0,Human Factor
1946-01-29 00:00:00,United States Army Air Forces - USAAF,Landing (descent or approach),Military / Government,China,Asia,11,4,4,7,7,11,0,Technical Failure
1946-01-30 00:00:00,Royal Air Force - RAF,Flight,Military / Government,France,Europe,11,4,4,7,7,11,0,Weather
1946-04-02 00:00:00,Royal Air Force - RAF,Flight,Military / Government,Italy,Europe,12,4,3,8,8,11,1,Human Factor
1946-04-04 00:00:00,United States Navy - USN,Flight,Military / Government,United States of America,North America,11,3,3,8,8,11,0,Human Factor
1946-05-17 00:00:00,United States Army Air Forces - USAAF,Flight,Military / Government,India,Asia,11,3,3,8,8,11,0,Unknown
1946-07-28 00:00:00,United States Navy - USN,Flight,Military / Government,Philippines,Asia,11,11,11,0,0,11,0,Human Factor
1946-08-29 00:00:00,United States Army Air Forces - USAAF,Flight,Military / Government,France,Europe,11,4,4,7,7,11,0,Human Factor
1946-10-17 00:00:00,Royal Air Force - RAF,Flight,Military / Government,Pakistan,Asia,11,3,3,8,8,11,0,Other
1946-11-13 00:00:00,Western Airlines,Flight,Commercial,United States of America,North America,11,3,3,8,8,11,0,Weather
1946-12-25 00:00:00,Central Air Transport - China,Landing (descent or approach),Commercial,China,Asia,11,4,4,7,7,11,0,Human Factor
1947-01-03 00:00:00,Panair do Brasil,Flight,Commercial,Brazil,South America,14,3,3,11,8,11,3,Unknown
1947-02-06 00:00:00,Aerovías Cubanas Internacionales,Flight,Commercial,Spain,Europe,11,8,8,3,3,11,0,Human Factor
1947-03-18 00:00:00,Royal Air Force - RAF,Takeoff (climb),Military / Government,Sri Lanka,Asia,20,4,4,16,7,11,9,Technical Failure
1947-05-04 00:00:00,TACA International Airlines - Transportes Aéreos Centro Americanos,Takeoff (climb),Commercial,Costa Rica,Central America,11,2,2,9,9,11,0,Terrorism
1947-08-02 00:00:00,British South American Airways - BSAA,Flight,Commercial,Argentina,South America,11,5,5,6,6,11,0,Weather
1948-01-20 00:00:00,China National Aviation Corporation - CNAC,Takeoff (climb),Humanitarian,China,Asia,54,3,0,51,11,11,43,Other
1948-01-27 00:00:00,United States Air Force - USAF,Flight,Military / Government,France,Europe,11,3,3,8,8,11,0,Weather
1948-04-30 00:00:00,Royal Air Force - RAF,Flight,Military / Government,France,Europe,11,4,4,7,7,11,0,Weather
1948-11-01 00:00:00,United States Air Force - USAF,Flight,Military / Government,United States of America,North America,11,11,11,0,0,11,0,Unknown
1949-03-12 00:00:00,Aeroflot - Russian International Airlines,Flight,Commercial,Uzbekistan,Asia,11,5,5,6,6,11,0,Human Factor
1949-03-14 00:00:00,Union of Burma Airways,Flight,Commercial,Myanmar,Asia,11,2,2,9,9,11,0,Unknown
1949-05-09 00:00:00,Ecuadorian Air Force - Fuerza Aérea Ecuatoriana,Landing (descent or approach),Military / Government,Ecuador,South America,11,5,5,6,6,11,0,Unknown
1949-11-03 00:00:00,United States Air Force - USAF,Flight,Military / Government,Bermuda,North America,11,11,11,0,0,11,0,Technical Failure
1949-12-22 00:00:00,United States Air Force - USAF,Takeoff (climb),Military / Government,United States of America,North America,11,11,11,0,0,11,0,Unknown
1950-03-22 00:00:00,Argentinian Air Force - Fuerza Aérea Argentina,Flight,Military / Government,Chile,South America,11,11,11,0,0,11,0,Human Factor
1950-06-07 00:00:00,United States Air Force - USAF,Flight,Military / Government,World,World,13,13,11,0,0,11,2,Unknown
1950-09-06 00:00:00,United States Air Force - USAF,Takeoff (climb),Military / Government,Japan,Asia,11,3,3,8,8,11,0,Unknown
1950-12-18 00:00:00,United States Navy - USN,Flight,Operational,Canada,North America,11,11,11,0,0,11,0,Human Factor
1951-03-26 00:00:00,Aerolineas Argentinas,Landing (descent or approach),Commercial,Argentina,South America,24,4,3,20,8,11,13,Unknown
1951-04-26 00:00:00,United States Air Force - USAF,Landing (descent or approach),Military / Government,Portugal,Europe,16,16,11,0,0,11,5,Technical Failure
1951-04-28 00:00:00,United Airlines,Landing (descent or approach),Commercial,United States of America,North America,11,3,3,8,8,11,0,Weather
1951-07-07 00:00:00,United States Air Force - USAF,Flight,Operational,United Kingdom,Europe,11,11,11,0,0,11,0,Unknown
1951-11-27 00:00:00,United States Navy - USN,Flight,Operational,United States of America,North America,11,11,11,0,0,11,0,Unknown
1952-04-08 00:00:00,United States Air Force - USAF,Flight,Military / Government,United States of America,North America,11,3,3,8,8,11,0,Human Factor
1952-05-05 00:00:00,Fred. Olsen's Air Transport - Fred. Olsen Flyselskap,Flight,Commercial,Norway,Europe,29,3,3,26,8,11,18,Human Factor
1952-05-13 00:00:00,United States Air Force - USAF,Flight,Operational,United States of America,North America,17,17,11,0,0,11,6,Human Factor
1952-06-24 00:00:00,United States Air Force - USAF,Landing (descent or approach),Operational,United Kingdom,Europe,11,11,11,0,0,11,0,Human Factor
1952-06-25 00:00:00,Royal Air Force - RAF,Flight,Operational,United Kingdom,Europe,13,11,9,2,2,11,2,Human Factor
1952-09-13 00:00:00,United States Air Force - USAF,Flight,Military / Government,South Korea,Asia,12,12,11,0,0,11,1,Weather
1952-09-13 00:00:00,United States Air Force - USAF,Flight,Military / Government,North Korea,Asia,12,12,11,0,0,11,1,Terrorism
1952-10-08 00:00:00,United States Air Force - USAF,Flight,Operational,United States of America,North America,11,11,11,0,0,11,0,Human Factor
1952-10-23 00:00:00,French Air Force - Armée de l'Air,Takeoff (climb),Operational,France,Europe,11,10,10,1,1,11,0,Technical Failure
1952-10-31 00:00:00,United States Air Force - USAF,Landing (descent or approach),Military / Government,Japan,Asia,14,14,11,0,0,11,3,Technical Failure
1952-11-06 00:00:00,United States Air Force - USAF,Flight,Operational,United Kingdom,Europe,11,11,11,0,0,11,0,Weather
1952-11-12 00:00:00,United States Navy - USN,Flight,Operational,United States of America,North America,11,11,11,0,0,11,0,Unknown
1952-11-15 00:00:00,United States Air Force - USAF,Takeoff (climb),Military / Government,South Korea,Asia,18,2,2,16,9,11,7,Unknown
1953-02-01 00:00:00,United States Navy - USN,Flight,Military / Government,Japan,Asia,11,11,11,0,0,11,0,Human Factor
1953-03-03 00:00:00,Canadian Pacific Airlines - CP Air,Takeoff (climb),Operational,Pakistan,Asia,11,5,5,6,6,11,0,Human Factor
1953-03-18 00:00:00,Kasernierte Volkspolizei,Takeoff (climb),Military / Government,Germany,Europe,11,11,11,0,0,11,0,Unknown
1953-03-22 00:00:00,United States Navy - USN,Flight,Military / Government,World,World,11,4,4,7,7,11,0,Unknown
1953-07-01 00:00:00,Aeroflot - Russian International Airlines,Flight,Commercial,Russia,Asia,11,3,3,8,8,11,0,Human Factor
1953-12-29 00:00:00,French Air Force - Armée de l'Air,Flight,Military / Government,Spain,Europe,11,9,9,2,2,11,0,Human Factor
1954-11-01 00:00:00,Spanish Air Force - Ejército del Aire,Flight,Military / Government,Spain,Europe,11,3,3,8,8,11,0,Unknown
1955-02-17 00:00:00,United States Navy - USN,Landing (descent or approach),Operational,United States of America,North America,11,11,11,0,0,11,0,Human Factor
1955-06-25 00:00:00,Indian Air Force - Bharatiya Vayu Sena,Flight,Military / Government,India,Asia,11,11,11,0,0,11,0,Human Factor
1955-09-17 00:00:00,Argentinian Air Force - Fuerza Aérea Argentina,Flight,Military / Government,Argentina,South America,11,11,11,0,0,11,0,Unknown
1955-09-26 00:00:00,United States Navy - USN,Flight,Other,World,World,11,9,9,2,2,11,0,Weather
1955-11-20 00:00:00,United States Air Force - USAF,Takeoff (climb),Military / Government,Japan,Asia,11,9,9,2,2,11,0,Technical Failure
1956-02-27 00:00:00,United States Air Force - USAF,Flight,Operational,United States of America,North America,11,11,11,0,0,11,0,Unknown
1956-06-26 00:00:00,United States Air Force - USAF,Takeoff (climb),Military / Government,United States of America,North America,11,11,11,0,0,11,0,Technical Failure
1957-04-02 00:00:00,United States Navy - USN,Takeoff (climb),Operational,United States of America,North America,11,11,11,0,0,11,0,Other
1957-07-19 00:00:00,United States Navy - USN,Flight,Military / Government,Italy,Europe,11,11,11,0,0,11,0,Unknown
1957-08-12 00:00:00,French Air Force - Armée de l'Air,Landing (descent or approach),Military / Government,Tunisia,Africa,11,11,11,0,0,11,0,Unknown
1958-01-08 00:00:00,Peruvian Air Force - Fuerza Aérea del Perú,Takeoff (climb),Military / Government,Peru,South America,11,4,4,7,7,11,0,Unknown
1958-01-21 00:00:00,TAM Bolivia - Transporte Aéreo Militar Boliviano,Landing (descent or approach),Military / Government,Bolivia,South America,11,3,3,8,8,11,0,Unknown
1958-05-20 00:00:00,Capital Airlines,Flight,Commercial,United States of America,North America,11,4,4,7,7,11,0,Human Factor
1958-08-25 00:00:00,Servicios Aéreos de Chiapas,Landing (descent or approach),Commercial,Mexico,Central America,11,2,2,9,9,11,0,Human Factor
1958-10-18 00:00:00,United States Navy - USN,Landing (descent or approach),Military / Government,Canada,North America,29,4,3,25,8,11,18,Human Factor
1958-12-09 00:00:00,Royal Air Force - RAF,Flight,Military / Government,World,World,11,10,10,1,1,11,0,Human Factor
1959-04-11 00:00:00,Portuguese Air Force - Força Aerea Portuguesa,Takeoff (climb),Military / Government,Portugal,Europe,11,2,2,9,9,11,0,Unknown
1959-12-31 00:00:00,Lloyd Aéreo Boliviano - LAB Airlines,Takeoff (climb),Commercial,Bolivia,South America,11,4,4,7,7,11,0,Unknown
1960-09-16 00:00:00,French Air Force - Armée de l'Air,Flight,Operational,Algeria,Africa,11,11,11,0,0,11,0,Human Factor
1960-10-14 00:00:00,Aerolinee Itavia,Flight,Commercial,Italy,Europe,11,4,4,7,7,11,0,Human Factor
1961-11-09 00:00:00,United States Navy - USN,Flight,Military / Government,World,World,11,11,11,0,0,11,0,Technical Failure
1962-03-08 00:00:00,Turkish Airlines - THY Türk Hava Yollari,Flight,Commercial,Turkey,Asia,11,3,3,8,8,11,0,Human Factor
1962-03-20 00:00:00,French Air Force - Armée de l'Air,Landing (descent or approach),Military / Government,Algeria,Africa,11,3,3,8,8,11,0,Human Factor
1962-07-06 00:00:00,Aeroflot - Russian International Airlines,Flight,Commercial,Uzbekistan,Asia,38,5,0,33,11,11,27,Technical Failure
1962-10-25 00:00:00,Aeroflot - Russian International Airlines,Takeoff (climb),Specialised Services,Russia,Asia,11,5,5,6,6,11,0,Human Factor
1963-05-01 00:00:00,Nitto Airlines,Flight,Commercial,Japan,Asia,11,2,2,9,9,11,0,Unknown
1964-05-20 00:00:00,Philippine Airlines - PAL,Flight,Commercial,Philippines,Asia,11,1,1,10,10,11,0,Human Factor
1965-03-05 00:00:00,Royal Thai Navy - Kong Thap Ruea Thai,Takeoff (climb),Military / Government,Taiwan,Asia,11,2,2,9,9,11,0,Unknown
1965-06-08 00:00:00,Spanish Air Force - Ejército del Aire,Flight,Operational,Spain,Europe,11,2,2,9,9,11,0,Unknown
1965-07-17 00:00:00,Japan Maritime Self-Defense Force - Kaijō Jieitai,Flight,Military / Government,Japan,Asia,11,11,11,0,0,11,0,Unknown
1965-11-07 00:00:00,Argentinian Navy - Armada Argentina,Flight,Operational,Brazil,South America,11,11,11,0,0,11,0,Unknown
1966-01-06 00:00:00,SATENA - Servicio de Aeronavegacion a Territorios Nacionales,Flight,Commercial,Colombia,South America,11,2,2,9,9,11,0,Human Factor
1966-01-14 00:00:00,Aeroflot - Russian International Airlines,Flight,Commercial,Uzbekistan,Asia,11,2,2,9,9,11,0,Human Factor
1966-04-09 00:00:00,United States Navy - USN,Flight,Operational,World,World,11,4,4,7,7,11,0,Technical Failure
1966-05-18 00:00:00,United States Air Force - USAF,Takeoff (climb),Military / Government,Japan,Asia,11,5,5,6,6,11,0,Human Factor
1967-03-17 00:00:00,Iran Air,Landing (descent or approach),Commercial,Iran,Asia,28,4,0,24,11,11,17,Human Factor
1967-08-31 00:00:00,French Navy,Flight,Military / Government,Norway,Europe,11,11,11,0,0,11,0,Human Factor
1967-09-04 00:00:00,United States Air Force - USAF,Landing (descent or approach),Military / Government,Vietnam,Asia,11,3,3,8,8,11,0,Human Factor
1967-12-29 00:00:00,United States Air Force - USAF,Flight,Military / Government,Vietnam,Asia,11,11,11,0,0,11,0,Unknown
1968-04-19 00:00:00,Royal Air Force - RAF,Flight,Operational,United Kingdom,Europe,11,11,11,0,0,11,0,Human Factor
1968-05-07 00:00:00,Royal Air Force - RAF,Landing (descent or approach),Military / Government,Libya,Africa,11,4,4,7,7,11,0,Human Factor
1968-07-08 00:00:00,Saudi Arabian Airlines - SAUDIA,Landing (descent or approach),Commercial,Saudi Arabia,Asia,11,3,3,8,8,11,0,Human Factor
1968-09-24 00:00:00,United States Air Force - USAF,Landing (descent or approach),Military / Government,United States of America,North America,56,4,0,52,11,11,45,Technical Failure
1968-10-11 00:00:00,CSA Czech Airlines - Československé Státní Aerolinie,Takeoff (climb),Commercial,Czech Republic,Europe,40,4,3,36,8,11,29,Technical Failure
1968-11-07 00:00:00,Philippine Air Force - Hukbong Himpapawid NG Pilipinas,Flight,Military / Government,Philippines,Asia,11,5,5,6,6,11,0,Unknown
1969-01-06 00:00:00,Allegheny Airlines,Landing (descent or approach),Commercial,United States of America,North America,28,3,2,25,9,11,17,Human Factor
1969-03-28 00:00:00,Aeroflot - Russian International Airlines,Flight,Commercial,Tajikistan,Asia,13,3,2,10,9,11,2,Human Factor
1969-05-05 00:00:00,Argentinian Air Force - Fuerza Aérea Argentina,Landing (descent or approach),Military / Government,Argentina,South America,11,3,3,8,8,11,0,Unknown
1969-12-05 00:00:00,Troy G. Hawkins,Flight,Business,United States of America,North America,11,2,2,9,9,11,0,Technical Failure
1970-01-29 00:00:00,Aeroflot - Russian International Airlines,Landing (descent or approach),Commercial,Russia,Asia,38,6,3,32,8,11,27,Human Factor
1970-03-06 00:00:00,Bavaria Fluggesellschaft,Landing (descent or approach),Commercial,Switzerland,Europe,11,2,2,9,9,11,0,Technical Failure
1970-04-10 00:00:00,United States Air Force - USAF,Takeoff (climb),Military / Government,Japan,Asia,11,8,8,3,3,11,0,Technical Failure
1970-05-15 00:00:00,Aeroflot - Russian International Airlines,Landing (descent or approach),Operational,Moldova,Europe,11,11,11,0,0,11,0,Human Factor
1970-09-08 00:00:00,Trans International Airlines - TIA,Takeoff (climb),Operational,United States of America,North America,11,11,11,0,0,11,0,Human Factor
1971-01-27 00:00:00,Cessnyca,Landing (descent or approach),Commercial,Colombia,South America,11,1,1,10,10,11,0,Unknown
1971-07-16 00:00:00,Japan Maritime Self-Defense Force - Kaijō Jieitai,Flight,Military / Government,Japan,Asia,11,11,11,0,0,11,0,Unknown
1971-08-16 00:00:00,Indian Air Force - Bharatiya Vayu Sena,Flight,Operational,India,Asia,11,3,3,8,8,11,0,Unknown
1971-09-03 00:00:00,Soviet Navy - Voyenno-morskoy flot CCCP,Landing (descent or approach),Operational,Russia,Asia,11,11,11,0,0,11,0,Human Factor
1971-11-12 00:00:00,United States Air Force - USAF,Takeoff (climb),Operational,United States of America,North America,12,4,4,8,7,11,1,Unknown
1972-05-03 00:00:00,United States Air Force - USAF,Landing (descent or approach),Military / Government,Suriname,South America,11,11,11,0,0,11,0,Human Factor
1972-09-10 00:00:00,Ethiopian Airlines,Landing (descent or approach),Commercial,Ethiopia,Africa,11,3,3,8,8,11,0,Technical Failure
1972-11-17 00:00:00,Metro Air System,Flight,Commercial,United States of America,North America,11,1,1,10,10,11,0,Other
1973-04-12 00:00:00,NASA - National Aeronautics %26 Space Administration,Landing (descent or approach),Specialised Services,United States of America,North America,11,3,3,8,8,11,0,Human Factor
1973-05-02 00:00:00,Portuguese Air Force - Força Aerea Portuguesa,Landing (descent or approach),Military / Government,Mozambique,Africa,11,7,7,4,4,11,0,Human Factor
1973-05-19 00:00:00,Cambodia Air Commercial,Takeoff (climb),Commercial,Cambodia,Asia,11,2,2,9,9,11,0,Terrorism
1973-06-05 00:00:00,Transportes Aéreos de Nayarit,Takeoff (climb),Commercial,Mexico,Central America,12,2,2,10,9,11,1,Unknown
1973-08-26 00:00:00,Aerovias Regionales,Flight,Commercial,Colombia,South America,11,2,2,9,9,11,0,Unknown
1973-09-27 00:00:00,Texas International Airlines,Flight,Commercial,United States of America,North America,11,3,3,8,8,11,0,Human Factor
1974-04-11 00:00:00,Island Air USA,Flight,Commercial,United States of America,North America,11,1,1,10,10,11,0,Human Factor
1974-09-09 00:00:00,West Coast Air Services,Flight,Commercial,Canada,North America,11,2,2,9,9,11,0,Unknown
1974-12-25 00:00:00,Lane Xang Airlines,Flight,Commercial,Cambodia,Asia,11,3,3,8,8,11,0,Unknown
1975-08-09 00:00:00,Aeroflot - Russian International Airlines,Landing (descent or approach),Specialised Services,Russia,Asia,11,5,5,6,6,11,0,Human Factor
1975-10-23 00:00:00,Connair,Landing (descent or approach),Commercial,Australia,Oceania,11,3,3,8,8,11,0,Human Factor
1976-06-06 00:00:00,Sabah Air,Landing (descent or approach),Military / Government,Malaysia,Asia,11,1,1,10,10,11,0,Human Factor
1976-09-15 00:00:00,Argentinian Air Force - Fuerza Aérea Argentina,Flight,Specialised Services,Antarctica,Antarctica,11,10,10,1,1,11,0,Human Factor
1976-09-26 00:00:00,Johnson %26 Johnson,Landing (descent or approach),Business,United States of America,North America,11,3,3,8,8,11,0,Human Factor
1977-01-19 00:00:00,Spanish Air Force - Ejército del Aire,Landing (descent or approach),Military / Government,Spain,Europe,11,5,5,6,6,11,0,Human Factor
1978-07-12 00:00:00,Ecuadorian Air Force - Fuerza Aérea Ecuatoriana,Flight,Military / Government,Ecuador,South America,11,5,5,6,6,11,0,Unknown
1978-09-03 00:00:00,Airwest Airlines,Landing (descent or approach),Commercial,Canada,North America,13,2,2,11,9,11,2,Technical Failure
1978-10-07 00:00:00,Acme Plywood %26 Veneer Company,Flight,Business,Philippines,Asia,10,2,5,8,6,11,-1,Weather
1978-10-22 00:00:00,Solomon Airlines,Flight,Commercial,Solomon Islands,Oceania,11,2,2,9,9,11,0,Unknown
1979-08-24 00:00:00,Aeroflot - Russian International Airlines,Landing (descent or approach),Operational,Russia,Asia,16,6,6,10,5,11,5,Technical Failure
1981-02-24 00:00:00,Votec Taxi Aéreo,Landing (descent or approach),Commercial,Brazil,South America,14,2,2,12,9,11,3,Human Factor
1981-08-01 00:00:00,Aeroflot - Russian International Airlines,Flight,Specialised Services,Russia,Asia,11,7,7,4,4,11,0,Human Factor
1981-12-05 00:00:00,Jump Hawaii Club,Flight,Operational,United States of America,North America,12,1,1,11,10,11,1,Human Factor
1982-04-02 00:00:00,United States Navy - USN,Landing (descent or approach),Military / Government,Greece,Europe,11,11,11,0,0,11,0,Human Factor
1982-08-14 00:00:00,Aeroflot - Russian International Airlines,Takeoff (climb),Commercial,Georgia,Asia,11,2,2,9,9,11,0,Human Factor
1983-04-26 00:00:00,Japan Maritime Self-Defense Force - Kaijō Jieitai,Takeoff (climb),Operational,Japan,Asia,14,14,11,0,0,11,3,Unknown
1983-08-21 00:00:00,Command Aviation,Flight,Humanitarian,United States of America,North America,26,2,2,24,9,11,15,Human Factor
1983-09-14 00:00:00,CAAC - Civil Aviation Administration of China,Taxiing,Commercial,China,Asia,106,6,0,100,11,11,95,Unknown
1984-01-22 00:00:00,Guatemalan Air Force - Fuerza Aérea Guatemalteca,Flight,Military / Government,Guatemala,Central America,11,2,2,9,9,11,0,Unknown
1984-08-18 00:00:00,Leicester Aircraft Preservation Society,Flight,Operational,United Kingdom,Europe,14,2,2,12,9,11,3,Technical Failure
1984-09-16 00:00:00,Aeroklub Polskiej Rzeczypospolitej Ludowej - APRL,Takeoff (climb),Operational,Poland,Europe,25,3,0,22,11,11,14,Unknown
1984-10-27 00:00:00,Soviet Air Force - Voyenno-vozdushnye sily CCCP,Landing (descent or approach),Military / Government,Afghanistan,Asia,11,7,7,4,4,11,0,Terrorism
1985-04-15 00:00:00,Thai Airways International,Landing (descent or approach),Commercial,Thailand,Asia,11,7,7,4,4,11,0,Human Factor
1986-04-02 00:00:00,United States Air Force - USAF,Flight,Specialised Services,United States of America,North America,11,11,11,0,0,11,0,Weather
1986-10-15 00:00:00,Chilean Navy,Flight,Military / Government,Chile,South America,11,2,2,9,9,11,0,Unknown
1986-12-27 00:00:00,Sunflower Airlines,Landing (descent or approach),Commercial,Fiji Islands,Oceania,14,2,2,12,9,11,3,Technical Failure
1986-12-27 00:00:00,Nicaraguayan Air Force - Fuerza Aérea - Ejercito de Nicaragua,Flight,Military / Government,Nicaragua,Central America,11,2,2,9,9,11,0,Unknown
1987-07-30 00:00:00,Belize Air International,Takeoff (climb),Operational,Mexico,Central America,12,4,3,8,8,11,1,Human Factor
1988-01-18 00:00:00,Aeroflot - Russian International Airlines,Landing (descent or approach),Commercial,Turkmenistan,Asia,146,9,0,137,11,11,135,Human Factor
1988-06-03 00:00:00,Ecuadorian Air Force - Fuerza Aérea Ecuatoriana,Landing (descent or approach),Military / Government,Ecuador,South America,11,2,2,9,9,11,0,Unknown
1989-02-23 00:00:00,Rheintalflug,Landing (descent or approach),Commercial,Switzerland,Europe,11,2,2,9,9,11,0,Human Factor
1989-04-19 00:00:00,SATENA - Servicio de Aeronavegacion a Territorios Nacionales,Flight,Military / Government,Venezuela,South America,11,1,1,10,10,11,0,Human Factor
1989-06-11 00:00:00,Scenic Air Tours,Flight,Commercial,United States of America,North America,11,1,1,10,10,11,0,Human Factor
1989-09-23 00:00:00,Vayudoot,Flight,Commercial,India,Asia,11,3,3,8,8,11,0,Technical Failure
1990-05-11 00:00:00,Air North Queensland,Landing (descent or approach),Commercial,Australia,Oceania,11,1,1,10,10,11,0,Human Factor
1990-10-24 00:00:00,Cubana de Aviación,Landing (descent or approach),Commercial,Cuba,Central America,31,7,2,24,9,11,20,Human Factor
1991-02-10 00:00:00,TVA - Travel Air,Flight,Commercial,Mexico,Central America,11,3,3,8,8,11,0,Human Factor
1992-09-19 00:00:00,AVESCA - Aerovias Especiales de Carga,Landing (descent or approach),Operational,Colombia,South America,19,2,2,17,9,11,8,Technical Failure
1993-04-02 00:00:00,Linea Aeropostal Venezolana - LAV,Flight,Specialised Services,Venezuela,South America,11,3,3,8,8,11,0,Unknown
1993-06-07 00:00:00,SASCO Air Lines,Takeoff (climb),Commercial,Sudan,Africa,11,2,2,9,9,11,0,Human Factor
1993-07-08 00:00:00,Russian Air Force - Voyenno-vozdushnye sily Rossii,Takeoff (climb),Operational,Russia,Asia,11,8,8,3,3,11,0,Technical Failure
1994-04-25 00:00:00,Dirgantara Air Service,Flight,Commercial,Indonesia,Asia,11,1,1,10,10,11,0,Human Factor
1994-07-09 00:00:00,Government of Punjab,Flight,Military / Government,India,Asia,11,3,3,8,8,11,0,Human Factor
1995-09-10 00:00:00,Peninsula Sky Divers,Takeoff (climb),Humanitarian,United States of America,North America,11,1,1,10,10,11,0,Technical Failure
1995-11-13 00:00:00,Nigeria Airways,Landing (descent or approach),Commercial,Nigeria,Africa,138,14,0,124,11,11,127,Human Factor
1996-02-12 00:00:00,Haïti Air Express,Takeoff (climb),Commercial,Haiti,Central America,15,2,2,13,9,11,4,Technical Failure
1997-12-22 00:00:00,Renan,Flight,Operational,Angola,Africa,11,5,5,6,6,11,0,Terrorism
1998-06-18 00:00:00,PropAir,Landing (descent or approach),Commercial,Canada,North America,11,2,2,9,9,11,0,Technical Failure
1998-08-23 00:00:00,Air Anguilla,Landing (descent or approach),Commercial,Dominica,Central America,11,1,1,10,10,11,0,Unknown
1998-11-01 00:00:00,Living Water Teaching Ministries,Landing (descent or approach),Humanitarian,Guatemala,Central America,18,2,2,16,9,11,7,Human Factor
1999-02-03 00:00:00,Airlink Papua New Guinea,Flight,Commercial,Papua New Guinea,Oceania,11,1,1,10,10,11,0,Weather
1999-06-01 00:00:00,American Airlines,Landing (descent or approach),Commercial,United States of America,North America,145,6,1,139,10,11,134,Human Factor
2003-03-01 00:00:00,Borki Air Club,Flight,Humanitarian,Russia,Asia,25,2,2,23,9,11,14,Other
2005-09-05 00:00:00,Kavatshi Airlines,Landing (descent or approach),Operational,Democratic Republic of Congo,Africa,11,4,4,7,7,11,0,Human Factor
2006-01-09 00:00:00,Islamic Revolutionary Guard Corps,Landing (descent or approach),Military / Government,Iran,Asia,11,3,3,8,8,11,0,Technical Failure
2007-03-23 00:00:00,TransAviaExport Airlines,Takeoff (climb),Operational,Somalia,Africa,11,7,7,4,4,11,0,Terrorism
2008-04-16 00:00:00,Government of Guinea Equatorial,Landing (descent or approach),Military / Government,Equatorial Guinea,Africa,11,5,5,6,6,11,0,Unknown
2008-08-24 00:00:00,Aéreo Ruta Maya,Flight,Commercial,Guatemala,Central America,14,2,2,12,9,11,3,Technical Failure
2008-08-25 00:00:00,Philippine Air Force - Hukbong Himpapawid NG Pilipinas,Takeoff (climb),Military / Government,Philippines,Asia,11,9,9,2,2,11,0,Unknown
2009-03-09 00:00:00,Aerolift,Takeoff (climb),Operational,Uganda,Africa,11,4,4,7,7,11,0,Unknown
2009-04-17 00:00:00,Mimika Air,Flight,Commercial,Indonesia,Asia,11,2,2,9,9,11,0,Human Factor
2009-10-09 00:00:00,Transporte Aéreo Militar de Uruguay - TAMU,Flight,Military / Government,Haiti,Central America,11,2,2,9,9,11,0,Unknown
2009-11-01 00:00:00,Russian Government,Takeoff (climb),Operational,Russia,Asia,11,7,7,4,4,11,0,Human Factor
2009-11-06 00:00:00,Russian Navy - Voyenno-morskoy Flot Rossii,Landing (descent or approach),Operational,Russia,Asia,11,11,11,0,0,11,0,Unknown
2010-06-19 00:00:00,Aéro-Service,Flight,Commercial,Congo,Africa,11,2,2,9,9,11,0,Unknown
2011-08-09 00:00:00,Avis-Amur,Flight,Operational,Russia,Asia,11,9,9,2,2,11,0,Technical Failure
2012-12-05 00:00:00,South African Air Force,Flight,Military / Government,South Africa,Africa,11,6,6,5,5,11,0,Human Factor
2013-02-11 00:00:00,Government of Guinea,Landing (descent or approach),Military / Government,Liberia,Africa,11,5,5,6,6,11,0,Human Factor
2013-10-19 00:00:00,Paraclub Namur,Flight,Humanitarian,Belgium,Europe,11,1,1,10,10,11,0,Human Factor
2014-02-21 00:00:00,Libyan Air Cargo,Landing (descent or approach),Humanitarian,Tunisia,Africa,11,6,6,5,5,11,0,Unknown
2014-07-05 00:00:00,Omega Skydiving School,Takeoff (climb),Humanitarian,Poland,Europe,12,1,1,11,10,11,1,Technical Failure
2015-07-31 00:00:00,Colombian Air Force - Fuerza Aérea Colombiana,Flight,Military / Government,Colombia,South America,11,11,11,0,0,11,0,Technical Failure
2015-10-02 00:00:00,United States Air Force - USAF,Takeoff (climb),Military / Government,Afghanistan,Asia,11,4,4,7,7,11,0,Human Factor
2017-11-15 00:00:00,Coastal Aviation,Flight,Commercial,Tanzania,Africa,11,1,1,10,10,11,0,Human Factor
2018-03-11 00:00:00,Basaran Holding,Flight,Business,Iran,Asia,11,3,3,8,8,11,0,Technical Failure
2019-06-21 00:00:00,Oahu Parachute Center,Takeoff (climb),Humanitarian,United States of America,North America,11,1,1,10,10,11,0,Human Factor
2021-05-21 00:00:00,Nigerian Air Force,Landing (descent or approach),Military / Government,Nigeria,Africa,11,4,4,7,7,11,0,Unknown
2022-05-11 00:00:00,Caverton Helicopters,Flight,Commercial,Cameroon,Africa,11,2,2,9,9,11,0,Unknown
1933-12-30 00:00:00,Imperial Airways,Flight,Commercial,Belgium,Europe,10,2,2,8,8,10,0,Human Factor
1934-01-15 00:00:00,Air France,Flight,Commercial,France,Europe,10,3,3,7,7,10,0,Weather
1934-07-27 00:00:00,Aeroflot - Russian International Airlines,Landing (descent or approach),Commercial,Kazakhstan,Asia,10,2,2,8,8,10,0,Human Factor
1935-06-24 00:00:00,Servicio Aéreo Colombiano - SACO,Takeoff (climb),Commercial,Colombia,South America,13,2,2,11,8,10,3,Weather
1936-07-31 00:00:00,Jersey Airways,Flight,Commercial,United Kingdom,Europe,10,2,2,8,8,10,0,Technical Failure
1936-09-05 00:00:00,Pittsburgh Skyways,Takeoff (climb),Commercial,United States of America,North America,11,1,1,10,9,10,1,Human Factor
1937-11-12 00:00:00,Deutsche Lufthansa,Landing (descent or approach),Commercial,Germany,Europe,12,2,2,10,8,10,2,Human Factor
1938-01-10 00:00:00,Northwest Airlines,Flight,Commercial,United States of America,North America,10,2,2,8,8,10,0,Technical Failure
1938-05-24 00:00:00,United Airlines,Landing (descent or approach),Commercial,United States of America,North America,10,3,3,7,7,10,0,Technical Failure
1938-12-08 00:00:00,Japan Air Transport,Flight,Commercial,Japan,Asia,12,3,3,9,7,10,2,Technical Failure
1939-01-13 00:00:00,Syndicato Condor,Flight,Commercial,Brazil,South America,10,3,3,7,7,10,0,Human Factor
1939-02-24 00:00:00,Reich Minister for Aviation -,Flight,Commercial,France,Europe,10,3,3,7,7,10,0,Human Factor
1939-03-18 00:00:00,Boeing Airplane Company,Flight,Specialised Services,United States of America,North America,10,10,10,0,0,10,0,Other
1940-02-10 00:00:00,Ala Littoria,Flight,Commercial,Italy,Europe,10,6,6,4,4,10,0,Weather
1940-04-13 00:00:00,German Air Force - Deutsche Luftwaffe,Flight,Military / Government,Norway,Europe,10,10,10,0,0,10,0,Terrorism
1940-08-13 00:00:00,Royal Australian Air Force - RAAF,Landing (descent or approach),Military / Government,Australia,Oceania,10,4,4,6,6,10,0,Unknown
1940-11-04 00:00:00,United Airlines,Flight,Commercial,United States of America,North America,10,3,3,7,7,10,0,Other
1940-12-04 00:00:00,United Airlines,Landing (descent or approach),Commercial,United States of America,North America,16,3,3,13,7,10,6,Human Factor
1941-01-15 00:00:00,Linee Aeree Transcontinentali Italiane - LATI,Flight,Commercial,World,World,10,4,4,6,6,10,0,Technical Failure
1941-03-28 00:00:00,South African Airways -SAA - Suid Afrikaanse Lugdiens - SAL,Flight,Commercial,South Africa,Africa,10,4,4,6,6,10,0,Unknown
1941-09-01 00:00:00,Royal Air Force - RAF,Landing (descent or approach),Military / Government,United Kingdom,Europe,10,4,4,6,6,10,0,Human Factor
1941-09-15 00:00:00,Royal Air Force - RAF,Landing (descent or approach),Military / Government,United Kingdom,Europe,10,10,10,0,0,10,0,Unknown
1942-06-08 00:00:00,United States Navy - USN,Flight,Military / Government,Canada,North America,10,10,10,0,0,10,0,Unknown
1942-06-11 00:00:00,United States Navy - USN,Flight,Operational,Brazil,South America,10,10,10,0,0,10,0,Weather
1942-07-07 00:00:00,Royal Australian Air Force - RAAF,Flight,Military / Government,Australia,Oceania,10,10,10,0,0,10,0,Technical Failure
1942-08-05 00:00:00,Royal Air Force - RAF,Takeoff (climb),Operational,United Kingdom,Europe,10,10,10,0,0,10,0,Technical Failure
1942-08-07 00:00:00,Royal Air Force - RAF,Flight,Military / Government,Egypt,Africa,17,7,0,10,10,10,7,Terrorism
1942-10-30 00:00:00,Royal Air Force - RAF,Flight,Military / Government,Norway,Europe,10,7,7,3,3,10,0,Terrorism
1942-12-06 00:00:00,United States Army Air Forces - USAAF,Flight,Military / Government,France,Europe,10,10,10,0,0,10,0,Terrorism
1942-12-09 00:00:00,United States Army Air Forces - USAAF,Flight,Military / Government,World,World,10,5,5,5,5,10,0,Unknown
1942-12-22 00:00:00,Aeroflot - Russian International Airlines,Landing (descent or approach),Commercial,Russia,Asia,12,5,5,7,5,10,2,Weather
1943-01-02 00:00:00,United States Army Air Forces - USAAF,Flight,Operational,United States of America,North America,10,10,10,0,0,10,0,Unknown
1943-01-12 00:00:00,United States Army Air Forces - USAAF,Flight,Operational,United States of America,North America,10,10,10,0,0,10,0,Unknown
1943-01-24 00:00:00,United States Army Air Forces - USAAF,Flight,Operational,United States of America,North America,10,10,10,0,0,10,0,Weather
1943-01-26 00:00:00,United States Army Air Forces - USAAF,Flight,Military / Government,United States of America,North America,10,10,10,0,0,10,0,Unknown
1943-03-21 00:00:00,United States Army Air Forces - USAAF,Flight,Military / Government,India,Asia,10,10,10,0,0,10,0,Unknown
1943-04-08 00:00:00,Royal Australian Air Force - RAAF,Flight,Military / Government,Australia,Oceania,10,10,10,0,0,10,0,Technical Failure
1943-04-18 00:00:00,Japan Air Self-Defense Force - Kōkū Jieitai,Flight,Military / Government,Papua New Guinea,Oceania,13,8,7,5,3,10,3,Terrorism
1943-04-21 00:00:00,United States Army Air Forces - USAAF,Landing (descent or approach),Military / Government,United States of America,North America,10,2,2,8,8,10,0,Human Factor
1943-05-14 00:00:00,United States Army Air Forces - USAAF,Flight,Military / Government,Netherlands,Europe,10,10,10,0,0,10,0,Terrorism
1943-05-18 00:00:00,United States Navy - USN,Flight,Military / Government,United States of America,North America,10,10,10,0,0,10,0,Unknown
1943-06-13 00:00:00,Royal Air Force - RAF,Flight,Military / Government,World,World,10,10,10,0,0,10,0,Unknown
1943-06-28 00:00:00,United States Army Air Forces - USAAF,Flight,Military / Government,United States of America,North America,10,10,10,0,0,10,0,Human Factor
1943-07-02 00:00:00,United States Navy - USN,Takeoff (climb),Operational,United States of America,North America,10,10,10,0,0,10,0,Unknown
1943-07-10 00:00:00,United States Army Air Forces - USAAF,Flight,Military / Government,Indonesia,Asia,10,10,10,0,0,10,0,Terrorism
1943-07-19 00:00:00,United States Army Air Forces - USAAF,Flight,Military / Government,Papua New Guinea,Oceania,10,10,10,0,0,10,0,Terrorism
1943-07-27 00:00:00,United States Army Air Forces - USAAF,Flight,Military / Government,Papua New Guinea,Oceania,10,10,10,0,0,10,0,Terrorism
1943-07-28 00:00:00,British Overseas Airways Corporation - BOAC,Landing (descent or approach),Commercial,Ireland,Europe,25,7,1,18,9,10,15,Human Factor
1943-07-29 00:00:00,United States Navy - USN,Flight,Military / Government,Solomon Islands,Oceania,10,10,10,0,0,10,0,Unknown
1943-08-12 00:00:00,United States Army Air Forces - USAAF,Flight,Operational,United States of America,North America,10,10,10,0,0,10,0,Technical Failure
1943-08-16 00:00:00,United States Army Air Forces - USAAF,Flight,Military / Government,Italy,Europe,10,10,10,0,0,10,0,Terrorism
1943-08-17 00:00:00,United States Army Air Forces - USAAF,Flight,Military / Government,Germany,Europe,10,10,10,0,0,10,0,Terrorism
1943-08-20 00:00:00,United States Army Air Forces - USAAF,Flight,Military / Government,United Kingdom,Europe,10,10,10,0,0,10,0,Human Factor
1943-09-02 00:00:00,United States Army Air Forces - USAAF,Flight,Operational,United States of America,North America,10,10,10,0,0,10,0,Unknown
1943-09-07 00:00:00,United States Army Air Forces - USAAF,Takeoff (climb),Military / Government,Ghana,Africa,10,10,10,0,0,10,0,Unknown
1943-09-21 00:00:00,United States Army Air Forces - USAAF,Landing (descent or approach),Military / Government,Australia,Oceania,11,4,4,7,6,10,1,Human Factor
1943-10-04 00:00:00,United States Army Air Forces - USAAF,Flight,Military / Government,Netherlands,Europe,10,10,10,0,0,10,0,Terrorism
1943-10-06 00:00:00,United States Navy - USN,Flight,Military / Government,World,World,10,10,10,0,0,10,0,Unknown
1943-10-06 00:00:00,United States Army Air Forces - USAAF,Flight,Operational,World,World,10,10,10,0,0,10,0,Unknown
1943-10-08 00:00:00,United States Army Air Forces - USAAF,Flight,Military / Government,Netherlands,Europe,10,10,10,0,0,10,0,Unknown
1943-10-19 00:00:00,United States Navy - USN,Flight,Military / Government,Honduras,Central America,11,11,10,0,0,10,1,Unknown
1943-11-11 00:00:00,United States Army Air Forces - USAAF,Takeoff (climb),Military / Government,Australia,Oceania,10,10,10,0,0,10,0,Unknown
1943-11-26 00:00:00,United States Army Air Forces - USAAF,Flight,Military / Government,Netherlands,Europe,10,10,10,0,0,10,0,Unknown
1943-11-26 00:00:00,United States Army Air Forces - USAAF,Flight,Military / Government,Germany,Europe,10,10,10,0,0,10,0,Unknown
1943-11-28 00:00:00,United States Navy - USN,Flight,Military / Government,Brazil,South America,10,10,10,0,0,10,0,Unknown
1943-12-09 00:00:00,United States Army Air Forces - USAAF,Takeoff (climb),Other,United Kingdom,Europe,10,10,10,0,0,10,0,Unknown
1943-12-16 00:00:00,United States Army Air Forces - USAAF,Flight,Military / Government,Netherlands,Europe,10,10,10,0,0,10,0,Terrorism
1943-12-16 00:00:00,United States Army Air Forces - USAAF,Flight,Military / Government,Netherlands,Europe,10,10,10,0,0,10,0,Unknown
1943-12-16 00:00:00,United States Army Air Forces - USAAF,Flight,Military / Government,Netherlands,Europe,10,10,10,0,0,10,0,Unknown
1943-12-16 00:00:00,United States Army Air Forces - USAAF,Flight,Military / Government,Netherlands,Europe,10,10,10,0,0,10,0,Unknown
1943-12-16 00:00:00,United States Army Air Forces - USAAF,Flight,Military / Government,Netherlands,Europe,10,10,10,0,0,10,0,Terrorism
1943-12-17 00:00:00,British Overseas Airways Corporation - BOAC,Landing (descent or approach),Commercial,United Kingdom,Europe,10,3,3,7,7,10,0,Weather
1943-12-22 00:00:00,United States Army Air Forces - USAAF,Flight,Military / Government,Netherlands,Europe,10,10,10,0,0,10,0,Terrorism
1943-12-29 00:00:00,United States Army Air Forces - USAAF,Takeoff (climb),Military / Government,Canada,North America,10,10,10,0,0,10,0,Unknown
1944-01-08 00:00:00,Royal Air Force - RAF,Landing (descent or approach),Military / Government,United Kingdom,Europe,10,7,7,3,3,10,0,Technical Failure
1944-01-25 00:00:00,Royal Air Force - RAF,Takeoff (climb),Operational,United Kingdom,Europe,10,10,10,0,0,10,0,Unknown
1944-02-02 00:00:00,United States Army Air Forces - USAAF,Flight,Military / Government,United Kingdom,Europe,10,10,10,0,0,10,0,Unknown
1944-02-04 00:00:00,United States Army Air Forces - USAAF,Flight,Military / Government,Germany,Europe,10,10,10,0,0,10,0,Terrorism
1944-02-04 00:00:00,United States Army Air Forces - USAAF,Flight,Military / Government,Netherlands,Europe,10,10,10,0,0,10,0,Terrorism
1944-02-22 00:00:00,United States Army Air Forces - USAAF,Flight,Military / Government,Netherlands,Europe,10,10,10,0,0,10,0,Unknown
1944-03-05 00:00:00,United States Army Air Forces - USAAF,Flight,Operational,United States of America,North America,10,10,10,0,0,10,0,Technical Failure
1944-03-24 00:00:00,United States Army Air Forces - USAAF,Flight,Military / Government,India,Asia,10,10,10,0,0,10,0,Unknown
1944-03-26 00:00:00,United States Army Air Forces - USAAF,Flight,Military / Government,France,Europe,10,10,10,0,0,10,0,Terrorism
1944-03-26 00:00:00,United States Army Air Forces - USAAF,Landing (descent or approach),Operational,United States of America,North America,11,11,10,0,0,10,1,Technical Failure
1944-04-16 00:00:00,United States Army Air Forces - USAAF,Flight,Military / Government,Papua New Guinea,Oceania,10,10,10,0,0,10,0,Unknown
1944-04-24 00:00:00,United States Army Air Forces - USAAF,Takeoff (climb),Operational,United States of America,North America,10,10,10,0,0,10,0,Unknown
1944-04-28 00:00:00,Royal Australian Air Force - RAAF,Flight,Military / Government,Indonesia,Asia,10,10,10,0,0,10,0,Unknown
1944-04-29 00:00:00,United States Army Air Forces - USAAF,Flight,Military / Government,United States of America,North America,10,10,10,0,0,10,0,Unknown
1944-05-07 00:00:00,United States Army Air Forces - USAAF,Takeoff (climb),Military / Government,Papua New Guinea,Oceania,10,10,10,0,0,10,0,Unknown
1944-05-10 00:00:00,United States Army Air Forces - USAAF,Flight,Military / Government,World,World,10,10,10,0,0,10,0,Unknown
1944-05-10 00:00:00,United States Navy - USN,Flight,Military / Government,Brazil,South America,10,10,10,0,0,10,0,Unknown
1944-05-19 00:00:00,United States Army Air Forces - USAAF,Flight,Military / Government,Germany,Europe,10,10,10,0,0,10,0,Terrorism
1944-05-23 00:00:00,United States Army Air Forces - USAAF,Flight,Military / Government,United Kingdom,Europe,10,10,10,0,0,10,0,Unknown
1944-05-25 00:00:00,United States Army Air Forces - USAAF,Flight,Military / Government,India,Asia,23,4,0,19,10,10,13,Unknown
1944-05-27 00:00:00,United States Army Air Forces - USAAF,Landing (descent or approach),Operational,United States of America,North America,10,10,10,0,0,10,0,Unknown
1944-06-01 00:00:00,United States Army Air Forces - USAAF,Landing (descent or approach),Operational,United Kingdom,Europe,10,10,10,0,0,10,0,Weather
1944-06-06 00:00:00,United States Army Air Forces - USAAF,Flight,Military / Government,United Kingdom,Europe,10,10,10,0,0,10,0,Unknown
1944-06-19 00:00:00,United States Army Air Forces - USAAF,Flight,Military / Government,Belgium,Europe,10,10,10,0,0,10,0,Terrorism
1944-06-20 00:00:00,VARIG - Viação Aérea Rio Grandense,Landing (descent or approach),Commercial,Brazil,South America,10,3,3,7,7,10,0,Unknown
1944-07-02 00:00:00,United States Navy - USN,Flight,Military / Government,Brazil,South America,10,10,10,0,0,10,0,Unknown
1944-07-03 00:00:00,United States Army Air Forces - USAAF,Flight,Military / Government,Bulgaria,Europe,10,6,6,4,4,10,0,Unknown
1944-08-03 00:00:00,United States Army Air Forces - USAAF,Takeoff (climb),Military / Government,Canada,North America,10,10,10,0,0,10,0,Unknown
1944-09-29 00:00:00,United States Navy - USN,Flight,Military / Government,Palau,Asia,10,10,10,0,0,10,0,Technical Failure
1944-10-01 00:00:00,United States Army Air Forces - USAAF,Takeoff (climb),Military / Government,Italy,Europe,10,10,10,0,0,10,0,Unknown
1944-10-29 00:00:00,United States Army Air Forces - USAAF,Flight,Military / Government,World,World,10,10,10,0,0,10,0,Technical Failure
1944-11-08 00:00:00,United States Army Air Forces - USAAF,Flight,Military / Government,Netherlands,Europe,10,10,10,0,0,10,0,Unknown
1944-11-09 00:00:00,United States Army Air Forces - USAAF,Flight,Operational,Norway,Europe,10,10,10,0,0,10,0,Weather
1944-11-10 00:00:00,Royal Canadian Air Force - RCAF,Flight,Operational,Canada,North America,10,10,10,0,0,10,0,Human Factor
1944-11-14 00:00:00,Royal Air Force - RAF,Flight,Military / Government,France,Europe,10,7,7,3,3,10,0,Human Factor
1944-11-14 00:00:00,Royal Canadian Air Force - RCAF,Flight,Military / Government,Canada,North America,10,10,10,0,0,10,0,Unknown
1944-11-28 00:00:00,Royal Air Force - RAF,Flight,Military / Government,World,World,10,10,10,0,0,10,0,Unknown
1944-11-29 00:00:00,Deutsche Lufthansa,Flight,Commercial,Sweden,Europe,10,4,4,6,6,10,0,Terrorism
1944-12-09 00:00:00,United States Army Air Forces - USAAF,Flight,Military / Government,Myanmar,Asia,10,5,5,5,5,10,0,Unknown
1944-12-25 00:00:00,United States Army Air Forces - USAAF,Takeoff (climb),Military / Government,France,Europe,10,4,4,6,6,10,0,Weather
1945-01-31 00:00:00,Australian National Airways - ANA,Flight,Commercial,Australia,Oceania,10,2,2,8,8,10,0,Technical Failure
1945-02-01 00:00:00,United States Navy - USN,Flight,Military / Government,,,10,10,10,0,0,10,0,Unknown
1945-02-06 00:00:00,United States Army Air Forces - USAAF,Landing (descent or approach),Military / Government,United Kingdom,Europe,10,10,10,0,0,10,0,Unknown
1945-02-10 00:00:00,United States Army Air Forces - USAAF,Flight,Military / Government,Philippines,Asia,10,4,4,6,6,10,0,Terrorism
1945-02-26 00:00:00,United States Army Air Forces - USAAF,Flight,Military / Government,World,World,10,6,6,4,4,10,0,Unknown
1945-04-06 00:00:00,Royal Australian Air Force - RAAF,Flight,Military / Government,Indonesia,Asia,11,11,10,0,0,10,1,Terrorism
1945-04-13 00:00:00,United States Army Air Forces - USAAF,Landing (descent or approach),Military / Government,Guam Island,Asia,11,11,10,0,0,10,1,Human Factor
1945-05-25 00:00:00,United States Navy - USN,Flight,Military / Government,China,Asia,10,10,10,0,0,10,0,Terrorism
1945-08-27 00:00:00,United States Army Air Forces - USAAF,Landing (descent or approach),Military / Government,Northern Mariana Islands,Oceania,10,10,10,0,0,10,0,Unknown
1945-11-08 00:00:00,United States Navy - USN,Landing (descent or approach),Operational,United States of America,North America,15,15,10,0,0,10,5,Human Factor
1945-12-25 00:00:00,Polyarnaya Aviatsiya,Takeoff (climb),Commercial,Russia,Asia,10,4,4,6,6,10,0,Technical Failure
1946-02-07 00:00:00,Spanish Air Force - Ejército del Aire,Landing (descent or approach),Military / Government,Spain,Europe,10,2,2,8,8,10,0,Weather
1946-02-09 00:00:00,Linea Aeropostal Venezolana - LAV,Flight,Commercial,Venezuela,South America,10,3,3,7,7,10,0,Unknown
1946-02-13 00:00:00,Royal Air Force - RAF,Landing (descent or approach),Military / Government,United Kingdom,Europe,10,10,10,0,0,10,0,Human Factor
1946-03-05 00:00:00,CSA Czech Airlines - Československé Státní Aerolinie,Landing (descent or approach),Commercial,Czech Republic,Europe,15,4,2,11,8,10,5,Human Factor
1946-03-23 00:00:00,British Overseas Airways Corporation - BOAC,Flight,Commercial,World,World,10,5,5,5,5,10,0,Unknown
1946-07-20 00:00:00,United States Army Air Forces - USAAF,Flight,Military / Government,Panama,Central America,10,3,3,7,7,10,0,Human Factor
1946-07-20 00:00:00,United States Army Air Forces - USAAF,Flight,Military / Government,Panama,Central America,10,3,3,7,7,10,0,Human Factor
1947-02-22 00:00:00,United States Navy - USN,Flight,Military / Government,World,World,13,12,9,1,1,10,3,Unknown
1947-08-22 00:00:00,British Overseas Airways Corporation - BOAC,Landing (descent or approach),Commercial,Bahrain,Asia,26,8,3,18,7,10,16,Human Factor
1947-10-01 00:00:00,Royal Air Force - RAF,Flight,Operational,Yemen,Asia,10,10,10,0,0,10,0,Technical Failure
1948-08-05 00:00:00,United States Navy - USN,Landing (descent or approach),Military / Government,United States of America,North America,10,10,10,0,0,10,0,Unknown
1948-10-12 00:00:00,Aeroflot - Russian International Airlines,Flight,Commercial,Azerbaijan,Asia,10,6,6,4,4,10,0,Human Factor
1948-12-22 00:00:00,United States Air Force - USAF,Flight,Operational,United States of America,North America,10,10,10,0,0,10,0,Technical Failure
1949-02-19 00:00:00,British European Airways - BEA,Flight,Commercial,United Kingdom,Europe,10,4,4,6,6,10,0,Human Factor
1949-08-31 00:00:00,United States Navy - USN,Takeoff (climb),Military / Government,United States of America,North America,10,10,10,0,0,10,0,Weather
1949-09-16 00:00:00,French Navy,Takeoff (climb),Military / Government,Senegal,Africa,10,10,10,0,0,10,0,Unknown
1949-09-30 00:00:00,United States Air Force - USAF,Flight,Operational,United States of America,North America,10,10,10,0,0,10,0,Human Factor
1949-11-27 00:00:00,Aigle Azur,Flight,Commercial,Vietnam,Asia,10,2,2,8,8,10,0,Terrorism
1950-04-08 00:00:00,United States Navy - USN,Flight,Military / Government,Latvia,Europe,10,10,10,0,0,10,0,Terrorism
1950-04-17 00:00:00,Aeroflot - Russian International Airlines,Flight,Commercial,Russia,Asia,20,4,0,16,10,10,10,Technical Failure
1950-05-11 00:00:00,Royal Air Force - RAF,Flight,Operational,Egypt,Africa,10,10,10,0,0,10,0,Human Factor
1950-09-21 00:00:00,JAT Yugoslav Airlines - Jugoslovenski Aerotransport,Landing (descent or approach),Commercial,Croatia,Europe,11,4,4,7,6,10,1,Unknown
1950-09-23 00:00:00,Svenska Aero,Takeoff (climb),Commercial,Sweden,Europe,10,1,1,9,9,10,0,Other
1951-01-13 00:00:00,Air Carriers - Hong Kong,Flight,Commercial,Malaysia,Asia,10,3,3,7,7,10,0,Unknown
1951-01-16 00:00:00,Northwest Airlines,Flight,Commercial,United States of America,North America,10,3,3,7,7,10,0,Unknown
1951-06-03 00:00:00,United States Air Force - USAF,Flight,Military / Government,United States of America,North America,10,10,10,0,0,10,0,Weather
1951-07-12 00:00:00,Royal Air Force - RAF,Takeoff (climb),Military / Government,United Kingdom,Europe,10,3,3,7,7,10,0,Technical Failure
1951-08-31 00:00:00,United States Navy - USN,Flight,Military / Government,United States of America,North America,10,10,10,0,0,10,0,Unknown
1951-09-08 00:00:00,VASP - Viação Aérea de São Paulo,Takeoff (climb),Commercial,Brazil,South America,10,4,4,6,6,10,0,Technical Failure
1951-09-17 00:00:00,Real Aerovias,Flight,Commercial,Brazil,South America,10,4,4,6,6,10,0,Technical Failure
1951-10-08 00:00:00,Aero Transportes,Flight,Commercial,Mexico,Central America,10,4,4,6,6,10,0,Unknown
1951-10-23 00:00:00,United States Air Force - USAF,Flight,Military / Government,North Korea,Asia,13,13,10,0,0,10,3,Terrorism
1951-11-06 00:00:00,United States Navy - USN,Flight,Military / Government,World,World,10,10,10,0,0,10,0,Terrorism
1951-12-06 00:00:00,United States Air Force - USAF,Flight,Military / Government,France,Europe,10,9,9,1,1,10,0,Human Factor
1952-03-15 00:00:00,Transportes Aéreos Mexicanos - TAMSA,Landing (descent or approach),Commercial,Mexico,Central America,10,2,2,8,8,10,0,Unknown
1952-03-21 00:00:00,United States Navy - USN,Takeoff (climb),Military / Government,United States of America,North America,10,10,10,0,0,10,0,Unknown
1952-03-30 00:00:00,Philippine Airlines - PAL,Takeoff (climb),Commercial,Philippines,Asia,29,4,2,25,8,10,19,Unknown
1952-04-05 00:00:00,United States Air Force - USAF,Landing (descent or approach),Other,United States of America,North America,10,10,10,0,0,10,0,Technical Failure
1952-04-09 00:00:00,United States Air Force - USAF,Takeoff (climb),Military / Government,United States of America,North America,10,10,10,0,0,10,0,Human Factor
1952-12-26 00:00:00,United States Navy - USN,Flight,Military / Government,World,World,14,14,10,0,0,10,4,Technical Failure
1953-01-08 00:00:00,Royal Air Force - RAF,Flight,Operational,United Kingdom,Europe,10,10,10,0,0,10,0,Unknown
1953-01-28 00:00:00,United States Navy - USN,Flight,Operational,United States of America,North America,10,8,8,2,2,10,0,Human Factor
1953-03-18 00:00:00,United States Air Force - USAF,Landing (descent or approach),Military / Government,Canada,North America,10,10,10,0,0,10,0,Unknown
1953-05-07 00:00:00,Royal Air Force - RAF,Flight,Operational,United Kingdom,Europe,10,4,4,6,6,10,0,Unknown
1953-05-26 00:00:00,Royal Canadian Air Force - RCAF,Flight,Military / Government,United States of America,North America,10,10,10,0,0,10,0,Unknown
1953-07-10 00:00:00,United States Air Force - USAF,Landing (descent or approach),Military / Government,Norway,Europe,10,4,4,6,6,10,0,Human Factor
1953-07-30 00:00:00,United States Navy - USN,Flight,Military / Government,World,World,15,15,10,0,0,10,5,Technical Failure
1953-12-11 00:00:00,Royal Air Force - RAF,Flight,Operational,United Kingdom,Europe,10,10,10,0,0,10,0,Unknown
1953-12-20 00:00:00,United States Navy - USN,Flight,Military / Government,Northern Mariana Islands,Oceania,10,10,10,0,0,10,0,Human Factor
1954-01-04 00:00:00,United States Navy - USN,Flight,Military / Government,South Korea,Asia,10,10,10,0,0,10,0,Technical Failure
1954-02-05 00:00:00,United States Air Force - USAF,Flight,Military / Government,United States of America,North America,16,3,0,13,10,10,6,Unknown
1954-02-12 00:00:00,Royal Air Force - RAF,Flight,Operational,Malta,Europe,10,10,10,0,0,10,0,Unknown
1954-05-05 00:00:00,United States Navy - USN,Flight,Operational,Mexico,Central America,10,10,10,0,0,10,0,Unknown
1954-05-06 00:00:00,United States Navy - USN,Flight,Military / Government,Mexico,Central America,10,10,10,0,0,10,0,Human Factor
1954-05-07 00:00:00,United States Navy - USN,Takeoff (climb),Military / Government,Bahamas,Central America,10,10,10,0,0,10,0,Unknown
1954-07-23 00:00:00,Cathay Pacific Airways,Flight,Commercial,China,Asia,18,4,2,14,8,10,8,Terrorism
1954-09-12 00:00:00,United States Air Force - USAF,Landing (descent or approach),Military / Government,Greenland,Europe,15,15,10,0,0,10,5,Technical Failure
1954-10-26 00:00:00,Argentinian Air Force - Fuerza Aérea Argentina,Flight,Operational,Argentina,South America,10,10,10,0,0,10,0,Human Factor
1954-12-22 00:00:00,Johnson Flying Service,Landing (descent or approach),Commercial,United States of America,North America,28,5,1,23,9,10,18,Technical Failure
1955-02-02 00:00:00,Indian Airlines,Takeoff (climb),Commercial,India,Asia,10,4,4,6,6,10,0,Human Factor
1955-04-28 00:00:00,United States Air Force - USAF,Flight,Operational,Japan,Asia,10,10,10,0,0,10,0,Human Factor
1955-06-10 00:00:00,United States Air Force - USAF,Flight,Military / Government,Germany,Europe,10,10,10,0,0,10,0,Human Factor
1955-06-29 00:00:00,United States Air Force - USAF,Flight,Military / Government,United States of America,North America,10,4,4,6,6,10,0,Human Factor
1955-07-13 00:00:00,United States Air Force - USAF,Takeoff (climb),Operational,United States of America,North America,10,10,10,0,0,10,0,Technical Failure
1956-01-28 00:00:00,Linea Expressa Bolivar Compania Aérea - LEBCA,Flight,Commercial,Venezuela,South America,10,2,2,8,8,10,0,Unknown
1956-11-09 00:00:00,United States Navy - USN,Flight,Military / Government,World,World,10,10,10,0,0,10,0,Technical Failure
1956-11-30 00:00:00,United States Air Force - USAF,Takeoff (climb),Operational,United States of America,North America,10,10,10,0,0,10,0,Human Factor
1956-12-02 00:00:00,French Navy,Flight,Military / Government,France,Europe,10,10,10,0,0,10,0,Unknown
1957-07-06 00:00:00,Soviet Air Force - Voyenno-vozdushnye sily CCCP,Landing (descent or approach),Operational,Russia,Asia,10,10,10,0,0,10,0,Human Factor
1957-07-23 00:00:00,United States Navy - USN,Landing (descent or approach),Operational,United States of America,North America,10,10,10,0,0,10,0,Unknown
1958-02-05 00:00:00,Indian Air Force - Bharatiya Vayu Sena,Flight,Operational,India,Asia,10,10,10,0,0,10,0,Human Factor
1958-05-07 00:00:00,Soviet Air Force - Voyenno-vozdushnye sily CCCP,Landing (descent or approach),Specialised Services,Russia,Asia,10,5,5,5,5,10,0,Technical Failure
1958-08-11 00:00:00,Loide Aéreo Nacional,Landing (descent or approach),Commercial,Brazil,South America,11,6,6,5,4,10,1,Unknown
1958-09-10 00:00:00,Royal Netherlands Navy - Marineluchtvaartdienst,Landing (descent or approach),Military / Government,Iran,Asia,10,10,10,0,0,10,0,Technical Failure
1958-09-29 00:00:00,United States Navy - USN,Flight,Operational,United States of America,North America,10,10,10,0,0,10,0,Unknown
1959-01-08 00:00:00,Southeast Airlines,Landing (descent or approach),Commercial,United States of America,North America,10,3,3,7,7,10,0,Human Factor
1959-01-22 00:00:00,Air Jordan,Landing (descent or approach),Commercial,Jordan,Asia,15,4,4,11,6,10,5,Human Factor
1959-04-09 00:00:00,United States Navy - USN,Flight,Military / Government,South Korea,Asia,10,10,10,0,0,10,0,Unknown
1959-05-15 00:00:00,Aerolineas Argentinas,Takeoff (climb),Commercial,Argentina,South America,10,4,4,6,6,10,0,Human Factor
1959-07-01 00:00:00,Continental Can Company,Flight,Business,United States of America,North America,10,2,2,8,8,10,0,Weather
1959-11-28 00:00:00,Soviet Air Force - Voyenno-vozdushnye sily CCCP,Takeoff (climb),Military / Government,Russia,Asia,10,6,6,4,4,10,0,Technical Failure
1960-01-04 00:00:00,United States Air Force - USAF,Flight,Military / Government,Libya,Africa,10,1,1,9,9,10,0,Unknown
1960-04-12 00:00:00,Cruzeiro do Sul,Takeoff (climb),Commercial,Brazil,South America,22,3,2,19,8,10,12,Human Factor
1961-01-02 00:00:00,CSA Czech Airlines - Československé Státní Aerolinie,Takeoff (climb),Operational,Czech Republic,Europe,10,5,5,5,5,10,0,Unknown
1961-09-22 00:00:00,United States Navy - USN,Flight,Military / Government,United States of America,North America,10,10,10,0,0,10,0,Human Factor
1962-01-21 00:00:00,Aeroflot - Russian International Airlines,Flight,Commercial,Russia,Asia,10,2,2,8,8,10,0,Human Factor
1962-02-06 00:00:00,Japan Maritime Self-Defense Force - Kaijō Jieitai,Flight,Military / Government,Japan,Asia,10,10,10,0,0,10,0,Unknown
1962-04-10 00:00:00,Spanish Air Force - Ejército del Aire,Takeoff (climb),Military / Government,Spain,Europe,10,3,3,7,7,10,0,Unknown
1962-05-27 00:00:00,United States Air Force - USAF,Flight,Military / Government,World,World,10,10,10,0,0,10,0,Unknown
1962-08-01 00:00:00,Royal Nepal Airlines,Flight,Commercial,Nepal,Asia,10,4,4,6,6,10,0,Human Factor
1962-10-09 00:00:00,PLUNA Uruguay - Primeras Lineas Uruguayas de Navegacion Aérea,Takeoff (climb),Specialised Services,Uruguay,South America,10,3,3,7,7,10,0,Human Factor
1962-11-16 00:00:00,Argentinian Air Force - Fuerza Aérea Argentina,Flight,Military / Government,Panama,Central America,10,10,10,0,0,10,0,Human Factor
1963-02-26 00:00:00,Aeroflot - Russian International Airlines,Flight,Operational,Russia,Asia,10,8,8,2,2,10,0,Technical Failure
1963-08-04 00:00:00,Sadia Transportes Aéreos,Flight,Commercial,Brazil,South America,10,3,3,7,7,10,0,Human Factor
1963-09-22 00:00:00,United States Air Force - USAF,Flight,Military / Government,World,World,10,10,10,0,0,10,0,Unknown
1964-02-03 00:00:00,South Central Airlines - SCA,Takeoff (climb),Commercial,United States of America,North America,10,1,1,9,9,10,0,Human Factor
1964-04-18 00:00:00,United States Air Force - USAF,Flight,Operational,United States of America,North America,10,10,10,0,0,10,0,Unknown
1964-05-11 00:00:00,United States Navy - USN,Flight,Military / Government,Spain,Europe,10,10,10,0,0,10,0,Unknown
1964-06-29 00:00:00,United States Air Force - USAF,Flight,Specialised Services,Bermuda,North America,10,10,10,0,0,10,0,Human Factor
1964-08-22 00:00:00,Czech Air Force - Ceské Vojenské Letectvo,Landing (descent or approach),Military / Government,Czech Republic,Europe,10,10,10,0,0,10,0,Human Factor
1964-11-17 00:00:00,United States Navy - USN,Landing (descent or approach),Operational,Canada,North America,10,10,10,0,0,10,0,Technical Failure
1965-01-17 00:00:00,Aerovias del Norte,Landing (descent or approach),Commercial,Mexico,Central America,10,1,1,9,9,10,0,Technical Failure
1965-01-22 00:00:00,United States Air Force - USAF,Flight,Military / Government,Greece,Europe,10,10,10,0,0,10,0,Unknown
1965-02-25 00:00:00,Ilyushin,Takeoff (climb),Specialised Services,Russia,Asia,17,17,10,0,0,10,7,Unknown
1965-03-08 00:00:00,Filipinas Orient Airways,Landing (descent or approach),Commercial,Philippines,Asia,12,3,3,9,7,10,2,Human Factor
1965-06-05 00:00:00,United States Air Force - USAF,Flight,Military / Government,Bahamas,Central America,10,5,5,5,5,10,0,Unknown
1965-09-11 00:00:00,Filipinas Orient Airways,Flight,Commercial,Philippines,Asia,10,3,3,7,7,10,0,Human Factor
1966-07-15 00:00:00,Pakistan Air Force - Pakistan Fiza'ya,Flight,Military / Government,Pakistan,Asia,10,10,10,0,0,10,0,Unknown
1966-12-20 00:00:00,Executive Aviation,Flight,Business,Mexico,Central America,10,2,2,8,8,10,0,Unknown
1967-01-06 00:00:00,United States Navy - USN,Flight,Operational,Philippines,Asia,10,10,10,0,0,10,0,Other
1967-02-09 00:00:00,Cubana de Aviación,Landing (descent or approach),Operational,Mexico,Central America,10,4,4,6,6,10,0,Human Factor
1967-06-09 00:00:00,United States Air Force - USAF,Landing (descent or approach),Military / Government,Vietnam,Asia,10,10,10,0,0,10,0,Technical Failure
1967-12-07 00:00:00,Lao Cathay Airways,Flight,Operational,Laos,Asia,12,2,2,10,8,10,2,Unknown
1968-07-28 00:00:00,United States Air Force - USAF,Flight,Military / Government,Brazil,South America,10,10,10,0,0,10,0,Human Factor
1968-10-08 00:00:00,Aerovias del Valle,Landing (descent or approach),Commercial,Costa Rica,Central America,10,1,1,9,9,10,0,Unknown
1968-10-19 00:00:00,Turkish Air Force - Türk Hava Kuvvetleri,Flight,Military / Government,Turkey,Asia,10,4,4,6,6,10,0,Unknown
1969-02-05 00:00:00,Puget Sound Airlines,Takeoff (climb),Commercial,United States of America,North America,10,2,2,8,8,10,0,Human Factor
1969-02-05 00:00:00,United States Air Force - USAF,Flight,Military / Government,Laos,Asia,10,10,10,0,0,10,0,Terrorism
1969-02-12 00:00:00,German Air Force - Deutsche Luftwaffe,Takeoff (climb),Military / Government,Germany,Europe,12,12,10,0,0,10,2,Weather
1969-11-11 00:00:00,Republic of Korea Air Force,Flight,Military / Government,Vietnam,Asia,10,2,2,8,8,10,0,Weather
1969-12-22 00:00:00,Air Vietnam,Landing (descent or approach),Commercial,Vietnam,Asia,77,7,0,70,10,10,67,Terrorism
1970-02-13 00:00:00,Avia-Taxi,Flight,Commercial,France,Europe,10,1,1,9,9,10,0,Weather
1970-03-30 00:00:00,Royal Malaysian Air Force - Tentera Udara Diraja Malaysia,Flight,Military / Government,Malaysia,Asia,19,3,0,16,10,10,9,Unknown
1970-04-22 00:00:00,United States Air Force - USAF,Flight,Military / Government,Laos,Asia,11,11,10,0,0,10,1,Terrorism
1970-06-27 00:00:00,MOM - Ministerstvo Obshego Mashinostroenia,Takeoff (climb),Military / Government,Russia,Asia,16,2,1,14,9,10,6,Human Factor
1970-08-03 00:00:00,United States Navy - USN,Flight,Military / Government,United States of America,North America,10,10,10,0,0,10,0,Weather
1971-10-10 00:00:00,HISISA Argentina,Takeoff (climb),Commercial,Argentina,South America,10,1,1,9,9,10,0,Technical Failure
1971-10-16 00:00:00,Scenic Airlines,Flight,Commercial,United States of America,North America,10,1,1,9,9,10,0,Human Factor
1971-12-06 00:00:00,Sudan Airways,Flight,Commercial,South Sudan,Africa,42,5,1,37,9,10,32,Human Factor
1972-05-30 00:00:00,Yokohama Koku Company,Landing (descent or approach),Commercial,Japan,Asia,10,2,2,8,8,10,0,Human Factor
1972-07-06 00:00:00,Aviaco - Aviacion y Comercio,Landing (descent or approach),Operational,Spain,Europe,10,10,10,0,0,10,0,Unknown
1972-09-24 00:00:00,Air Vietnam,Flight,Commercial,Vietnam,Asia,13,5,4,8,6,10,3,Technical Failure
1972-12-20 00:00:00,North Central Airlines,Takeoff (climb),Commercial,United States of America,North America,45,4,0,41,10,10,35,Human Factor
1973-07-11 00:00:00,Aviones de Panama,Flight,Commercial,Panama,Central America,10,2,2,8,8,10,0,Unknown
1973-08-15 00:00:00,Turks and Caicos Airways - Turks and Caicos National Airline,Landing (descent or approach),Commercial,Haiti,Central America,10,1,1,9,9,10,0,Human Factor
1973-10-02 00:00:00,Aeroflot - Russian International Airlines,Landing (descent or approach),Operational,Russia,Asia,10,8,8,2,2,10,0,Human Factor
1973-12-11 00:00:00,United States Navy - USN,Flight,Military / Government,United States of America,North America,10,4,4,6,6,10,0,Human Factor
1974-02-28 00:00:00,Imperial Iranian Air Force,Landing (descent or approach),Military / Government,Iran,Asia,10,5,5,5,5,10,0,Unknown
1974-05-26 00:00:00,Indonesian Navy - TNI-AL Tentara Nasional Indonesia - Angkatan Laut,Flight,Military / Government,Indonesia,Asia,10,10,10,0,0,10,0,Human Factor
1974-09-29 00:00:00,Aeroflot - Russian International Airlines,Flight,Commercial,Russia,Asia,13,2,2,11,8,10,3,Human Factor
1974-10-13 00:00:00,United States Air Force - USAF,Flight,Military / Government,World,World,10,5,5,5,5,10,0,Weather
1975-03-18 00:00:00,Aeroflot - Russian International Airlines,Takeoff (climb),Commercial,Russia,Asia,16,2,1,14,9,10,6,Other
1975-07-26 00:00:00,SATENA - Servicio de Aeronavegacion a Territorios Nacionales,Flight,Military / Government,Colombia,South America,10,3,3,7,7,10,0,Human Factor
1975-08-30 00:00:00,Wien Air Alaska,Landing (descent or approach),Commercial,United States of America,North America,32,4,3,28,7,10,22,Human Factor
1976-09-04 00:00:00,Austin Airways,Flight,Commercial,Canada,North America,10,1,1,9,9,10,0,Human Factor
1976-12-08 00:00:00,Safari Air Services,Takeoff (climb),Commercial,Tanzania,Africa,10,1,1,9,9,10,0,Unknown
1977-04-05 00:00:00,National Remote Sensing Agency,Flight,Military / Government,India,Asia,10,5,5,5,5,10,0,Human Factor
1977-08-23 00:00:00,Aeroflot - Russian International Airlines,Flight,Commercial,Russia,Asia,11,3,3,8,7,10,1,Human Factor
1977-12-24 00:00:00,Valley Air Service,Landing (descent or approach),Commercial,Netherlands,Central America,10,2,2,8,8,10,0,Unknown
1978-04-27 00:00:00,South Pacific Island Airways - SPIA,Landing (descent or approach),Commercial,Samoa Islands (Western Samoa),Oceania,10,1,1,9,9,10,0,Unknown
1978-05-06 00:00:00,Aeroflot - Russian International Airlines,Landing (descent or approach),Commercial,Russia,Asia,15,2,2,13,8,10,5,Human Factor
1978-06-23 00:00:00,Gander Aviation,Takeoff (climb),Commercial,Canada,North America,10,2,2,8,8,10,0,Unknown
1978-08-30 00:00:00,Las Vegas Airlines,Takeoff (climb),Commercial,United States of America,North America,10,1,1,9,9,10,0,Technical Failure
1978-12-16 00:00:00,Air 70,Flight,Commercial,Italy,Europe,10,2,2,8,8,10,0,Weather
1978-12-26 00:00:00,Haïti Air Inter,Flight,Commercial,Turks and Caicos Islands,Central America,10,2,2,8,8,10,0,Technical Failure
1978-12-28 00:00:00,United Airlines,Landing (descent or approach),Commercial,United States of America,North America,189,8,2,181,8,10,179,Human Factor
1979-03-26 00:00:00,Interflug,Takeoff (climb),Operational,Angola,Africa,10,4,4,6,6,10,0,Technical Failure
1979-05-18 00:00:00,Bush Aviation,Flight,Commercial,Mexico,Central America,10,3,3,7,7,10,0,Technical Failure
1979-06-11 00:00:00,United States Forest Service - USFS,Flight,Commercial,United States of America,North America,12,2,2,10,8,10,2,Technical Failure
1979-08-03 00:00:00,Aeroflot - Russian International Airlines,Landing (descent or approach),Commercial,Russia,Asia,14,3,3,11,7,10,4,Technical Failure
1979-09-03 00:00:00,Sterling Airways,Landing (descent or approach),Business,France,Europe,10,2,2,8,8,10,0,Technical Failure
1979-10-27 00:00:00,Procuraduría General de la República,Landing (descent or approach),Military / Government,United States of America,North America,10,2,2,8,8,10,0,Human Factor
1979-12-12 00:00:00,CAMBA Transportes Aéreos - Comercializadora Aérea Mixta Boliviana,Takeoff (climb),Commercial,Bolivia,South America,11,3,3,8,7,10,1,Unknown
1980-03-27 00:00:00,Lufkin Industries,Takeoff (climb),Business,United States of America,North America,10,2,2,8,8,10,0,Weather
1980-05-28 00:00:00,Spanish Air Force - Ejército del Aire,Flight,Military / Government,Spain,Europe,10,5,5,5,5,10,0,Human Factor
1980-12-05 00:00:00,Tanzania Aviation,Flight,Humanitarian,Tanzania,Africa,10,1,1,9,9,10,0,Human Factor
1981-11-19 00:00:00,Royal Nepal Airlines,Takeoff (climb),Commercial,Nepal,Asia,10,1,1,9,9,10,0,Unknown
1982-04-29 00:00:00,Interandes Colombia,Landing (descent or approach),Commercial,Colombia,South America,10,2,2,8,8,10,0,Technical Failure
1982-04-29 00:00:00,Ecuadorian Air Force - Fuerza Aérea Ecuatoriana,Landing (descent or approach),Military / Government,Ecuador,South America,10,4,4,6,6,10,0,Unknown
1982-08-20 00:00:00,Inter Island Air Services,Flight,Commercial,Saint Vincent and Grenadines,Central America,10,2,2,8,8,10,0,Unknown
1982-09-04 00:00:00,Companhia Brasileira de Tratores,Landing (descent or approach),Business,Brazil,South America,10,2,2,8,8,10,0,Human Factor
1982-12-22 00:00:00,Rijnmond Air Services - RAS,Flight,Commercial,France,Europe,10,2,2,8,8,10,0,Human Factor
1983-08-17 00:00:00,Las Vegas Airlines,Flight,Commercial,United States of America,North America,10,1,1,9,9,10,0,Human Factor
1983-09-28 00:00:00,Taiwan Airlines,Landing (descent or approach),Commercial,Taiwan,Asia,10,1,1,9,9,10,0,Unknown
1983-10-11 00:00:00,Air Illinois,Flight,Commercial,United States of America,North America,10,3,3,7,7,10,0,Technical Failure
1983-12-08 00:00:00,Trans Europe Air Charter,Landing (descent or approach),Commercial,United Kingdom,Europe,10,2,2,8,8,10,0,Human Factor
1984-01-14 00:00:00,Talair,Landing (descent or approach),Commercial,Papua New Guinea,Oceania,10,1,1,9,9,10,0,Human Factor
1984-12-04 00:00:00,Aeroflot - Russian International Airlines,Takeoff (climb),Commercial,Russia,Asia,10,2,2,8,8,10,0,Human Factor
1985-11-21 00:00:00,Indonesian Air Force - TNI-AU Tentara Nasional Indonesia - Angkatan Udara,Landing (descent or approach),Military / Government,Indonesia,Asia,10,4,4,6,6,10,0,Human Factor
1985-12-31 00:00:00,Linea Aérea Aeropetrel - Aeropetrel,Landing (descent or approach),Commercial,Antarctica,Antarctica,10,2,2,8,8,10,0,Human Factor
1986-05-18 00:00:00,Indonesian Aero-Sports Association,Takeoff (climb),Humanitarian,Indonesia,Asia,10,2,2,8,8,10,0,Technical Failure
1987-04-02 00:00:00,Scanex Air,Landing (descent or approach),Commercial,Norway,Europe,10,1,1,9,9,10,0,Weather
1987-06-05 00:00:00,Rutaca - Rutas Aéreas,Flight,Commercial,Venezuela,South America,10,1,1,9,9,10,0,Unknown
1987-07-04 00:00:00,Imitari Athol North Aero,Flight,Commercial,United States of America,North America,10,1,1,9,9,10,0,Human Factor
1987-11-06 00:00:00,Air Malawi,Flight,Commercial,Mozambique,Africa,10,2,2,8,8,10,0,Terrorism
1988-01-19 00:00:00,Taiwan Airlines,Landing (descent or approach),Commercial,Taiwan,Asia,11,1,1,10,9,10,1,Human Factor
1988-09-08 00:00:00,Aero Commercial Edsan,Takeoff (climb),Commercial,Ecuador,South America,10,2,2,8,8,10,0,Technical Failure
1988-10-04 00:00:00,Indian Air Force - Bharatiya Vayu Sena,Flight,Military / Government,India,Asia,10,3,3,7,7,10,0,Unknown
1988-12-16 00:00:00,Broughton Air Services,Flight,Commercial,Australia,Oceania,10,1,1,9,9,10,0,Weather
1989-02-19 00:00:00,Las Vegas Flyers,Flight,Commercial,United States of America,North America,10,1,1,9,9,10,0,Human Factor
1989-02-25 00:00:00,Albiacion Circulo General,Landing (descent or approach),Humanitarian,Honduras,Central America,10,3,3,7,7,10,0,Human Factor
1989-03-10 00:00:00,Aero Condor - Servicio de Transporte Aéreo Turistico - STAT,Landing (descent or approach),Commercial,Peru,South America,10,2,2,8,8,10,0,Human Factor
1989-07-19 00:00:00,Aeroflot - Russian International Airlines,Flight,Military / Government,Russia,Asia,10,6,6,4,4,10,0,Human Factor
1989-08-08 00:00:00,Aspiring Air,Flight,Commercial,New Zealand,Oceania,10,1,1,9,9,10,0,Unknown
1989-09-27 00:00:00,Grand Canyon Airlines,Landing (descent or approach),Commercial,United States of America,North America,21,2,2,19,8,10,11,Human Factor
1990-04-20 00:00:00,Afghan Republican Air Force - Afghan Hanai Qurah,Flight,Military / Government,Afghanistan,Asia,10,4,4,6,6,10,0,Unknown
1990-04-30 00:00:00,Royal Air Force - RAF,Flight,Military / Government,United Kingdom,Europe,10,10,10,0,0,10,0,Human Factor
1990-05-11 00:00:00,German Air Force - Deutsche Luftwaffe,Flight,Military / Government,Germany,Europe,10,5,5,5,5,10,0,Human Factor
1990-12-04 00:00:00,Sudania Air Cargo,Landing (descent or approach),Operational,Kenya,Africa,10,3,3,7,7,10,0,Human Factor
1991-03-16 00:00:00,Duncan Aircraft Sales,Takeoff (climb),Commercial,United States of America,North America,10,2,2,8,8,10,0,Human Factor
1991-04-18 00:00:00,Air Tahiti,Landing (descent or approach),Commercial,French Polynesia,Oceania,22,2,1,20,9,10,12,Human Factor
1991-06-10 00:00:00,Angola Air Charter,Takeoff (climb),Operational,Angola,Africa,10,4,4,6,6,10,0,Unknown
1991-08-28 00:00:00,Philippine Air Force - Hukbong Himpapawid NG Pilipinas,Flight,Military / Government,Philippines,Asia,10,1,1,9,9,10,0,Human Factor
1991-09-26 00:00:00,AKF Polet,Takeoff (climb),Operational,Russia,Asia,10,3,3,7,7,10,0,Unknown
1992-03-22 00:00:00,Myachkovo Avia,Flight,Operational,Russia,Asia,10,5,5,5,5,10,0,Human Factor
1992-06-19 00:00:00,Adventure Airlines,Takeoff (climb),Commercial,United States of America,North America,10,1,1,9,9,10,0,Technical Failure
1992-06-22 00:00:00,Kras Air - Krasnoyarsk Avia - Krasnoyarskie Avialinii,Landing (descent or approach),Operational,Russia,Asia,12,7,6,5,4,10,2,Human Factor
1992-08-21 00:00:00,Servicios Aéreos Santa Ana - SASA,Landing (descent or approach),Operational,Bolivia,South America,10,3,3,7,7,10,0,Human Factor
1992-12-10 00:00:00,Ecuadorian Air Force - Fuerza Aérea Ecuatoriana,Landing (descent or approach),Military / Government,Ecuador,South America,10,3,3,7,7,10,0,Human Factor
1994-01-05 00:00:00,Kimura International,Landing (descent or approach),Business,United States of America,North America,10,1,1,9,9,10,0,Technical Failure
1995-01-20 00:00:00,Leadair Unijet,Landing (descent or approach),Commercial,France,Europe,10,3,3,7,7,10,0,Other
1995-02-21 00:00:00,Japan Air Self-Defense Force - Kōkū Jieitai,Flight,Military / Government,Japan,Asia,12,12,10,0,0,10,2,Unknown
1995-08-09 00:00:00,Bouraq Indonesia Airlines,Landing (descent or approach),Commercial,Indonesia,Asia,10,6,6,4,4,10,0,Human Factor
1996-01-12 00:00:00,Centravia,Flight,Commercial,Central African Republic,Africa,10,1,1,9,9,10,0,Technical Failure
1996-02-19 00:00:00,Private Wings Flugcharter,Landing (descent or approach),Commercial,Germany,Europe,10,2,2,8,8,10,0,Unknown
1996-06-06 00:00:00,Hoseba,Takeoff (climb),Operational,Democratic Republic of Congo,Africa,10,7,7,3,3,10,0,Human Factor
1996-11-22 00:00:00,United States Air Force - USAF,Flight,Military / Government,World,World,11,11,10,0,0,10,1,Technical Failure
1997-09-06 00:00:00,Royal Brunei Airlines - RBA,Landing (descent or approach),Commercial,Malaysia,Asia,10,2,2,8,8,10,0,Human Factor
1997-12-12 00:00:00,Servicios y Transportes Aéreos Petroleros - STAP,Takeoff (climb),Commercial,Bolivia,South America,19,2,1,17,9,10,9,Technical Failure
1997-12-31 00:00:00,PARSA,Landing (descent or approach),Commercial,Panama,Central America,10,1,1,9,9,10,0,Weather
1998-07-17 00:00:00,Ukrainian Cargo Airways,Landing (descent or approach),Operational,Eritrea,Africa,10,9,9,1,1,10,0,Human Factor
1998-12-14 00:00:00,Khors Aircompany,Flight,Humanitarian,Angola,Africa,10,5,5,5,5,10,0,Terrorism
1999-07-31 00:00:00,Parahawks Skydiving Center,Takeoff (climb),Humanitarian,United States of America,North America,10,1,1,9,9,10,0,Human Factor
1999-09-25 00:00:00,Big Island Air,Flight,Commercial,United States of America,North America,10,1,1,9,9,10,0,Human Factor
1999-12-06 00:00:00,Flightline Charter Services,Takeoff (climb),Commercial,South Africa,Africa,10,1,1,9,9,10,0,Technical Failure
1999-12-25 00:00:00,Skyline Airways,Takeoff (climb),Commercial,Nepal,Asia,10,3,3,7,7,10,0,Human Factor
2000-01-10 00:00:00,Crossair,Takeoff (climb),Commercial,Switzerland,Europe,10,3,3,7,7,10,0,Human Factor
2000-03-17 00:00:00,Aeroperlas,Flight,Commercial,Panama,Central America,10,2,2,8,8,10,0,Human Factor
2000-07-09 00:00:00,Rolando Medina Marmolejo,Takeoff (climb),Commercial,Colombia,South America,19,2,2,17,8,10,9,Technical Failure
2000-08-26 00:00:00,Aeroperlas,Flight,Commercial,Costa Rica,Central America,10,2,2,8,8,10,0,Human Factor
2001-01-27 00:00:00,Jet Express,Flight,Commercial,United States of America,North America,10,2,2,8,8,10,0,Human Factor
2001-02-10 00:00:00,Gum Air,Landing (descent or approach),Commercial,Suriname,South America,10,2,2,8,8,10,0,Human Factor
2001-04-28 00:00:00,Les Grands Jorasses,Flight,Commercial,Argentina,South America,10,2,2,8,8,10,0,Weather
2001-07-14 00:00:00,Russ Air Transport,Takeoff (climb),Operational,Russia,Asia,10,8,8,2,2,10,0,Human Factor
2001-10-10 00:00:00,Flightline - Spain,Flight,Commercial,Spain,Europe,10,2,2,8,8,10,0,Weather
2001-10-10 00:00:00,PenAir - Peninsula Airways - Alaska Airlines Commuter,Takeoff (climb),Commercial,United States of America,North America,10,1,1,9,9,10,0,Weather
2002-08-07 00:00:00,United States Air Force - USAF,Landing (descent or approach),Operational,Puerto Rico,Central America,10,10,10,0,0,10,0,Human Factor
2003-09-11 00:00:00,Jeannine Emma Louise Van Laere,Takeoff (climb),Commercial,Portugal,Europe,10,1,1,9,9,10,0,Human Factor
2004-01-17 00:00:00,Georgian Express,Takeoff (climb),Commercial,Canada,North America,10,1,1,9,9,10,0,Other
2004-10-24 00:00:00,Hendrick Motorsports,Landing (descent or approach),Business,United States of America,North America,10,2,2,8,8,10,0,Human Factor
2005-01-30 00:00:00,Royal Air Force - RAF,Takeoff (climb),Military / Government,Iraq,Asia,10,8,8,2,2,10,0,Terrorism
2005-05-05 00:00:00,Kisangani Airlift,Flight,Operational,Democratic Republic of Congo,Africa,11,4,4,7,6,10,1,Unknown
2005-05-16 00:00:00,Transportes Aéreos Don Carlos,Flight,Commercial,Argentina,South America,10,1,1,9,9,10,0,Weather
2007-10-07 00:00:00,Kapowsin Air Sports,Flight,Humanitarian,United States of America,North America,10,1,1,9,9,10,0,Human Factor
2008-08-22 00:00:00,Leavitt Group Wings,Takeoff (climb),Business,United States of America,North America,10,1,1,9,9,10,0,Unknown
2012-09-12 00:00:00,Petropavlosvk-Khamchatsky Air Enterprise,Landing (descent or approach),Commercial,Russia,Asia,14,2,2,12,8,10,4,Human Factor
2012-11-21 00:00:00,Yemeni Air Force,Takeoff (climb),Military / Government,Yemen,Asia,10,10,10,0,0,10,0,Technical Failure
2013-03-12 00:00:00,Fretax Taxi Aéreo,Landing (descent or approach),Commercial,Brazil,South America,10,1,1,9,9,10,0,Human Factor
2013-07-07 00:00:00,Rediske Air,Takeoff (climb),Commercial,United States of America,North America,10,1,1,9,9,10,0,Other
2014-09-06 00:00:00,Laser Aéreo,Takeoff (climb),Commercial,Colombia,South America,10,2,2,8,8,10,0,Technical Failure
2014-12-03 00:00:00,Nacional de Aviacion,Landing (descent or approach),Commercial,Colombia,South America,10,2,2,8,8,10,0,Technical Failure
2015-03-19 00:00:00,Droguería Meta,Takeoff (climb),Commercial,Uruguay,South America,10,2,2,8,8,10,0,Human Factor
2015-10-02 00:00:00,Aviastar Mandiri,Flight,Commercial,Indonesia,Asia,10,2,2,8,8,10,0,Human Factor
2015-12-22 00:00:00,Border Security Force,Takeoff (climb),Military / Government,India,Asia,10,2,2,8,8,10,0,Human Factor
2016-07-01 00:00:00,MCHS Rossii,Flight,Humanitarian,Russia,Asia,10,10,10,0,0,10,0,Unknown
2018-06-05 00:00:00,Fly-SAX,Flight,Commercial,Kenya,Africa,10,2,2,8,8,10,0,Human Factor
2019-06-30 00:00:00,EE Operations,Takeoff (climb),Business,United States of America,North America,10,2,2,8,8,10,0,Human Factor
2021-03-02 00:00:00,South Supreme Airlines,Takeoff (climb),Commercial,South Sudan,Africa,10,2,2,8,8,10,0,Unknown
1928-04-19 00:00:00,Iberia - Lineas Aéreas de Espana,Flight,Commercial,Spain,Europe,9,2,2,7,7,9,0,Unknown
1931-02-04 00:00:00,Royal Air Force - RAF,Landing (descent or approach),Operational,United Kingdom,Europe,12,12,9,0,0,9,3,Human Factor
1932-07-16 00:00:00,Panagra - Pan American-Grace Airways,Flight,Commercial,Chile,South America,9,3,3,6,6,9,0,Weather
1933-06-11 00:00:00,C. G. Bennett,Flight,Commercial,United States of America,North America,9,2,2,7,7,9,0,Technical Failure
1935-02-15 00:00:00,Royal Air Force - RAF,Flight,Operational,Italy,Europe,9,8,8,1,1,9,0,Human Factor
1936-09-24 00:00:00,Ala Littoria,Landing (descent or approach),Commercial,Libya,Africa,10,3,2,7,7,9,1,Technical Failure
1936-12-06 00:00:00,Deruluft - Deutsch-Russische Luftverkehrs Gesellschaft,Landing (descent or approach),Commercial,Russia,Asia,14,3,2,11,7,9,5,Unknown
1937-01-11 00:00:00,Mexicana de Aviación,Flight,Commercial,Mexico,Central America,9,2,2,7,7,9,0,Human Factor
1937-06-02 00:00:00,Chilean Air Force - Fuerza Aérea de Chile,Flight,Military / Government,Chile,South America,9,4,4,5,5,9,0,Unknown
1938-03-01 00:00:00,Transcontinental %26 Western Air - TWA,Flight,Commercial,United States of America,North America,9,3,3,6,6,9,0,Human Factor
1938-05-16 00:00:00,Northwest Airlines,Flight,Commercial,United States of America,North America,9,2,2,7,7,9,0,Human Factor
1938-08-15 00:00:00,Syndicato Condor,Takeoff (climb),Commercial,Brazil,South America,9,4,4,5,5,9,0,Unknown
1939-05-02 00:00:00,Air France,Flight,Commercial,Morocco,Africa,9,3,3,6,6,9,0,Weather
1939-09-17 00:00:00,Royal Air Force - RAF,Flight,Military / Government,United Kingdom,Europe,9,9,9,0,0,9,0,Technical Failure
1939-12-18 00:00:00,Iberia - Lineas Aéreas de Espana,Flight,Commercial,Spain,Europe,9,3,3,6,6,9,0,Terrorism
1940-04-07 00:00:00,Royal Air Force - RAF,Flight,Military / Government,Norway,Europe,9,9,9,0,0,9,0,Terrorism
1940-04-09 00:00:00,Royal Air Force - RAF,Flight,Military / Government,Norway,Europe,10,10,9,0,0,9,1,Terrorism
1940-05-26 00:00:00,German Air Force - Deutsche Luftwaffe,Flight,Military / Government,Norway,Europe,15,3,3,12,6,9,6,Terrorism
1940-06-02 00:00:00,German Air Force - Deutsche Luftwaffe,Flight,Military / Government,Sweden,Europe,15,3,2,12,7,9,6,Terrorism
1940-06-14 00:00:00,Aero Oy,Takeoff (climb),Commercial,Estonia,Europe,9,3,3,6,6,9,0,Terrorism
1940-06-28 00:00:00,Regia Aeronautica,Flight,Military / Government,Libya,Africa,9,9,9,0,0,9,0,Terrorism
1940-10-29 00:00:00,China National Aviation Corporation - CNAC,Taxiing,Commercial,China,Asia,14,4,2,10,7,9,5,Terrorism
1941-06-20 00:00:00,Royal Air Force - RAF,Flight,Military / Government,Spain,Europe,11,10,8,1,1,9,2,Technical Failure
1941-10-14 00:00:00,Royal Air Force - RAF,Flight,Operational,United Kingdom,Europe,12,12,9,0,0,9,3,Unknown
1941-12-03 00:00:00,Royal Air Force - RAF,Flight,Military / Government,Ireland,Europe,11,11,9,0,0,9,2,Unknown
1942-01-13 00:00:00,German Air Force - Deutsche Luftwaffe,Flight,Military / Government,Ukraine,Europe,9,9,9,0,0,9,0,Weather
1942-01-16 00:00:00,United States Army Air Forces - USAAF,Flight,Military / Government,Indonesia,Asia,9,9,9,0,0,9,0,Unknown
1942-02-15 00:00:00,British Overseas Airways Corporation - BOAC,Flight,Commercial,United Kingdom,Europe,9,4,4,5,5,9,0,Terrorism
1942-02-20 00:00:00,Qantas Airways - Queensland and Northern Territory Aerial Services,Takeoff (climb),Commercial,Australia,Oceania,9,2,2,7,7,9,0,Technical Failure
1942-04-05 00:00:00,United States Navy - USN,Landing (descent or approach),Military / Government,United States of America,North America,9,9,9,0,0,9,0,Human Factor
1942-04-22 00:00:00,United States Army Air Forces - USAAF,Flight,Operational,United States of America,North America,9,9,9,0,0,9,0,Weather
1942-05-06 00:00:00,Royal Australian Air Force - RAAF,Flight,Military / Government,Papua New Guinea,Oceania,9,9,9,0,0,9,0,Terrorism
1942-05-18 00:00:00,United States Navy - USN,Flight,Operational,United States of America,North America,9,9,9,0,0,9,0,Unknown
1942-05-25 00:00:00,United States Army Air Forces - USAAF,Takeoff (climb),Military / Government,Australia,Oceania,9,4,4,5,5,9,0,Other
1942-05-29 00:00:00,United States Army Air Forces - USAAF,Flight,Military / Government,Colombia,South America,9,2,2,7,7,9,0,Unknown
1942-06-11 00:00:00,Royal Air Force - RAF,Flight,Military / Government,World,World,9,9,9,0,0,9,0,Unknown
1942-07-14 00:00:00,United States Navy - USN,Flight,Military / Government,World,World,9,9,9,0,0,9,0,Unknown
1942-08-04 00:00:00,United States Army Air Forces - USAAF,Flight,Military / Government,Solomon Islands,Oceania,9,9,9,0,0,9,0,Terrorism
1942-08-09 00:00:00,United States Navy - USN,Flight,Military / Government,United States of America,North America,9,9,9,0,0,9,0,Unknown
1942-08-09 00:00:00,United States Army Air Forces - USAAF,Flight,Military / Government,Papua New Guinea,Oceania,9,9,9,0,0,9,0,Terrorism
1942-08-14 00:00:00,United States Army Air Forces - USAAF,Flight,Operational,United States of America,North America,9,9,9,0,0,9,0,Technical Failure
1942-08-17 00:00:00,Royal Air Force - RAF,Flight,Military / Government,Sierra Leone,Africa,9,9,9,0,0,9,0,Unknown
1942-08-23 00:00:00,United States Navy - USN,Flight,Military / Government,United States of America,North America,9,9,9,0,0,9,0,Unknown
1942-09-06 00:00:00,United States Army Air Forces - USAAF,Flight,Military / Government,Solomon Islands,Oceania,9,9,9,0,0,9,0,Terrorism
1942-09-24 00:00:00,United States Army Air Forces - USAAF,Flight,Military / Government,Solomon Islands,Oceania,9,9,9,0,0,9,0,Terrorism
1942-10-05 00:00:00,United States Army Air Forces - USAAF,Flight,Military / Government,Papua New Guinea,Oceania,9,9,9,0,0,9,0,Terrorism
1942-11-26 00:00:00,United States Navy - USN,Flight,Military / Government,World,World,9,9,9,0,0,9,0,Unknown
1942-12-31 00:00:00,United States Army Air Forces - USAAF,Flight,Operational,United States of America,North America,9,9,9,0,0,9,0,Unknown
1943-01-09 00:00:00,Royal Air Force - RAF,Landing (descent or approach),Military / Government,Iceland,Europe,15,7,4,8,5,9,6,Technical Failure
1943-01-24 00:00:00,Royal Air Force - RAF,Landing (descent or approach),Military / Government,United Kingdom,Europe,12,12,9,0,0,9,3,Human Factor
1943-03-02 00:00:00,Soviet Air Force - Voyenno-vozdushnye sily CCCP,Landing (descent or approach),Military / Government,Russia,Asia,0,0,9,0,0,9,-9,Unknown
1943-03-08 00:00:00,Royal Australian Air Force - RAAF,Flight,Military / Government,Papua New Guinea,Oceania,9,9,9,0,0,9,0,Technical Failure
1943-03-10 00:00:00,Royal Air Force - RAF,Flight,Military / Government,Algeria,Africa,9,9,9,0,0,9,0,Terrorism
1943-03-18 00:00:00,United States Army Air Forces - USAAF,Flight,Military / Government,World,World,9,9,9,0,0,9,0,Unknown
1943-03-29 00:00:00,United States Army Air Forces - USAAF,Flight,Operational,United States of America,North America,9,9,9,0,0,9,0,Unknown
1943-04-04 00:00:00,United States Army Air Forces - USAAF,Flight,Military / Government,Libya,Africa,9,9,9,0,0,9,0,Technical Failure
1943-04-21 00:00:00,United States Navy - USN,Flight,Military / Government,United States of America,North America,9,9,9,0,0,9,0,Unknown
1943-06-26 00:00:00,United States Army Air Forces - USAAF,Flight,Military / Government,Papua New Guinea,Oceania,10,10,9,0,0,9,1,Terrorism
1943-08-15 00:00:00,United States Army Air Forces - USAAF,Landing (descent or approach),Military / Government,Papua New Guinea,Oceania,9,4,4,5,5,9,0,Terrorism
1943-09-22 00:00:00,Royal Air Force - RAF,Landing (descent or approach),Operational,Gambia,Africa,9,9,9,0,0,9,0,Human Factor
1943-10-01 00:00:00,Royal Australian Air Force - RAAF,Flight,Military / Government,Indonesia,Asia,10,10,9,0,0,9,1,Terrorism
1943-10-02 00:00:00,United States Navy - USN,Flight,Military / Government,World,World,9,9,9,0,0,9,0,Unknown
1943-10-06 00:00:00,Royal Air Force - RAF,Flight,Specialised Services,United Kingdom,Europe,9,9,9,0,0,9,0,Human Factor
1943-10-25 00:00:00,United States Army Air Forces - USAAF,Flight,Operational,United States of America,North America,10,10,9,0,0,9,1,Human Factor
1943-11-02 00:00:00,Royal Air Force - RAF,Flight,Operational,Ireland,Europe,9,9,9,0,0,9,0,Terrorism
1943-11-06 00:00:00,United States Navy - USN,Flight,Military / Government,World,World,9,9,9,0,0,9,0,Unknown
1943-11-22 00:00:00,Royal Air Force - RAF,Flight,Operational,World,World,9,9,9,0,0,9,0,Unknown
1943-12-05 00:00:00,Royal Canadian Air Force - RCAF,Landing (descent or approach),Military / Government,United Kingdom,Europe,12,12,9,0,0,9,3,Human Factor
1943-12-17 00:00:00,United States Army Air Forces - USAAF,Flight,Military / Government,Kiribati,Oceania,9,2,2,7,7,9,0,Human Factor
1944-01-11 00:00:00,United States Army Air Forces - USAAF,Flight,Military / Government,Netherlands,Europe,10,10,9,0,0,9,1,Terrorism
1944-03-06 00:00:00,United States Army Air Forces - USAAF,Flight,Military / Government,Germany,Europe,12,12,9,0,0,9,3,Terrorism
1944-03-08 00:00:00,United States Navy - USN,Flight,Military / Government,Solomon Islands,Oceania,9,9,9,0,0,9,0,Unknown
1944-04-12 00:00:00,Royal Air Force - RAF,Flight,Operational,United Kingdom,Europe,9,9,9,0,0,9,0,Human Factor
1944-04-21 00:00:00,Deutsche Lufthansa,Flight,Commercial,Norway,Europe,20,3,3,17,6,9,11,Technical Failure
1944-05-10 00:00:00,United States Navy - USN,Flight,Military / Government,United States of America,North America,9,9,9,0,0,9,0,Unknown
1944-05-21 00:00:00,Royal Australian Air Force - RAAF,Flight,Military / Government,Indonesia,Asia,9,9,9,0,0,9,0,Terrorism
1944-05-25 00:00:00,United States Army Air Forces - USAAF,Flight,Operational,India,Asia,9,6,6,3,3,9,0,Unknown
1944-05-31 00:00:00,United States Navy - USN,Flight,Operational,United States of America,North America,9,9,9,0,0,9,0,Unknown
1944-06-08 00:00:00,United States Army Air Forces - USAAF,Takeoff (climb),Military / Government,United Kingdom,Europe,9,9,9,0,0,9,0,Technical Failure
1944-06-15 00:00:00,Royal Air Force - RAF,Flight,Military / Government,Morocco,Africa,9,9,9,0,0,9,0,Unknown
1944-06-16 00:00:00,United States Navy - USN,Takeoff (climb),Military / Government,United States of America,North America,9,9,9,0,0,9,0,Other
1944-07-02 00:00:00,United States Army Air Forces - USAAF,Flight,Operational,United States of America,North America,9,9,9,0,0,9,0,Unknown
1944-07-19 00:00:00,United States Army Air Forces - USAAF,Flight,Military / Government,Germany,Europe,9,9,9,0,0,9,0,Human Factor
1944-07-20 00:00:00,Royal Australian Air Force - RAAF,Flight,Military / Government,Indonesia,Asia,9,9,9,0,0,9,0,Human Factor
1944-07-27 00:00:00,United States Navy - USN,Flight,Military / Government,United States of America,North America,9,9,9,0,0,9,0,Unknown
1944-07-31 00:00:00,United States Army Air Forces - USAAF,Flight,Military / Government,Italy,Europe,22,4,0,18,9,9,13,Weather
1944-08-22 00:00:00,United States Army Air Forces - USAAF,Flight,Military / Government,United States of America,North America,9,2,2,7,7,9,0,Human Factor
1944-09-06 00:00:00,Royal Air Force - RAF,Flight,Military / Government,Ireland,Europe,10,10,9,0,0,9,1,Technical Failure
1944-09-17 00:00:00,United States Army Air Forces - USAAF,Flight,Military / Government,Belgium,Europe,15,5,5,10,4,9,6,Terrorism
1944-09-27 00:00:00,German Air Force - Deutsche Luftwaffe,Flight,Commercial,France,Europe,9,4,4,5,5,9,0,Terrorism
1944-10-04 00:00:00,Royal Air Force - RAF,Flight,Military / Government,World,World,9,9,9,0,0,9,0,Terrorism
1944-10-09 00:00:00,United States Army Air Forces - USAAF,Flight,Operational,United Kingdom,Europe,10,8,7,2,2,9,1,Human Factor
1944-10-16 00:00:00,United States Army Air Forces - USAAF,Flight,Military / Government,United States of America,North America,10,10,9,0,0,9,1,Unknown
1944-10-22 00:00:00,United States Navy - USN,Flight,Military / Government,United States of America,North America,9,9,9,0,0,9,0,Technical Failure
1944-11-26 00:00:00,Royal Air Force - RAF,Landing (descent or approach),Operational,United Kingdom,Europe,9,9,9,0,0,9,0,Human Factor
1944-11-29 00:00:00,United States Army Air Forces - USAAF,Flight,Military / Government,United States of America,North America,9,9,9,0,0,9,0,Technical Failure
1944-12-01 00:00:00,United States Army Air Forces - USAAF,Landing (descent or approach),Military / Government,United States of America,North America,9,7,7,2,2,9,0,Human Factor
1944-12-03 00:00:00,Royal Canadian Air Force - RCAF,Flight,Military / Government,Canada,North America,9,9,9,0,0,9,0,Unknown
1944-12-14 00:00:00,Royal Australian Air Force - RAAF,Flight,Military / Government,Philippines,Asia,9,9,9,0,0,9,0,Unknown
1944-12-19 00:00:00,Royal Air Force - RAF,Flight,Military / Government,Ireland,Europe,9,9,9,0,0,9,0,Human Factor
1945-01-25 00:00:00,Mexican Air Force - Fuerza Aérea Mexicana,Takeoff (climb),Military / Government,Mexico,Central America,11,3,2,8,7,9,2,Human Factor
1945-01-31 00:00:00,United States Navy - USN,Flight,Military / Government,United States of America,North America,9,9,9,0,0,9,0,Unknown
1945-02-06 00:00:00,United States Army Air Forces - USAAF,Landing (descent or approach),Military / Government,United Kingdom,Europe,9,9,9,0,0,9,0,Unknown
1945-02-11 00:00:00,Royal Canadian Air Force - RCAF,Takeoff (climb),Military / Government,United Kingdom,Europe,9,9,9,0,0,9,0,Technical Failure
1945-02-23 00:00:00,United States Army Air Forces - USAAF,Flight,Military / Government,Sudan,Africa,9,9,9,0,0,9,0,Technical Failure
1945-03-01 00:00:00,United States Army Air Forces - USAAF,Flight,Military / Government,Belgium,Europe,9,9,9,0,0,9,0,Human Factor
1945-03-01 00:00:00,United States Army Air Forces - USAAF,Flight,Military / Government,Belgium,Europe,9,9,9,0,0,9,0,Human Factor
1945-03-07 00:00:00,Royal Australian Air Force - RAAF,Flight,Military / Government,World,World,9,9,9,0,0,9,0,Unknown
1945-04-06 00:00:00,Royal Australian Air Force - RAAF,Flight,Military / Government,Indonesia,Asia,11,11,9,0,0,9,2,Terrorism
1945-05-10 00:00:00,United States Navy - USN,Flight,Operational,United States of America,North America,12,12,9,0,0,9,3,Technical Failure
1945-06-27 00:00:00,Royal Canadian Air Force - RCAF,Landing (descent or approach),Military / Government,Australia,Oceania,14,8,8,6,1,9,5,Human Factor
1945-07-31 00:00:00,Royal Australian Air Force - RAAF,Flight,Military / Government,Indonesia,Asia,9,9,9,0,0,9,0,Unknown
1945-08-17 00:00:00,United States Army Air Forces - USAAF,Flight,Operational,United States of America,North America,11,11,9,0,0,9,2,Human Factor
1945-08-17 00:00:00,United States Army Air Forces - USAAF,Flight,Operational,United States of America,North America,9,9,9,0,0,9,0,Human Factor
1945-08-19 00:00:00,Royal Air Force - RAF,Flight,Military / Government,India,Asia,9,3,3,6,6,9,0,Technical Failure
1945-09-28 00:00:00,South African Air Force,Flight,Military / Government,Zambia,Africa,28,4,0,24,9,9,19,Unknown
1945-10-24 00:00:00,British Overseas Airways Corporation - BOAC,Takeoff (climb),Commercial,Malta,Europe,16,3,0,13,9,9,7,Technical Failure
1945-11-28 00:00:00,United States Army Air Forces - USAAF,Landing (descent or approach),Military / Government,United States of America,North America,25,3,3,22,6,9,16,Human Factor
1946-07-26 00:00:00,Empresa Commercial Aéreas de Veracruz,Flight,Commercial,Mexico,Central America,9,1,1,8,8,9,0,Technical Failure
1946-12-28 00:00:00,Trans World Airlines - TWA,Landing (descent or approach),Commercial,Ireland,Europe,23,9,4,14,5,9,14,Human Factor
1947-03-08 00:00:00,VIARCO - Vias Aéreas Colombianas,Takeoff (climb),Commercial,Colombia,South America,9,4,4,5,5,9,0,Human Factor
1947-04-18 00:00:00,Royal Air Force - RAF,Flight,Military / Government,World,World,9,9,9,0,0,9,0,Technical Failure
1947-04-22 00:00:00,Aeroflot - Russian International Airlines,Flight,Commercial,Russia,Asia,33,5,1,28,8,9,24,Technical Failure
1947-09-24 00:00:00,Royal Air Force - RAF,Flight,Operational,United Kingdom,Europe,9,9,9,0,0,9,0,Weather
1947-12-31 00:00:00,United States Air Force - USAF,Takeoff (climb),Operational,United States of America,North America,9,9,9,0,0,9,0,Unknown
1948-01-08 00:00:00,Compagnie Algérienne des Transports Aériens - CATA,Flight,Commercial,Algeria,Africa,9,2,2,7,7,9,0,Technical Failure
1948-01-26 00:00:00,Air France,Takeoff (climb),Operational,France,Europe,9,9,9,0,0,9,0,Unknown
1948-01-30 00:00:00,United States Air Force - USAF,Flight,Military / Government,France,Europe,10,5,4,5,5,9,1,Weather
1948-05-11 00:00:00,United States Air Force - USAF,Flight,Military / Government,Saudi Arabia,Asia,9,9,9,0,0,9,0,Technical Failure
1948-07-15 00:00:00,United States Air Force - USAF,Takeoff (climb),Operational,United States of America,North America,13,13,9,0,0,9,4,Technical Failure
1948-08-24 00:00:00,United States Air Force - USAF,Flight,Military / Government,United States of America,North America,9,3,3,6,6,9,0,Unknown
1948-11-04 00:00:00,United States Navy - USN,Flight,Operational,Canada,North America,9,9,9,0,0,9,0,Unknown
1948-12-05 00:00:00,Civil Air Transport,Landing (descent or approach),Commercial,China,Asia,40,3,2,37,7,9,31,Unknown
1949-02-28 00:00:00,United States Air Force - USAF,Flight,Military / Government,Mexico,Central America,9,2,2,7,7,9,0,Weather
1949-03-01 00:00:00,United States Air Force - USAF,Flight,Operational,Philippines,Asia,9,9,9,0,0,9,0,Unknown
1949-07-08 00:00:00,United States Navy - USN,Landing (descent or approach),Military / Government,Panama,Central America,9,9,9,0,0,9,0,Technical Failure
1949-07-16 00:00:00,French Air Force - Armée de l'Air,Flight,Military / Government,Egypt,Africa,9,9,9,0,0,9,0,Technical Failure
1949-10-05 00:00:00,United States Air Force - USAF,Flight,Military / Government,United States of America,North America,9,2,2,7,7,9,0,Human Factor
1949-11-16 00:00:00,United States Air Force - USAF,Flight,Military / Government,United States of America,North America,11,11,9,0,0,9,2,Technical Failure
1949-11-16 00:00:00,United States Air Force - USAF,Flight,Military / Government,United States of America,North America,10,10,9,0,0,9,1,Technical Failure
1949-12-07 00:00:00,California Arrow Airlines,Flight,Commercial,United States of America,North America,9,3,3,6,6,9,0,Human Factor
1950-02-10 00:00:00,United States Navy - USN,Flight,Military / Government,United States of America,North America,9,9,9,0,0,9,0,Unknown
1950-06-01 00:00:00,United States Navy - USN,Landing (descent or approach),Military / Government,United States of America,North America,12,12,9,0,0,9,3,Unknown
1950-07-31 00:00:00,Royal Canadian Air Force - RCAF,Flight,Military / Government,Canada,North America,9,7,7,2,2,9,0,Technical Failure
1950-08-30 00:00:00,Royal Air Force - RAF,Flight,Military / Government,China,Asia,10,10,9,0,0,9,1,Unknown
1950-09-12 00:00:00,Brazilian Air Force - Força Aérea Brasileira,Flight,Military / Government,Brazil,South America,9,2,2,7,7,9,0,Human Factor
1950-09-14 00:00:00,Iran Air,Takeoff (climb),Operational,Iran,Asia,9,2,2,7,7,9,0,Unknown
1950-11-23 00:00:00,Faucett,Landing (descent or approach),Commercial,Peru,South America,9,4,4,5,5,9,0,Unknown
1951-02-07 00:00:00,United States Navy - USN,Flight,Military / Government,United States of America,North America,9,9,9,0,0,9,0,Weather
1951-04-12 00:00:00,United States Air Force - USAF,Flight,Military / Government,North Korea,Asia,11,11,9,0,0,9,2,Terrorism
1951-05-07 00:00:00,United States Air Force - USAF,Flight,Military / Government,North Korea,Asia,13,13,9,0,0,9,4,Terrorism
1951-06-06 00:00:00,United States Air Force - USAF,Takeoff (climb),Military / Government,United States of America,North America,9,9,9,0,0,9,0,Technical Failure
1951-07-12 00:00:00,French Air Force - Armée de l'Air,Takeoff (climb),Military / Government,Senegal,Africa,17,3,2,14,7,9,8,Unknown
1951-07-27 00:00:00,United States Navy - USN,Takeoff (climb),Operational,Japan,Asia,9,9,9,0,0,9,0,Human Factor
1951-08-06 00:00:00,United States Navy - USN,Flight,Operational,United States of America,North America,9,9,9,0,0,9,0,Unknown
1951-08-22 00:00:00,United States Air Force - USAF,,Military / Government,United States of America,North America,9,9,9,0,0,9,0,Unknown
1951-08-23 00:00:00,United States Navy - USN,Takeoff (climb),Military / Government,United States of America,North America,9,9,9,0,0,9,0,Unknown
1951-10-14 00:00:00,United States Air Force - USAF,Landing (descent or approach),Military / Government,Japan,Asia,14,14,9,0,0,9,5,Technical Failure
1951-10-23 00:00:00,United States Air Force - USAF,Flight,Military / Government,World,World,13,13,9,0,0,9,4,Terrorism
1951-12-04 00:00:00,United States Air Force - USAF,Takeoff (climb),Military / Government,Japan,Asia,12,12,9,0,0,9,3,Technical Failure
1952-02-19 00:00:00,United States Air Force - USAF,Flight,Military / Government,North Korea,Asia,10,10,9,0,0,9,1,Terrorism
1952-02-28 00:00:00,Panair do Brasil,Landing (descent or approach),Commercial,Brazil,South America,31,4,3,27,6,9,22,Human Factor
1952-03-31 00:00:00,United States Air Force - USAF,Takeoff (climb),Military / Government,Japan,Asia,11,11,9,0,0,9,2,Human Factor
1952-04-04 00:00:00,United States Air Force - USAF,Landing (descent or approach),Military / Government,United States of America,North America,9,9,9,0,0,9,0,Human Factor
1952-04-30 00:00:00,Deccan Airways,Landing (descent or approach),Commercial,India,Asia,9,3,3,6,6,9,0,Technical Failure
1952-10-20 00:00:00,French Air Force - Armée de l'Air,Flight,Military / Government,Vietnam,Asia,11,3,2,8,7,9,2,Unknown
1952-11-08 00:00:00,United States Air Force - USAF,Flight,Military / Government,North Korea,Asia,12,12,9,0,0,9,3,Terrorism
1952-12-21 00:00:00,Syrian Airways,Flight,Commercial,Lebanon,Asia,15,5,2,10,7,9,6,Weather
1953-01-08 00:00:00,United States Air Force - USAF,Flight,Operational,United States of America,North America,9,9,9,0,0,9,0,Human Factor
1953-01-12 00:00:00,Royal Air Force - RAF,Takeoff (climb),Operational,Egypt,Africa,9,9,9,0,0,9,0,Other
1953-01-18 00:00:00,United States Navy - USN,Takeoff (climb),Military / Government,China,Asia,9,9,9,0,0,9,0,Unknown
1953-01-29 00:00:00,United States Air Force - USAF,Flight,Military / Government,North Korea,Asia,14,14,9,0,0,9,5,Terrorism
1953-02-01 00:00:00,Royal Canadian Air Force - RCAF,Takeoff (climb),Military / Government,Canada,North America,9,9,9,0,0,9,0,Unknown
1953-06-15 00:00:00,Lineas Aéreas Costarricenses - LACSA,Flight,Commercial,Costa Rica,Central America,15,3,3,12,6,9,6,Human Factor
1953-10-09 00:00:00,United States Navy - USN,Takeoff (climb),Military / Government,Iceland,Europe,9,9,9,0,0,9,0,Technical Failure
1953-12-11 00:00:00,United States Air Force - USAF,Landing (descent or approach),Military / Government,United States of America,North America,9,8,8,1,1,9,0,Human Factor
1953-12-17 00:00:00,United States Navy - USN,Flight,Other,Northern Mariana Islands,Oceania,9,9,9,0,0,9,0,Weather
1953-12-17 00:00:00,United States Air Force - USAF,Landing (descent or approach),Military / Government,Guam Island,Asia,16,4,4,12,5,9,7,Technical Failure
1954-02-26 00:00:00,Western Airlines,Flight,Commercial,United States of America,North America,9,3,3,6,6,9,0,Weather
1954-04-12 00:00:00,French Navy,Flight,Military / Government,Vietnam,Asia,9,9,9,0,0,9,0,Terrorism
1954-04-16 00:00:00,United States Navy - USN,Flight,Military / Government,Canada,North America,9,9,9,0,0,9,0,Human Factor
1954-12-29 00:00:00,United States Air Force - USAF,Flight,Military / Government,United States of America,North America,11,4,4,7,5,9,2,Unknown
1955-01-11 00:00:00,Royal Air Force - RAF,Flight,Operational,World,World,9,9,9,0,0,9,0,Human Factor
1955-01-11 00:00:00,Royal Air Force - RAF,Flight,Operational,World,World,9,9,9,0,0,9,0,Human Factor
1955-02-23 00:00:00,United States Air Force - USAF,Flight,Operational,United States of America,North America,11,11,9,0,0,9,2,Technical Failure
1955-03-18 00:00:00,Air France,Takeoff (climb),Operational,France,Europe,9,9,9,0,0,9,0,Unknown
1955-05-04 00:00:00,United States Air Force - USAF,Flight,Military / Government,World,World,9,9,9,0,0,9,0,Technical Failure
1955-10-13 00:00:00,Royal Air Force - RAF,Flight,Military / Government,World,World,9,9,9,0,0,9,0,Unknown
1956-06-15 00:00:00,Royal Air Force - RAF,Flight,Military / Government,Malaysia,Asia,9,9,9,0,0,9,0,Human Factor
1956-10-10 00:00:00,Royal Air Force - RAF,Flight,Operational,United Kingdom,Europe,9,9,9,0,0,9,0,Unknown
1957-01-22 00:00:00,French Air Force - Armée de l'Air,Flight,Operational,Spain,Europe,9,2,2,7,7,9,0,Human Factor
1957-02-02 00:00:00,United States Air Force - USAF,Flight,Operational,France,Europe,10,10,9,0,0,9,1,Human Factor
1957-05-21 00:00:00,French Navy,Flight,Military / Government,Algeria,Africa,12,12,9,0,0,9,3,Unknown
1957-06-14 00:00:00,LOT Polish Airlines - Polskie Linie Lotnicze,Landing (descent or approach),Commercial,Russia,Asia,13,5,4,8,5,9,4,Human Factor
1957-06-19 00:00:00,Swissair,Flight,Operational,Switzerland,Europe,9,9,9,0,0,9,0,Human Factor
1957-07-21 00:00:00,United States Navy - USN,Flight,Military / Government,Italy,Europe,10,10,9,0,0,9,1,Unknown
1957-08-12 00:00:00,Royal Netherlands Navy - Marineluchtvaartdienst,Takeoff (climb),Military / Government,Indonesia,Asia,10,10,9,0,0,9,1,Unknown
1957-10-10 00:00:00,United States Navy - USN,Landing (descent or approach),Military / Government,United States of America,North America,9,9,9,0,0,9,0,Unknown
1957-11-19 00:00:00,French Air Force - Armée de l'Air,Flight,Military / Government,Morocco,Africa,9,5,5,4,4,9,0,Unknown
1957-12-31 00:00:00,Aerolineas Argentinas,Landing (descent or approach),Commercial,Argentina,South America,50,6,1,44,8,9,41,Human Factor
1958-01-14 00:00:00,United States Navy - USN,Landing (descent or approach),Operational,United States of America,North America,9,9,9,0,0,9,0,Human Factor
1958-03-25 00:00:00,Braniff International Airways,Takeoff (climb),Commercial,United States of America,North America,24,5,0,19,9,9,15,Technical Failure
1958-09-18 00:00:00,Turkish Air Force - Türk Hava Kuvvetleri,Takeoff (climb),Military / Government,Turkey,Asia,9,4,4,5,5,9,0,Weather
1958-12-24 00:00:00,British Overseas Airways Corporation - BOAC,Flight,Specialised Services,United Kingdom,Europe,12,3,2,9,7,9,3,Human Factor
1959-01-11 00:00:00,United States Air Force - USAF,Flight,Military / Government,United States of America,North America,9,9,9,0,0,9,0,Technical Failure
1959-03-29 00:00:00,Union Aéromaritime de Transport - UAT,Flight,Military / Government,Central African Republic,Africa,9,3,3,6,6,9,0,Technical Failure
1959-05-11 00:00:00,United States Navy - USN,Takeoff (climb),Operational,United States of America,North America,10,10,9,0,0,9,1,Technical Failure
1959-08-10 00:00:00,Aeroflot - Russian International Airlines,Flight,Military / Government,Russia,Asia,9,6,6,3,3,9,0,Human Factor
1960-01-03 00:00:00,Indian Airlines,Flight,Military / Government,India,Asia,9,8,8,1,1,9,0,Human Factor
1960-01-26 00:00:00,Transportes Aéreos de Timor,Flight,Commercial,Australia,Oceania,9,2,2,7,7,9,0,Human Factor
1960-02-11 00:00:00,United States Navy - USN,Flight,Operational,United States of America,North America,9,9,9,0,0,9,0,Other
1960-04-18 00:00:00,United States Air Force - USAF,Takeoff (climb),Military / Government,Canada,North America,9,9,9,0,0,9,0,Unknown
1960-05-18 00:00:00,Transamerican Air Transport,Flight,Operational,Argentina,South America,9,4,4,5,5,9,0,Weather
1960-09-11 00:00:00,United States Air Force - USAF,Flight,Military / Government,United States of America,North America,9,6,6,3,3,9,0,Human Factor
1960-11-25 00:00:00,Aeroflot - Russian International Airlines,Flight,Operational,Russia,Asia,9,7,7,2,2,9,0,Human Factor
1960-12-21 00:00:00,United States Navy - USN,Flight,Military / Government,Canada,North America,9,9,9,0,0,9,0,Unknown
1961-01-03 00:00:00,Aeroflot - Russian International Airlines,Flight,Commercial,Kyrgyzstan,Asia,9,2,2,7,7,9,0,Human Factor
1961-03-05 00:00:00,United States Air Force - USAF,Landing (descent or approach),Military / Government,United States of America,North America,9,9,9,0,0,9,0,Unknown
1961-06-20 00:00:00,Imperial Iranian Air Force,Flight,Operational,Iran,Asia,9,9,9,0,0,9,0,Unknown
1961-07-08 00:00:00,Aeroflot - Russian International Airlines,Flight,Commercial,Russia,Asia,26,5,5,21,4,9,17,Technical Failure
1962-01-08 00:00:00,United States Air Force - USAF,Flight,Military / Government,World,World,9,9,9,0,0,9,0,Unknown
1962-02-11 00:00:00,United States Air Force - USAF,Flight,Military / Government,Vietnam,Asia,9,9,9,0,0,9,0,Unknown
1962-06-17 00:00:00,Indian Air Force - Bharatiya Vayu Sena,Flight,Military / Government,India,Asia,9,9,9,0,0,9,0,Unknown
1962-07-16 00:00:00,Kalinga Airlines,Flight,Operational,India,Asia,9,3,3,6,6,9,0,Human Factor
1962-07-31 00:00:00,Brazilian Air Force - Força Aérea Brasileira,Flight,Operational,Brazil,South America,9,9,9,0,0,9,0,Unknown
1962-08-24 00:00:00,Faucett,Flight,Commercial,Peru,South America,9,3,3,6,6,9,0,Unknown
1962-09-12 00:00:00,United States Navy - USN,Takeoff (climb),Military / Government,United States of America,North America,9,9,9,0,0,9,0,Unknown
1962-11-01 00:00:00,Aeroflot - Russian International Airlines,Flight,Operational,Russia,Asia,9,5,5,4,4,9,0,Weather
1962-11-19 00:00:00,Aeroflot - Russian International Airlines,Flight,Military / Government,Ukraine,Europe,9,3,3,6,6,9,0,Human Factor
1963-04-10 00:00:00,United States Air Force - USAF,Landing (descent or approach),Operational,United States of America,North America,9,9,9,0,0,9,0,Unknown
1963-04-26 00:00:00,United States Air Force - USAF,Flight,Military / Government,United States of America,North America,9,4,4,5,5,9,0,Weather
1963-11-08 00:00:00,Portuguese Air Force - Força Aerea Portuguesa,Landing (descent or approach),Military / Government,Angola,Africa,9,2,2,7,7,9,0,Unknown
1963-12-23 00:00:00,United States Air Force - USAF,Takeoff (climb),Military / Government,United States of America,North America,9,9,9,0,0,9,0,Technical Failure
1964-01-02 00:00:00,United States Air Force - USAF,Flight,Military / Government,World,World,9,8,8,1,1,9,0,Unknown
1964-03-28 00:00:00,Facilities Management Corporation,Flight,Business,World,World,9,3,3,6,6,9,0,Technical Failure
1964-04-29 00:00:00,Israeli Air Force - Heyl Ha'avir,Landing (descent or approach),Operational,Israel,Asia,9,2,2,7,7,9,0,Unknown
1964-11-11 00:00:00,French Navy,Landing (descent or approach),Operational,Greece,Europe,13,13,9,0,0,9,4,Technical Failure
1965-03-18 00:00:00,Servicio Aéreo de Transportes Comerciales - SATCO,Flight,Operational,Peru,South America,9,6,6,3,3,9,0,Human Factor
1965-04-13 00:00:00,Indian Air Force - Bharatiya Vayu Sena,Flight,Military / Government,India,Asia,9,2,2,7,7,9,0,Unknown
1965-05-29 00:00:00,United States Government,Flight,Military / Government,United States of America,North America,9,1,1,8,8,9,0,Technical Failure
1965-09-16 00:00:00,Transportes Aéreos Orientales - TAO,Landing (descent or approach),Commercial,Ecuador,South America,11,3,3,8,6,9,2,Human Factor
1965-11-06 00:00:00,Turkish Air Force - Türk Hava Kuvvetleri,Landing (descent or approach),Military / Government,Turkey,Asia,9,2,2,7,7,9,0,Unknown
1965-12-17 00:00:00,United States Air Force - USAF,Flight,Military / Government,Vietnam,Asia,9,9,9,0,0,9,0,Terrorism
1966-01-02 00:00:00,BC Air Lines,Landing (descent or approach),Commercial,Canada,North America,10,2,2,8,7,9,1,Weather
1966-03-25 00:00:00,Aeroflot - Russian International Airlines,Flight,Operational,Russia,Asia,9,8,8,1,1,9,0,Weather
1966-07-16 00:00:00,United States Air Force - USAF,Landing (descent or approach),Military / Government,United States of America,North America,9,5,5,4,4,9,0,Weather
1966-08-21 00:00:00,Alaska Coastal Airlines,Flight,Commercial,United States of America,North America,9,1,1,8,8,9,0,Unknown
1966-11-18 00:00:00,United States Air Force - USAF,Flight,Operational,United States of America,North America,9,9,9,0,0,9,0,Unknown
1967-01-05 00:00:00,Air Taxi Company,Takeoff (climb),Commercial,United States of America,North America,9,1,1,8,8,9,0,Technical Failure
1967-01-08 00:00:00,United States Navy - USN,Takeoff (climb),Operational,United States of America,North America,9,9,9,0,0,9,0,Unknown
1967-01-19 00:00:00,United States Air Force - USAF,Flight,Military / Government,United States of America,North America,9,9,9,0,0,9,0,Human Factor
1967-03-24 00:00:00,Air America,Takeoff (climb),Commercial,Vietnam,Asia,9,1,1,8,8,9,0,Weather
1967-04-03 00:00:00,Lexington Air Taxi,Takeoff (climb),Commercial,United States of America,North America,9,1,1,8,8,9,0,Technical Failure
1967-06-17 00:00:00,Aeroflot - Russian International Airlines,Landing (descent or approach),Commercial,Kazakhstan,Asia,34,3,2,31,7,9,25,Technical Failure
1967-06-30 00:00:00,MAP - Ministerstvo Aviatsionnoi Promyshlennosti - Minaviaprom,Flight,Specialised Services,Russia,Asia,9,5,5,4,4,9,0,Technical Failure
1967-09-01 00:00:00,United States Air Force - USAF,Takeoff (climb),Military / Government,Panama,Central America,9,9,9,0,0,9,0,Unknown
1967-11-14 00:00:00,French Air Force - Armée de l'Air,Flight,Humanitarian,Senegal,Africa,9,7,7,2,2,9,0,Unknown
1967-11-19 00:00:00,Royal Air Force - RAF,Flight,Operational,World,World,11,11,9,0,0,9,2,Human Factor
1968-01-11 00:00:00,United States Navy - USN,Flight,Military / Government,Laos,Asia,9,9,9,0,0,9,0,Human Factor
1968-02-17 00:00:00,United States Navy - USN,Flight,Military / Government,Laos,Asia,9,9,9,0,0,9,0,Terrorism
1968-03-17 00:00:00,Black Hills Glass %26 Mirror Company,Landing (descent or approach),Business,United States of America,North America,9,1,1,8,8,9,0,Human Factor
1968-04-11 00:00:00,Egyptian Air Force and Air Defence Command,Flight,Military / Government,Egypt,Africa,9,2,2,7,7,9,0,Technical Failure
1968-05-22 00:00:00,United States Air Force - USAF,Flight,Military / Government,Laos,Asia,9,9,9,0,0,9,0,Terrorism
1968-07-30 00:00:00,United States Air Force - USAF,Flight,Operational,United States of America,North America,9,9,9,0,0,9,0,Technical Failure
1968-09-06 00:00:00,Northern Wings,Flight,Commercial,Canada,North America,9,2,2,7,7,9,0,Unknown
1968-11-23 00:00:00,Cable Commuter Airlines,Landing (descent or approach),Commercial,United States of America,North America,9,2,2,7,7,9,0,Human Factor
1969-02-03 00:00:00,Transportes Aéreos de Nayarit,Takeoff (climb),Commercial,Mexico,Central America,9,1,1,8,8,9,0,Unknown
1969-04-19 00:00:00,Simpson Air Services,Takeoff (climb),Commercial,United States of America,North America,9,1,1,8,8,9,0,Human Factor
1970-01-28 00:00:00,TAG Airlines,Takeoff (climb),Commercial,United States of America,North America,9,2,2,7,7,9,0,Human Factor
1970-12-15 00:00:00,United States Navy - USN,Takeoff (climb),Military / Government,Vietnam,Asia,9,4,4,5,5,9,0,Other
1971-01-07 00:00:00,United States Air Force - USAF,Flight,Operational,United States of America,North America,9,9,9,0,0,9,0,Unknown
1971-08-12 00:00:00,Aerotaxi Servicios Aéreos,Takeoff (climb),Commercial,Colombia,South America,10,1,1,9,8,9,1,Unknown
1971-09-13 00:00:00,Chinese Air Force - AFPLA - Chung-Kuo Shan Min Taie Fang Tsun Pu-Tai,Flight,Military / Government,Mongolia,Asia,9,9,9,0,0,9,0,Terrorism
1971-12-16 00:00:00,Aerotaxi Servicios Aéreos,Takeoff (climb),Commercial,Colombia,South America,9,1,1,8,8,9,0,Technical Failure
1972-01-18 00:00:00,Tandy Corporation,Landing (descent or approach),Business,United States of America,North America,9,2,2,7,7,9,0,Human Factor
1972-05-19 00:00:00,Ross Aviation - USA,Takeoff (climb),Commercial,United States of America,North America,9,1,1,8,8,9,0,Technical Failure
1972-05-29 00:00:00,Amazonense Importação e Exportação,Flight,Operational,Brazil,South America,18,3,3,15,6,9,9,Technical Failure
1972-06-24 00:00:00,Ilford Riverton Airways,Takeoff (climb),Commercial,Canada,North America,9,2,2,7,7,9,0,Technical Failure
1972-08-27 00:00:00,Air America,Flight,Commercial,Laos,Asia,9,4,4,5,5,9,0,Human Factor
1972-10-02 00:00:00,Cambodia Air Commercial,Landing (descent or approach),Commercial,Cambodia,Asia,9,3,3,6,6,9,0,Terrorism
1972-11-05 00:00:00,Aeroflot - Russian International Airlines,Takeoff (climb),Commercial,Russia,Asia,9,2,2,7,7,9,0,Human Factor
1974-02-27 00:00:00,Brethour Realty Services,Flight,Business,Canada,North America,9,2,2,7,7,9,0,Technical Failure
1974-07-18 00:00:00,Aeroflot - Russian International Airlines,Takeoff (climb),Commercial,Kazakhstan,Asia,10,2,2,8,7,9,1,Human Factor
1974-08-09 00:00:00,Royal Canadian Air Force - RCAF,Landing (descent or approach),Humanitarian,Syria,Asia,9,2,2,7,7,9,0,Terrorism
1974-09-07 00:00:00,Indian Air Force - Bharatiya Vayu Sena,Flight,Military / Government,India,Asia,9,9,9,0,0,9,0,Unknown
1974-10-22 00:00:00,Projeto Rondon,Flight,Business,Brazil,South America,9,2,2,7,7,9,0,Weather
1974-12-09 00:00:00,TAROM - Transporturile Aeriene Române,Flight,Operational,Saudi Arabia,Asia,9,9,9,0,0,9,0,Unknown
1975-01-03 00:00:00,Air America,Landing (descent or approach),Operational,Vietnam,Asia,9,3,3,6,6,9,0,Terrorism
1975-01-15 00:00:00,Malév Hungarian Airlines - Magyar Légiközlekedési Vallalat,Landing (descent or approach),Operational,Hungary,Europe,9,9,9,0,0,9,0,Human Factor
1975-02-26 00:00:00,Bolivian Air Force - Fuerza Aérea Boliviana,Flight,Operational,Bolivia,South America,9,9,9,0,0,9,0,Unknown
1975-09-17 00:00:00,Chilean Air Force - Fuerza Aérea de Chile,Flight,Military / Government,Chile,South America,9,3,3,6,6,9,0,Unknown
1975-10-16 00:00:00,United States Navy - USN,Takeoff (climb),Operational,United States of America,North America,9,2,2,7,7,9,0,Technical Failure
1975-10-17 00:00:00,Air Algérie,Flight,Commercial,Algeria,Africa,9,2,2,7,7,9,0,Unknown
1975-12-21 00:00:00,Philippine Aerotransport,Flight,Commercial,Philippines,Asia,9,2,2,7,7,9,0,Unknown
1975-12-26 00:00:00,Star Aviation,Flight,Commercial,United States of America,North America,9,1,1,8,8,9,0,Human Factor
1976-05-04 00:00:00,De Havilland Aircraft of Canada,Takeoff (climb),Operational,Zambia,Africa,11,2,2,9,7,9,2,Technical Failure
1976-12-18 00:00:00,Aeroflot - Russian International Airlines,Landing (descent or approach),Military / Government,Russia,Asia,11,6,6,5,3,9,2,Human Factor
1976-12-21 00:00:00,Imperial Iranian Air Force,Landing (descent or approach),Military / Government,Iran,Asia,9,5,5,4,4,9,0,Weather
1977-05-13 00:00:00,LOT Polish Airlines - Polskie Linie Lotnicze,Landing (descent or approach),Operational,Lebanon,Asia,9,9,9,0,0,9,0,Human Factor
1978-04-23 00:00:00,Franklin Flying Field,Flight,Commercial,United States of America,North America,9,1,1,8,8,9,0,Weather
1978-09-18 00:00:00,Imperial Iranian Air Force,Landing (descent or approach),Humanitarian,Iran,Asia,13,5,5,8,4,9,4,Technical Failure
1978-10-16 00:00:00,Aeroflot - Russian International Airlines,Flight,Commercial,Georgia,Asia,9,2,2,7,7,9,0,Other
1978-10-31 00:00:00,Taxi Aéreo Kovacs,Flight,Commercial,Brazil,South America,9,1,1,8,8,9,0,Technical Failure
1979-07-12 00:00:00,Fiji Air Services,Flight,Commercial,Fiji Islands,Oceania,9,1,1,8,8,9,0,Human Factor
1979-08-29 00:00:00,Bradley Air Services,Landing (descent or approach),Commercial,Canada,North America,9,2,2,7,7,9,0,Human Factor
1979-11-30 00:00:00,Aerolineas La Gaviola,Landing (descent or approach),Commercial,Colombia,South America,9,2,2,7,7,9,0,Unknown
1979-12-10 00:00:00,MRP - Ministerstvo Radioelektronnoi Promyshlennosti,Takeoff (climb),Specialised Services,Russia,Asia,9,9,9,0,0,9,0,Unknown
1980-01-02 00:00:00,Haïti Air Inter,Flight,Commercial,Haiti,Central America,9,1,1,8,8,9,0,Human Factor
1980-03-30 00:00:00,Votec Taxi Aéreo,Takeoff (climb),Commercial,Brazil,South America,9,1,1,8,8,9,0,Unknown
1980-06-04 00:00:00,Royal Thai Police,Flight,Military / Government,Thailand,Asia,9,1,1,8,8,9,0,Unknown
1980-08-23 00:00:00,Indian Air Force - Bharatiya Vayu Sena,Takeoff (climb),Military / Government,India,Asia,9,2,2,7,7,9,0,Unknown
1981-01-14 00:00:00,United States Air Force - USAF,Takeoff (climb),Military / Government,Germany,Europe,9,7,7,2,2,9,0,Unknown
1981-05-24 00:00:00,Ecuadorian Air Force - Fuerza Aérea Ecuatoriana,Flight,Military / Government,Ecuador,South America,9,3,3,6,6,9,0,Human Factor
1981-10-15 00:00:00,Öfag Flugdienst,Flight,Commercial,Austria,Europe,9,2,2,7,7,9,0,Human Factor
1982-03-15 00:00:00,Soviet Navy - Voyenno-morskoy flot CCCP,Landing (descent or approach),Military / Government,Russia,Asia,9,6,6,3,3,9,0,Human Factor
1982-05-11 00:00:00,Air Service Hungary - Repülögépes Szolgalat Allami Vallat,Flight,Operational,Hungary,Europe,9,2,2,7,7,9,0,Human Factor
1982-08-31 00:00:00,United States Air Force - USAF,Flight,Operational,United States of America,North America,9,9,9,0,0,9,0,Human Factor
1982-12-16 00:00:00,United States Air Force - USAF,Takeoff (climb),Operational,United States of America,North America,9,9,9,0,0,9,0,Human Factor
1983-06-02 00:00:00,Julio Roberto Silva,Takeoff (climb),Business,Colombia,South America,9,1,1,8,8,9,0,Technical Failure
1983-11-21 00:00:00,Soviet Air Force - Voyenno-vozdushnye sily CCCP,Flight,Operational,Russia,Asia,9,9,9,0,0,9,0,Weather
1984-07-01 00:00:00,Coval Air,Takeoff (climb),Commercial,Canada,North America,9,1,1,8,8,9,0,Human Factor
1984-07-12 00:00:00,United States Air Force - USAF,Takeoff (climb),Military / Government,Italy,Europe,9,8,8,1,1,9,0,Technical Failure
1984-08-02 00:00:00,Vieques Air Link,Takeoff (climb),Commercial,Puerto Rico,Central America,9,1,1,8,8,9,0,Other
1984-08-08 00:00:00,Pioneer Airlines - Kenya,Flight,Commercial,Kenya,Africa,9,1,1,8,8,9,0,Human Factor
1984-09-06 00:00:00,Talair,Flight,Commercial,Papua New Guinea,Oceania,11,1,1,10,8,9,2,Human Factor
1984-11-13 00:00:00,Flight Line - Ireland,Flight,Commercial,United Kingdom,Europe,9,1,1,8,8,9,0,Technical Failure
1985-02-04 00:00:00,North Pacific Airlines,Landing (descent or approach),Commercial,United States of America,North America,9,2,2,7,7,9,0,Human Factor
1985-02-14 00:00:00,Dirgantara Air Service,Landing (descent or approach),Commercial,Indonesia,Asia,10,1,1,9,8,9,1,Human Factor
1985-09-25 00:00:00,MAP - Ministerstvo Aviatsionnoi Promyshlennosti - Minaviaprom,Flight,Operational,Ukraine,Europe,9,5,5,4,4,9,0,Technical Failure
1985-12-18 00:00:00,Interamericana de Aviacion,Takeoff (climb),Humanitarian,Colombia,South America,9,2,2,7,7,9,0,Technical Failure
1986-03-25 00:00:00,MOM - Ministerstvo Obshego Mashinostroenia,Landing (descent or approach),Operational,Russia,Asia,9,6,6,3,3,9,0,Human Factor
1987-01-10 00:00:00,Philippine Air Force - Hukbong Himpapawid NG Pilipinas,Flight,Military / Government,Philippines,Asia,12,2,2,10,7,9,3,Technical Failure
1987-01-16 00:00:00,Aeroflot - Russian International Airlines,Takeoff (climb),Operational,Uzbekistan,Asia,9,4,4,5,5,9,0,Human Factor
1987-02-05 00:00:00,Aero France,Flight,Commercial,Cameroon,Africa,9,2,2,7,7,9,0,Unknown
1987-02-19 00:00:00,Soviet Air Force - Voyenno-vozdushnye sily CCCP,Landing (descent or approach),Military / Government,Ukraine,Europe,9,4,4,5,5,9,0,Human Factor
1987-03-04 00:00:00,Northwest Airlink,Landing (descent or approach),Commercial,United States of America,North America,19,3,2,16,7,9,10,Human Factor
1987-03-06 00:00:00,Aeroflot - Russian International Airlines,Flight,Operational,Kazakhstan,Asia,9,4,4,5,5,9,0,Human Factor
1987-09-08 00:00:00,Brazilian Air Force - Força Aérea Brasileira,Takeoff (climb),Military / Government,Brazil,South America,9,2,2,7,7,9,0,Unknown
1987-09-26 00:00:00,Colombian Air Force - Fuerza Aérea Colombiana,Flight,Military / Government,Colombia,South America,9,1,1,8,8,9,0,Unknown
1987-10-19 00:00:00,MAP - Ministerstvo Aviatsionnoi Promyshlennosti - Minaviaprom,Takeoff (climb),Operational,Russia,Asia,9,5,5,4,4,9,0,Human Factor
1988-01-18 00:00:00,Empresa Transportes Aéreos - ETA,Flight,Commercial,Bolivia,South America,9,3,3,6,6,9,0,Human Factor
1988-01-19 00:00:00,Trans-Colorado Airlines - TCA,Landing (descent or approach),Commercial,United States of America,North America,17,2,2,15,7,9,8,Human Factor
1988-01-23 00:00:00,Contras Air Force - Fuerza Aérea de Contras,Flight,Military / Government,Nicaragua,Central America,10,10,9,0,0,9,1,Terrorism
1988-03-08 00:00:00,Aeroflot - Russian International Airlines,Parking,Commercial,Russia,Asia,84,8,1,76,8,9,75,Terrorism
1988-03-08 00:00:00,Indian Air Force - Bharatiya Vayu Sena,Takeoff (climb),Military / Government,India,Asia,9,4,4,5,5,9,0,Technical Failure
1988-04-21 00:00:00,École de parachutisme d’Île de France,Takeoff (climb),Humanitarian,France,Europe,10,1,1,9,8,9,1,Technical Failure
1989-01-30 00:00:00,Royal Canadian Air Force - RCAF,Landing (descent or approach),Military / Government,United States of America,North America,18,8,2,10,7,9,9,Human Factor
1989-05-20 00:00:00,Policía Nacional del Peru,Flight,Military / Government,Peru,South America,9,1,1,8,8,9,0,Human Factor
1989-09-28 00:00:00,MAP - Ministerstvo Aviatsionnoi Promyshlennosti - Minaviaprom,Flight,Operational,Ukraine,Europe,9,9,9,0,0,9,0,Technical Failure
1990-01-02 00:00:00,Pelita Air Service,Flight,Commercial,Indonesia,Asia,16,3,2,13,7,9,7,Technical Failure
1990-03-27 00:00:00,Soviet Air Force - Voyenno-vozdushnye sily CCCP,Landing (descent or approach),Operational,Afghanistan,Asia,9,9,9,0,0,9,0,Human Factor
1990-07-31 00:00:00,Servicio Expresso Nacional,Flight,Commercial,Peru,South America,9,1,1,8,8,9,0,Technical Failure
1990-10-11 00:00:00,MAP - Ministerstvo Aviatsionnoi Promyshlennosti - Minaviaprom,Landing (descent or approach),Operational,Russia,Asia,10,5,4,5,5,9,1,Human Factor
1990-11-12 00:00:00,Brazilian Air Force - Força Aérea Brasileira,Takeoff (climb),Military / Government,Brazil,South America,10,10,9,0,0,9,1,Unknown
1991-03-16 00:00:00,Transafrik,Flight,Operational,Angola,Africa,9,4,4,5,5,9,0,Terrorism
1991-07-25 00:00:00,Vanair,Takeoff (climb),Commercial,Vanuatu,Oceania,9,1,1,8,8,9,0,Human Factor
1991-08-13 00:00:00,TAROM - Transporturile Aeriene Române,Flight,Operational,Romania,Europe,9,5,5,4,4,9,0,Human Factor
1991-08-15 00:00:00,Soviet Air Force - Voyenno-vozdushnye sily CCCP,Takeoff (climb),Military / Government,Russia,Asia,9,6,6,3,3,9,0,Human Factor
1991-09-07 00:00:00,Occidental de Aviación,Landing (descent or approach),Commercial,Colombia,South America,9,2,2,7,7,9,0,Human Factor
1991-12-11 00:00:00,Bruno's Inc.,Takeoff (climb),Business,United States of America,North America,9,2,2,7,7,9,0,Human Factor
1991-12-26 00:00:00,Eagle Aviation - Kenya,Flight,Commercial,Kenya,Africa,9,1,1,8,8,9,0,Other
1992-02-28 00:00:00,M. B. Pereira Industrial e Comercial,Flight,Business,Brazil,South America,9,2,2,7,7,9,0,Unknown
1992-04-22 00:00:00,Scenic Air Tours,Flight,Commercial,United States of America,North America,9,1,1,8,8,9,0,Human Factor
1992-04-28 00:00:00,United States Air Force - USAF,Flight,Operational,United States of America,North America,9,9,9,0,0,9,0,Unknown
1992-10-19 00:00:00,Procuraduría General de la República,Takeoff (climb),Military / Government,Mexico,Central America,9,2,2,7,7,9,0,Unknown
1992-12-09 00:00:00,Aero Sudpacífico,Takeoff (climb),Commercial,Mexico,Central America,9,1,1,8,8,9,0,Technical Failure
1993-01-08 00:00:00,Avemex - Aviacion Ejecutiva Mexicana,Landing (descent or approach),Commercial,Mexico,Central America,9,2,2,7,7,9,0,Human Factor
1993-05-27 00:00:00,Royal Air Force - RAF,Flight,Operational,United Kingdom,Europe,9,9,9,0,0,9,0,Human Factor
1993-06-09 00:00:00,South West Air - PNG,Landing (descent or approach),Commercial,Papua New Guinea,Oceania,11,1,0,10,9,9,2,Human Factor
1993-10-25 00:00:00,Hibiscus Air Services,Flight,Commercial,New Zealand,Oceania,9,2,2,7,7,9,0,Human Factor
1994-05-07 00:00:00,Société Nationale d'Electricité,Landing (descent or approach),Business,Democratic Republic of Congo,Africa,9,2,2,7,7,9,0,Human Factor
1994-06-13 00:00:00,Aero Cuahonte,Landing (descent or approach),Commercial,Mexico,Central America,9,2,2,7,7,9,0,Human Factor
1994-10-02 00:00:00,Seaview Air,Flight,Commercial,World,World,9,1,1,8,8,9,0,Unknown
1995-03-16 00:00:00,Central Region Airlines - Avialinii Tsentralnykh Rayonov,Landing (descent or approach),Operational,Russia,Asia,10,7,7,3,2,9,1,Human Factor
1995-05-09 00:00:00,Cooperativa Interregional de Colombia,Landing (descent or approach),Operational,Colombia,South America,9,2,2,7,7,9,0,Human Factor
1995-10-31 00:00:00,Transportes Aéreos de Coahuila - TACSA,Flight,Commercial,Mexico,Central America,11,1,1,10,8,9,2,Human Factor
1996-02-27 00:00:00,Aero Tropical,Landing (descent or approach),Operational,Angola,Africa,9,6,6,3,3,9,0,Terrorism
1996-03-02 00:00:00,Madrid Taxi Aéreo,Landing (descent or approach),Commercial,Brazil,South America,9,2,2,7,7,9,0,Human Factor
1996-07-11 00:00:00,Archana Airways,Landing (descent or approach),Commercial,India,Asia,9,3,3,6,6,9,0,Human Factor
1996-08-03 00:00:00,Royal Danish Air Force - Flyvevåbnet,Landing (descent or approach),Military / Government,Denmark,Europe,9,4,4,5,5,9,0,Weather
1996-08-17 00:00:00,United States Air Force - USAF,Takeoff (climb),Military / Government,United States of America,North America,9,8,8,1,1,9,0,Human Factor
1996-11-17 00:00:00,Brazilian Air Force - Força Aérea Brasileira,Flight,Military / Government,Brazil,South America,9,2,2,7,7,9,0,Human Factor
1997-08-29 00:00:00,SATENA - Servicio de Aeronavegacion a Territorios Nacionales,Landing (descent or approach),Military / Government,Colombia,South America,9,2,2,7,7,9,0,Human Factor
1997-09-13 00:00:00,United States Air Force - USAF,Flight,Military / Government,World,World,9,9,9,0,0,9,0,Human Factor
1997-10-08 00:00:00,Scenic Airlines,Flight,Commercial,United States of America,North America,9,1,1,8,8,9,0,Human Factor
1997-10-10 00:00:00,NAYSA Aerotaxis - Navegación y Servicios Aéreos Canarios,Landing (descent or approach),Commercial,Gambia,Africa,10,2,2,8,7,9,1,Weather
1997-11-01 00:00:00,Centre Ecole Régional Parachutisme de Picardie,Takeoff (climb),Humanitarian,France,Europe,9,1,1,8,8,9,0,Human Factor
1997-12-20 00:00:00,Viproca,Landing (descent or approach),Business,Venezuela,South America,10,1,1,9,8,9,1,Technical Failure
1998-02-13 00:00:00,Heading South,Landing (descent or approach),Commercial,Kenya,Africa,9,1,1,8,8,9,0,Human Factor
1998-10-12 00:00:00,Jetair Flight Academy,Landing (descent or approach),Commercial,Norway,Europe,9,1,1,8,8,9,0,Technical Failure
1998-11-17 00:00:00,Paradise Air - Philippines,Landing (descent or approach),Commercial,Palau,Asia,9,2,2,7,7,9,0,Human Factor
1999-01-02 00:00:00,Transafrik,Takeoff (climb),Humanitarian,Angola,Africa,9,4,4,5,5,9,0,Terrorism
2000-03-09 00:00:00,Vologda Air Enterprise - Vologodskoe Aviapredpriatie,Takeoff (climb),Commercial,Russia,Asia,9,5,5,4,4,9,0,Human Factor
2000-08-09 00:00:00,Patuxent Airways,Takeoff (climb),Commercial,United States of America,North America,9,2,2,7,7,9,0,Human Factor
2001-01-08 00:00:00,Indonesian Navy - TNI-AL Tentara Nasional Indonesia - Angkatan Laut,Flight,Military / Government,Indonesia,Asia,9,5,5,4,4,9,0,Human Factor
2001-01-14 00:00:00,Skydive Salt Lake,Landing (descent or approach),Business,United States of America,North America,9,1,1,8,8,9,0,Human Factor
2001-08-25 00:00:00,Blackhwak International Airways,Takeoff (climb),Commercial,Bahamas,Central America,9,1,1,8,8,9,0,Human Factor
2001-09-27 00:00:00,Brazilian Air Force - Força Aérea Brasileira,Landing (descent or approach),Military / Government,Brazil,South America,9,9,9,0,0,9,0,Human Factor
2002-07-16 00:00:00,Sabang Merauke Raya Air Charter - SMAC,Landing (descent or approach),Commercial,Indonesia,Asia,10,2,2,8,7,9,1,Human Factor
2004-02-26 00:00:00,Macedonian Government,Landing (descent or approach),Military / Government,Bosnia and Herzegovina,Europe,9,2,2,7,7,9,0,Human Factor
2005-01-13 00:00:00,Tura Air Enterprise - Turinskoe Aviapredpriatie,Landing (descent or approach),Commercial,Russia,Asia,9,2,2,7,7,9,0,Human Factor
2005-03-26 00:00:00,West Caribbean Airways,Takeoff (climb),Commercial,Colombia,South America,14,2,2,12,7,9,5,Technical Failure
2005-03-31 00:00:00,United States Air Force - USAF,Flight,Operational,Albania,Europe,9,9,9,0,0,9,0,Human Factor
2006-06-21 00:00:00,Yeti Airlines,Landing (descent or approach),Commercial,Nepal,Asia,9,3,3,6,6,9,0,Human Factor
2007-05-06 00:00:00,French Air Force - Armée de l'Air,Flight,Military / Government,Egypt,Africa,9,1,1,8,8,9,0,Technical Failure
2008-05-26 00:00:00,Moskovia Airlines,Takeoff (climb),Operational,Russia,Asia,9,9,9,0,0,9,0,Technical Failure
2008-07-10 00:00:00,Aerocord - Inversiones Aéreas Patagonia,Takeoff (climb),Commercial,Chile,South America,9,1,1,8,8,9,0,Technical Failure
2008-10-05 00:00:00,Glen Lena,Flight,Business,South Africa,Africa,9,1,1,8,8,9,0,Human Factor
2008-11-04 00:00:00,Mexican Government,Landing (descent or approach),Military / Government,Mexico,Central America,9,3,3,6,6,9,0,Human Factor
2009-02-25 00:00:00,Turkish Airlines - THY Türk Hava Yollari,Landing (descent or approach),Commercial,Netherlands,Europe,135,7,4,128,5,9,126,Technical Failure
2010-06-14 00:00:00,Servicios Aéreos Milenio,Takeoff (climb),Commercial,Mexico,Central America,9,2,2,7,7,9,0,Unknown
2010-09-04 00:00:00,Skydive New Zealand,Takeoff (climb),Humanitarian,New Zealand,Oceania,9,1,1,8,8,9,0,Human Factor
2010-10-05 00:00:00,Acklins Blue Charters - ABC Charters,Takeoff (climb),Commercial,Bahamas,Central America,9,2,2,7,7,9,0,Technical Failure
2011-02-08 00:00:00,Majuba Aviation,Landing (descent or approach),Commercial,South Africa,Africa,9,2,2,7,7,9,0,Human Factor
2011-03-21 00:00:00,Trans Air Congo,Landing (descent or approach),Operational,Congo,Africa,9,4,4,5,5,9,0,Technical Failure
2011-07-06 00:00:00,Silk Way Airlines,Landing (descent or approach),Operational,Afghanistan,Asia,9,9,9,0,0,9,0,Human Factor
2013-03-06 00:00:00,ATSA-Aero Transporte - Asesoramientos Tecnicos,Landing (descent or approach),Commercial,Peru,South America,9,2,2,7,7,9,0,Human Factor
2013-12-26 00:00:00,Irkut,Landing (descent or approach),Operational,Russia,Asia,9,6,6,3,3,9,0,Human Factor
2014-11-09 00:00:00,Diplomat Aviation,Landing (descent or approach),Commercial,Bahamas,Central America,9,2,2,7,7,9,0,Human Factor
2015-06-25 00:00:00,Promech Air,Flight,Commercial,United States of America,North America,9,1,1,8,8,9,0,Human Factor
2015-11-10 00:00:00,Execuflight,Landing (descent or approach),Commercial,United States of America,North America,9,2,2,7,7,9,0,Human Factor
2016-06-16 00:00:00,Vietnam Marine Police - Vietnam Coast Guard,Flight,Military / Government,Vietnam,Asia,9,3,3,6,6,9,0,Unknown
2017-07-04 00:00:00,Servicio Autónomo de Transporte Aéreo - SATA,Flight,Military / Government,Venezuela,South America,9,3,3,6,6,9,0,Unknown
2018-05-02 00:00:00,United States Air Force - USAF,Takeoff (climb),Military / Government,United States of America,North America,9,5,5,4,4,9,0,Human Factor
2019-07-14 00:00:00,Skydive Umeå,Flight,Humanitarian,Sweden,Europe,9,1,1,8,8,9,0,Human Factor
2019-09-01 00:00:00,INAEC Aviation Corporation,Flight,Humanitarian,Philippines,Asia,9,2,2,7,7,9,0,Unknown
2019-11-30 00:00:00,Conrad %26 Bischoff,Flight,Business,United States of America,North America,12,1,1,11,8,9,3,Unknown
2019-12-19 00:00:00,Private Venezuelan,Landing (descent or approach),Business,Venezuela,South America,9,2,2,7,7,9,0,Unknown
2021-07-08 00:00:00,Skydive Skåne,Takeoff (climb),Humanitarian,Sweden,Europe,9,1,1,8,8,9,0,Unknown
2021-11-03 00:00:00,Grodno Aircompany,Landing (descent or approach),Operational,Russia,Asia,9,7,7,2,2,9,0,Unknown
2021-12-15 00:00:00,Helidosa Aviation Group,Landing (descent or approach),Commercial,Dominican Republic,Central America,9,3,3,6,6,9,0,Unknown
1924-12-24 00:00:00,Imperial Airways,Takeoff (climb),Commercial,United Kingdom,Europe,8,1,1,7,7,8,0,Technical Failure
1928-05-05 00:00:00,Nakajima Aircraft Company,Flight,Specialised Services,Japan,Asia,8,8,8,0,0,8,0,Unknown
1929-01-11 00:00:00,United States Army Air Corps - USAAC,Takeoff (climb),Military / Government,United States of America,North America,8,1,1,7,7,8,0,Technical Failure
1929-08-14 00:00:00,Japan Air Self-Defense Force - Kōkū Jieitai,Takeoff (climb),Military / Government,Japan,Asia,8,8,8,0,0,8,0,Unknown
1929-09-03 00:00:00,Transcontinental Air Transport - TAT,Flight,Commercial,United States of America,North America,8,3,3,5,5,8,0,Weather
1930-10-06 00:00:00,Deutsche Lufthansa,Landing (descent or approach),Commercial,Germany,Europe,8,2,2,6,6,8,0,Technical Failure
1931-03-21 00:00:00,Australian National Airways - ANA,Flight,Commercial,Australia,Oceania,8,2,2,6,6,8,0,Weather
1931-03-31 00:00:00,Transcontinental %26 Western Air - TWA,Flight,Commercial,United States of America,North America,8,2,2,6,6,8,0,Weather
1932-01-29 00:00:00,Century Pacific Lines,Flight,Commercial,United States of America,North America,8,1,1,7,7,8,0,Weather
1933-09-05 00:00:00,Aeroflot - Russian International Airlines,Flight,Commercial,Russia,Asia,8,2,2,6,6,8,0,Human Factor
1933-09-12 00:00:00,Aeroput,Takeoff (climb),Commercial,Slovenia,Europe,8,2,2,6,6,8,0,Technical Failure
1934-02-23 00:00:00,Boeing Air Transport,Flight,Commercial,United States of America,North America,8,3,3,5,5,8,0,Human Factor
1935-09-13 00:00:00,Panama Airways,Flight,Commercial,Panama,Central America,8,2,2,6,6,8,0,Weather
1936-08-05 00:00:00,Chicago %26 Southern Air Lines,Takeoff (climb),Commercial,United States of America,North America,8,2,2,6,6,8,0,Human Factor
1937-04-03 00:00:00,KLM Royal Dutch Airlines - Koninklijke Luchtvaart Maatschappij,Flight,Operational,United States of America,North America,8,8,8,0,0,8,0,Human Factor
1937-08-02 00:00:00,Ala Littoria,Landing (descent or approach),Commercial,Sudan,Africa,8,4,4,4,4,8,0,Unknown
1938-01-09 00:00:00,Argentinian Air Force - Fuerza Aérea Argentina,Flight,Military / Government,Uruguay,South America,8,2,2,6,6,8,0,Unknown
1938-02-09 00:00:00,Air France,Takeoff (climb),Commercial,France,Europe,14,5,3,9,5,8,6,Weather
1938-03-23 00:00:00,Air France,Flight,Commercial,France,Europe,8,3,3,5,5,8,0,Weather
1938-07-11 00:00:00,Transportes Aéreos de Chiapas,Flight,Commercial,Mexico,Central America,8,1,1,7,7,8,0,Unknown
1938-12-02 00:00:00,Mexicana de Aviación,Takeoff (climb),Commercial,Mexico,Central America,8,3,3,5,5,8,0,Human Factor
1939-03-15 00:00:00,SCADTA - Sociedad Colombo-Alemana de Transportes Aéreos,Landing (descent or approach),Commercial,Colombia,South America,8,2,2,6,6,8,0,Unknown
1939-03-26 00:00:00,Braniff Airways,Takeoff (climb),Commercial,United States of America,North America,12,3,1,9,7,8,4,Technical Failure
1940-01-22 00:00:00,KNILM - Koninklijke Nederlandse Indies Luchtvaart Maatschappij,Takeoff (climb),Commercial,Indonesia,Asia,9,4,3,5,5,8,1,Unknown
1940-03-01 00:00:00,Imperial Airways,Flight,Commercial,World,World,8,4,4,4,4,8,0,Unknown
1940-05-30 00:00:00,German Air Force - Deutsche Luftwaffe,Flight,Military / Government,Norway,Europe,8,4,4,4,4,8,0,Terrorism
1941-02-26 00:00:00,Eastern Airlines,Landing (descent or approach),Commercial,United States of America,North America,16,3,3,13,5,8,8,Human Factor
1941-06-10 00:00:00,Brazilian Air Force - Força Aérea Brasileira,Flight,Operational,Brazil,South America,8,1,1,7,7,8,0,Human Factor
1941-06-22 00:00:00,Royal Air Force - RAF,Flight,Specialised Services,United Kingdom,Europe,9,9,8,0,0,8,1,Weather
1941-07-31 00:00:00,Royal Air Force - RAF,Flight,Military / Government,Libya,Africa,12,12,8,0,0,8,4,Terrorism
1941-08-18 00:00:00,Panair do Brasil,Landing (descent or approach),Commercial,Brazil,South America,14,4,3,10,5,8,6,Human Factor
1941-09-06 00:00:00,Royal Air Force - RAF,Flight,Military / Government,Norway,Europe,8,8,8,0,0,8,0,Terrorism
1941-11-08 00:00:00,United States Navy - USN,Landing (descent or approach),Military / Government,Canada,North America,8,8,8,0,0,8,0,Unknown
1941-12-08 00:00:00,Royal Australian Air Force - RAAF,Takeoff (climb),Military / Government,Papua New Guinea,Oceania,8,8,8,0,0,8,0,Unknown
1941-12-10 00:00:00,Royal Air Force - RAF,Flight,Operational,United Kingdom,Europe,8,8,8,0,0,8,0,Human Factor
1941-12-12 00:00:00,United States Army Air Forces - USAAF,Flight,Military / Government,United States of America,North America,8,3,3,5,5,8,0,Human Factor
1941-12-18 00:00:00,United States Army Air Forces - USAAF,Takeoff (climb),Operational,United States of America,North America,8,8,8,0,0,8,0,Weather
1942-01-06 00:00:00,Royal Air Force - RAF,Takeoff (climb),Operational,United Kingdom,Europe,10,10,8,0,0,8,2,Technical Failure
1942-01-09 00:00:00,Royal Air Force - RAF,Flight,Military / Government,United Kingdom,Europe,8,8,8,0,0,8,0,Technical Failure
1942-01-15 00:00:00,Royal Australian Air Force - RAAF,Takeoff (climb),Military / Government,Papua New Guinea,Oceania,8,8,8,0,0,8,0,Unknown
1942-01-21 00:00:00,Royal Australian Air Force - RAAF,Flight,Operational,Papua New Guinea,Oceania,9,9,8,0,0,8,1,Terrorism
1942-01-29 00:00:00,United States Army Air Forces - USAAF,Flight,Military / Government,Indonesia,Asia,8,8,8,0,0,8,0,Terrorism
1942-01-31 00:00:00,Royal Air Force - RAF,Flight,Military / Government,World,World,8,8,8,0,0,8,0,Unknown
1942-02-03 00:00:00,United States Army Air Forces - USAAF,Flight,Military / Government,Indonesia,Asia,8,8,8,0,0,8,0,Terrorism
1942-02-06 00:00:00,United States Army Air Forces - USAAF,Flight,Military / Government,United States of America,North America,8,8,8,0,0,8,0,Unknown
1942-02-17 00:00:00,United States Navy - USN,Takeoff (climb),Military / Government,United States of America,North America,8,8,8,0,0,8,0,Unknown
1942-02-24 00:00:00,Royal Australian Air Force - RAAF,Flight,Military / Government,Papua New Guinea,Oceania,8,8,8,0,0,8,0,Unknown
1942-04-12 00:00:00,United States Navy - USN,Flight,Military / Government,United States of America,North America,8,8,8,0,0,8,0,Human Factor
1942-04-20 00:00:00,Royal Air Force - RAF,Flight,Military / Government,Germany,Europe,8,8,8,0,0,8,0,Unknown
1942-04-21 00:00:00,United States Army Air Forces - USAAF,Takeoff (climb),Military / Government,Australia,Oceania,8,8,8,0,0,8,0,Unknown
1942-05-09 00:00:00,Royal Air Force - RAF,Flight,Military / Government,World,World,8,8,8,0,0,8,0,Unknown
1942-05-15 00:00:00,United States Army Air Forces - USAAF,Takeoff (climb),Military / Government,Australia,Oceania,8,8,8,0,0,8,0,Unknown
1942-05-18 00:00:00,United States Army Air Forces - USAAF,Flight,Military / Government,United States of America,North America,8,8,8,0,0,8,0,Unknown
1942-06-01 00:00:00,United States Navy - USN,Flight,Operational,United States of America,North America,8,8,8,0,0,8,0,Unknown
1942-06-09 00:00:00,United States Army Air Forces - USAAF,Flight,Military / Government,Papua New Guinea,Oceania,8,8,8,0,0,8,0,Terrorism
1942-06-20 00:00:00,United States Army Air Forces - USAAF,Flight,Military / Government,United States of America,North America,8,8,8,0,0,8,0,Unknown
1942-07-13 00:00:00,Royal Air Force - RAF,Flight,Operational,United Kingdom,Europe,8,8,8,0,0,8,0,Human Factor
1942-08-02 00:00:00,United States Army Air Forces - USAAF,Flight,Military / Government,Papua New Guinea,Oceania,9,9,8,0,0,8,1,Terrorism
1942-08-09 00:00:00,United States Army Air Forces - USAAF,Flight,Military / Government,Papua New Guinea,Oceania,8,8,8,0,0,8,0,Terrorism
1942-08-13 00:00:00,United States Army Air Forces - USAAF,Flight,Operational,United States of America,North America,8,8,8,0,0,8,0,Unknown
1942-08-21 00:00:00,Royal Air Force - RAF,Flight,Specialised Services,United Kingdom,Europe,8,8,8,0,0,8,0,Human Factor
1942-08-21 00:00:00,Royal Air Force - RAF,Flight,Specialised Services,United Kingdom,Europe,8,8,8,0,0,8,0,Human Factor
1942-09-07 00:00:00,Royal Air Force - RAF,Takeoff (climb),Military / Government,Egypt,Africa,14,14,8,0,0,8,6,Technical Failure
1942-09-24 00:00:00,United States Army Air Forces - USAAF,Flight,Military / Government,Papua New Guinea,Oceania,8,8,8,0,0,8,0,Technical Failure
1942-09-25 00:00:00,Royal Air Force - RAF,Flight,Military / Government,Spain,Europe,8,7,7,1,1,8,0,Weather
1942-10-09 00:00:00,United States Navy - USN,Takeoff (climb),Military / Government,New Caledonia,Oceania,8,8,8,0,0,8,0,Technical Failure
1942-10-16 00:00:00,United States Army Air Forces - USAAF,Flight,Military / Government,United States of America,North America,8,8,8,0,0,8,0,Terrorism
1942-10-16 00:00:00,United States Army Air Forces - USAAF,Flight,Military / Government,United States of America,North America,8,8,8,0,0,8,0,Terrorism
1942-11-01 00:00:00,United States Army Air Forces - USAAF,Flight,Military / Government,Papua New Guinea,Oceania,8,8,8,0,0,8,0,Unknown
1942-12-08 00:00:00,Soviet Air Force - Voyenno-vozdushnye sily CCCP,Flight,Operational,Kazakhstan,Asia,8,5,5,3,3,8,0,Weather
1942-12-16 00:00:00,United States Army Air Forces - USAAF,Takeoff (climb),Operational,United States of America,North America,8,8,8,0,0,8,0,Unknown
1942-12-17 00:00:00,Royal Air Force - RAF,Flight,Military / Government,Netherlands,Europe,8,8,8,0,0,8,0,Unknown
1942-12-27 00:00:00,United States Navy - USN,Flight,Military / Government,World,World,8,8,8,0,0,8,0,Unknown
1942-12-31 00:00:00,United States Navy - USN,Landing (descent or approach),Operational,United States of America,North America,8,8,8,0,0,8,0,Unknown
1943-01-10 00:00:00,United States Navy - USN,Flight,Operational,Bermuda,North America,8,8,8,0,0,8,0,Unknown
1943-02-03 00:00:00,Royal Air Force - RAF,Flight,Military / Government,Netherlands,Europe,8,8,8,0,0,8,0,Terrorism
1943-02-08 00:00:00,United States Army Air Forces - USAAF,Flight,Military / Government,Italy,Europe,8,8,8,0,0,8,0,Unknown
1943-03-05 00:00:00,United States Navy - USN,Flight,Military / Government,World,World,8,8,8,0,0,8,0,Unknown
1943-03-10 00:00:00,United States Navy - USN,Flight,Military / Government,United States of America,North America,8,8,8,0,0,8,0,Unknown
1943-03-11 00:00:00,United States Army Air Forces - USAAF,Flight,Military / Government,Papua New Guinea,Oceania,8,6,6,2,2,8,0,Human Factor
1943-03-11 00:00:00,United States Army Air Forces - USAAF,Flight,Operational,United States of America,North America,8,8,8,0,0,8,0,Unknown
1943-03-30 00:00:00,United States Navy - USN,Flight,Operational,United States of America,North America,8,8,8,0,0,8,0,Human Factor
1943-05-21 00:00:00,United States Army Air Forces - USAAF,Flight,Military / Government,Papua New Guinea,Oceania,11,10,7,1,1,8,3,Terrorism
1943-05-24 00:00:00,United States Navy - USN,Landing (descent or approach),Military / Government,United States of America,North America,8,8,8,0,0,8,0,Weather
1943-06-09 00:00:00,Royal Air Force - RAF,Flight,Military / Government,Spain,Europe,10,10,8,0,0,8,2,Human Factor
1943-06-11 00:00:00,United States Navy - USN,Landing (descent or approach),Humanitarian,World,World,9,9,8,0,0,8,1,Human Factor
1943-06-21 00:00:00,United States Army Air Forces - USAAF,Flight,Operational,United States of America,North America,8,8,8,0,0,8,0,Unknown
1943-06-25 00:00:00,Royal Air Force - RAF,Flight,Military / Government,South Africa,Africa,8,8,8,0,0,8,0,Unknown
1943-07-17 00:00:00,United States Navy - USN,Flight,Military / Government,World,World,8,8,8,0,0,8,0,Unknown
1943-07-18 00:00:00,United States Navy - USN,Flight,Specialised Services,United States of America,North America,8,8,8,0,0,8,0,Unknown
1943-07-30 00:00:00,United States Army Air Forces - USAAF,Flight,Military / Government,Netherlands,Europe,10,10,8,0,0,8,2,Terrorism
1943-08-01 00:00:00,United States Army Air Forces - USAAF,Flight,Military / Government,Romania,Europe,10,10,8,0,0,8,2,Terrorism
1943-08-03 00:00:00,Royal Air Force - RAF,Flight,Military / Government,World,World,8,8,8,0,0,8,0,Unknown
1943-08-22 00:00:00,Royal Air Force - RAF,Flight,Military / Government,Ireland,Europe,11,11,8,0,0,8,3,Human Factor
1943-08-24 00:00:00,Royal Air Force - RAF,Landing (descent or approach),Operational,United Kingdom,Europe,12,12,8,0,0,8,4,Unknown
1943-08-24 00:00:00,Royal Air Force - RAF,Flight,Military / Government,World,World,8,8,8,0,0,8,0,Unknown
1943-09-02 00:00:00,Royal Air Force - RAF,Flight,Military / Government,World,World,8,8,8,0,0,8,0,Terrorism
1943-09-15 00:00:00,Royal Air Force - RAF,Flight,Military / Government,Germany,Europe,8,8,8,0,0,8,0,Terrorism
1943-09-16 00:00:00,Royal Air Force - RAF,Flight,Military / Government,Germany,Europe,8,8,8,0,0,8,0,Terrorism
1943-09-16 00:00:00,Royal Air Force - RAF,Flight,Military / Government,Germany,Europe,8,8,8,0,0,8,0,Terrorism
1943-09-22 00:00:00,Royal Air Force - RAF,Flight,Military / Government,World,World,8,8,8,0,0,8,0,Terrorism
1943-10-04 00:00:00,United States Navy - USN,Flight,Operational,United States of America,North America,10,10,8,0,0,8,2,Weather
1943-10-16 00:00:00,Royal Air Force - RAF,Flight,Military / Government,United Kingdom,Europe,10,10,8,0,0,8,2,Unknown
1943-10-24 00:00:00,United States Army Air Forces - USAAF,Flight,Military / Government,World,World,8,8,8,0,0,8,0,Unknown
1943-10-24 00:00:00,United States Army Air Forces - USAAF,Flight,Military / Government,World,World,8,8,8,0,0,8,0,Unknown
1943-10-25 00:00:00,United States Army Air Forces - USAAF,Flight,Operational,United States of America,North America,8,8,8,0,0,8,0,Human Factor
1943-10-26 00:00:00,Royal Air Force - RAF,Flight,Specialised Services,India,Asia,8,8,8,0,0,8,0,Terrorism
1943-11-17 00:00:00,United States Navy - USN,Flight,Military / Government,World,World,8,8,8,0,0,8,0,Unknown
1943-11-24 00:00:00,Royal Air Force - RAF,Flight,Operational,United Kingdom,Europe,8,8,8,0,0,8,0,Technical Failure
1943-11-27 00:00:00,United States Army Air Forces - USAAF,Flight,Military / Government,United States of America,North America,8,8,8,0,0,8,0,Unknown
1943-12-29 00:00:00,Royal Air Force - RAF,Flight,Military / Government,Kenya,Africa,8,8,8,0,0,8,0,Unknown
1944-01-14 00:00:00,Royal Air Force - RAF,Flight,Military / Government,Netherlands,Europe,9,9,8,0,0,8,1,Terrorism
1944-01-17 00:00:00,United States Navy - USN,Flight,Military / Government,United States of America,North America,8,8,8,0,0,8,0,Unknown
1944-01-18 00:00:00,United States Army Air Forces - USAAF,Takeoff (climb),Military / Government,United States of America,North America,8,4,4,4,4,8,0,Technical Failure
1944-01-20 00:00:00,United States Army Air Forces - USAAF,Flight,Operational,United States of America,North America,8,8,8,0,0,8,0,Unknown
1944-01-23 00:00:00,Royal Air Force - RAF,Flight,Other,Ireland,Europe,8,8,8,0,0,8,0,Human Factor
1944-02-03 00:00:00,Iberia - Lineas Aéreas de Espana,Landing (descent or approach),Commercial,Spain,Europe,16,3,1,13,7,8,8,Weather
1944-02-05 00:00:00,Royal Air Force - RAF,Flight,Operational,United Kingdom,Europe,8,8,8,0,0,8,0,Unknown
1944-02-06 00:00:00,Royal Canadian Air Force - RCAF,Flight,Military / Government,Canada,North America,8,8,8,0,0,8,0,Weather
1944-03-08 00:00:00,Aeroflot - Russian International Airlines,Flight,Military / Government,Ukraine,Europe,8,6,6,2,2,8,0,Terrorism
1944-04-09 00:00:00,United States Army Air Forces - USAAF,Flight,Military / Government,United States of America,North America,8,8,8,0,0,8,0,Weather
1944-04-10 00:00:00,United States Army Air Forces - USAAF,Flight,Military / Government,Papua New Guinea,Oceania,12,12,8,0,0,8,4,Terrorism
1944-05-13 00:00:00,Royal Air Force - RAF,Flight,Military / Government,Belgium,Europe,8,8,8,0,0,8,0,Terrorism
1944-05-23 00:00:00,Royal Air Force - RAF,Flight,Military / Government,France,Europe,8,8,8,0,0,8,0,Unknown
1944-05-28 00:00:00,Royal Air Force - RAF,Flight,Military / Government,Netherlands,Europe,8,8,8,0,0,8,0,Unknown
1944-05-30 00:00:00,Aeroflot - Russian International Airlines,Landing (descent or approach),Military / Government,Belarus,Europe,8,5,5,3,3,8,0,Human Factor
1944-06-20 00:00:00,United States Army Air Forces - USAAF,Flight,Operational,United States of America,North America,8,7,7,1,1,8,0,Human Factor
1944-06-25 00:00:00,Royal Air Force - RAF,Flight,Military / Government,France,Europe,8,7,7,1,1,8,0,Terrorism
1944-06-28 00:00:00,United States Army Air Forces - USAAF,Flight,Military / Government,Myanmar,Asia,8,8,8,0,0,8,0,Unknown
1944-07-06 00:00:00,Royal Air Force - RAF,Flight,Military / Government,Netherlands,Europe,8,4,4,4,4,8,0,Terrorism
1944-07-15 00:00:00,United States Navy - USN,Flight,Military / Government,Venezuela,South America,8,8,8,0,0,8,0,Technical Failure
1944-07-26 00:00:00,Portuguese Air Force - Aeronáutica Militar,Landing (descent or approach),Military / Government,Portugal,Europe,14,14,8,0,0,8,6,Unknown
1944-08-20 00:00:00,United States Navy - USN,Flight,Operational,Bermuda,North America,8,8,8,0,0,8,0,Unknown
1944-08-21 00:00:00,United States Army Air Forces - USAAF,Flight,Military / Government,World,World,8,6,6,2,2,8,0,Unknown
1944-09-15 00:00:00,United States Army Air Forces - USAAF,Flight,Operational,United States of America,North America,8,8,8,0,0,8,0,Human Factor
1944-09-23 00:00:00,Royal Air Force - RAF,Flight,Military / Government,Netherlands,Europe,8,8,8,0,0,8,0,Terrorism
1944-09-29 00:00:00,Soviet Air Force - Voyenno-vozdushnye sily CCCP,Flight,Military / Government,Russia,Asia,8,8,8,0,0,8,0,Unknown
1944-10-06 00:00:00,United States Army Air Forces - USAAF,Flight,Military / Government,Germany,Europe,9,9,8,0,0,8,1,Terrorism
1944-11-15 00:00:00,United States Army Air Forces - USAAF,Flight,Military / Government,Austria,Europe,10,10,8,0,0,8,2,Weather
1944-11-20 00:00:00,Royal Air Force - RAF,Landing (descent or approach),Operational,United Kingdom,Europe,10,10,8,0,0,8,2,Unknown
1944-11-21 00:00:00,United States Navy - USN,Flight,Operational,Brazil,South America,8,8,8,0,0,8,0,Unknown
1944-11-30 00:00:00,United States Navy - USN,Flight,Military / Government,United States of America,North America,8,8,8,0,0,8,0,Human Factor
1944-12-01 00:00:00,Transcontinental %26 Western Air - TWA,Landing (descent or approach),Commercial,United States of America,North America,23,3,2,20,6,8,15,Human Factor
1944-12-15 00:00:00,Royal Canadian Air Force - RCAF,Flight,Operational,World,World,8,5,5,3,3,8,0,Unknown
1944-12-20 00:00:00,Royal Australian Air Force - RAAF,Landing (descent or approach),Specialised Services,Australia,Oceania,8,8,8,0,0,8,0,Technical Failure
1945-01-23 00:00:00,United States Navy - USN,Flight,Operational,United States of America,North America,8,8,8,0,0,8,0,Technical Failure
1945-02-02 00:00:00,United States Marine Corps,Flight,Military / Government,United States of America,North America,8,8,8,0,0,8,0,Unknown
1945-02-06 00:00:00,United States Army Air Forces - USAAF,Landing (descent or approach),Operational,France,Europe,9,9,8,0,0,8,1,Technical Failure
1945-02-09 00:00:00,United States Army Air Forces - USAAF,Flight,Military / Government,Germany,Europe,9,9,8,0,0,8,1,Human Factor
1945-02-19 00:00:00,United States Army Air Forces - USAAF,Flight,Military / Government,United Kingdom,Europe,11,5,3,6,5,8,3,Human Factor
1945-02-23 00:00:00,German Air Force - Deutsche Luftwaffe,Flight,Military / Government,Czech Republic,Europe,8,8,8,0,0,8,0,Unknown
1945-04-06 00:00:00,United States Navy - USN,Takeoff (climb),Military / Government,United States of America,North America,8,8,8,0,0,8,0,Unknown
1945-04-21 00:00:00,German Air Force - Deutsche Luftwaffe,Flight,Military / Government,Germany,Europe,9,9,8,0,0,8,1,Unknown
1945-06-02 00:00:00,United States Navy - USN,Flight,Military / Government,World,World,8,8,8,0,0,8,0,Unknown
1945-06-08 00:00:00,United States Army Air Forces - USAAF,Flight,Military / Government,World,World,8,4,4,4,4,8,0,Unknown
1945-06-17 00:00:00,United States Army Air Forces - USAAF,Flight,Military / Government,Philippines,Asia,8,8,8,0,0,8,0,Unknown
1945-07-17 00:00:00,United States Army Air Forces - USAAF,Flight,Operational,Philippines,Asia,8,8,8,0,0,8,0,Human Factor
1945-07-26 00:00:00,Royal Air Force - RAF,Flight,Operational,India,Asia,8,8,8,0,0,8,0,Human Factor
1945-08-14 00:00:00,Royal Australian Air Force - RAAF,Landing (descent or approach),Military / Government,Indonesia,Asia,8,8,8,0,0,8,0,Human Factor
1945-08-23 00:00:00,Royal Air Force - RAF,Flight,Military / Government,Malaysia,Asia,8,8,8,0,0,8,0,Human Factor
1945-09-12 00:00:00,Royal Air Force - RAF,Flight,Military / Government,Myanmar,Asia,8,8,8,0,0,8,0,Unknown
1945-09-30 00:00:00,Transport Aérien Militaire,Takeoff (climb),Military / Government,Libya,Africa,8,3,3,5,5,8,0,Unknown
1945-10-03 00:00:00,United States Navy - USN,Landing (descent or approach),Military / Government,United States of America,North America,15,6,3,9,5,8,7,Human Factor
1945-10-07 00:00:00,United States Army Air Forces - USAAF,Flight,Military / Government,World,World,8,8,8,0,0,8,0,Unknown
1945-10-15 00:00:00,United States Army Air Forces - USAAF,Takeoff (climb),Military / Government,Guam Island,Asia,8,8,8,0,0,8,0,Unknown
1945-11-07 00:00:00,Royal Air Force - RAF,Flight,Military / Government,World,World,8,8,8,0,0,8,0,Unknown
1945-11-30 00:00:00,Royal Air Force - RAF,Landing (descent or approach),Military / Government,Egypt,Africa,8,8,8,0,0,8,0,Human Factor
1945-12-13 00:00:00,United States Army Air Forces - USAAF,Flight,Military / Government,Philippines,Asia,8,8,8,0,0,8,0,Unknown
1945-12-18 00:00:00,Companha Meridional de Transportes Aéreos,Takeoff (climb),Commercial,Brazil,South America,8,2,2,6,6,8,0,Technical Failure
1945-12-26 00:00:00,Air France,Flight,Commercial,Central African Republic,Africa,8,3,3,5,5,8,0,Human Factor
1946-01-05 00:00:00,United States Army Air Forces - USAAF,Flight,Military / Government,Philippines,Asia,8,8,8,0,0,8,0,Unknown
1946-02-13 00:00:00,Royal Air Force - RAF,Landing (descent or approach),Military / Government,United Kingdom,Europe,18,3,2,15,6,8,10,Human Factor
1946-03-11 00:00:00,United States Navy - USN,Flight,Military / Government,Japan,Asia,8,8,8,0,0,8,0,Human Factor
1946-03-29 00:00:00,Royal Air Force - RAF,Flight,Operational,Myanmar,Asia,8,2,2,6,6,8,0,Human Factor
1946-04-10 00:00:00,Hellenic Air Force - Elleniki Polemiki Aeroporia,Flight,Operational,Greece,Europe,8,4,4,4,4,8,0,Technical Failure
1946-08-20 00:00:00,British Overseas Airways Corporation - BOAC,Flight,Operational,France,Europe,9,9,8,0,0,8,1,Human Factor
1946-11-01 00:00:00,United States Army Air Forces - USAAF,Flight,Military / Government,France,Europe,8,8,8,0,0,8,0,Weather
1946-11-02 00:00:00,United States Army Air Forces - USAAF,Flight,Military / Government,World,World,8,8,8,0,0,8,0,Unknown
1947-01-11 00:00:00,British Overseas Airways Corporation - BOAC,Flight,Commercial,United Kingdom,Europe,16,5,4,11,4,8,8,Technical Failure
1947-02-13 00:00:00,Royal Air Force - RAF,Flight,Operational,United Kingdom,Europe,8,6,6,2,2,8,0,Human Factor
1947-03-17 00:00:00,TACA International Airlines - Transportes Aéreos Centro Americanos,Takeoff (climb),Commercial,Colombia,South America,8,3,3,5,5,8,0,Human Factor
1947-04-22 00:00:00,Delta Airlines,Landing (descent or approach),Commercial,United States of America,North America,8,3,3,5,5,8,0,Human Factor
1947-06-21 00:00:00,Aeroflot - Russian International Airlines,Flight,Commercial,Ukraine,Europe,29,4,2,25,6,8,21,Technical Failure
1947-06-23 00:00:00,Colombian Air Force - Fuerza Aérea Colombiana,Flight,Military / Government,Colombia,South America,8,2,2,6,6,8,0,Weather
1947-08-13 00:00:00,French Air Force - Armée de l'Air,Takeoff (climb),Military / Government,France,Europe,8,8,8,0,0,8,0,Unknown
1947-11-30 00:00:00,Alaska Airlines,Landing (descent or approach),Commercial,United States of America,North America,28,3,1,25,7,8,20,Human Factor
1948-03-20 00:00:00,Private American,Flight,Business,United States of America,North America,8,1,1,7,7,8,0,Technical Failure
1948-03-21 00:00:00,United States Air Force - USAF,Landing (descent or approach),Military / Government,United States of America,North America,10,2,2,8,6,8,2,Weather
1948-05-22 00:00:00,Aeroflot - Russian International Airlines,Flight,Commercial,Russia,Asia,9,4,4,5,4,8,1,Human Factor
1948-07-01 00:00:00,Avio Linee Italiane - ALI,Landing (descent or approach),Commercial,Belgium,Europe,12,5,4,7,4,8,4,Human Factor
1948-08-23 00:00:00,Royal Air Force - RAF,Landing (descent or approach),Operational,United Kingdom,Europe,8,8,8,0,0,8,0,Weather
1948-10-24 00:00:00,Transandina Ecuador,Landing (descent or approach),Operational,Mexico,Central America,8,5,5,3,3,8,0,Technical Failure
1948-10-29 00:00:00,R.A. Brand %26 Company,Flight,Business,Italy,Europe,8,2,2,6,6,8,0,Unknown
1948-11-08 00:00:00,Escadrille Mercure Taxis Aeriens,Flight,Commercial,France,Europe,8,2,2,6,6,8,0,Human Factor
1948-11-12 00:00:00,Mannin Airways,Landing (descent or approach),Commercial,United Kingdom,Europe,9,2,2,7,6,8,1,Technical Failure
1948-11-26 00:00:00,French Navy,Flight,Military / Government,Algeria,Africa,8,8,8,0,0,8,0,Unknown
1948-12-23 00:00:00,Aeroflot - Russian International Airlines,Takeoff (climb),Operational,Russia,Asia,8,4,4,4,4,8,0,Human Factor
1949-01-04 00:00:00,United States Air Force - USAF,Flight,Military / Government,United States of America,North America,8,8,8,0,0,8,0,Technical Failure
1949-01-11 00:00:00,Sociedade Anônima Viação Aérea Gaúcha - SAVAG,Takeoff (climb),Commercial,Brazil,South America,8,2,2,6,6,8,0,Human Factor
1949-01-19 00:00:00,Aeroflot - Russian International Airlines,Takeoff (climb),Commercial,Ukraine,Europe,9,4,3,5,5,8,1,Technical Failure
1949-01-24 00:00:00,Royal Air Force - RAF,Landing (descent or approach),Military / Government,Germany,Europe,22,3,1,19,7,8,14,Human Factor
1949-02-04 00:00:00,United States Air Force - USAF,Flight,Operational,United States of America,North America,8,8,8,0,0,8,0,Unknown
1949-02-17 00:00:00,United States Air Force - USAF,Flight,Military / Government,Argentina,South America,8,3,3,5,5,8,0,Human Factor
1949-05-02 00:00:00,West African Airways Corporation,Takeoff (climb),Commercial,Nigeria,Africa,8,2,2,6,6,8,0,Unknown
1949-05-14 00:00:00,Royal Netherlands East Indies Air Force - ML-KNIL,Flight,Military / Government,Indonesia,Asia,8,8,8,0,0,8,0,Unknown
1949-08-15 00:00:00,Transocean Air Lines - TOA,Flight,Commercial,Ireland,Europe,58,9,1,49,7,8,50,Technical Failure
1949-08-20 00:00:00,Aeroflot - Russian International Airlines,Flight,Commercial,Russia,Asia,11,5,3,6,5,8,3,Weather
1949-10-10 00:00:00,Aerovias Coahuila,Flight,Commercial,Mexico,Central America,8,2,2,6,6,8,0,Unknown
1949-12-09 00:00:00,Mexican Air Force - Fuerza Aérea Mexicana,Flight,Operational,World,World,8,8,8,0,0,8,0,Unknown
1949-12-18 00:00:00,SABENA - Société Anonyme Belge d'Exploitation de la Navigation Aérienne,Takeoff (climb),Commercial,France,Europe,8,4,4,4,4,8,0,Technical Failure
1950-06-16 00:00:00,Royal Air Force - RAF,Flight,Military / Government,Ireland,Europe,8,8,8,0,0,8,0,Human Factor
1950-09-08 00:00:00,United States Air Force - USAF,Flight,Military / Government,Japan,Asia,11,11,8,0,0,8,3,Unknown
1950-09-09 00:00:00,United States Air Force - USAF,Flight,Military / Government,North Korea,Asia,11,11,8,0,0,8,3,Terrorism
1950-10-19 00:00:00,United States Air Force - USAF,Flight,Operational,United States of America,North America,8,8,8,0,0,8,0,Human Factor
1950-10-19 00:00:00,United States Air Force - USAF,Takeoff (climb),Military / Government,Japan,Asia,11,11,8,0,0,8,3,Technical Failure
1950-12-01 00:00:00,Iran Air,Landing (descent or approach),Commercial,Iran,Asia,8,7,7,1,1,8,0,Unknown
1950-12-27 00:00:00,Aeroflot - Russian International Airlines,Flight,Operational,Kazakhstan,Asia,8,8,8,0,0,8,0,Human Factor
1950-12-29 00:00:00,Royal Air Force - RAF,Flight,Other,United Kingdom,Europe,8,8,8,0,0,8,0,Technical Failure
1951-01-09 00:00:00,Aeroflot - Russian International Airlines,Flight,Commercial,Russia,Asia,8,6,6,2,2,8,0,Weather
1951-01-10 00:00:00,United States Air Force - USAF,Flight,Specialised Services,United States of America,North America,8,6,6,2,2,8,0,Human Factor
1951-02-16 00:00:00,Royal Air Force - RAF,Flight,Military / Government,Tunisia,Africa,8,8,8,0,0,8,0,Human Factor
1951-03-14 00:00:00,Royal Air Force - RAF,Flight,Operational,United Kingdom,Europe,8,8,8,0,0,8,0,Human Factor
1951-04-08 00:00:00,Aeroflot - Russian International Airlines,Landing (descent or approach),Operational,Russia,Asia,8,8,8,0,0,8,0,Human Factor
1951-04-10 00:00:00,United States Air Force - USAF,Takeoff (climb),Operational,United States of America,North America,8,8,8,0,0,8,0,Technical Failure
1951-05-02 00:00:00,Royal Air Force - RAF,Flight,Operational,Egypt,Africa,8,8,8,0,0,8,0,Human Factor
1951-06-11 00:00:00,Argentinian Government,Flight,Humanitarian,Argentina,South America,8,3,3,5,5,8,0,Weather
1951-06-26 00:00:00,Spanish Air Force - Ejército del Aire,Takeoff (climb),Military / Government,Spain,Europe,8,8,8,0,0,8,0,Unknown
1951-06-29 00:00:00,United States Navy - USN,Takeoff (climb),Operational,United States of America,North America,8,8,8,0,0,8,0,Technical Failure
1951-08-23 00:00:00,United States Navy - USN,Takeoff (climb),Operational,United States of America,North America,8,8,8,0,0,8,0,Unknown
1951-12-03 00:00:00,United States Air Force - USAF,Landing (descent or approach),Military / Government,United States of America,North America,14,14,8,0,0,8,6,Technical Failure
1951-12-26 00:00:00,United States Air Force - USAF,Flight,Military / Government,United States of America,North America,8,8,8,0,0,8,0,Human Factor
1952-02-19 00:00:00,Société de Transports Aériens Alpes Provence - STAAP,Flight,Specialised Services,Cameroon,Africa,8,4,4,4,4,8,0,Unknown
1952-03-08 00:00:00,United States Air Force - USAF,Flight,Military / Government,Switzerland,Europe,8,7,7,1,1,8,0,Human Factor
1952-03-12 00:00:00,United States Air Force - USAF,Flight,Operational,United States of America,North America,8,8,8,0,0,8,0,Human Factor
1952-04-25 00:00:00,Aeroflot - Russian International Airlines,Flight,Operational,Russia,Asia,9,9,8,0,0,8,1,Unknown
1952-04-29 00:00:00,United States Air Force - USAF,Flight,Humanitarian,South Korea,Asia,8,8,8,0,0,8,0,Unknown
1952-06-13 00:00:00,Swedish Air Force - Flygvapnet,Flight,Military / Government,Sweden,Europe,8,3,3,5,5,8,0,Terrorism
1952-07-18 00:00:00,Czech Air Force - Ceské Vojenské Letectvo,Flight,Military / Government,Czech Republic,Europe,8,1,1,7,7,8,0,Unknown
1952-11-17 00:00:00,United States Air Force - USAF,Flight,Military / Government,United States of America,North America,16,2,0,14,8,8,8,Technical Failure
1952-11-20 00:00:00,United States Navy - USN,Flight,Operational,World,World,8,8,8,0,0,8,0,Unknown
1952-11-24 00:00:00,Royal Canadian Air Force - RCAF,Landing (descent or approach),Military / Government,Canada,North America,10,4,2,6,6,8,2,Unknown
1953-02-13 00:00:00,United States Air Force - USAF,Flight,Military / Government,Japan,Asia,8,5,5,3,3,8,0,Human Factor
1953-03-17 00:00:00,Aigle Azur,Landing (descent or approach),Commercial,Vietnam,Asia,8,2,2,6,6,8,0,Weather
1953-04-20 00:00:00,Western Airlines,Landing (descent or approach),Commercial,United States of America,North America,10,5,4,5,4,8,2,Human Factor
1953-06-23 00:00:00,United States Air Force - USAF,Takeoff (climb),Military / Government,Japan,Asia,8,8,8,0,0,8,0,Unknown
1953-07-17 00:00:00,United States Air Force - USAF,Flight,Operational,United States of America,North America,11,11,8,0,0,8,3,Unknown
1953-09-26 00:00:00,Royal Air Force - RAF,Flight,Military / Government,Malaysia,Asia,8,3,3,5,5,8,0,Human Factor
1954-01-02 00:00:00,Spanish Air Force - Ejército del Aire,Landing (descent or approach),Military / Government,Spain,Europe,8,4,4,4,4,8,0,Unknown
1954-01-21 00:00:00,United States Navy - USN,Landing (descent or approach),Military / Government,United States of America,North America,8,8,8,0,0,8,0,Human Factor
1954-02-11 00:00:00,Peruvian Air Force - Fuerza Aérea del Perú,Flight,Military / Government,Peru,South America,8,8,8,0,0,8,0,Unknown
1954-03-28 00:00:00,Royal Norwegian Air Force - Kongelige Norske Luftforsvaret,Flight,Military / Government,Norway,Europe,9,8,7,1,1,8,1,Human Factor
1954-09-16 00:00:00,French Air Force - Armée de l'Air,Takeoff (climb),Military / Government,Algeria,Africa,8,8,8,0,0,8,0,Unknown
1955-01-06 00:00:00,Saskatchewan Government Airways,Landing (descent or approach),Commercial,Canada,North America,8,2,2,6,6,8,0,Other
1955-01-19 00:00:00,Brazilian Air Force - Força Aérea Brasileira,Flight,Military / Government,Brazil,South America,8,2,2,6,6,8,0,Unknown
1955-03-09 00:00:00,Avianca,Flight,Commercial,Colombia,South America,8,3,3,5,5,8,0,Unknown
1955-05-16 00:00:00,Aeroflot - Russian International Airlines,Takeoff (climb),Military / Government,Russia,Asia,8,4,4,4,4,8,0,Human Factor
1955-06-25 00:00:00,Indian Air Force - Bharatiya Vayu Sena,Flight,Military / Government,India,Asia,8,8,8,0,0,8,0,Human Factor
1955-12-11 00:00:00,United States Air Force - USAF,Flight,Military / Government,Morocco,Africa,8,8,8,0,0,8,0,Unknown
1956-05-15 00:00:00,Crane Company,Landing (descent or approach),Business,United States of America,North America,8,2,2,6,6,8,0,Technical Failure
1956-10-14 00:00:00,Spanish Air Force - Ejército del Aire,Flight,Military / Government,Spain,Europe,8,8,8,0,0,8,0,Unknown
1956-12-10 00:00:00,Royal New Zealand Air Force - RNZAF,Flight,Military / Government,Malaysia,Asia,9,3,3,6,5,8,1,Unknown
1956-12-12 00:00:00,Phillips Petroleum Company,Flight,Business,United States of America,North America,8,2,2,6,6,8,0,Technical Failure
1956-12-26 00:00:00,United States Air Force - USAF,Flight,Military / Government,United States of America,North America,8,8,8,0,0,8,0,Unknown
1957-01-10 00:00:00,United States Air Force - USAF,Flight,Operational,Canada,North America,9,9,8,0,0,8,1,Unknown
1957-04-19 00:00:00,Japan Maritime Self-Defense Force - Kaijō Jieitai,Flight,Military / Government,Japan,Asia,8,8,8,0,0,8,0,Unknown
1957-05-29 00:00:00,Spanish Air Force - Ejército del Aire,Flight,Military / Government,Spain,Europe,8,8,8,0,0,8,0,Unknown
1957-07-03 00:00:00,Aeroflot - Russian International Airlines,Flight,Commercial,Russia,Asia,15,3,0,12,8,8,7,Human Factor
1957-08-20 00:00:00,Indamer Airways,Flight,Military / Government,India,Asia,8,8,8,0,0,8,0,Unknown
1957-09-03 00:00:00,AVENSA - Aerovias Venezolanas,Flight,Commercial,Venezuela,South America,8,3,3,5,5,8,0,Weather
1957-10-22 00:00:00,French Navy,Takeoff (climb),Operational,Algeria,Africa,8,8,8,0,0,8,0,Unknown
1957-12-09 00:00:00,United States Navy - USN,Takeoff (climb),Military / Government,United States of America,North America,9,9,8,0,0,8,1,Technical Failure
1957-12-12 00:00:00,United States Air Force - USAF,Takeoff (climb),Operational,United States of America,North America,9,9,8,0,0,8,1,Human Factor
1958-03-07 00:00:00,Misrair,Landing (descent or approach),Commercial,Egypt,Africa,26,4,4,22,4,8,18,Unknown
1958-04-06 00:00:00,United States Navy - USN,Takeoff (climb),Military / Government,Japan,Asia,11,11,8,0,0,8,3,Unknown
1958-09-08 00:00:00,United States Air Force - USAF,Landing (descent or approach),Operational,United States of America,North America,9,9,8,0,0,8,1,Human Factor
1958-09-09 00:00:00,Flying Tiger Line,Landing (descent or approach),Military / Government,Japan,Asia,8,6,6,2,2,8,0,Human Factor
1958-11-03 00:00:00,Yemen Airlines,Flight,Military / Government,Italy,Europe,8,4,4,4,4,8,0,Human Factor
1958-12-09 00:00:00,United States Air Force - USAF,Landing (descent or approach),Operational,United States of America,North America,9,9,8,0,0,8,1,Technical Failure
1959-02-04 00:00:00,Royal Australian Air Force - RAAF,Landing (descent or approach),Operational,Australia,Oceania,8,8,8,0,0,8,0,Technical Failure
1959-05-21 00:00:00,Lineas Aéreas Interpolar,Flight,Operational,Peru,South America,8,4,4,4,4,8,0,Unknown
1959-06-10 00:00:00,Royal Netherlands Navy - Marineluchtvaartdienst,Landing (descent or approach),Military / Government,India,Asia,8,8,8,0,0,8,0,Unknown
1959-06-12 00:00:00,Transair Canada,Takeoff (climb),Commercial,Canada,North America,8,1,1,7,7,8,0,Human Factor
1959-09-01 00:00:00,Bailey Enterprises,Flight,Commercial,United States of America,North America,8,1,1,7,7,8,0,Human Factor
1960-02-20 00:00:00,Spanish Air Force - Ejército del Aire,Flight,Military / Government,Spain,Europe,8,8,8,0,0,8,0,Unknown
1960-04-01 00:00:00,United States Air Force - USAF,Takeoff (climb),Military / Government,United States of America,North America,9,9,8,0,0,8,1,Technical Failure
1960-07-16 00:00:00,Zonen Aviation - Zone-Redningskorpset Flyve-Tjenesten,Takeoff (climb),Commercial,Denmark,Europe,9,1,0,8,8,8,1,Human Factor
1960-07-21 00:00:00,Aeroflot - Russian International Airlines,Takeoff (climb),Commercial,Belarus,Europe,28,4,4,24,4,8,20,Human Factor
1960-09-28 00:00:00,Mexicana de Aviación,Landing (descent or approach),Commercial,Mexico,Central America,18,3,3,15,5,8,10,Weather
1960-10-11 00:00:00,Somali Air Force - Ciidamada Cirka Soomaaliyeed,Flight,Military / Government,Yemen,Asia,8,2,2,6,6,8,0,Unknown
1960-12-11 00:00:00,Brazilian Air Force - Força Aérea Brasileira,Takeoff (climb),Military / Government,Portugal,Europe,8,8,8,0,0,8,0,Unknown
1961-03-09 00:00:00,United States Navy - USN,Flight,Operational,United States of America,North America,8,8,8,0,0,8,0,Unknown
1961-06-10 00:00:00,United States Air Force - USAF,Flight,Military / Government,World,World,8,8,8,0,0,8,0,Technical Failure
1961-10-15 00:00:00,United States Air Force - USAF,Flight,Military / Government,World,World,8,8,8,0,0,8,0,Unknown
1961-12-12 00:00:00,Belgian Air Force - Force Aérienne Belge - Belgische Luchtmacht,Flight,Operational,Belgium,Europe,8,8,8,0,0,8,0,Human Factor
1962-06-28 00:00:00,Royal Netherlands Air Force - Koninklijke Luchtmacht,Flight,Military / Government,Indonesia,Asia,8,5,5,3,3,8,0,Human Factor
1962-09-21 00:00:00,Kalinga Airlines,Flight,Operational,India,Asia,8,3,3,5,5,8,0,Unknown
1962-10-01 00:00:00,Center Air Lines,Landing (descent or approach),Commercial,United States of America,North America,8,2,2,6,6,8,0,Technical Failure
1963-01-29 00:00:00,Continental Airlines,Landing (descent or approach),Commercial,United States of America,North America,8,3,3,5,5,8,0,Weather
1963-03-08 00:00:00,Soviet Air Force - Voyenno-vozdushnye sily CCCP,Flight,Military / Government,Russia,Asia,8,8,8,0,0,8,0,Human Factor
1963-03-30 00:00:00,Aerolinee Itavia,Flight,Commercial,Italy,Europe,8,3,3,5,5,8,0,Human Factor
1963-04-18 00:00:00,Royal Air Force - RAF,Flight,Operational,United Arab Emirates,Asia,9,2,2,7,6,8,1,Unknown
1963-10-24 00:00:00,United States Air Force - USAF,Flight,Military / Government,Vietnam,Asia,8,4,4,4,4,8,0,Terrorism
1963-11-22 00:00:00,Indian Air Force - Bharatiya Vayu Sena,Flight,Military / Government,India,Asia,8,8,8,0,0,8,0,Unknown
1963-12-30 00:00:00,Royal Canadian Air Force - RCAF,Landing (descent or approach),Military / Government,France,Europe,11,5,2,6,6,8,3,Unknown
1964-10-24 00:00:00,United States Air Force - USAF,Flight,Military / Government,Cambodia,Asia,8,8,8,0,0,8,0,Terrorism
1965-02-05 00:00:00,Aeroflot - Russian International Airlines,Takeoff (climb),Operational,Russia,Asia,8,8,8,0,0,8,0,Human Factor
1965-03-17 00:00:00,Eastern Provincial Airways - EPA,Flight,Commercial,Canada,North America,8,3,3,5,5,8,0,Technical Failure
1965-07-15 00:00:00,Virgin Islands Airways - VIA,Takeoff (climb),Commercial,United States of America,Central America,12,1,1,11,7,8,4,Human Factor
1965-08-07 00:00:00,Traceways,Takeoff (climb),Commercial,United States of America,North America,8,1,1,7,7,8,0,Technical Failure
1965-09-11 00:00:00,Aeroflot - Russian International Airlines,Landing (descent or approach),Operational,Russia,Asia,8,6,6,2,2,8,0,Human Factor
1965-10-17 00:00:00,Kalinga Airlines,Flight,Military / Government,India,Asia,8,3,3,5,5,8,0,Other
1965-10-22 00:00:00,Belgian Air Force - Force Aérienne Belge - Belgische Luchtmacht,Flight,Operational,Germany,Europe,8,5,5,3,3,8,0,Unknown
1965-11-14 00:00:00,Paul Kelly Flying Service,Takeoff (climb),Business,United States of America,North America,8,2,2,6,6,8,0,Human Factor
1966-01-14 00:00:00,Tupolev Industries - GKAP Tupolev OKB,Flight,Specialised Services,Russia,Asia,8,8,8,0,0,8,0,Human Factor
1966-02-12 00:00:00,United States Air Force - USAF,Flight,Military / Government,Spain,Europe,8,8,8,0,0,8,0,Unknown
1966-04-25 00:00:00,Aer Aosta,Flight,Commercial,Italy,Europe,8,1,1,7,7,8,0,Human Factor
1966-05-15 00:00:00,United States Air Force - USAF,Flight,Military / Government,Laos,Asia,8,8,8,0,0,8,0,Terrorism
1966-05-31 00:00:00,United States Air Force - USAF,Flight,Military / Government,Vietnam,Asia,8,8,8,0,0,8,0,Unknown
1966-06-17 00:00:00,United States Air Force - USAF,Flight,Military / Government,Vietnam,Asia,8,8,8,0,0,8,0,Terrorism
1966-07-11 00:00:00,Aeropesca Colombia,Flight,Operational,Chile,South America,8,3,3,5,5,8,0,Human Factor
1966-07-29 00:00:00,United States Air Force - USAF,Flight,Military / Government,Vietnam,Asia,8,8,8,0,0,8,0,Terrorism
1966-07-30 00:00:00,Aerotaxi Servicios Aéreos,Takeoff (climb),Commercial,Colombia,South America,8,1,1,7,7,8,0,Technical Failure
1966-09-06 00:00:00,United States Air Force - USAF,Flight,Military / Government,Taiwan,Asia,8,5,5,3,3,8,0,Unknown
1966-10-21 00:00:00,Air Melanesiæ,Flight,Commercial,Vanuatu,Oceania,8,1,1,7,7,8,0,Human Factor
1967-02-06 00:00:00,Syrianair - Syrian Arab Airlines,Landing (descent or approach),Commercial,Syria,Asia,19,3,0,16,8,8,11,Human Factor
1967-04-06 00:00:00,Aeroflot - Russian International Airlines,Takeoff (climb),Operational,Russia,Asia,8,8,8,0,0,8,0,Unknown
1967-10-07 00:00:00,Biafran Air Force,Flight,Military / Government,Nigeria,Africa,8,4,4,4,4,8,0,Terrorism
1967-11-04 00:00:00,Royal Air Force - RAF,Flight,Military / Government,World,World,11,11,8,0,0,8,3,Technical Failure
1968-02-10 00:00:00,United States Navy - USN,Landing (descent or approach),Military / Government,Vietnam,Asia,11,6,3,5,5,8,3,Terrorism
1968-02-15 00:00:00,United States Air Force - USAF,Flight,Military / Government,Vietnam,Asia,8,8,8,0,0,8,0,Terrorism
1968-02-29 00:00:00,United States Air Force - USAF,Flight,Operational,United States of America,North America,8,8,8,0,0,8,0,Unknown
1968-04-05 00:00:00,United States Navy - USN,Flight,Military / Government,World,World,12,12,8,0,0,8,4,Technical Failure
1968-04-26 00:00:00,United States Air Force - USAF,Flight,Military / Government,Vietnam,Asia,8,8,8,0,0,8,0,Terrorism
1968-12-14 00:00:00,United States Air Force - USAF,Flight,Military / Government,Puerto Rico,Central America,8,8,8,0,0,8,0,Technical Failure
1969-05-23 00:00:00,Union of Burma Airways,Landing (descent or approach),Commercial,Myanmar,Asia,8,3,3,5,5,8,0,Technical Failure
1969-09-01 00:00:00,United States Air Force - USAF,Flight,Military / Government,Vietnam,Asia,8,8,8,0,0,8,0,Terrorism
1969-11-11 00:00:00,Churchill Falls Corporation,Landing (descent or approach),Business,Canada,North America,8,2,2,6,6,8,0,Human Factor
1969-11-24 00:00:00,United States Air Force - USAF,Flight,Military / Government,Laos,Asia,8,8,8,0,0,8,0,Terrorism
1969-11-28 00:00:00,Biafran Government,Flight,Operational,Morocco,Africa,8,3,3,5,5,8,0,Technical Failure
1969-12-06 00:00:00,Aeroflot - Russian International Airlines,Landing (descent or approach),Operational,Russia,Asia,8,6,6,2,2,8,0,Weather
1969-12-15 00:00:00,United States Air Force - USAF,Landing (descent or approach),Military / Government,Taiwan,Asia,8,8,8,0,0,8,0,Technical Failure
1970-01-22 00:00:00,Rocky Mountain Airways,Landing (descent or approach),Commercial,United States of America,North America,8,1,1,7,7,8,0,Human Factor
1970-04-28 00:00:00,Trans Australia Airlines - TAA,Landing (descent or approach),Commercial,Papua New Guinea,Oceania,11,2,2,9,6,8,3,Human Factor
1970-09-26 00:00:00,Flugfélag Íslands,Landing (descent or approach),Commercial,Denmark,Europe,34,4,1,30,7,8,26,Human Factor
1970-10-01 00:00:00,Aeroflot - Russian International Airlines,Landing (descent or approach),Operational,Russia,Asia,8,7,7,1,1,8,0,Technical Failure
1970-12-13 00:00:00,Ecuadorian Air Force - Fuerza Aérea Ecuatoriana,Flight,Humanitarian,Ecuador,South America,8,3,3,5,5,8,0,Human Factor
1971-01-21 00:00:00,Air Algérie,Flight,Commercial,Algeria,Africa,8,2,2,6,6,8,0,Human Factor
1971-02-01 00:00:00,Indonesian Air Force - TNI-AU Tentara Nasional Indonesia - Angkatan Udara,Flight,Operational,Indonesia,Asia,8,2,2,6,6,8,0,Unknown
1971-02-26 00:00:00,Florida Community Bank,Landing (descent or approach),Business,United States of America,North America,8,1,1,7,7,8,0,Human Factor
1971-04-21 00:00:00,Coastal Airways,Takeoff (climb),Commercial,United States of America,Central America,8,1,1,7,7,8,0,Human Factor
1971-06-18 00:00:00,Corporación Minera de Bolivia,Flight,Business,Bolivia,South America,8,2,2,6,6,8,0,Unknown
1971-09-17 00:00:00,Government of Bulgaria,Flight,Military / Government,Bulgaria,Europe,9,2,2,7,6,8,1,Human Factor
1971-11-02 00:00:00,Royal Canadian Air Force - RCAF,Flight,Military / Government,Canada,North America,8,8,8,0,0,8,0,Human Factor
1972-02-22 00:00:00,Alii Air Hawaii,Flight,Commercial,United States of America,North America,8,1,1,7,7,8,0,Weather
1972-05-12 00:00:00,Carolina Aircraft Corporation,Flight,Business,United States of America,North America,8,2,2,6,6,8,0,Human Factor
1972-05-16 00:00:00,Soviet Navy - Voyenno-morskoy flot CCCP,Flight,Other,Russia,Asia,8,6,6,2,2,8,0,Human Factor
1972-05-26 00:00:00,United States Navy - USN,Flight,Military / Government,World,World,8,4,4,4,4,8,0,Unknown
1972-05-27 00:00:00,General Air,Takeoff (climb),Commercial,Germany,Europe,13,3,2,10,6,8,5,Unknown
1972-06-29 00:00:00,Air Wisconsin,Landing (descent or approach),Commercial,United States of America,North America,8,2,2,6,6,8,0,Human Factor
1972-07-13 00:00:00,Ansett General Aviation,Takeoff (climb),Commercial,Australia,Oceania,8,1,1,7,7,8,0,Unknown
1972-07-26 00:00:00,Japan Maritime Self-Defense Force - Kaijō Jieitai,Landing (descent or approach),Military / Government,Japan,Asia,8,8,8,0,0,8,0,Unknown
1972-08-26 00:00:00,Air America,Landing (descent or approach),Commercial,Vietnam,Asia,8,4,4,4,4,8,0,Unknown
1972-10-06 00:00:00,Línea Aérea Taxpa,Flight,Commercial,World,World,8,1,1,7,7,8,0,Technical Failure
1972-10-10 00:00:00,Firma Aerosimport,Landing (descent or approach),Commercial,Sweden,Europe,8,1,1,7,7,8,0,Weather
1973-02-04 00:00:00,United States Air Force - USAF,Flight,Military / Government,Laos,Asia,8,8,8,0,0,8,0,Terrorism
1973-04-27 00:00:00,Japan Maritime Self-Defense Force - Kaijō Jieitai,Flight,Military / Government,Japan,Asia,8,8,8,0,0,8,0,Unknown
1973-08-29 00:00:00,Aeroflot - Russian International Airlines,Flight,Commercial,Russia,Asia,14,2,2,12,6,8,6,Human Factor
1973-09-29 00:00:00,Southwestern Railway Company,Flight,Business,United States of America,North America,8,1,1,7,7,8,0,Human Factor
1973-10-04 00:00:00,Taxi Aero Cesar Aguiar,Takeoff (climb),Commercial,Brazil,South America,8,2,2,6,6,8,0,Unknown
1973-10-12 00:00:00,Avionas Banamex,Landing (descent or approach),Business,Mexico,Central America,8,2,2,6,6,8,0,Human Factor
1973-10-23 00:00:00,VASP - Viação Aérea de São Paulo,Takeoff (climb),Commercial,Brazil,South America,65,5,0,60,8,8,57,Technical Failure
1974-02-08 00:00:00,United States Air Force - USAF,Takeoff (climb),Operational,United States of America,North America,8,8,8,0,0,8,0,Technical Failure
1974-05-11 00:00:00,Aeroflot - Russian International Airlines,Landing (descent or approach),Business,Azerbaijan,Asia,8,1,1,7,7,8,0,Human Factor
1974-09-19 00:00:00,Spanish Air Force - Ejército del Aire,Flight,Military / Government,Spain,Europe,8,8,8,0,0,8,0,Unknown
1974-12-06 00:00:00,McAlpine Aviation,Takeoff (climb),Commercial,United Kingdom,Europe,8,1,1,7,7,8,0,Human Factor
1974-12-22 00:00:00,McGee Enterprises,Flight,Business,United States of America,North America,8,1,1,7,7,8,0,Human Factor
1975-07-02 00:00:00,Transport Aérien Transrégional - TAT,Takeoff (climb),Commercial,France,Europe,8,2,2,6,6,8,0,Technical Failure
1975-09-12 00:00:00,Ketchum Air Service,Flight,Commercial,United States of America,North America,8,1,1,7,7,8,0,Human Factor
1975-09-26 00:00:00,Portuguese Air Force - Força Aerea Portuguesa,Landing (descent or approach),Military / Government,Portugal,Europe,8,8,8,0,0,8,0,Technical Failure
1975-12-21 00:00:00,Pelita Air Service,Flight,Commercial,Indonesia,Asia,8,2,2,6,6,8,0,Human Factor
1976-02-06 00:00:00,United States Air Force - USAF,Landing (descent or approach),Military / Government,Spain,Europe,8,8,8,0,0,8,0,Human Factor
1976-09-13 00:00:00,Philippine Aviation,Flight,Commercial,Philippines,Asia,8,2,2,6,6,8,0,Human Factor
1976-11-19 00:00:00,Servicios Aéreos Cora,Takeoff (climb),Commercial,Mexico,Central America,8,1,1,7,7,8,0,Technical Failure
1977-01-18 00:00:00,Yugoslav Government,Landing (descent or approach),Military / Government,Bosnia and Herzegovina,Europe,8,2,2,6,6,8,0,Human Factor
1977-01-21 00:00:00,Soviet Air Force - Voyenno-vozdushnye sily CCCP,Flight,Operational,Russia,Asia,8,8,8,0,0,8,0,Unknown
1977-02-24 00:00:00,Commonwealth of Pennsylvania,Takeoff (climb),Military / Government,United States of America,North America,8,2,2,6,6,8,0,Human Factor
1977-03-30 00:00:00,Aeroflot - Russian International Airlines,Landing (descent or approach),Commercial,Ukraine,Europe,28,4,3,24,5,8,20,Human Factor
1977-04-01 00:00:00,United States Air Force - USAF,Landing (descent or approach),Operational,United States of America,North America,8,8,8,0,0,8,0,Human Factor
1977-04-02 00:00:00,Aviogenex,Landing (descent or approach),Operational,Gabon,Africa,8,6,6,2,2,8,0,Human Factor
1977-11-23 00:00:00,Textafrica,Landing (descent or approach),Commercial,Mozambique,Africa,8,2,2,6,6,8,0,Terrorism
1977-12-09 00:00:00,Churchill Falls Corporation,Landing (descent or approach),Business,Canada,North America,8,2,2,6,6,8,0,Human Factor
1977-12-21 00:00:00,Soviet Air Force - Voyenno-vozdushnye sily CCCP,Flight,Operational,Russia,Asia,8,8,8,0,0,8,0,Human Factor
1977-12-21 00:00:00,Kenn Borek Air,Landing (descent or approach),Commercial,Canada,North America,8,2,2,6,6,8,0,Weather
1978-04-29 00:00:00,LAC Colombia - Lineas Aéreas del Caribe,Takeoff (climb),Operational,Colombia,South America,12,3,3,9,5,8,4,Technical Failure
1978-05-19 00:00:00,Indian Government,Flight,Specialised Services,India,Asia,8,3,3,5,5,8,0,Technical Failure
1978-07-16 00:00:00,Colombian Air Force - Fuerza Aérea Colombiana,Flight,Military / Government,Colombia,South America,8,6,6,2,2,8,0,Human Factor
1978-09-08 00:00:00,United States Air Force - USAF,Flight,Operational,United States of America,North America,8,8,8,0,0,8,0,Weather
1978-09-22 00:00:00,United States Navy - USN,Flight,Military / Government,United States of America,North America,8,8,8,0,0,8,0,Technical Failure
1978-10-09 00:00:00,Soviet Air Force - Voyenno-vozdushnye sily CCCP,Landing (descent or approach),Humanitarian,Eritrea,Africa,8,8,8,0,0,8,0,Terrorism
1978-11-06 00:00:00,McCart Aviation,Flight,Operational,United States of America,North America,8,1,1,7,7,8,0,Technical Failure
1979-03-01 00:00:00,Universal Airways - USA,Takeoff (climb),Commercial,United States of America,North America,8,1,1,7,7,8,0,Human Factor
1979-07-24 00:00:00,Prinair - Puerto Rico International Airlines,Takeoff (climb),Commercial,United States of America,Central America,21,2,1,19,7,8,13,Other
1979-10-08 00:00:00,Comair,Takeoff (climb),Commercial,United States of America,North America,8,1,1,7,7,8,0,Technical Failure
1979-11-21 00:00:00,Yacimientos Petroliferos Fiscales Argentinas - YPFA,Landing (descent or approach),Business,Chile,South America,8,3,3,5,5,8,0,Unknown
1980-04-16 00:00:00,Plankumu,Flight,Business,Democratic Republic of Congo,Africa,8,1,1,7,7,8,0,Unknown
1980-07-12 00:00:00,Ryan Air,Flight,Commercial,United States of America,North America,8,1,1,7,7,8,0,Human Factor
1980-07-21 00:00:00,Scenic Airlines,Takeoff (climb),Commercial,United States of America,North America,8,1,1,7,7,8,0,Technical Failure
1980-08-01 00:00:00,AeroPeru,Landing (descent or approach),Operational,Mexico,Central America,8,3,3,5,5,8,0,Human Factor
1980-09-05 00:00:00,Kuwait Air Force,Flight,Military / Government,France,Europe,8,4,4,4,4,8,0,Weather
1980-10-15 00:00:00,Royal Canadian Air Force - RCAF,Flight,Military / Government,Canada,North America,10,10,8,0,0,8,2,Unknown
1981-02-11 00:00:00,Texasgulf Aviation,Landing (descent or approach),Business,United States of America,North America,8,2,2,6,6,8,0,Technical Failure
1981-04-01 00:00:00,Talair,Landing (descent or approach),Commercial,Papua New Guinea,Oceania,8,1,1,7,7,8,0,Human Factor
1981-10-30 00:00:00,United States Air Force - USAF,Flight,Operational,United States of America,North America,8,8,8,0,0,8,0,Human Factor
1982-01-03 00:00:00,Ashland Properties,Landing (descent or approach),Business,United States of America,North America,8,1,1,7,7,8,0,Human Factor
1982-02-16 00:00:00,GNC Energy Corporation,Landing (descent or approach),Business,United States of America,North America,8,1,1,7,7,8,0,Human Factor
1982-05-19 00:00:00,J. Hurler Flugdienst,Landing (descent or approach),Business,Germany,Europe,8,2,2,6,6,8,0,Human Factor
1982-07-14 00:00:00,South African Air Force,Landing (descent or approach),Military / Government,South Africa,Africa,8,2,2,6,6,8,0,Human Factor
1982-08-12 00:00:00,Burma Airways,Flight,Commercial,Myanmar,Asia,8,3,3,5,5,8,0,Weather
1982-10-20 00:00:00,Carib Air Service,Flight,Commercial,World,World,8,1,1,7,7,8,0,Unknown
1982-11-14 00:00:00,7 C'S Transportation,Takeoff (climb),Business,United States of America,North America,8,1,1,7,7,8,0,Human Factor
1982-12-09 00:00:00,Tyee Airlines,Flight,Commercial,United States of America,North America,8,1,1,7,7,8,0,Human Factor
1983-04-04 00:00:00,Total France,Takeoff (climb),Business,China,Asia,8,2,2,6,6,8,0,Unknown
1983-04-16 00:00:00,Air Liberia,Takeoff (climb),Commercial,Sudan,Africa,9,3,2,6,6,8,1,Technical Failure
1983-04-19 00:00:00,Japan Air Self-Defense Force - Kōkū Jieitai,Flight,Operational,Japan,Asia,8,8,8,0,0,8,0,Human Factor
1983-04-29 00:00:00,SAN Ecuador - Servicios Aéreos Nacionales,Landing (descent or approach),Commercial,Ecuador,South America,100,6,1,94,7,8,92,Technical Failure
1983-05-02 00:00:00,Aeroflot - Russian International Airlines,Flight,Commercial,Russia,Asia,13,2,1,11,7,8,5,Human Factor
1983-06-05 00:00:00,Soviet Air Force - Voyenno-vozdushnye sily CCCP,Landing (descent or approach),Military / Government,Afghanistan,Asia,8,8,8,0,0,8,0,Other
1983-06-09 00:00:00,Peruvian Air Force - Fuerza Aérea del Perú,Landing (descent or approach),Military / Government,Peru,South America,8,8,8,0,0,8,0,Human Factor
1983-06-21 00:00:00,Odom Flying Service,Landing (descent or approach),Business,United States of America,North America,8,1,1,7,7,8,0,Technical Failure
1983-07-23 00:00:00,Schröter Verwaltungs,Takeoff (climb),Commercial,Germany,Europe,8,1,1,7,7,8,0,Unknown
1983-09-04 00:00:00,Osage Aviation Services,Takeoff (climb),Business,United States of America,North America,8,1,1,7,7,8,0,Human Factor
1983-11-26 00:00:00,Texas Western Aviation,Landing (descent or approach),Commercial,United States of America,North America,8,1,1,7,7,8,0,Unknown
1984-01-18 00:00:00,Soviet Air Force - Voyenno-vozdushnye sily CCCP,Landing (descent or approach),Military / Government,Afghanistan,Asia,8,8,8,0,0,8,0,Terrorism
1984-08-27 00:00:00,Unnamed operator,Flight,Military / Government,Nicaragua,Central America,8,2,2,6,6,8,0,Terrorism
1984-09-15 00:00:00,Royal Thai Police,Takeoff (climb),Military / Government,Thailand,Asia,8,1,1,7,7,8,0,Unknown
1984-09-24 00:00:00,Mecon Taxi Aéreo,Takeoff (climb),Commercial,Brazil,South America,8,1,1,7,7,8,0,Technical Failure
1984-09-30 00:00:00,Private Mexican,Flight,Business,Mexico,Central America,9,1,0,8,8,8,1,Unknown
1985-01-22 00:00:00,Soviet Air Force - Voyenno-vozdushnye sily CCCP,Landing (descent or approach),Military / Government,Afghanistan,Asia,8,6,6,2,2,8,0,Human Factor
1985-02-24 00:00:00,Royal Saudi Air Force,Landing (descent or approach),Operational,Saudi Arabia,Asia,8,8,8,0,0,8,0,Human Factor
1985-03-12 00:00:00,United States Air Force - USAF,Flight,Operational,United States of America,North America,8,8,8,0,0,8,0,Unknown
1985-06-08 00:00:00,Soviet Air Force - Voyenno-vozdushnye sily CCCP,Landing (descent or approach),Military / Government,Russia,Asia,8,8,8,0,0,8,0,Terrorism
1985-06-17 00:00:00,Nielson Leasing,Flight,Business,United States of America,North America,8,1,1,7,7,8,0,Human Factor
1985-08-12 00:00:00,Merpati Nusantara Airlines - MNA,Takeoff (climb),Commercial,Indonesia,Asia,19,3,0,16,8,8,11,Unknown
1985-08-25 00:00:00,Bar Harbor Airlines,Landing (descent or approach),Commercial,United States of America,North America,8,2,2,6,6,8,0,Human Factor
1985-09-30 00:00:00,La Pourvoirie Roger Fortier,Landing (descent or approach),Commercial,Canada,North America,8,1,1,7,7,8,0,Unknown
1985-10-04 00:00:00,Air Albatross,Flight,Commercial,New Zealand,Oceania,9,1,1,8,7,8,1,Human Factor
1986-02-03 00:00:00,Royal Malaysian Air Force - Tentera Udara Diraja Malaysia,Landing (descent or approach),Military / Government,Malaysia,Asia,8,2,2,6,6,8,0,Human Factor
1986-03-03 00:00:00,Taxair,Takeoff (climb),Commercial,Switzerland,Europe,8,1,1,7,7,8,0,Human Factor
1986-03-12 00:00:00,Inversiones Gabriel J. Restrepo,Takeoff (climb),Business,Colombia,South America,8,1,1,7,7,8,0,Unknown
1986-06-14 00:00:00,Royal Canadian Air Force - RCAF,Flight,Military / Government,Canada,North America,8,2,2,6,6,8,0,Human Factor
1986-08-14 00:00:00,Indonesian Air Force - TNI-AU Tentara Nasional Indonesia - Angkatan Udara,Takeoff (climb),Operational,Indonesia,Asia,8,8,8,0,0,8,0,Unknown
1986-08-29 00:00:00,René Martínez,Flight,Business,Mexico,Central America,8,1,1,7,7,8,0,Technical Failure
1986-09-02 00:00:00,Private Australian,Takeoff (climb),Business,Australia,Oceania,8,1,1,7,7,8,0,Human Factor
1986-12-15 00:00:00,Radio Communications Corporation,Landing (descent or approach),Business,Morocco,Africa,8,2,2,6,6,8,0,Human Factor
1987-01-15 00:00:00,SkyWest Airlines - USA,Landing (descent or approach),Commercial,United States of America,North America,8,2,2,6,6,8,0,Human Factor
1987-03-20 00:00:00,Aeroguayacán,Landing (descent or approach),Commercial,Chile,South America,9,2,2,7,6,8,1,Technical Failure
1987-04-02 00:00:00,Soviet Air Force - Voyenno-vozdushnye sily CCCP,Flight,Operational,Ukraine,Europe,8,8,8,0,0,8,0,Human Factor
1987-04-02 00:00:00,Soviet Air Force - Voyenno-vozdushnye sily CCCP,Flight,Operational,Ukraine,Europe,8,8,8,0,0,8,0,Human Factor
1987-05-23 00:00:00,Merpati Nusantara Airlines - MNA,Landing (descent or approach),Commercial,Indonesia,Asia,8,2,2,6,6,8,0,Unknown
1987-06-19 00:00:00,Aeroflot - Russian International Airlines,Landing (descent or approach),Commercial,Ukraine,Europe,29,5,2,24,6,8,21,Human Factor
1987-08-15 00:00:00,Sunbird Aviation,Landing (descent or approach),Commercial,Kenya,Africa,28,2,0,26,8,8,20,Human Factor
1987-10-22 00:00:00,Soviet Air Force - Voyenno-vozdushnye sily CCCP,Landing (descent or approach),Military / Government,Afghanistan,Asia,8,6,6,2,2,8,0,Terrorism
1987-11-16 00:00:00,Danpar Aviation,Flight,Commercial,United States of America,North America,8,2,2,6,6,8,0,Unknown
1987-12-23 00:00:00,Panorama Air Tour,Flight,Commercial,United States of America,North America,8,1,1,7,7,8,0,Human Factor
1988-06-13 00:00:00,Néstor Benito Ibañez,Landing (descent or approach),Business,Argentina,South America,9,1,1,8,7,8,1,Technical Failure
1988-08-30 00:00:00,Colombian Air Force - Fuerza Aérea Colombiana,Flight,Military / Government,Colombia,South America,8,8,8,0,0,8,0,Unknown
1988-09-01 00:00:00,Soviet Air Force - Voyenno-vozdushnye sily CCCP,Landing (descent or approach),Operational,Russia,Asia,8,8,8,0,0,8,0,Unknown
1988-10-02 00:00:00,Aramar Aerotaxi,Flight,Business,Brazil,South America,8,1,1,7,7,8,0,Unknown
1988-10-11 00:00:00,Soviet Air Force - Voyenno-vozdushnye sily CCCP,Landing (descent or approach),Military / Government,Georgia,Asia,8,7,7,1,1,8,0,Human Factor
1988-12-14 00:00:00,GAS Air Cargo - General %26 Aviation Services,Flight,Operational,Egypt,Africa,8,3,3,5,5,8,0,Human Factor
1989-02-20 00:00:00,United States Air Force - USAF,Landing (descent or approach),Military / Government,United States of America,North America,8,7,7,1,1,8,0,Human Factor
1989-05-05 00:00:00,Executive Air,Landing (descent or approach),Commercial,Zimbabwe,Africa,8,1,1,7,7,8,0,Human Factor
1989-11-28 00:00:00,New England Airlines,Takeoff (climb),Commercial,United States of America,North America,8,1,1,7,7,8,0,Weather
1990-02-01 00:00:00,Soviet Air Force - Voyenno-vozdushnye sily CCCP,Takeoff (climb),Operational,Lithuania,Europe,8,8,8,0,0,8,0,Unknown
1990-05-11 00:00:00,Philippine Airlines - PAL,Taxiing,Commercial,Philippines,Asia,120,6,0,114,8,8,112,Technical Failure
1990-07-05 00:00:00,Douglas Airways,Flight,Commercial,Papua New Guinea,Oceania,12,1,1,11,7,8,4,Human Factor
1990-09-12 00:00:00,Nuna Air,Flight,Commercial,Greenland,Europe,8,2,2,6,6,8,0,Technical Failure
1990-09-29 00:00:00,Douglas M. Lacey,Flight,Operational,United States of America,North America,8,1,1,7,7,8,0,Human Factor
1990-11-26 00:00:00,Soviet Air Force - Voyenno-vozdushnye sily CCCP,Landing (descent or approach),Military / Government,Kazakhstan,Asia,8,8,8,0,0,8,0,Unknown
1990-12-03 00:00:00,Northwest Airlines,Taxiing,Commercial,United States of America,North America,44,4,1,40,7,8,36,Human Factor
1991-04-01 00:00:00,Tropic Air,Landing (descent or approach),Commercial,Belize,Central America,8,1,1,7,7,8,0,Human Factor
1991-05-05 00:00:00,Nile Safaris Aviation,Landing (descent or approach),Commercial,South Sudan,Africa,8,1,1,7,7,8,0,Terrorism
1991-12-11 00:00:00,Líneas Aéreas Suramericanas,Landing (descent or approach),Operational,Colombia,South America,8,4,4,4,4,8,0,Human Factor
1992-07-24 00:00:00,Volga-Dnepr Airlines,Landing (descent or approach),Operational,Macedonia,Europe,8,6,6,2,2,8,0,Human Factor
1992-08-27 00:00:00,Transportes Aéreos Nacionales de la Selva - TANS,Flight,Commercial,Peru,South America,21,3,2,18,6,8,13,Technical Failure
1992-10-13 00:00:00,Antonov Design Bureau,Flight,Specialised Services,Ukraine,Europe,9,9,8,0,0,8,1,Other
1992-10-21 00:00:00,Transportes Aéreos Nacionales de la Selva - TANS,Flight,Commercial,Peru,South America,11,3,1,8,7,8,3,Technical Failure
1992-11-12 00:00:00,United States Army,Flight,Military / Government,United States of America,North America,8,2,2,6,6,8,0,Human Factor
1992-11-29 00:00:00,Transportes Aéreos San Rafael,Takeoff (climb),Commercial,Chile,South America,8,1,1,7,7,8,0,Unknown
1992-12-18 00:00:00,U.S. Department of Energy,Landing (descent or approach),Military / Government,United States of America,North America,8,2,2,6,6,8,0,Human Factor
1993-04-19 00:00:00,State of South Dakota,Landing (descent or approach),Military / Government,United States of America,North America,8,2,2,6,6,8,0,Technical Failure
1994-03-14 00:00:00,United States Air Force - USAF,Flight,Military / Government,Kenya,Africa,14,14,8,0,0,8,6,Other
1994-04-27 00:00:00,Action Airlines,Landing (descent or approach),Commercial,United States of America,North America,9,1,1,8,7,8,1,Human Factor
1994-04-29 00:00:00,Lineas Aéreas de Los Libertadores - LALI,Landing (descent or approach),Commercial,Colombia,South America,9,1,1,8,7,8,1,Human Factor
1994-09-09 00:00:00,Gromov Flight Research Institute - GFRI,Flight,Specialised Services,Russia,Asia,8,5,5,3,3,8,0,Human Factor
1994-09-29 00:00:00,Radeair,Takeoff (climb),Commercial,Argentina,South America,9,2,1,7,7,8,1,Human Factor
1994-09-30 00:00:00,Arsenyev Aviation Production Association,Takeoff (climb),Operational,Russia,Asia,21,6,4,15,4,8,13,Technical Failure
1994-11-05 00:00:00,Servicios Aereos Amazonicos,Landing (descent or approach),Commercial,Peru,South America,31,5,1,26,7,8,23,Human Factor
1995-02-13 00:00:00,Las Vegas Airlines,Takeoff (climb),Commercial,United States of America,North America,10,1,1,9,7,8,2,Technical Failure
1995-04-17 00:00:00,United States Air Force - USAF,Landing (descent or approach),Military / Government,United States of America,North America,8,2,2,6,6,8,0,Technical Failure
1995-08-14 00:00:00,Aires Colombia - Aerovias de Integracion Regional,Flight,Commercial,Colombia,South America,8,2,2,6,6,8,0,Human Factor
1995-08-21 00:00:00,Atlantic Southeast Airlines - ASA,Landing (descent or approach),Commercial,United States of America,North America,29,3,1,26,7,8,21,Technical Failure
1995-09-02 00:00:00,Adventure Airlines,Landing (descent or approach),Business,United States of America,North America,8,1,1,7,7,8,0,Human Factor
1995-09-27 00:00:00,Western Straits Air,Landing (descent or approach),Commercial,Canada,North America,10,1,1,9,7,8,2,Human Factor
1995-10-25 00:00:00,MAP Ufa Motors,Landing (descent or approach),Operational,Russia,Asia,13,6,4,7,4,8,5,Human Factor
1996-01-15 00:00:00,Pro Air Services,Flight,Business,United States of America,North America,8,2,2,6,6,8,0,Weather
1996-02-06 00:00:00,Aérotaxi Cachanilla,Landing (descent or approach),Commercial,Mexico,Central America,8,2,2,6,6,8,0,Human Factor
1996-02-22 00:00:00,Autoritatea Aeronautică Civilă Romănă,Landing (descent or approach),Specialised Services,Romania,Europe,8,3,3,5,5,8,0,Human Factor
1996-03-13 00:00:00,Avia Air,Landing (descent or approach),Commercial,Venezuela,South America,8,1,1,7,7,8,0,Technical Failure
1996-04-05 00:00:00,Mauritanian Air Force - Force Aérienne Islamique de Mauritanie,Takeoff (climb),Military / Government,Mauritania,Africa,8,2,2,6,6,8,0,Technical Failure
1996-07-24 00:00:00,Myanma Airways,Landing (descent or approach),Commercial,Myanmar,Asia,49,4,0,45,8,8,41,Weather
1996-08-30 00:00:00,Brazilian Air Force - Força Aérea Brasileira,Flight,Specialised Services,Brazil,South America,8,2,2,6,6,8,0,Unknown
1996-10-20 00:00:00,Telford Aviation,Landing (descent or approach),Commercial,Canada,North America,8,1,1,7,7,8,0,Technical Failure
1996-11-07 00:00:00,Jetcom,Flight,Commercial,France,Europe,8,1,1,7,7,8,0,Technical Failure
1996-11-13 00:00:00,Kissimayu Aviation,Flight,Commercial,Kenya,Africa,8,1,1,7,7,8,0,Technical Failure
1997-10-10 00:00:00,Republic of China Air Force,Landing (descent or approach),Operational,Taiwan,Asia,8,6,6,2,2,8,0,Unknown
1997-11-08 00:00:00,Hageland Aviation Services,Takeoff (climb),Commercial,United States of America,North America,8,1,1,7,7,8,0,Weather
1998-06-26 00:00:00,Federal Airlines,Landing (descent or approach),Commercial,Ivory Coast,Africa,8,1,1,7,7,8,0,Human Factor
1998-07-13 00:00:00,ATI Aircompany,Takeoff (climb),Operational,United Arab Emirates,Asia,8,8,8,0,0,8,0,Other
1999-01-11 00:00:00,Indian Air Force - Bharatiya Vayu Sena,Landing (descent or approach),Specialised Services,India,Asia,8,4,4,4,4,8,0,Technical Failure
1999-03-18 00:00:00,Aliansa Colombia - Aerolíneas Andinas,Flight,Commercial,Colombia,South America,8,3,3,5,5,8,0,Weather
1999-07-02 00:00:00,Myanma Airways,Landing (descent or approach),Operational,Myanmar,Asia,8,4,4,4,4,8,0,Human Factor
1999-07-28 00:00:00,Lepanto Consolidated Mining Company,Flight,Business,Philippines,Asia,8,2,2,6,6,8,0,Human Factor
1999-09-03 00:00:00,Edinburgh Air Charter,Takeoff (climb),Commercial,United Kingdom,Europe,11,2,2,9,6,8,3,Technical Failure
1999-09-03 00:00:00,CP Horizons Corporation,Landing (descent or approach),Business,United States of America,North America,8,1,1,7,7,8,0,Technical Failure
1999-12-09 00:00:00,Twin Air - Sweden,Takeoff (climb),Commercial,Sweden,Europe,8,1,1,7,7,8,0,Human Factor
2000-05-31 00:00:00,Whyalla Airlines,Landing (descent or approach),Commercial,Australia,Oceania,8,1,1,7,7,8,0,Technical Failure
2000-06-27 00:00:00,Japan Air Self-Defense Force - Kōkū Jieitai,Flight,Specialised Services,Japan,Asia,8,8,8,0,0,8,0,Technical Failure
2000-09-04 00:00:00,Central Air,Flight,Commercial,Australia,Oceania,8,1,1,7,7,8,0,Technical Failure
2000-10-19 00:00:00,Lao Aviation,Landing (descent or approach),Commercial,Laos,Asia,17,2,0,15,8,8,9,Human Factor
2000-10-29 00:00:00,Oscar Osorio Ramírez,Flight,Business,Colombia,South America,8,2,2,6,6,8,0,Human Factor
2001-01-04 00:00:00,Chinese Air Force - AFPLA - Chung-Kuo Shan Min Taie Fang Tsun Pu-Tai,Landing (descent or approach),Military / Government,China,Asia,8,8,8,0,0,8,0,Unknown
2001-01-04 00:00:00,Chinese Air Force - AFPLA - Chung-Kuo Shan Min Taie Fang Tsun Pu-Tai,Landing (descent or approach),Military / Government,China,Asia,8,8,8,0,0,8,0,Unknown
2001-02-19 00:00:00,Colombian National Army - Ejército Nacional de Colombia,Landing (descent or approach),Military / Government,Colombia,South America,8,2,2,6,6,8,0,Human Factor
2001-09-18 00:00:00,Atlantic Airlines,Takeoff (climb),Commercial,Guatemala,Central America,13,2,1,11,7,8,5,Human Factor
2001-09-30 00:00:00,Birla Global Finance,Flight,Business,India,Asia,8,2,2,6,6,8,0,Weather
2001-12-26 00:00:00,BAL Bremerhaven Airline,Takeoff (climb),Commercial,Germany,Europe,9,1,1,8,7,8,1,Weather
2002-02-07 00:00:00,Volare Aircompany,Flight,Operational,Morocco,Africa,8,8,8,0,0,8,0,Human Factor
2002-10-25 00:00:00,Aviation Charter,Landing (descent or approach),Commercial,United States of America,North America,8,2,2,6,6,8,0,Human Factor
2002-12-13 00:00:00,Island Airways - PNG,Takeoff (climb),Commercial,Papua New Guinea,Oceania,8,1,1,7,7,8,0,Human Factor
2003-02-24 00:00:00,Edhi Air Ambulance,Takeoff (climb),Commercial,Pakistan,Asia,8,2,2,6,6,8,0,Other
2003-06-06 00:00:00,Air Adventures New Zealand,Landing (descent or approach),Commercial,New Zealand,Oceania,10,1,1,9,7,8,2,Human Factor
2003-09-11 00:00:00,Wasaya Airways,Landing (descent or approach),Commercial,Canada,North America,8,1,1,7,7,8,0,Unknown
2003-09-13 00:00:00,Private Mexican,Flight,Business,Mexico,Central America,8,1,1,7,7,8,0,Human Factor
2005-02-16 00:00:00,Circuit City Stores,Landing (descent or approach),Business,United States of America,North America,8,2,2,6,6,8,0,Human Factor
2005-03-23 00:00:00,Airline Transport,Takeoff (climb),Operational,Tanzania,Africa,8,8,8,0,0,8,0,Human Factor
2005-09-01 00:00:00,AeroAndes,Takeoff (climb),Commercial,Colombia,South America,8,2,2,6,6,8,0,Technical Failure
2005-11-11 00:00:00,Royal Airlines Cargo,Flight,Operational,Afghanistan,Asia,8,8,8,0,0,8,0,Human Factor
2005-11-19 00:00:00,Ivolga Avia,Flight,Commercial,Russia,Asia,8,2,2,6,6,8,0,Weather
2006-04-27 00:00:00,LAC - Sky Congo,Landing (descent or approach),Operational,Democratic Republic of Congo,Africa,8,3,3,5,5,8,0,Unknown
2007-09-07 00:00:00,Transavia Service,Landing (descent or approach),Operational,Democratic Republic of Congo,Africa,8,5,5,3,3,8,0,Unknown
2008-04-11 00:00:00,Kata Air Transport,Landing (descent or approach),Operational,Moldova,Europe,8,4,4,4,4,8,0,Human Factor
2008-07-31 00:00:00,East Coast Jets,Landing (descent or approach),Commercial,United States of America,North America,8,2,2,6,6,8,0,Human Factor
2009-12-13 00:00:00,Chelavia,Takeoff (climb),Humanitarian,Russia,Asia,8,1,1,7,7,8,0,Human Factor
2010-01-28 00:00:00,Philippine Air Force - Hukbong Himpapawid NG Pilipinas,Takeoff (climb),Military / Government,Philippines,Asia,8,2,2,6,6,8,0,Technical Failure
2010-05-15 00:00:00,Blue Wing Airlines,Flight,Commercial,Suriname,South America,8,2,2,6,6,8,0,Unknown
2010-07-07 00:00:00,Rajet Aeroservicios,Flight,Military / Government,Mexico,Central America,8,2,2,6,6,8,0,Unknown
2010-10-06 00:00:00,Aviones Taxi AIFE,Takeoff (climb),Commercial,Mexico,Central America,8,2,2,6,6,8,0,Unknown
2010-10-12 00:00:00,National Airlines - National Air Cargo,Flight,Operational,Afghanistan,Asia,8,8,8,0,0,8,0,Human Factor
2010-11-28 00:00:00,Sun Way,Takeoff (climb),Operational,Pakistan,Asia,8,6,6,2,2,8,0,Technical Failure
2011-08-02 00:00:00,Brazilian Air Force - Força Aérea Brasileira,Flight,Military / Government,Brazil,South America,8,2,2,6,6,8,0,Unknown
2011-09-06 00:00:00,Aerocon - Aero Comercial Oriente Norte,Landing (descent or approach),Commercial,Bolivia,South America,9,2,2,7,6,8,1,Unknown
2011-10-14 00:00:00,Moremi Air,Takeoff (climb),Commercial,Botswana,Africa,12,1,1,11,7,8,4,Technical Failure
2012-03-01 00:00:00,Aerohein,Flight,Commercial,Chile,South America,8,1,1,7,7,8,0,Human Factor
2012-03-22 00:00:00,INAER Helicopter Chile,Flight,Humanitarian,Chile,South America,8,2,2,6,6,8,0,Unknown
2012-07-28 00:00:00,Vilma Alimentos,Landing (descent or approach),Business,Brazil,South America,8,2,2,6,6,8,0,Human Factor
2013-01-17 00:00:00,Habilitaciones Turisticas SA - HATUSA,Takeoff (climb),Commercial,Mexico,Central America,8,2,2,6,6,8,0,Technical Failure
2013-11-03 00:00:00,Aerocon - Aero Comercial Oriente Norte,Landing (descent or approach),Commercial,Bolivia,South America,18,2,0,16,8,8,10,Human Factor
2014-04-19 00:00:00,Lineas Aéreas Comerciales,Landing (descent or approach),Commercial,Mexico,Central America,8,2,2,6,6,8,0,Human Factor
2014-04-20 00:00:00,Suomen Urheiluilmailijat,Flight,Humanitarian,Finland,Europe,11,1,0,10,8,8,3,Technical Failure
2016-07-31 00:00:00,Fenatracoop,Landing (descent or approach),Business,Brazil,South America,8,2,2,6,6,8,0,Technical Failure
2017-04-29 00:00:00,Aerogaviota,Flight,Operational,Cuba,Central America,8,8,8,0,0,8,0,Unknown
2017-05-01 00:00:00,Colombian National Army - Ejército Nacional de Colombia,Landing (descent or approach),Military / Government,Colombia,South America,8,3,3,5,5,8,0,Unknown
2018-08-11 00:00:00,Dimonim Air,Landing (descent or approach),Commercial,Indonesia,Asia,9,2,2,7,6,8,1,Human Factor
2019-10-10 00:00:00,Congolese Air Force - Force Aérienne de la République Démocratique du Congo,Flight,Military / Government,Democratic Republic of Congo,Africa,8,4,4,4,4,8,0,Unknown
2020-03-29 00:00:00,Lionair Inc.,Takeoff (climb),Humanitarian,Philippines,Asia,8,2,2,6,6,8,0,Unknown
2021-08-14 00:00:00,Russian Navy - Voyenno-morskoy Flot Rossii,Flight,Humanitarian,Turkey,Asia,8,8,8,0,0,8,0,Unknown
2021-10-03 00:00:00,Private Romanian,Takeoff (climb),Business,Italy,Europe,8,1,1,7,7,8,0,Unknown
2022-02-13 00:00:00,EDP Management Group,Flight,Business,United States of America,North America,8,1,1,7,7,8,0,Unknown
1918-08-19 00:00:00,Royal Air Force - RAF,Flight,Specialised Services,United Kingdom,Europe,7,2,2,5,5,7,0,Technical Failure
1921-05-28 00:00:00,United States Army Air Service - USAAS,Flight,Humanitarian,United States of America,North America,7,1,1,6,6,7,0,Weather
1926-10-02 00:00:00,Air Union France,Landing (descent or approach),Commercial,United Kingdom,Europe,7,2,2,5,5,7,0,Technical Failure
1927-09-17 00:00:00,Reynolds Airways,Flight,Commercial,United States of America,North America,12,2,2,10,5,7,5,Technical Failure
1927-09-23 00:00:00,Deutsche Lufthansa,Flight,Commercial,Germany,Europe,7,2,2,5,5,7,0,Technical Failure
1928-08-25 00:00:00,British Columbia Airways - BCA,Flight,Commercial,United States of America,North America,7,2,2,5,5,7,0,Weather
1928-09-04 00:00:00,National Parks Airways,Landing (descent or approach),Commercial,United States of America,North America,7,2,2,5,5,7,0,Unknown
1929-06-17 00:00:00,Imperial Airways,Flight,Commercial,United Kingdom,Europe,13,2,0,11,7,7,6,Technical Failure
1929-10-26 00:00:00,Imperial Airways,Flight,Commercial,Italy,Europe,7,2,2,5,5,7,0,Technical Failure
1929-11-06 00:00:00,Deutsche Lufthansa,Landing (descent or approach),Commercial,United Kingdom,Europe,9,3,2,6,5,7,2,Human Factor
1931-07-24 00:00:00,Compagnie Internationale de Navigation Aérienne - CIDNA,Flight,Commercial,Bulgaria,Europe,7,2,2,5,5,7,0,Unknown
1932-03-19 00:00:00,American Airways,Flight,Commercial,United States of America,North America,7,2,2,5,5,7,0,Human Factor
1933-03-31 00:00:00,J. H. O’Brien,Flight,Business,United States of America,North America,13,2,2,11,5,7,6,Technical Failure
1933-07-25 00:00:00,United States Army Air Corps - USAAC,Flight,Military / Government,United States of America,North America,7,7,7,0,0,7,0,Technical Failure
1933-10-10 00:00:00,United Airlines,Flight,Commercial,United States of America,North America,7,3,3,4,4,7,0,Terrorism
1933-12-11 00:00:00,Deutsche Lufthansa,Landing (descent or approach),Commercial,Germany,Europe,8,4,4,4,3,7,1,Human Factor
1934-06-07 00:00:00,Compañia Aeronautica Francisco Sarabia SA - CAFSSA,Landing (descent or approach),Commercial,Mexico,Central America,8,1,1,7,6,7,1,Human Factor
1934-06-09 00:00:00,American Airlines,Flight,Commercial,United States of America,North America,7,3,3,4,4,7,0,Human Factor
1934-10-02 00:00:00,Hillman's Airways,Flight,Commercial,United Kingdom,Europe,7,1,1,6,6,7,0,Human Factor
1934-12-20 00:00:00,KLM Royal Dutch Airlines - Koninklijke Luchtvaart Maatschappij,Landing (descent or approach),Commercial,Iraq,Asia,7,3,3,4,4,7,0,Weather
1934-12-21 00:00:00,Lineas Aéreas Occidentales,Flight,Commercial,Mexico,Central America,7,2,2,5,5,7,0,Unknown
1935-04-06 00:00:00,KLM Royal Dutch Airlines - Koninklijke Luchtvaart Maatschappij,Flight,Commercial,Germany,Europe,7,5,5,2,2,7,0,Weather
1935-06-24 00:00:00,SCADTA - Sociedad Colombo-Alemana de Transportes Aéreos,Taxiing,Commercial,Colombia,South America,7,3,3,4,4,7,0,Human Factor
1935-08-07 00:00:00,Ala Littoria,Takeoff (climb),Military / Government,Egypt,Africa,7,4,4,3,3,7,0,Other
1936-04-15 00:00:00,Avio Linee Italiane - ALI,Flight,Commercial,Italy,Europe,7,2,2,5,5,7,0,Unknown
1936-06-16 00:00:00,Det Norske Luftfartselskap - DNL,Flight,Commercial,Norway,Europe,7,4,4,3,3,7,0,Unknown
1936-07-15 00:00:00,Aeroput,Takeoff (climb),Commercial,Croatia,Europe,7,2,2,5,5,7,0,Weather
1936-12-15 00:00:00,Western Air Express,Landing (descent or approach),Commercial,United States of America,North America,7,3,3,4,4,7,0,Human Factor
1937-10-27 00:00:00,Air France,Flight,Commercial,Morocco,Africa,7,5,5,2,2,7,0,Technical Failure
1938-01-11 00:00:00,Pan American World Airways - PAA,Flight,Operational,World,World,7,7,7,0,0,7,0,Technical Failure
1938-02-02 00:00:00,United States Navy - USN,Flight,Military / Government,United States of America,North America,7,2,2,5,5,7,0,Human Factor
1938-03-07 00:00:00,Air France,Flight,Commercial,India,Asia,7,3,3,4,4,7,0,Unknown
1938-06-23 00:00:00,French Government,Takeoff (climb),Operational,France,Europe,7,7,7,0,0,7,0,Technical Failure
1939-08-04 00:00:00,Deutsche Lufthansa,Flight,Commercial,Spain,Europe,7,3,3,4,4,7,0,Unknown
1939-08-30 00:00:00,Deutsche Lufthansa,Takeoff (climb),Commercial,Germany,Europe,7,3,3,4,4,7,0,Unknown
1939-10-18 00:00:00,Royal Air Force - RAF,Takeoff (climb),Operational,United Kingdom,Europe,9,3,3,6,4,7,2,Human Factor
1939-11-05 00:00:00,Royal Air Force - RAF,Flight,Operational,United Kingdom,Europe,7,7,7,0,0,7,0,Human Factor
1939-11-10 00:00:00,Spanish Air Force - Ejército del Aire,Flight,Military / Government,Spain,Europe,11,2,2,9,5,7,4,Unknown
1939-12-24 00:00:00,Linee Aeree Transcontinentali Italiane - LATI,Flight,Commercial,Morocco,Africa,7,4,4,3,3,7,0,Weather
1940-10-22 00:00:00,Aeroput,Landing (descent or approach),Commercial,Croatia,Europe,12,3,3,9,4,7,5,Unknown
1940-12-24 00:00:00,Ala Littoria,Flight,Commercial,Italy,Europe,7,4,4,3,3,7,0,Terrorism
1941-01-16 00:00:00,United States Army Air Corps - USAAC,Flight,Military / Government,United States of America,North America,7,6,6,1,1,7,0,Human Factor
1941-03-01 00:00:00,Royal Air Force - RAF,Landing (descent or approach),Operational,United Kingdom,Europe,7,7,7,0,0,7,0,Unknown
1941-05-27 00:00:00,Royal Air Force - RAF,Flight,Operational,United Kingdom,Europe,7,1,1,6,6,7,0,Unknown
1941-06-22 00:00:00,Royal Air Force - RAF,Flight,Military / Government,United Kingdom,Europe,7,7,7,0,0,7,0,Terrorism
1941-06-27 00:00:00,Royal Air Force - RAF,Flight,Military / Government,Germany,Europe,7,7,7,0,0,7,0,Terrorism
1941-07-26 00:00:00,Soviet Air Force - Voyenno-vozdushnye sily CCCP,Flight,Military / Government,Russia,Asia,17,2,2,15,5,7,10,Human Factor
1941-07-28 00:00:00,Royal Air Force - RAF,Flight,Military / Government,United Kingdom,Europe,7,7,7,0,0,7,0,Technical Failure
1941-07-30 00:00:00,Royal Air Force - RAF,Flight,Military / Government,United Kingdom,Europe,7,7,7,0,0,7,0,Unknown
1941-09-03 00:00:00,Royal Air Force - RAF,Flight,Military / Government,Germany,Europe,7,7,7,0,0,7,0,Terrorism
1941-09-08 00:00:00,Royal Air Force - RAF,Flight,Military / Government,Norway,Europe,7,7,7,0,0,7,0,Terrorism
1941-10-21 00:00:00,Royal Air Force - RAF,Flight,Military / Government,United Kingdom,Europe,7,7,7,0,0,7,0,Unknown
1941-10-21 00:00:00,Royal Air Force - RAF,Flight,Military / Government,World,World,7,7,7,0,0,7,0,Unknown
1941-10-21 00:00:00,Royal Air Force - RAF,Takeoff (climb),Specialised Services,United Kingdom,Europe,7,6,6,1,1,7,0,Technical Failure
1941-11-08 00:00:00,Royal Air Force - RAF,Flight,Military / Government,World,World,7,7,7,0,0,7,0,Unknown
1941-11-12 00:00:00,French Government,Flight,Military / Government,France,Europe,7,4,4,3,3,7,0,Weather
1941-11-29 00:00:00,Aeroflot - Russian International Airlines,Takeoff (climb),Commercial,Turkmenistan,Asia,36,5,2,31,5,7,29,Human Factor
1941-12-08 00:00:00,Royal Air Force - RAF,Flight,Military / Government,France,Europe,7,7,7,0,0,7,0,Unknown
1942-01-09 00:00:00,Royal Air Force - RAF,Flight,Military / Government,France,Europe,7,7,7,0,0,7,0,Terrorism
1942-01-14 00:00:00,Royal Air Force - RAF,Flight,Military / Government,United Kingdom,Europe,7,7,7,0,0,7,0,Terrorism
1942-02-02 00:00:00,United States Army Air Forces - USAAF,Flight,Military / Government,Indonesia,Asia,7,7,7,0,0,7,0,Terrorism
1942-02-03 00:00:00,United States Army Air Forces - USAAF,Flight,Specialised Services,Indonesia,Asia,7,7,7,0,0,7,0,Terrorism
1942-02-17 00:00:00,Royal Air Force - RAF,Flight,Military / Government,Netherlands,Europe,7,7,7,0,0,7,0,Terrorism
1942-02-22 00:00:00,Royal Air Force - RAF,Flight,Military / Government,Norway,Europe,7,7,7,0,0,7,0,Terrorism
1942-02-23 00:00:00,Royal Netherlands Navy - Marineluchtvaartdienst,Flight,Military / Government,Indonesia,Asia,7,7,7,0,0,7,0,Unknown
1942-02-27 00:00:00,United States Navy - USN,Flight,Military / Government,United States of America,North America,7,7,7,0,0,7,0,Weather
1942-03-05 00:00:00,United States Army Air Forces - USAAF,Landing (descent or approach),Military / Government,United States of America,North America,7,4,4,3,3,7,0,Weather
1942-03-09 00:00:00,Royal Air Force - RAF,Flight,Military / Government,Netherlands,Europe,7,7,7,0,0,7,0,Terrorism
1942-03-25 00:00:00,Royal Air Force - RAF,Flight,Military / Government,Netherlands,Europe,7,7,7,0,0,7,0,Terrorism
1942-03-25 00:00:00,United States Army Air Forces - USAAF,Flight,Military / Government,World,World,7,7,7,0,0,7,0,Weather
1942-03-26 00:00:00,Royal Air Force - RAF,Flight,Military / Government,World,World,7,7,7,0,0,7,0,Unknown
1942-03-26 00:00:00,Royal Air Force - RAF,Flight,Military / Government,Belgium,Europe,7,7,7,0,0,7,0,Terrorism
1942-03-30 00:00:00,Royal Air Force - RAF,Flight,Military / Government,World,World,7,7,7,0,0,7,0,Unknown
1942-03-30 00:00:00,Royal Air Force - RAF,Flight,Military / Government,World,World,7,7,7,0,0,7,0,Unknown
1942-04-01 00:00:00,United States Army Air Forces - USAAF,Flight,Military / Government,United States of America,North America,7,7,7,0,0,7,0,Weather
1942-04-07 00:00:00,Royal Air Force - RAF,Flight,Military / Government,Belgium,Europe,7,7,7,0,0,7,0,Terrorism
1942-04-11 00:00:00,Royal Air Force - RAF,Flight,Military / Government,Germany,Europe,7,7,7,0,0,7,0,Terrorism
1942-04-17 00:00:00,Royal Air Force - RAF,Flight,Military / Government,France,Europe,7,7,7,0,0,7,0,Terrorism
1942-04-17 00:00:00,Royal Air Force - RAF,Flight,Military / Government,World,World,7,7,7,0,0,7,0,Unknown
1942-04-21 00:00:00,United States Army Air Forces - USAAF,Flight,Military / Government,Australia,Oceania,8,8,7,0,0,7,1,Technical Failure
1942-04-28 00:00:00,Royal Air Force - RAF,Flight,Military / Government,Norway,Europe,7,7,7,0,0,7,0,Terrorism
1942-04-29 00:00:00,United States Army Air Forces - USAAF,Takeoff (climb),Specialised Services,United States of America,North America,8,6,5,2,2,7,1,Human Factor
1942-05-10 00:00:00,United States Army Air Forces - USAAF,Flight,Military / Government,Papua New Guinea,Oceania,7,7,7,0,0,7,0,Terrorism
1942-05-15 00:00:00,United States Army Air Forces - USAAF,Flight,Operational,United States of America,North America,7,7,7,0,0,7,0,Unknown
1942-05-27 00:00:00,United States Army Air Forces - USAAF,Flight,Operational,United States of America,North America,7,7,7,0,0,7,0,Unknown
1942-05-28 00:00:00,United States Army Air Forces - USAAF,Flight,Military / Government,Papua New Guinea,Oceania,7,7,7,0,0,7,0,Terrorism
1942-05-31 00:00:00,Royal Air Force - RAF,Flight,Military / Government,World,World,7,7,7,0,0,7,0,Unknown
1942-06-04 00:00:00,United States Army Air Forces - USAAF,Flight,Military / Government,World,World,7,7,7,0,0,7,0,Terrorism
1942-06-05 00:00:00,United States Navy - USN,Flight,Military / Government,World,World,7,7,7,0,0,7,0,Unknown
1942-06-07 00:00:00,Royal Air Force - RAF,Flight,Military / Government,World,World,7,7,7,0,0,7,0,Unknown
1942-06-07 00:00:00,Royal Air Force - RAF,Flight,Military / Government,World,World,7,7,7,0,0,7,0,Unknown
1942-06-20 00:00:00,Royal Air Force - RAF,Flight,Military / Government,World,World,7,7,7,0,0,7,0,Unknown
1942-06-26 00:00:00,Royal Air Force - RAF,Flight,Military / Government,Germany,Europe,7,7,7,0,0,7,0,Terrorism
1942-07-12 00:00:00,Royal Air Force - RAF,Flight,Military / Government,World,World,7,7,7,0,0,7,0,Unknown
1942-08-01 00:00:00,Royal Air Force - RAF,Flight,Military / Government,Germany,Europe,7,7,7,0,0,7,0,Unknown
1942-08-19 00:00:00,United States Navy - USN,Takeoff (climb),Military / Government,Panama,Central America,7,7,7,0,0,7,0,Unknown
1942-08-27 00:00:00,Royal Air Force - RAF,Flight,Military / Government,Netherlands,Europe,7,7,7,0,0,7,0,Terrorism
1942-08-29 00:00:00,German Air Force - Deutsche Luftwaffe,Takeoff (climb),Military / Government,Norway,Europe,7,7,7,0,0,7,0,Weather
1942-09-19 00:00:00,United States Army Air Forces - USAAF,Flight,Operational,United States of America,North America,7,7,7,0,0,7,0,Human Factor
1942-10-13 00:00:00,Royal Air Force - RAF,Flight,Military / Government,Netherlands,Europe,7,7,7,0,0,7,0,Unknown
1942-10-16 00:00:00,Royal New Zealand Air Force - RNZAF,Takeoff (climb),Military / Government,Vanuatu,Oceania,7,7,7,0,0,7,0,Unknown
1942-11-07 00:00:00,Royal Air Force - RAF,Flight,Military / Government,France,Europe,7,7,7,0,0,7,0,Unknown
1942-11-07 00:00:00,Royal Air Force - RAF,Landing (descent or approach),Military / Government,United Kingdom,Europe,7,7,7,0,0,7,0,Unknown
1942-11-20 00:00:00,Royal Air Force - RAF,Flight,Military / Government,Norway,Europe,7,7,7,0,0,7,0,Weather
1942-12-17 00:00:00,United States Navy - USN,Flight,Military / Government,World,World,7,7,7,0,0,7,0,Unknown
1942-12-17 00:00:00,United States Army Air Forces - USAAF,Flight,Military / Government,Papua New Guinea,Oceania,7,7,7,0,0,7,0,Unknown
1942-12-23 00:00:00,United States Army Air Forces - USAAF,Flight,Operational,United States of America,North America,7,7,7,0,0,7,0,Human Factor
1943-01-10 00:00:00,United States Army Air Forces - USAAF,Takeoff (climb),Military / Government,Papua New Guinea,Oceania,15,15,7,0,0,7,8,Unknown
1943-01-30 00:00:00,Royal Air Force - RAF,Flight,Military / Government,United Kingdom,Europe,7,7,7,0,0,7,0,Technical Failure
1943-01-31 00:00:00,Royal Air Force - RAF,Flight,Military / Government,Netherlands,Europe,7,7,7,0,0,7,0,Unknown
1943-02-05 00:00:00,Royal Netherlands East Indies Air Force - ML-KNIL,Takeoff (climb),Military / Government,Australia,Oceania,7,7,7,0,0,7,0,Unknown
1943-02-05 00:00:00,Royal Air Force - RAF,Flight,Military / Government,France,Europe,7,7,7,0,0,7,0,Weather
1943-02-17 00:00:00,United States Navy - USN,Takeoff (climb),Operational,United States of America,North America,12,12,7,0,0,7,5,Unknown
1943-02-18 00:00:00,LAN Chile - Linea Aérea Nacional de Chile,Flight,Commercial,Chile,South America,7,2,2,5,5,7,0,Unknown
1943-02-19 00:00:00,Royal Air Force - RAF,Flight,Military / Government,Netherlands,Europe,7,7,7,0,0,7,0,Unknown
1943-03-05 00:00:00,Royal Air Force - RAF,Flight,Military / Government,Netherlands,Europe,7,7,7,0,0,7,0,Terrorism
1943-03-07 00:00:00,Royal Air Force - RAF,Flight,Military / Government,World,World,7,7,7,0,0,7,0,Unknown
1943-03-26 00:00:00,Royal Canadian Air Force - RCAF,Landing (descent or approach),Military / Government,United States of America,North America,7,4,4,3,3,7,0,Human Factor
1943-03-31 00:00:00,Royal Navy,Flight,Military / Government,United Kingdom,Europe,8,1,1,7,6,7,1,Unknown
1943-04-01 00:00:00,United States Navy - USN,Flight,Military / Government,United States of America,North America,12,2,2,10,5,7,5,Technical Failure
1943-04-04 00:00:00,British Overseas Airways Corporation - BOAC,Flight,Commercial,Denmark,Europe,7,3,3,4,4,7,0,Terrorism
1943-04-04 00:00:00,Royal Air Force - RAF,Flight,Military / Government,Netherlands,Europe,7,7,7,0,0,7,0,Terrorism
1943-04-08 00:00:00,Royal Air Force - RAF,Flight,Operational,United Kingdom,Europe,7,7,7,0,0,7,0,Unknown
1943-05-14 00:00:00,Royal Air Force - RAF,Flight,Military / Government,Netherlands,Europe,7,7,7,0,0,7,0,Unknown
1943-05-16 00:00:00,Royal Air Force - RAF,Flight,Military / Government,Germany,Europe,7,7,7,0,0,7,0,Terrorism
1943-05-16 00:00:00,Royal Air Force - RAF,Flight,Military / Government,Germany,Europe,7,7,7,0,0,7,0,Human Factor
1943-05-16 00:00:00,Royal Air Force - RAF,Flight,Military / Government,Netherlands,Europe,7,7,7,0,0,7,0,Terrorism
1943-05-17 00:00:00,Royal Air Force - RAF,Flight,Military / Government,Netherlands,Europe,7,7,7,0,0,7,0,Terrorism
1943-05-17 00:00:00,Royal Air Force - RAF,Flight,Military / Government,Netherlands,Europe,7,7,7,0,0,7,0,Terrorism
1943-05-17 00:00:00,Royal Air Force - RAF,Flight,Military / Government,Netherlands,Europe,7,7,7,0,0,7,0,Terrorism
1943-05-21 00:00:00,United States Army Air Forces - USAAF,Flight,Military / Government,Papua New Guinea,Oceania,11,11,7,0,0,7,4,Terrorism
1943-05-29 00:00:00,United States Army Air Forces - USAAF,Flight,Military / Government,France,Europe,10,10,7,0,0,7,3,Unknown
1943-06-02 00:00:00,Aeroflot - Russian International Airlines,Flight,Military / Government,Russia,Asia,7,7,7,0,0,7,0,Terrorism
1943-06-12 00:00:00,Royal Australian Air Force - RAAF,Landing (descent or approach),Operational,Australia,Oceania,7,7,7,0,0,7,0,Technical Failure
1943-07-12 00:00:00,United States Navy - USN,Flight,Military / Government,Solomon Islands,Oceania,7,7,7,0,0,7,0,Unknown
1943-07-13 00:00:00,Royal Air Force - RAF,Flight,Military / Government,Switzerland,Europe,7,7,7,0,0,7,0,Human Factor
1943-07-28 00:00:00,Royal Air Force - RAF,Flight,Military / Government,Netherlands,Europe,7,7,7,0,0,7,0,Unknown
1943-08-01 00:00:00,United States Army Air Forces - USAAF,Flight,Military / Government,Romania,Europe,10,10,7,0,0,7,3,Terrorism
1943-08-27 00:00:00,Aktiebolaget Aerotransport - ABA,Flight,Commercial,World,World,7,4,4,3,3,7,0,Terrorism
1943-08-27 00:00:00,United States Army Air Forces - USAAF,Flight,Operational,Papua New Guinea,Oceania,7,4,4,3,3,7,0,Unknown
1943-09-17 00:00:00,Royal Air Force - RAF,Flight,Military / Government,France,Europe,7,7,7,0,0,7,0,Unknown
1943-09-26 00:00:00,United States Army Air Forces - USAAF,Flight,Operational,United States of America,North America,7,7,7,0,0,7,0,Unknown
1943-09-30 00:00:00,United States Army Air Forces - USAAF,Flight,Military / Government,United Kingdom,Europe,7,5,5,2,2,7,0,Unknown
1943-10-22 00:00:00,Royal Air Force - RAF,Flight,Operational,United Kingdom,Europe,7,7,7,0,0,7,0,Terrorism
1943-11-04 00:00:00,Royal Air Force - RAF,Flight,Military / Government,France,Europe,8,8,7,0,0,7,1,Human Factor
1943-11-18 00:00:00,Royal Air Force - RAF,Flight,Military / Government,World,World,7,7,7,0,0,7,0,Terrorism
1943-11-21 00:00:00,United States Army Air Forces - USAAF,Flight,Military / Government,United States of America,North America,9,4,4,5,3,7,2,Human Factor
1943-11-24 00:00:00,United States Army Air Forces - USAAF,Flight,Military / Government,Algeria,Africa,10,10,7,0,0,7,3,Technical Failure
1943-12-27 00:00:00,United States Army Air Forces - USAAF,Flight,Military / Government,Myanmar,Asia,7,7,7,0,0,7,0,Unknown
1944-01-08 00:00:00,United States Army Air Forces - USAAF,Flight,Operational,United States of America,North America,7,7,7,0,0,7,0,Unknown
1944-01-09 00:00:00,United States Navy - USN,Takeoff (climb),Military / Government,Morocco,Africa,8,8,7,0,0,7,1,Unknown
1944-01-09 00:00:00,Royal Air Force - RAF,Flight,Military / Government,United Kingdom,Europe,7,7,7,0,0,7,0,Unknown
1944-01-11 00:00:00,United States Army Air Forces - USAAF,Flight,Military / Government,Netherlands,Europe,10,10,7,0,0,7,3,Terrorism
1944-01-17 00:00:00,Royal New Zealand Air Force - RNZAF,Landing (descent or approach),Military / Government,Vanuatu,Oceania,7,7,7,0,0,7,0,Technical Failure
1944-01-20 00:00:00,Royal Air Force - RAF,Flight,Military / Government,Germany,Europe,7,7,7,0,0,7,0,Terrorism
1944-01-26 00:00:00,Servicio Aéreo Panini,Flight,Commercial,Mexico,Central America,7,1,1,6,6,7,0,Unknown
1944-01-29 00:00:00,Royal Air Force - RAF,Flight,Military / Government,Denmark,Europe,7,7,7,0,0,7,0,Terrorism
1944-01-31 00:00:00,Royal Air Force - RAF,Flight,Military / Government,Ireland,Europe,13,13,7,0,0,7,6,Human Factor
1944-01-31 00:00:00,Royal Air Force - RAF,Flight,Operational,United Kingdom,Europe,7,7,7,0,0,7,0,Human Factor
1944-02-03 00:00:00,United States Army Air Forces - USAAF,Flight,Operational,United States of America,North America,7,7,7,0,0,7,0,Human Factor
1944-02-03 00:00:00,United States Army Air Forces - USAAF,Flight,Operational,United States of America,North America,7,7,7,0,0,7,0,Human Factor
1944-02-05 00:00:00,Royal Air Force - RAF,Flight,Military / Government,France,Europe,7,7,7,0,0,7,0,Weather
1944-02-08 00:00:00,Royal Air Force - RAF,Flight,Military / Government,France,Europe,7,7,7,0,0,7,0,Human Factor
1944-02-22 00:00:00,United States Army Air Forces - USAAF,Flight,Military / Government,Austria,Europe,11,11,7,0,0,7,4,Unknown
1944-02-29 00:00:00,Royal Air Force - RAF,Flight,Military / Government,United Kingdom,Europe,7,7,7,0,0,7,0,Unknown
1944-03-18 00:00:00,United States Army Air Forces - USAAF,Flight,Military / Government,China,Asia,7,4,4,3,3,7,0,Unknown
1944-03-20 00:00:00,Aeroflot - Russian International Airlines,Flight,Military / Government,Belarus,Europe,8,6,6,2,1,7,1,Terrorism
1944-03-21 00:00:00,Royal Air Force - RAF,Takeoff (climb),Military / Government,United Kingdom,Europe,7,7,7,0,0,7,0,Technical Failure
1944-03-24 00:00:00,Royal Air Force - RAF,Flight,Military / Government,Germany,Europe,7,7,7,0,0,7,0,Unknown
1944-03-25 00:00:00,Royal Air Force - RAF,Flight,Military / Government,Netherlands,Europe,7,7,7,0,0,7,0,Terrorism
1944-03-26 00:00:00,United States Army Air Forces - USAAF,Takeoff (climb),Operational,United States of America,North America,7,7,7,0,0,7,0,Unknown
1944-03-27 00:00:00,Royal Air Force - RAF,Flight,Military / Government,Germany,Europe,7,7,7,0,0,7,0,Unknown
1944-03-31 00:00:00,Royal Canadian Air Force - RCAF,Flight,Military / Government,Germany,Europe,7,7,7,0,0,7,0,Terrorism
1944-04-05 00:00:00,German Air Force - Deutsche Luftwaffe,Flight,Military / Government,France,Europe,7,7,7,0,0,7,0,Terrorism
1944-04-06 00:00:00,Royal New Zealand Air Force - RNZAF,Flight,Operational,Vanuatu,Oceania,7,7,7,0,0,7,0,Unknown
1944-04-22 00:00:00,Royal Air Force - RAF,Flight,Military / Government,France,Europe,7,7,7,0,0,7,0,Terrorism
1944-04-23 00:00:00,Royal Air Force - RAF,Flight,Military / Government,Netherlands,Europe,7,7,7,0,0,7,0,Unknown
1944-04-25 00:00:00,Royal Air Force - RAF,Flight,Military / Government,Belgium,Europe,7,7,7,0,0,7,0,Terrorism
1944-04-25 00:00:00,Royal Air Force - RAF,Flight,Military / Government,Netherlands,Europe,7,7,7,0,0,7,0,Unknown
1944-05-08 00:00:00,United States Army Air Forces - USAAF,Flight,Operational,China,Asia,7,5,5,2,2,7,0,Unknown
1944-05-10 00:00:00,Royal Air Force - RAF,Landing (descent or approach),Military / Government,United Kingdom,Europe,7,7,7,0,0,7,0,Unknown
1944-05-12 00:00:00,Royal Air Force - RAF,Flight,Military / Government,Belgium,Europe,7,7,7,0,0,7,0,Terrorism
1944-05-12 00:00:00,Royal Air Force - RAF,Flight,Military / Government,Netherlands,Europe,7,7,7,0,0,7,0,Unknown
1944-05-23 00:00:00,Royal Air Force - RAF,Flight,Military / Government,Netherlands,Europe,7,7,7,0,0,7,0,Unknown
1944-05-23 00:00:00,United States Army Air Forces - USAAF,Flight,Military / Government,Myanmar,Asia,7,7,7,0,0,7,0,Weather
1944-05-25 00:00:00,Royal Air Force - RAF,Flight,Military / Government,Netherlands,Europe,7,7,7,0,0,7,0,Terrorism
1944-05-25 00:00:00,United States Army Air Forces - USAAF,Flight,Operational,United States of America,North America,7,7,7,0,0,7,0,Weather
1944-05-25 00:00:00,Royal Air Force - RAF,Flight,Military / Government,Netherlands,Europe,7,7,7,0,0,7,0,Unknown
1944-05-26 00:00:00,Royal Air Force - RAF,Flight,Operational,United Kingdom,Europe,7,7,7,0,0,7,0,Unknown
1944-06-01 00:00:00,Royal Air Force - RAF,Flight,Military / Government,Myanmar,Asia,7,5,5,2,2,7,0,Unknown
1944-06-13 00:00:00,Royal Air Force - RAF,Flight,Military / Government,Netherlands,Europe,7,7,7,0,0,7,0,Terrorism
1944-06-13 00:00:00,Royal Air Force - RAF,Flight,Military / Government,Netherlands,Europe,7,7,7,0,0,7,0,Terrorism
1944-06-13 00:00:00,Royal Air Force - RAF,Flight,Military / Government,Netherlands,Europe,7,7,7,0,0,7,0,Terrorism
1944-06-13 00:00:00,Royal Air Force - RAF,Flight,Military / Government,Netherlands,Europe,7,7,7,0,0,7,0,Terrorism
1944-06-13 00:00:00,Royal Air Force - RAF,Flight,Military / Government,Netherlands,Europe,7,7,7,0,0,7,0,Terrorism
1944-06-13 00:00:00,Royal Air Force - RAF,Flight,Military / Government,Netherlands,Europe,7,7,7,0,0,7,0,Terrorism
1944-06-15 00:00:00,United States Army Air Forces - USAAF,Flight,Military / Government,India,Asia,7,7,7,0,0,7,0,Unknown
1944-06-16 00:00:00,United States Navy - USN,Flight,Military / Government,World,World,7,7,7,0,0,7,0,Unknown
1944-06-17 00:00:00,German Air Force - Deutsche Luftwaffe,Flight,Military / Government,France,Europe,7,7,7,0,0,7,0,Unknown
1944-06-23 00:00:00,German Air Force - Deutsche Luftwaffe,Flight,Military / Government,Austria,Europe,7,3,3,4,4,7,0,Unknown
1944-06-25 00:00:00,Royal Air Force - RAF,Flight,Military / Government,France,Europe,7,7,7,0,0,7,0,Weather
1944-06-28 00:00:00,Royal Air Force - RAF,Flight,Military / Government,France,Europe,7,7,7,0,0,7,0,Terrorism
1944-06-28 00:00:00,United States Army Air Forces - USAAF,Landing (descent or approach),Military / Government,India,Asia,7,7,7,0,0,7,0,Other
1944-07-20 00:00:00,Guinea Airways,Flight,Commercial,Australia,Oceania,7,1,1,6,6,7,0,Unknown
1944-07-21 00:00:00,Royal Air Force - RAF,Flight,Military / Government,Netherlands,Europe,7,7,7,0,0,7,0,Terrorism
1944-07-27 00:00:00,Royal Canadian Air Force - RCAF,Flight,Military / Government,United Kingdom,Europe,8,8,7,0,0,7,1,Human Factor
1944-08-14 00:00:00,German Air Force - Deutsche Luftwaffe,Takeoff (climb),Military / Government,Norway,Europe,9,9,7,0,0,7,2,Human Factor
1944-08-15 00:00:00,United States Army Air Forces - USAAF,Flight,Military / Government,France,Europe,8,8,7,0,0,7,1,Human Factor
1944-08-19 00:00:00,United States Army Air Forces - USAAF,Flight,Military / Government,Myanmar,Asia,7,3,3,4,4,7,0,Weather
1944-08-20 00:00:00,Royal New Zealand Air Force - RNZAF,Flight,Military / Government,World,World,7,7,7,0,0,7,0,Unknown
1944-08-20 00:00:00,Royal New Zealand Air Force - RNZAF,Flight,Military / Government,World,World,7,7,7,0,0,7,0,Unknown
1944-08-31 00:00:00,Royal Air Force - RAF,Flight,Military / Government,Netherlands,Europe,7,7,7,0,0,7,0,Terrorism
1944-09-19 00:00:00,Royal Air Force - RAF,Flight,Military / Government,Netherlands,Europe,8,8,7,0,0,7,1,Terrorism
1944-09-23 00:00:00,Royal Air Force - RAF,Flight,Military / Government,Netherlands,Europe,7,7,7,0,0,7,0,Unknown
1944-10-14 00:00:00,Royal Air Force - RAF,Flight,Military / Government,Germany,Europe,7,7,7,0,0,7,0,Unknown
1944-10-15 00:00:00,Aeroflot - Russian International Airlines,Flight,Military / Government,World,World,7,5,5,2,2,7,0,Unknown
1944-10-15 00:00:00,United States Navy - USN,Flight,Military / Government,World,World,7,7,7,0,0,7,0,Unknown
1944-10-26 00:00:00,United States Army Air Forces - USAAF,Landing (descent or approach),Operational,United States of America,North America,7,7,7,0,0,7,0,Human Factor
1944-11-06 00:00:00,Royal Air Force - RAF,Flight,Military / Government,Netherlands,Europe,7,7,7,0,0,7,0,Unknown
1944-11-16 00:00:00,United States Army Air Forces - USAAF,Flight,Operational,United States of America,North America,12,3,2,9,5,7,5,Weather
1944-11-16 00:00:00,Royal Air Force - RAF,Flight,Military / Government,Germany,Europe,7,7,7,0,0,7,0,Unknown
1944-11-16 00:00:00,Royal Air Force - RAF,Flight,Military / Government,Germany,Europe,7,7,7,0,0,7,0,Unknown
1944-11-22 00:00:00,Royal Air Force - RAF,Flight,Military / Government,Netherlands,Europe,7,7,7,0,0,7,0,Unknown
1944-11-25 00:00:00,Aeroflot - Russian International Airlines,Flight,Operational,Azerbaijan,Asia,7,7,7,0,0,7,0,Technical Failure
1944-12-12 00:00:00,United States Navy - USN,Flight,Military / Government,World,World,10,10,7,0,0,7,3,Human Factor
1944-12-17 00:00:00,Royal Air Force - RAF,Flight,Military / Government,Netherlands,Europe,7,7,7,0,0,7,0,Unknown
1944-12-21 00:00:00,Royal Air Force - RAF,Flight,Military / Government,Norway,Europe,7,7,7,0,0,7,0,Unknown
1944-12-21 00:00:00,Royal Air Force - RAF,Flight,Military / Government,Norway,Europe,7,7,7,0,0,7,0,Unknown
1944-12-30 00:00:00,United States Army Air Forces - USAAF,Flight,Military / Government,Italy,Europe,7,5,5,2,2,7,0,Weather
1945-01-03 00:00:00,Royal Air Force - RAF,Flight,Operational,United Kingdom,Europe,7,7,7,0,0,7,0,Human Factor
1945-01-06 00:00:00,Royal New Zealand Air Force - RNZAF,Takeoff (climb),Military / Government,Papua New Guinea,Oceania,7,7,7,0,0,7,0,Unknown
1945-01-10 00:00:00,Deutsche Lufthansa,Flight,Commercial,Bosnia and Herzegovina,Europe,7,3,3,4,4,7,0,Unknown
1945-02-06 00:00:00,Misrair,Flight,Commercial,Egypt,Africa,7,1,1,6,6,7,0,Unknown
1945-02-11 00:00:00,United States Army Air Forces - USAAF,Landing (descent or approach),Operational,United Kingdom,Europe,7,5,5,2,2,7,0,Human Factor
1945-02-22 00:00:00,United States Army Air Forces - USAAF,Flight,Military / Government,Italy,Europe,7,5,5,2,2,7,0,Unknown
1945-03-08 00:00:00,United States Army Air Forces - USAAF,Takeoff (climb),Military / Government,Italy,Europe,10,10,7,0,0,7,3,Other
1945-03-09 00:00:00,United States Army Air Forces - USAAF,Flight,Military / Government,World,World,7,7,7,0,0,7,0,Unknown
1945-03-14 00:00:00,United States Navy - USN,Flight,Military / Government,United States of America,North America,23,4,0,19,7,7,16,Weather
1945-04-19 00:00:00,Royal Air Force - RAF,Landing (descent or approach),Military / Government,France,Europe,7,4,4,3,3,7,0,Weather
1945-04-25 00:00:00,United States Army Air Forces - USAAF,Flight,Military / Government,Myanmar,Asia,7,7,7,0,0,7,0,Unknown
1945-05-04 00:00:00,United States Navy - USN,Takeoff (climb),Military / Government,United States of America,North America,9,9,7,0,0,7,2,Unknown
1945-05-10 00:00:00,Royal Australian Air Force - RAAF,Flight,Military / Government,Papua New Guinea,Oceania,7,3,3,4,4,7,0,Weather
1945-06-05 00:00:00,United States Army Air Forces - USAAF,Flight,Military / Government,Bhutan,Asia,7,5,5,2,2,7,0,Unknown
1945-06-15 00:00:00,United States Navy - USN,Landing (descent or approach),Operational,United States of America,North America,7,7,7,0,0,7,0,Human Factor
1945-06-22 00:00:00,United States Army Air Forces - USAAF,Flight,Military / Government,Indonesia,Asia,7,4,4,3,3,7,0,Unknown
1945-07-03 00:00:00,Royal Air Force - RAF,Flight,Operational,United Kingdom,Europe,7,7,7,0,0,7,0,Unknown
1945-07-03 00:00:00,Brazilian Air Force - Força Aérea Brasileira,Flight,Military / Government,United States of America,North America,7,7,7,0,0,7,0,Unknown
1945-07-19 00:00:00,Royal Air Force - RAF,Flight,Military / Government,France,Europe,7,7,7,0,0,7,0,Human Factor
1945-07-24 00:00:00,United States Army Air Forces - USAAF,Flight,Operational,United Kingdom,Europe,7,5,5,2,2,7,0,Human Factor
1945-08-01 00:00:00,United States Army Air Forces - USAAF,Flight,Military / Government,United States of America,North America,7,7,7,0,0,7,0,Technical Failure
1945-08-23 00:00:00,Air France,Takeoff (climb),Commercial,Algeria,Africa,7,3,3,4,4,7,0,Unknown
1945-09-15 00:00:00,Royal Australian Air Force - RAAF,Flight,Military / Government,Indonesia,Asia,8,8,7,0,0,7,1,Human Factor
1945-09-30 00:00:00,United States Navy - USN,Landing (descent or approach),Military / Government,Guam Island,Asia,7,7,7,0,0,7,0,Unknown
1945-10-13 00:00:00,United States Army Air Forces - USAAF,Flight,Military / Government,United Kingdom,Europe,7,3,3,4,4,7,0,Unknown
1945-12-06 00:00:00,French Air Force - Armée de l'Air,Flight,Military / Government,France,Europe,7,7,7,0,0,7,0,Weather
1945-12-18 00:00:00,United States Coast Guard - USCG,Flight,Operational,United States of America,North America,7,7,7,0,0,7,0,Technical Failure
1946-01-10 00:00:00,United States Army Air Forces - USAAF,Flight,Military / Government,Brazil,South America,7,7,7,0,0,7,0,Unknown
1946-01-19 00:00:00,Royal Canadian Air Force - RCAF,Flight,Military / Government,Canada,North America,7,7,7,0,0,7,0,Unknown
1946-03-18 00:00:00,Royal Air Force - RAF,Takeoff (climb),Operational,United Kingdom,Europe,7,7,7,0,0,7,0,Human Factor
1946-03-29 00:00:00,Royal Air Force - RAF,Flight,Military / Government,Myanmar,Asia,7,7,7,0,0,7,0,Unknown
1946-04-19 00:00:00,Aeronaves Oaxaca,Flight,Commercial,Mexico,Central America,7,2,2,5,5,7,0,Unknown
1946-05-10 00:00:00,Royal Air Force - RAF,Takeoff (climb),Operational,United Kingdom,Europe,7,7,7,0,0,7,0,Technical Failure
1946-05-10 00:00:00,Royal Air Force - RAF,Takeoff (climb),Operational,United Kingdom,Europe,7,7,7,0,0,7,0,Technical Failure
1946-08-31 00:00:00,Queen Charlotte Airlines,Landing (descent or approach),Commercial,Canada,North America,7,3,3,4,4,7,0,Human Factor
1946-09-07 00:00:00,Expreso Aéreo Interamericano,Flight,Commercial,Cuba,Central America,7,3,3,4,4,7,0,Technical Failure
1946-09-16 00:00:00,United States Navy - USN,Flight,Military / Government,United States of America,North America,7,7,7,0,0,7,0,Unknown
1946-09-27 00:00:00,Railway Air Services,Landing (descent or approach),Commercial,United Kingdom,Europe,7,2,2,5,5,7,0,Human Factor
1946-10-17 00:00:00,TACA International Airlines - Transportes Aéreos Centro Americanos,Flight,Commercial,Honduras,Central America,7,2,2,5,5,7,0,Unknown
1946-11-07 00:00:00,Royal Air Force - RAF,Flight,Military / Government,Germany,Europe,7,2,2,5,5,7,0,Human Factor
1946-11-09 00:00:00,Aeroflot - Russian International Airlines,Landing (descent or approach),Commercial,Russia,Asia,7,4,4,3,3,7,0,Human Factor
1946-12-07 00:00:00,MVD - Ministerstvo Vnutrennikh Del,Takeoff (climb),Humanitarian,Russia,Asia,7,4,4,3,3,7,0,Technical Failure
1946-12-17 00:00:00,Winged Cargo,Flight,Commercial,Costa Rica,Central America,7,2,2,5,5,7,0,Unknown
1947-01-11 00:00:00,Far East Air Transport,Flight,Commercial,Philippines,Asia,42,5,0,37,7,7,35,Technical Failure
1947-02-13 00:00:00,United States Army Air Forces - USAAF,Takeoff (climb),Military / Government,United States of America,North America,7,2,2,5,5,7,0,Unknown
1947-03-20 00:00:00,Royal Air Force - RAF,Flight,Operational,World,World,9,9,7,0,0,7,2,Human Factor
1947-07-05 00:00:00,Royal Air Force - RAF,Flight,Operational,Ireland,Europe,12,12,7,0,0,7,5,Human Factor
1947-07-29 00:00:00,Indonesian Government,Landing (descent or approach),Humanitarian,Indonesia,Asia,7,4,4,3,3,7,0,Terrorism
1947-08-12 00:00:00,Brazilian Air Force - Força Aérea Brasileira,Flight,Operational,Brazil,South America,7,7,7,0,0,7,0,Human Factor
1947-11-11 00:00:00,Royal Air Force - RAF,Flight,Operational,United Kingdom,Europe,8,8,7,0,0,7,1,Human Factor
1947-12-18 00:00:00,Aeroflot - Russian International Airlines,Landing (descent or approach),Commercial,Russia,Asia,25,5,4,20,3,7,18,Technical Failure
1948-01-31 00:00:00,Royal Air Force - RAF,Landing (descent or approach),Military / Government,France,Europe,16,4,0,12,7,7,9,Technical Failure
1948-02-20 00:00:00,Aerea Teseo,Landing (descent or approach),Commercial,Italy,Europe,10,3,3,7,4,7,3,Human Factor
1948-07-04 00:00:00,Royal Air Force - RAF,Landing (descent or approach),Military / Government,United Kingdom,Europe,7,3,3,4,4,7,0,Human Factor
1948-09-03 00:00:00,Royal Air Force - RAF,Flight,Military / Government,Italy,Europe,7,7,7,0,0,7,0,Human Factor
1948-09-16 00:00:00,Polyarnaya Aviatsiya,Flight,Military / Government,Russia,Asia,7,7,7,0,0,7,0,Weather
1948-09-21 00:00:00,Brazilian Air Force - Força Aérea Brasileira,Flight,Operational,Brazil,South America,7,7,7,0,0,7,0,Unknown
1948-09-23 00:00:00,French Navy,Flight,Military / Government,Algeria,Africa,7,2,2,5,5,7,0,Unknown
1948-09-28 00:00:00,Royal Australian Air Force - RAAF,Landing (descent or approach),Operational,Australia,Oceania,9,9,7,0,0,7,2,Technical Failure
1948-11-22 00:00:00,Flight Refuelling,Landing (descent or approach),Operational,United Kingdom,Europe,8,4,3,4,4,7,1,Human Factor
1948-12-06 00:00:00,Avio Linee Italiane - ALI,Takeoff (climb),Commercial,Italy,Europe,7,6,6,1,1,7,0,Technical Failure
1948-12-21 00:00:00,Royal Air Force - RAF,Flight,Operational,United Kingdom,Europe,7,7,7,0,0,7,0,Human Factor
1949-02-12 00:00:00,United States Air Force - USAF,Landing (descent or approach),Military / Government,United States of America,North America,11,11,7,0,0,7,4,Unknown
1949-04-06 00:00:00,Hellenic Air Force - Elleniki Polemiki Aeroporia,Flight,Military / Government,Greece,Europe,7,7,7,0,0,7,0,Terrorism
1949-04-21 00:00:00,Royal Canadian Air Force - RCAF,Flight,Military / Government,Canada,North America,7,3,3,4,4,7,0,Unknown
1949-05-06 00:00:00,Bristol Aeroplane Company,Flight,Specialised Services,United Kingdom,Europe,7,7,7,0,0,7,0,Technical Failure
1949-05-26 00:00:00,Czech Air Force - Ceské Vojenské Letectvo,Flight,Military / Government,Czech Republic,Europe,7,7,7,0,0,7,0,Weather
1949-06-13 00:00:00,United States Navy - USN,Landing (descent or approach),Military / Government,United States of America,North America,7,7,7,0,0,7,0,Unknown
1949-07-09 00:00:00,Royal Air Force - RAF,Flight,Other,World,World,7,4,4,3,3,7,0,Unknown
1949-07-15 00:00:00,Royal Air Force - RAF,Takeoff (climb),Military / Government,United Kingdom,Europe,7,7,7,0,0,7,0,Human Factor
1949-08-14 00:00:00,Turkish Air Force - Türk Hava Kuvvetleri,Takeoff (climb),Military / Government,Turkey,Asia,7,3,3,4,4,7,0,Technical Failure
1949-09-02 00:00:00,United States Air Force - USAF,Flight,Operational,United States of America,North America,7,7,7,0,0,7,0,Unknown
1949-09-26 00:00:00,Royal Air Force - RAF,Flight,Operational,United Kingdom,Europe,7,7,7,0,0,7,0,Human Factor
1949-09-26 00:00:00,Royal Air Force - RAF,Flight,Operational,United Kingdom,Europe,7,7,7,0,0,7,0,Human Factor
1949-10-17 00:00:00,United States Air Force - USAF,Flight,Military / Government,Panama,Central America,7,7,7,0,0,7,0,Unknown
1949-11-03 00:00:00,Royal Air Force - RAF,Flight,Operational,United Kingdom,Europe,7,7,7,0,0,7,0,Human Factor
1949-12-15 00:00:00,United States Air Force - USAF,Landing (descent or approach),Military / Government,United States of America,North America,12,12,7,0,0,7,5,Unknown
1950-02-02 00:00:00,KLM Royal Dutch Airlines - Koninklijke Luchtvaart Maatschappij,Flight,Operational,World,World,7,7,7,0,0,7,0,Technical Failure
1950-06-12 00:00:00,French Air Force - Armée de l'Air,Flight,Military / Government,Madagascar,Africa,16,3,0,13,7,7,9,Unknown
1950-06-30 00:00:00,United States Air Force - USAF,Landing (descent or approach),Military / Government,United States of America,North America,12,12,7,0,0,7,5,Technical Failure
1950-07-13 00:00:00,United States Air Force - USAF,Flight,Military / Government,Japan,Asia,12,12,7,0,0,7,5,Terrorism
1950-09-01 00:00:00,United States Air Force - USAF,Flight,Operational,United States of America,North America,9,9,7,0,0,7,2,Unknown
1950-09-13 00:00:00,Brazilian Air Force - Força Aérea Brasileira,Flight,Military / Government,Brazil,South America,7,2,2,5,5,7,0,Unknown
1950-09-19 00:00:00,United States Navy - USN,Flight,Operational,United States of America,North America,7,7,7,0,0,7,0,Technical Failure
1950-11-16 00:00:00,United States Air Force - USAF,Flight,Operational,United States of America,North America,13,13,7,0,0,7,6,Human Factor
1950-12-05 00:00:00,Royal Air Force - RAF,Flight,Military / Government,Spain,Europe,7,7,7,0,0,7,0,Human Factor
1950-12-12 00:00:00,Royal New Zealand Air Force - RNZAF,Takeoff (climb),Military / Government,Samoa Islands (Western Samoa),Oceania,8,8,7,0,0,7,1,Unknown
1951-01-11 00:00:00,United States Navy - USN,Landing (descent or approach),Operational,Japan,Asia,7,7,7,0,0,7,0,Unknown
1951-01-14 00:00:00,National Airlines,Landing (descent or approach),Commercial,United States of America,North America,28,3,1,25,6,7,21,Human Factor
1951-03-07 00:00:00,United States Navy - USN,Landing (descent or approach),Military / Government,Italy,Europe,12,12,7,0,0,7,5,Technical Failure
1951-05-18 00:00:00,VASP - Viação Aérea de São Paulo,Flight,Commercial,Brazil,South America,7,4,4,3,3,7,0,Human Factor
1951-05-23 00:00:00,United States Air Force - USAF,Flight,Operational,United States of America,North America,12,7,3,5,4,7,5,Technical Failure
1951-06-03 00:00:00,United States Air Force - USAF,Flight,Military / Government,South Korea,Asia,7,7,7,0,0,7,0,Terrorism
1951-06-14 00:00:00,United States Navy - USN,Flight,Operational,United States of America,North America,9,9,7,0,0,7,2,Technical Failure
1951-06-27 00:00:00,French Navy,Landing (descent or approach),Military / Government,Morocco,Africa,28,7,4,21,3,7,21,Human Factor
1951-07-14 00:00:00,Royal Air Force - RAF,Landing (descent or approach),Operational,United Kingdom,Europe,7,7,7,0,0,7,0,Human Factor
1951-07-16 00:00:00,Qantas Airways - Queensland and Northern Territory Aerial Services,Landing (descent or approach),Commercial,Papua New Guinea,Oceania,7,1,1,6,6,7,0,Human Factor
1951-07-29 00:00:00,Loide Aéreo Nacional,Takeoff (climb),Operational,Bolivia,South America,7,3,3,4,4,7,0,Unknown
1951-08-04 00:00:00,Queen Charlotte Airlines,Flight,Commercial,Canada,North America,7,1,1,6,6,7,0,Unknown
1951-09-04 00:00:00,United States Air Force - USAF,Takeoff (climb),Operational,United States of America,North America,7,7,7,0,0,7,0,Unknown
1951-09-04 00:00:00,United States Navy - USN,Flight,Operational,United States of America,North America,7,7,7,0,0,7,0,Technical Failure
1951-09-19 00:00:00,Buchan's Mining Company,Landing (descent or approach),Commercial,Canada,North America,7,1,1,6,6,7,0,Unknown
1951-09-29 00:00:00,United States Air Force - USAF,Landing (descent or approach),Military / Government,South Korea,Asia,7,7,7,0,0,7,0,Human Factor
1951-10-15 00:00:00,Airlines WA,Landing (descent or approach),Commercial,Australia,Oceania,7,2,2,5,5,7,0,Technical Failure
1951-10-23 00:00:00,United States Air Force - USAF,Flight,Military / Government,North Korea,Asia,13,13,7,0,0,7,6,Terrorism
1952-02-08 00:00:00,Royal Air Force - RAF,Flight,Military / Government,France,Europe,7,7,7,0,0,7,0,Human Factor
1952-03-12 00:00:00,United States Air Force - USAF,Flight,Operational,United States of America,North America,7,7,7,0,0,7,0,Human Factor
1952-05-01 00:00:00,United States Air Force - USAF,Flight,Operational,United States of America,North America,14,14,7,0,0,7,7,Unknown
1952-05-28 00:00:00,United States Air Force - USAF,Landing (descent or approach),Operational,United States of America,North America,7,7,7,0,0,7,0,Technical Failure
1952-06-25 00:00:00,United States Air Force - USAF,Flight,Military / Government,United States of America,North America,7,7,7,0,0,7,0,Unknown
1952-07-06 00:00:00,Spanish Air Force - Ejército del Aire,Flight,Military / Government,Spain,Europe,12,12,7,0,0,7,5,Unknown
1952-07-06 00:00:00,Nord Aviation,Flight,Operational,France,Europe,7,6,6,1,1,7,0,Human Factor
1952-07-21 00:00:00,Manitoba Government Air Service,Flight,Military / Government,Canada,North America,7,1,1,6,6,7,0,Unknown
1952-08-02 00:00:00,Royal Air Force - RAF,Flight,Military / Government,Malaysia,Asia,7,7,7,0,0,7,0,Technical Failure
1952-08-25 00:00:00,Airwork - UK,Flight,Commercial,Italy,Europe,57,6,1,51,6,7,50,Technical Failure
1952-09-28 00:00:00,Aeroflot - Russian International Airlines,Flight,Operational,Russia,Asia,7,6,6,1,1,7,0,Weather
1952-10-05 00:00:00,Aeroflot - Russian International Airlines,Takeoff (climb),Commercial,Russia,Asia,7,4,4,3,3,7,0,Human Factor
1952-10-26 00:00:00,Indian Air Force - Bharatiya Vayu Sena,Flight,Operational,India,Asia,7,7,7,0,0,7,0,Unknown
1952-12-30 00:00:00,United States Air Force - USAF,Flight,Military / Government,North Korea,Asia,12,12,7,0,0,7,5,Terrorism
1953-01-07 00:00:00,Flying Tiger Line,Landing (descent or approach),Operational,United States of America,North America,7,4,4,3,3,7,0,Human Factor
1953-01-15 00:00:00,Royal Air Force - RAF,Flight,Operational,Italy,Europe,7,7,7,0,0,7,0,Weather
1953-02-17 00:00:00,GLAM - Groupe de Liaisons Aériennes Ministérielles,Takeoff (climb),Military / Government,Germany,Europe,7,7,7,0,0,7,0,Technical Failure
1953-03-12 00:00:00,Royal Air Force - RAF,Flight,Military / Government,Germany,Europe,7,7,7,0,0,7,0,Terrorism
1953-04-14 00:00:00,Miami Airlines,Flight,Commercial,United States of America,North America,25,3,2,22,5,7,18,Human Factor
1953-05-27 00:00:00,Aeroflot - Russian International Airlines,Flight,Specialised Services,Russia,Asia,7,7,7,0,0,7,0,Human Factor
1953-06-15 00:00:00,LAN Chile - Linea Aérea Nacional de Chile,Takeoff (climb),Commercial,Chile,South America,7,2,2,5,5,7,0,Technical Failure
1953-07-06 00:00:00,Aeroflot - Russian International Airlines,Flight,Commercial,Tajikistan,Asia,7,4,4,3,3,7,0,Weather
1953-07-13 00:00:00,United States Navy - USN,Flight,Operational,United States of America,North America,7,7,7,0,0,7,0,Technical Failure
1953-10-17 00:00:00,Société Indochinoise de Liaisons Aériennes - SILA,Landing (descent or approach),Commercial,Vietnam,Asia,7,2,2,5,5,7,0,Unknown
1953-11-11 00:00:00,Royal Air Force - RAF,Takeoff (climb),Specialised Services,Singapore,Asia,7,3,3,4,4,7,0,Weather
1953-11-12 00:00:00,Argentinian Air Force - Fuerza Aérea Argentina,Flight,Military / Government,Argentina,South America,7,7,7,0,0,7,0,Human Factor
1954-01-06 00:00:00,United States Navy - USN,Landing (descent or approach),Military / Government,Panama,Central America,14,14,7,0,0,7,7,Unknown
1954-01-26 00:00:00,Royal Air Force - RAF,Flight,Military / Government,United Kingdom,Europe,7,7,7,0,0,7,0,Weather
1954-03-03 00:00:00,Royal Air Force - RAF,Takeoff (climb),Military / Government,United Kingdom,Europe,11,7,4,4,3,7,4,Unknown
1954-03-29 00:00:00,United States Air Force - USAF,Takeoff (climb),Operational,United States of America,North America,10,10,7,0,0,7,3,Unknown
1954-04-20 00:00:00,United States Air Force - USAF,Landing (descent or approach),Military / Government,United States of America,North America,7,7,7,0,0,7,0,Human Factor
1954-05-08 00:00:00,French Navy,Flight,Military / Government,Vietnam,Asia,9,9,7,0,0,7,2,Terrorism
1954-06-21 00:00:00,Royal Air Force - RAF,Landing (descent or approach),Military / Government,Kenya,Africa,7,7,7,0,0,7,0,Human Factor
1954-07-19 00:00:00,Italian Air Force - Aeronautica Militare Italiana,Flight,Operational,World,World,7,7,7,0,0,7,0,Technical Failure
1954-08-25 00:00:00,United States Air Force - USAF,Flight,Military / Government,United States of America,North America,8,8,7,0,0,7,1,Unknown
1954-10-20 00:00:00,Civil Air Transport,Flight,Military / Government,Thailand,Asia,7,3,3,4,4,7,0,Human Factor
1954-11-02 00:00:00,French Navy,Flight,Operational,Tunisia,Africa,8,8,7,0,0,7,1,Unknown
1954-12-17 00:00:00,Royal Air Force - RAF,Flight,Operational,World,World,7,7,7,0,0,7,0,Unknown
1955-05-13 00:00:00,Myanmar Air Force - Tatmadaw Lei,Flight,Military / Government,Thailand,Asia,7,7,7,0,0,7,0,Unknown
1955-05-30 00:00:00,United States Air Force - USAF,Flight,Military / Government,United States of America,North America,7,7,7,0,0,7,0,Unknown
1955-08-19 00:00:00,United States Air Force - USAF,Flight,Military / Government,United States of America,North America,7,7,7,0,0,7,0,Human Factor
1955-09-15 00:00:00,Aeroflot - Russian International Airlines,Flight,Commercial,Russia,Asia,7,4,4,3,3,7,0,Weather
1955-09-24 00:00:00,United States Air Force - USAF,Flight,Military / Government,United States of America,North America,7,7,7,0,0,7,0,Unknown
1955-09-28 00:00:00,Aeroflot - Russian International Airlines,Flight,Commercial,Russia,Asia,19,6,5,13,2,7,12,Technical Failure
1955-09-30 00:00:00,Uruguayan Air Force - Fuerza Aérea Uruguaya,Flight,Military / Government,Uruguay,South America,7,7,7,0,0,7,0,Unknown
1955-10-11 00:00:00,JAT Yugoslav Airlines - Jugoslovenski Aerotransport,Landing (descent or approach),Commercial,Austria,Europe,29,4,1,25,6,7,22,Human Factor
1955-12-03 00:00:00,Royal Canadian Air Force - RCAF,Landing (descent or approach),Military / Government,France,Europe,14,4,0,10,7,7,7,Unknown
1955-12-07 00:00:00,United States Navy - USN,Flight,Operational,United States of America,North America,10,10,7,0,0,7,3,Unknown
1955-12-09 00:00:00,Aeroflot - Russian International Airlines,Flight,Operational,Russia,Asia,9,5,5,4,2,7,2,Technical Failure
1956-02-02 00:00:00,Spanish Air Force - Ejército del Aire,Landing (descent or approach),Military / Government,Spain,Europe,7,7,7,0,0,7,0,Unknown
1956-03-02 00:00:00,Royal Air Force - RAF,Flight,Military / Government,Malaysia,Asia,7,7,7,0,0,7,0,Human Factor
1956-10-30 00:00:00,Swedish Air Force - Flygvapnet,Takeoff (climb),Operational,Sweden,Europe,11,2,2,9,5,7,4,Technical Failure
1956-11-05 00:00:00,Britavia,Landing (descent or approach),Commercial,United Kingdom,Europe,80,6,3,74,4,7,73,Human Factor
1956-11-23 00:00:00,Royal Air Force - RAF,Flight,Military / Government,Malaysia,Asia,7,3,3,4,4,7,0,Human Factor
1957-01-22 00:00:00,United States Air Force - USAF,Flight,Operational,United States of America,North America,7,7,7,0,0,7,0,Human Factor
1957-01-28 00:00:00,Colombian Air Force - Fuerza Aérea Colombiana,Landing (descent or approach),Military / Government,Colombia,South America,7,1,1,6,6,7,0,Unknown
1957-08-30 00:00:00,Aeroflot - Russian International Airlines,Takeoff (climb),Operational,Ukraine,Europe,7,5,5,2,2,7,0,Human Factor
1957-10-23 00:00:00,British European Airways - BEA,Landing (descent or approach),Operational,United Kingdom,Europe,7,5,5,2,2,7,0,Unknown
1958-01-19 00:00:00,United States Air Force - USAF,Flight,Military / Government,World,World,7,7,7,0,0,7,0,Unknown
1958-09-16 00:00:00,United States Air Force - USAF,Flight,Operational,United States of America,North America,8,8,7,0,0,7,1,Technical Failure
1958-10-16 00:00:00,United States Air Force - USAF,Landing (descent or approach),Military / Government,Antarctica,Antarctica,13,3,2,10,5,7,6,Human Factor
1958-12-15 00:00:00,Johnson %26 Johnson,Flight,Business,United States of America,North America,7,2,2,5,5,7,0,Weather
1959-01-28 00:00:00,Chilean Air Force - Fuerza Aérea de Chile,Flight,Military / Government,Chile,South America,7,4,4,3,3,7,0,Unknown
1959-01-29 00:00:00,Pakistan Air Force - Pakistan Fiza'ya,Takeoff (climb),Military / Government,Pakistan,Asia,7,3,3,4,4,7,0,Unknown
1959-07-22 00:00:00,United States Air Force - USAF,Flight,Operational,United States of America,North America,7,7,7,0,0,7,0,Technical Failure
1959-08-10 00:00:00,Polyarnaya Aviatsiya,Flight,Military / Government,Russia,Asia,10,5,2,5,5,7,3,Human Factor
1959-12-05 00:00:00,Comisión Federal de Electricidad,Landing (descent or approach),Military / Government,Mexico,Central America,8,3,3,5,4,7,1,Technical Failure
1960-02-01 00:00:00,United States Air Force - USAF,Landing (descent or approach),Operational,Puerto Rico,Central America,7,7,7,0,0,7,0,Human Factor
1960-03-30 00:00:00,Czech Air Force - Ceské Vojenské Letectvo,Takeoff (climb),Military / Government,Czech Republic,Europe,7,7,7,0,0,7,0,Human Factor
1960-10-11 00:00:00,Royal Air Force - RAF,Flight,Military / Government,Yemen,Asia,7,7,7,0,0,7,0,Human Factor
1960-11-26 00:00:00,Aerovias Condor,Landing (descent or approach),Operational,Bolivia,South America,7,3,3,4,4,7,0,Unknown
1961-03-23 00:00:00,United States Air Force - USAF,Flight,Military / Government,Laos,Asia,8,8,7,0,0,7,1,Terrorism
1961-10-18 00:00:00,Golden Gate Airways,Takeoff (climb),Commercial,United States of America,North America,7,2,2,5,5,7,0,Unknown
1961-11-01 00:00:00,Mexican Air Force - Fuerza Aérea Mexicana,Flight,Humanitarian,Belize,Central America,7,3,3,4,4,7,0,Unknown
1961-11-23 00:00:00,United States Air Force - USAF,Takeoff (climb),Military / Government,Canada,North America,10,10,7,0,0,7,3,Technical Failure
1961-12-19 00:00:00,United States Air Force - USAF,Takeoff (climb),Military / Government,United States of America,North America,7,7,7,0,0,7,0,Technical Failure
1962-02-04 00:00:00,United States Air Force - USAF,Takeoff (climb),Military / Government,United States of America,North America,7,4,4,3,3,7,0,Unknown
1962-05-24 00:00:00,United States Air Force - USAF,Flight,Operational,Japan,Asia,7,7,7,0,0,7,0,Unknown
1962-10-23 00:00:00,United States Air Force - USAF,Landing (descent or approach),Military / Government,Cuba,Central America,7,7,7,0,0,7,0,Human Factor
1962-12-23 00:00:00,Soviet Air Force - Voyenno-vozdushnye sily CCCP,Landing (descent or approach),Military / Government,Russia,Asia,8,8,7,0,0,7,1,Human Factor
1963-01-10 00:00:00,United States Navy - USN,Landing (descent or approach),Military / Government,United States of America,North America,12,12,7,0,0,7,5,Human Factor
1963-01-24 00:00:00,United States Air Force - USAF,Flight,Operational,United States of America,North America,9,9,7,0,0,7,2,Technical Failure
1963-02-08 00:00:00,Aeroflot - Russian International Airlines,Landing (descent or approach),Operational,Russia,Asia,7,7,7,0,0,7,0,Weather
1963-02-27 00:00:00,United States Air Force - USAF,Takeoff (climb),Operational,United States of America,North America,7,7,7,0,0,7,0,Technical Failure
1963-04-21 00:00:00,Spanish Air Force - Ejército del Aire,Flight,Military / Government,Spain,Europe,7,7,7,0,0,7,0,Unknown
1963-07-02 00:00:00,Mohawk Airlines,Takeoff (climb),Commercial,United States of America,North America,43,5,2,38,5,7,36,Weather
1963-09-20 00:00:00,Garuda Indonesian Airways,Flight,Commercial,Indonesia,Asia,7,2,2,5,5,7,0,Unknown
1963-10-20 00:00:00,Aeroflot - Russian International Airlines,Flight,Military / Government,Russia,Asia,7,5,5,2,2,7,0,Human Factor
1963-10-22 00:00:00,British Aircraft Corporation,Flight,Specialised Services,United Kingdom,Europe,7,7,7,0,0,7,0,Human Factor
1964-04-18 00:00:00,United States Air Force - USAF,Flight,Operational,United States of America,North America,9,9,7,0,0,7,2,Unknown
1964-06-29 00:00:00,United States Air Force - USAF,Flight,Specialised Services,Bermuda,North America,7,7,7,0,0,7,0,Human Factor
1964-08-13 00:00:00,United States Air Force - USAF,Flight,Operational,Japan,Asia,11,11,7,0,0,7,4,Technical Failure
1964-08-18 00:00:00,Aerotaxi Servicios Aéreos,Takeoff (climb),Commercial,Colombia,South America,9,1,1,8,6,7,2,Unknown
1964-09-16 00:00:00,Antonov Industries,Takeoff (climb),Specialised Services,Ukraine,Europe,7,7,7,0,0,7,0,Human Factor
1964-11-07 00:00:00,United States Air Force - USAF,Takeoff (climb),Military / Government,Canada,North America,7,7,7,0,0,7,0,Human Factor
1964-11-10 00:00:00,United States Air Force - USAF,Flight,Operational,United States of America,North America,7,7,7,0,0,7,0,Unknown
1964-11-28 00:00:00,Aeroflot - Russian International Airlines,Flight,Commercial,Georgia,Asia,15,4,3,11,4,7,8,Human Factor
1965-01-16 00:00:00,United States Air Force - USAF,Takeoff (climb),Operational,United States of America,North America,7,7,7,0,0,7,0,Technical Failure
1965-03-25 00:00:00,United States Air Force - USAF,Flight,Operational,France,Europe,7,7,7,0,0,7,0,Human Factor
1965-06-11 00:00:00,United States Air Force - USAF,Flight,Military / Government,Vietnam,Asia,7,7,7,0,0,7,0,Human Factor
1965-08-04 00:00:00,Rutas Internacionales Peruanas,Takeoff (climb),Operational,Panama,Central America,7,3,3,4,4,7,0,Human Factor
1965-09-19 00:00:00,Gujarat State Government,Flight,Military / Government,India,Asia,7,3,3,4,4,7,0,Terrorism
1965-12-07 00:00:00,Aerolineas Carreras Transportes Aéreos - ACTA,Takeoff (climb),Operational,Panama,Central America,7,3,3,4,4,7,0,Unknown
1965-12-08 00:00:00,Royal Air Force - RAF,Landing (descent or approach),Operational,United Kingdom,Europe,7,7,7,0,0,7,0,Human Factor
1966-03-13 00:00:00,United States Air Force - USAF,Flight,Military / Government,Vietnam,Asia,7,7,7,0,0,7,0,Terrorism
1966-03-20 00:00:00,United States Air Force - USAF,Landing (descent or approach),Military / Government,Norway,Europe,7,7,7,0,0,7,0,Human Factor
1966-04-03 00:00:00,Mexican Government,Flight,Military / Government,Mexico,Central America,7,2,2,5,5,7,0,Unknown
1966-04-13 00:00:00,Iraqi Air Force - Al Quwwat al Jawwiya al Iraqiya,Landing (descent or approach),Military / Government,Iraq,Asia,7,2,2,5,5,7,0,Weather
1966-07-25 00:00:00,United States Marine Corps,Takeoff (climb),Military / Government,Vietnam,Asia,31,8,7,23,0,7,24,Unknown
1966-10-18 00:00:00,United States Air Force - USAF,Flight,Military / Government,World,World,7,7,7,0,0,7,0,Weather
1966-11-05 00:00:00,Air Mali,Flight,Operational,France,Europe,7,5,5,2,2,7,0,Human Factor
1967-01-09 00:00:00,United States Air Force - USAF,Flight,Military / Government,Vietnam,Asia,7,7,7,0,0,7,0,Terrorism
1967-01-26 00:00:00,Brazilian Air Force - Força Aérea Brasileira,Flight,Military / Government,Brazil,South America,7,2,2,5,5,7,0,Unknown
1967-02-18 00:00:00,Brazilian Air Force - Força Aérea Brasileira,Flight,Military / Government,Brazil,South America,7,2,2,5,5,7,0,Unknown
1967-03-09 00:00:00,United States Air Force - USAF,Flight,Military / Government,Vietnam,Asia,7,7,7,0,0,7,0,Terrorism
1967-03-29 00:00:00,United States Air Force - USAF,Flight,Military / Government,Vietnam,Asia,7,7,7,0,0,7,0,Terrorism
1967-04-04 00:00:00,Continental Air Services,Takeoff (climb),Commercial,Laos,Asia,7,2,2,5,5,7,0,Unknown
1967-04-26 00:00:00,United States Air Force - USAF,Flight,Military / Government,Vietnam,Asia,7,7,7,0,0,7,0,Unknown
1967-05-17 00:00:00,Petróleos Mexicanos,Flight,Business,Mexico,Central America,7,3,3,4,4,7,0,Unknown
1967-06-22 00:00:00,Airlift International,Landing (descent or approach),Operational,Vietnam,Asia,7,3,3,4,4,7,0,Human Factor
1967-09-27 00:00:00,Ling-Temco-Vought,Landing (descent or approach),Business,United States of America,North America,7,1,1,6,6,7,0,Technical Failure
1967-10-02 00:00:00,United States Air Force - USAF,Flight,Military / Government,Vietnam,Asia,7,7,7,0,0,7,0,Terrorism
1967-10-10 00:00:00,Hidromontaža Maribor,Flight,Commercial,Serbia,Europe,7,1,1,6,6,7,0,Unknown
1967-11-22 00:00:00,United States Army,Takeoff (climb),Military / Government,Vietnam,Asia,7,2,2,5,5,7,0,Unknown
1967-12-10 00:00:00,Private American,Landing (descent or approach),Business,United States of America,North America,8,1,1,7,6,7,1,Technical Failure
1968-03-19 00:00:00,D. L. Peterson Trust,Flight,Business,United States of America,North America,7,2,2,5,5,7,0,Human Factor
1968-04-28 00:00:00,Private American,Landing (descent or approach),Business,United States of America,North America,7,1,1,6,6,7,0,Unknown
1968-05-05 00:00:00,United States Air Force - USAF,Flight,Military / Government,Vietnam,Asia,7,7,7,0,0,7,0,Terrorism
1968-07-13 00:00:00,SABENA - Société Anonyme Belge d'Exploitation de la Navigation Aérienne,Landing (descent or approach),Operational,Nigeria,Africa,7,5,5,2,2,7,0,Human Factor
1968-10-18 00:00:00,Christopher Cordaro,Landing (descent or approach),Business,United States of America,North America,7,1,1,6,6,7,0,Technical Failure
1968-11-21 00:00:00,Barrow Air Services,Takeoff (climb),Commercial,United States of America,North America,8,1,1,7,6,7,1,Technical Failure
1969-01-12 00:00:00,Aero Laguna,Flight,Specialised Services,Mexico,Central America,7,2,2,5,5,7,0,Human Factor
1969-02-11 00:00:00,United States Navy - USN,Landing (descent or approach),Operational,United States of America,North America,7,7,7,0,0,7,0,Human Factor
1969-03-15 00:00:00,Royal Moroccan Air Force - Forces Royales Air,Flight,Military / Government,Spain,Europe,7,6,6,1,1,7,0,Unknown
1969-03-30 00:00:00,Federal Government of Nigeria,Takeoff (climb),Military / Government,Nigeria,Africa,7,2,2,5,5,7,0,Unknown
1969-04-18 00:00:00,Aeroflot - Russian International Airlines,Flight,Military / Government,Kazakhstan,Asia,7,1,1,6,6,7,0,Human Factor
1969-05-14 00:00:00,Spanish Air Force - Ejército del Aire,Landing (descent or approach),Military / Government,Spain,Europe,8,8,7,0,0,7,1,Unknown
1969-06-03 00:00:00,Soviet Air Force - Voyenno-vozdushnye sily CCCP,Landing (descent or approach),Operational,Russia,Asia,7,7,7,0,0,7,0,Human Factor
1969-06-03 00:00:00,Soviet Air Force - Voyenno-vozdushnye sily CCCP,Landing (descent or approach),Operational,Russia,Asia,7,7,7,0,0,7,0,Human Factor
1969-07-01 00:00:00,Spanish Air Force - Ejército del Aire,Flight,Military / Government,Spain,Europe,7,7,7,0,0,7,0,Unknown
1969-07-04 00:00:00,French Air Force - Armée de l'Air,Landing (descent or approach),Military / Government,France,Europe,7,2,2,5,5,7,0,Unknown
1969-09-04 00:00:00,United States Air Force - USAF,Takeoff (climb),Military / Government,United States of America,North America,7,7,7,0,0,7,0,Technical Failure
1969-11-06 00:00:00,Mack Trucks,Landing (descent or approach),Business,United States of America,North America,7,2,2,5,5,7,0,Human Factor
1969-12-21 00:00:00,Brazilian Air Force - Força Aérea Brasileira,Takeoff (climb),Military / Government,Brazil,South America,7,7,7,0,0,7,0,Technical Failure
1970-04-04 00:00:00,Aeroflot - Russian International Airlines,Landing (descent or approach),Commercial,Ukraine,Europe,35,5,1,30,6,7,28,Human Factor
1970-05-15 00:00:00,Winchester Development Company,Landing (descent or approach),Business,United States of America,North America,7,1,1,6,6,7,0,Human Factor
1970-05-21 00:00:00,Viennair,Landing (descent or approach),Commercial,Austria,Europe,7,2,2,5,5,7,0,Human Factor
1970-05-22 00:00:00,Linea Aeropostal Venezolana - LAV,Flight,Specialised Services,Costa Rica,Central America,7,3,3,4,4,7,0,Unknown
1970-08-26 00:00:00,United States Air Force - USAF,Flight,Military / Government,United States of America,North America,7,7,7,0,0,7,0,Human Factor
1970-10-28 00:00:00,Soviet Air Force - Voyenno-vozdushnye sily CCCP,Landing (descent or approach),Operational,Russia,Asia,7,7,7,0,0,7,0,Human Factor
1970-12-30 00:00:00,Pakistan International Airlines - PIA,Landing (descent or approach),Commercial,Bangladesh,Asia,48,4,0,44,7,7,41,Human Factor
1971-01-21 00:00:00,Colombian Air Force - Fuerza Aérea Colombiana,Landing (descent or approach),Military / Government,Colombia,South America,7,4,4,3,3,7,0,Unknown
1971-01-31 00:00:00,Aeroflot - Russian International Airlines,Landing (descent or approach),Operational,Russia,Asia,7,6,6,1,1,7,0,Weather
1971-09-17 00:00:00,Israeli Air Force - Heyl Ha'avir,Flight,Military / Government,Egypt,Africa,8,8,7,0,0,7,1,Terrorism
1971-09-19 00:00:00,Aerotaxi Servicios Aéreos,Landing (descent or approach),Commercial,Colombia,South America,7,1,1,6,6,7,0,Unknown
1971-12-06 00:00:00,Soviet Air Force - Voyenno-vozdushnye sily CCCP,Flight,Operational,Ukraine,Europe,7,7,7,0,0,7,0,Human Factor
1971-12-09 00:00:00,Monarch Tile Company,Takeoff (climb),Business,United States of America,North America,7,1,1,6,6,7,0,Technical Failure
1971-12-30 00:00:00,Dominican Air Force - Fuerza Aérea Dominicana,Flight,Military / Government,Dominican Republic,Central America,7,7,7,0,0,7,0,Unknown
1972-01-20 00:00:00,Connair,Takeoff (climb),Commercial,Australia,Oceania,7,1,1,6,6,7,0,Technical Failure
1972-03-31 00:00:00,United States Air Force - USAF,Landing (descent or approach),Operational,United States of America,North America,7,7,7,0,0,7,0,Technical Failure
1972-04-02 00:00:00,Thomas W. Lane,Flight,Business,United States of America,North America,7,2,2,5,5,7,0,Human Factor
1972-06-29 00:00:00,Inter City Flug,Takeoff (climb),Business,United Kingdom,Europe,8,2,2,6,5,7,1,Human Factor
1972-12-31 00:00:00,Soviet Air Force - Voyenno-vozdushnye sily CCCP,Flight,Military / Government,Egypt,Africa,7,7,7,0,0,7,0,Human Factor
1973-02-26 00:00:00,Machinery Buyers Corporation,Takeoff (climb),Business,United States of America,North America,7,2,2,5,5,7,0,Other
1973-03-29 00:00:00,Aero Consultant Service,Takeoff (climb),Business,Italy,Europe,7,2,2,5,5,7,0,Technical Failure
1973-07-28 00:00:00,Compagnie Cotonnière et Industrielle,Flight,Business,Democratic Republic of Congo,Africa,7,2,2,5,5,7,0,Human Factor
1973-09-07 00:00:00,Aeroflot - Russian International Airlines,Flight,Operational,Russia,Asia,7,5,5,2,2,7,0,Weather
1973-10-15 00:00:00,United States Air Force - USAF,Flight,Operational,United States of America,North America,7,7,7,0,0,7,0,Human Factor
1973-10-15 00:00:00,United States Air Force - USAF,Flight,Operational,United States of America,North America,7,7,7,0,0,7,0,Human Factor
1973-11-16 00:00:00,United States Navy - USN,Takeoff (climb),Military / Government,Greece,Europe,10,10,7,0,0,7,3,Technical Failure
1974-02-09 00:00:00,United States Air Force - USAF,Flight,Military / Government,United States of America,North America,7,2,2,5,5,7,0,Human Factor
1974-02-23 00:00:00,SAVCO - Servicios Aéreos Virgen de Copacabana,Flight,Operational,Bolivia,South America,7,3,3,4,4,7,0,Other
1974-08-18 00:00:00,United States Air Force - USAF,Landing (descent or approach),Military / Government,Bolivia,South America,7,7,7,0,0,7,0,Human Factor
1974-09-20 00:00:00,Nicaraguayan Air Force - Fuerza Aérea - Ejercito de Nicaragua,Takeoff (climb),Military / Government,Nicaragua,Central America,7,7,7,0,0,7,0,Unknown
1974-09-20 00:00:00,Nicaraguayan Air Force - Fuerza Aérea - Ejercito de Nicaragua,Takeoff (climb),Military / Government,Nicaragua,Central America,7,7,7,0,0,7,0,Unknown
1974-11-12 00:00:00,Brazilian Air Force - Força Aérea Brasileira,Flight,Military / Government,Brazil,South America,7,7,7,0,0,7,0,Technical Failure
1974-12-04 00:00:00,Philippine Air Force - Hukbong Himpapawid NG Pilipinas,Landing (descent or approach),Military / Government,Philippines,Asia,7,1,1,6,6,7,0,Unknown
1974-12-14 00:00:00,Aeroflot - Russian International Airlines,Takeoff (climb),Commercial,Uzbekistan,Asia,19,4,0,15,7,7,12,Technical Failure
1975-01-09 00:00:00,United States Air Force - USAF,Landing (descent or approach),Military / Government,United States of America,North America,7,5,5,2,2,7,0,Human Factor
1975-01-12 00:00:00,Paul B. Jatkoe,Flight,Business,United States of America,North America,7,2,2,5,5,7,0,Weather
1975-07-31 00:00:00,Chilean Air Force - Fuerza Aérea de Chile,Flight,Operational,Chile,South America,7,3,3,4,4,7,0,Human Factor
1975-09-30 00:00:00,Northern Thunderbird Air - NT Air,Takeoff (climb),Commercial,Canada,North America,7,2,2,5,5,7,0,Unknown
1976-01-08 00:00:00,Philippine Aerotransport,,Commercial,Philippines,Asia,7,2,2,5,5,7,0,Unknown
1976-01-18 00:00:00,Frigorifico Maniqui,Landing (descent or approach),Operational,Bolivia,South America,10,3,3,7,4,7,3,Technical Failure
1976-01-22 00:00:00,Transbrasil,Takeoff (climb),Commercial,Brazil,South America,9,2,2,7,5,7,2,Unknown
1976-04-08 00:00:00,North Sound Aviation,Landing (descent or approach),Commercial,United States of America,North America,7,1,1,6,6,7,0,Human Factor
1976-05-31 00:00:00,Michael D. McGee,Landing (descent or approach),Business,United States of America,North America,7,1,1,6,6,7,0,Human Factor
1976-09-26 00:00:00,Servicios Pecas de Aviones,Landing (descent or approach),Business,Brazil,South America,7,2,2,5,5,7,0,Human Factor
1976-12-17 00:00:00,Aeroflot - Russian International Airlines,Takeoff (climb),Operational,Russia,Asia,7,3,3,4,4,7,0,Human Factor
1976-12-22 00:00:00,Soviet Air Force - Voyenno-vozdushnye sily CCCP,Flight,Specialised Services,Russia,Asia,7,7,7,0,0,7,0,Human Factor
1977-01-17 00:00:00,Turkish Air Force - Türk Hava Kuvvetleri,Flight,Military / Government,Turkey,Asia,7,7,7,0,0,7,0,Unknown
1977-02-10 00:00:00,United States Army,Flight,Military / Government,United States of America,North America,7,2,2,5,5,7,0,Unknown
1977-04-01 00:00:00,EA Miller Inc.,Flight,Business,United States of America,North America,7,1,1,6,6,7,0,Human Factor
1977-04-05 00:00:00,Mount Victory Flying Service,Landing (descent or approach),Business,United States of America,North America,8,1,1,7,6,7,1,Technical Failure
1977-08-27 00:00:00,Terminal Ice %26 Cold Storage Company,Flight,Business,United States of America,North America,7,2,2,5,5,7,0,Technical Failure
1977-08-30 00:00:00,MSP - Ministerstvo Sudostroitelnoi Promyshlennosti,Flight,Military / Government,Russia,Asia,7,5,5,2,2,7,0,Technical Failure
1977-09-04 00:00:00,Aeroflot - Russian International Airlines,Flight,Business,Russia,Asia,7,3,3,4,4,7,0,Technical Failure
1977-10-01 00:00:00,Kenmore Air,Flight,Commercial,United States of America,North America,7,1,1,6,6,7,0,Human Factor
1977-11-05 00:00:00,Aeroflot - Russian International Airlines,Flight,Commercial,Russia,Asia,7,2,2,5,5,7,0,Human Factor
1977-11-15 00:00:00,Cessna Aircraft Company,Flight,Operational,United States of America,North America,7,1,1,6,6,7,0,Other
1977-12-22 00:00:00,Private Canadian,Flight,Business,United States of America,North America,7,1,1,6,6,7,0,Weather
1978-01-05 00:00:00,Soviet Air Force - Voyenno-vozdushnye sily CCCP,Landing (descent or approach),Military / Government,Kazakhstan,Asia,9,5,3,4,4,7,2,Human Factor
1978-02-02 00:00:00,Royal Thai Air Force - Kong Thap Akat Thai,Flight,Military / Government,Thailand,Asia,7,1,1,6,6,7,0,Unknown
1978-02-28 00:00:00,Security Air Transport,Flight,Commercial,United States of America,North America,7,3,3,4,4,7,0,Human Factor
1978-03-04 00:00:00,Soviet Air Force - Voyenno-vozdushnye sily CCCP,Takeoff (climb),Military / Government,Russia,Asia,7,6,6,1,1,7,0,Technical Failure
1978-04-26 00:00:00,United States Navy - USN,Flight,Operational,Portugal,Europe,7,7,7,0,0,7,0,Unknown
1978-04-28 00:00:00,United States Air Force - USAF,Landing (descent or approach),Military / Government,United States of America,North America,7,5,5,2,2,7,0,Unknown
1978-07-14 00:00:00,Ecuavia,Takeoff (climb),Commercial,Ecuador,South America,7,1,1,6,6,7,0,Unknown
1978-08-28 00:00:00,Soviet Air Force - Voyenno-vozdushnye sily CCCP,Flight,Military / Government,Norway,Europe,7,7,7,0,0,7,0,Unknown
1978-09-23 00:00:00,Connie E. Bowman,Flight,Business,United States of America,North America,7,1,1,6,6,7,0,Human Factor
1978-12-06 00:00:00,Mexican Air Force - Fuerza Aérea Mexicana,Takeoff (climb),Military / Government,United States of America,North America,7,4,4,3,3,7,0,Technical Failure
1978-12-09 00:00:00,Aeroflot - Russian International Airlines,Takeoff (climb),Operational,Russia,Asia,7,5,5,2,2,7,0,Other
1979-04-26 00:00:00,Bolivian Air Force - Fuerza Aérea Boliviana,Takeoff (climb),Military / Government,Bolivia,South America,7,2,2,5,5,7,0,Unknown
1979-07-12 00:00:00,Soldotna Air Service,Takeoff (climb),Commercial,United States of America,North America,7,1,1,6,6,7,0,Technical Failure
1979-08-03 00:00:00,Turbine Aircraft Parts,Flight,Business,United States of America,North America,7,1,1,6,6,7,0,Technical Failure
1979-08-30 00:00:00,Trans-Provincial Airlines - TPA,Flight,Commercial,Canada,North America,10,2,2,8,5,7,3,Unknown
1979-11-23 00:00:00,Soviet Air Force - Voyenno-vozdushnye sily CCCP,Landing (descent or approach),Operational,Belarus,Europe,7,7,7,0,0,7,0,Technical Failure
1979-12-16 00:00:00,A. H. Cowley %26 Associates,Takeoff (climb),Business,United States of America,North America,7,1,1,6,6,7,0,Weather
1980-02-16 00:00:00,Redcoat Air Cargo,Takeoff (climb),Operational,United States of America,North America,8,5,4,3,3,7,1,Weather
1980-02-23 00:00:00,Proform,Landing (descent or approach),Business,United States of America,North America,7,1,1,6,6,7,0,Human Factor
1980-03-21 00:00:00,Eagle Commuter Airlines,Takeoff (climb),Commercial,United States of America,North America,10,2,2,8,5,7,3,Technical Failure
1980-05-13 00:00:00,Votec Taxi Aéreo,Flight,Military / Government,Brazil,South America,7,1,1,6,6,7,0,Unknown
1980-09-21 00:00:00,Cavalier Air Force,Flight,Operational,United Kingdom,Europe,7,1,1,6,6,7,0,Unknown
1980-10-17 00:00:00,Établissements Économiques du Casino,Landing (descent or approach),Business,France,Europe,7,2,2,5,5,7,0,Unknown
1980-11-03 00:00:00,Aero Express - Guatemala,Landing (descent or approach),Commercial,Guatemala,Central America,7,2,2,5,5,7,0,Unknown
1980-12-04 00:00:00,Private Venezuelan,Takeoff (climb),Military / Government,Portugal,Europe,7,2,2,5,5,7,0,Human Factor
1981-01-20 00:00:00,Cascade Airways,Landing (descent or approach),Commercial,United States of America,North America,9,2,2,7,5,7,2,Human Factor
1981-02-07 00:00:00,S. A. International Trading Company,Landing (descent or approach),Business,United States of America,North America,7,2,2,5,5,7,0,Human Factor
1981-04-06 00:00:00,Urcupina,Flight,Operational,Bolivia,South America,7,3,3,4,4,7,0,Human Factor
1981-07-31 00:00:00,Panamanian Air Force - Fuerza Aérea Panameña,Flight,Military / Government,Panama,Central America,7,2,2,5,5,7,0,Human Factor
1981-09-21 00:00:00,United States Air Force - USAF,Landing (descent or approach),Military / Government,United States of America,North America,70,9,0,61,7,7,63,Human Factor
1981-11-18 00:00:00,Aldora Corporation,Landing (descent or approach),Business,United States of America,North America,7,2,2,5,5,7,0,Human Factor
1982-01-21 00:00:00,French Navy,Takeoff (climb),Operational,New Caledonia,Oceania,7,7,7,0,0,7,0,Human Factor
1982-01-24 00:00:00,Vernon L. Meyer,Landing (descent or approach),Business,United States of America,North America,7,2,2,5,5,7,0,Human Factor
1982-01-25 00:00:00,TAROM - Transporturile Aeriene Române,Landing (descent or approach),Operational,Romania,Europe,7,7,7,0,0,7,0,Technical Failure
1982-02-19 00:00:00,Sandinist Air Force - Fuerza Aérea Sandinista,Flight,Military / Government,Nicaragua,Central America,7,2,2,5,5,7,0,Unknown
1982-05-05 00:00:00,Texas Aero,Flight,Business,United States of America,North America,7,1,1,6,6,7,0,Human Factor
1982-05-12 00:00:00,United States Air Force - USAF,Flight,Operational,United States of America,North America,7,7,7,0,0,7,0,Technical Failure
1982-06-01 00:00:00,Argentinian Air Force - Fuerza Aérea Argentina,Flight,Military / Government,Falkland Islands,South America,7,7,7,0,0,7,0,Terrorism
1982-08-31 00:00:00,Private German,Flight,Business,Austria,Europe,7,1,1,6,6,7,0,Unknown
1982-09-16 00:00:00,Aeroflot - Russian International Airlines,Landing (descent or approach),Commercial,Kazakhstan,Asia,7,2,2,5,5,7,0,Human Factor
1982-09-24 00:00:00,Royal Malaysian Air Force - Tentera Udara Diraja Malaysia,Flight,Military / Government,Malaysia,Asia,7,7,7,0,0,7,0,Unknown
1982-09-29 00:00:00,Aeroflot - Russian International Airlines,Landing (descent or approach),Commercial,Luxembourg,Europe,77,11,0,66,7,7,70,Technical Failure
1982-11-16 00:00:00,Royal Canadian Air Force - RCAF,Landing (descent or approach),Operational,Canada,North America,7,7,7,0,0,7,0,Technical Failure
1983-04-11 00:00:00,United States Air Force - USAF,Flight,Military / Government,United States of America,North America,7,7,7,0,0,7,0,Human Factor
1983-06-05 00:00:00,Linair Express,Flight,Business,South Africa,Africa,9,1,1,8,6,7,2,Human Factor
1983-06-21 00:00:00,Air Mali,Landing (descent or approach),Commercial,Mali,Africa,7,2,2,5,5,7,0,Unknown
1983-07-26 00:00:00,Bali International Air Service,Landing (descent or approach),Commercial,Indonesia,Asia,11,2,2,9,5,7,4,Unknown
1983-08-28 00:00:00,Transamerica Airlines,Landing (descent or approach),Operational,Angola,Africa,7,4,4,3,3,7,0,Human Factor
1983-09-02 00:00:00,Central Mountain Air Services,Landing (descent or approach),Commercial,Canada,North America,7,1,1,6,6,7,0,Unknown
1983-10-07 00:00:00,TAM Brasil - Taxi Aéreo Marilia - Transportes Aéreos Regionais,Landing (descent or approach),Commercial,Brazil,South America,15,2,2,13,5,7,8,Human Factor
1983-10-08 00:00:00,Private Colombian,Takeoff (climb),Humanitarian,Colombia,South America,7,3,3,4,4,7,0,Unknown
1983-10-08 00:00:00,Private Colombian,Takeoff (climb),Humanitarian,Colombia,South America,7,3,3,4,4,7,0,Unknown
1983-11-18 00:00:00,Aeroflot - Russian International Airlines,Landing (descent or approach),Commercial,Georgia,Asia,66,7,3,59,4,7,59,Terrorism
1984-03-24 00:00:00,Central Intelligence Agency - CIA,Flight,Operational,Costa Rica,Central America,7,2,2,5,5,7,0,Unknown
1984-05-05 00:00:00,Private Mexican,Landing (descent or approach),Business,Mexico,Central America,7,2,2,5,5,7,0,Human Factor
1984-06-27 00:00:00,Austrian Air Force - Österreichische Luftstreitkräfte,Takeoff (climb),Operational,Austria,Europe,7,1,1,6,6,7,0,Human Factor
1984-09-12 00:00:00,Transportes Aéreos Neuquén,Takeoff (climb),Humanitarian,Argentina,South America,7,2,2,5,5,7,0,Human Factor
1984-10-09 00:00:00,Nahanni Air Services,Landing (descent or approach),Commercial,Canada,North America,7,2,2,5,5,7,0,Human Factor
1984-10-13 00:00:00,Confederate Air Force,Flight,Specialised Services,United States of America,North America,10,3,1,7,6,7,3,Human Factor
1984-11-23 00:00:00,French Air Force - Armée de l'Air,Flight,Operational,France,Europe,7,7,7,0,0,7,0,Human Factor
1984-12-12 00:00:00,France Europe Avia Jet,Landing (descent or approach),Commercial,France,Europe,7,2,2,5,5,7,0,Human Factor
1985-04-11 00:00:00,Yacimientos Petroliferos Fiscales Argentinas - YPFA,Landing (descent or approach),Business,Argentina,South America,7,2,2,5,5,7,0,Human Factor
1985-06-24 00:00:00,Brazilian Air Force - Força Aérea Brasileira,Landing (descent or approach),Operational,Brazil,South America,7,7,7,0,0,7,0,Human Factor
1985-07-26 00:00:00,Russian Government,Flight,Military / Government,Russia,Asia,7,7,7,0,0,7,0,Unknown
1985-08-27 00:00:00,United States Air Force - USAF,Landing (descent or approach),Operational,United States of America,North America,7,7,7,0,0,7,0,Human Factor
1985-11-25 00:00:00,Iowa State University,Landing (descent or approach),Business,United States of America,North America,7,1,1,6,6,7,0,Weather
1985-12-13 00:00:00,Aviones de Panama,Flight,Commercial,Panama,Central America,7,1,1,6,6,7,0,Human Factor
1985-12-26 00:00:00,South American Placers of Peru,Flight,Commercial,Peru,South America,7,2,2,5,5,7,0,Unknown
1985-12-31 00:00:00,Century Equipment,Landing (descent or approach),Business,United States of America,North America,9,2,0,7,7,7,2,Technical Failure
1985-12-31 00:00:00,Federal Government of Nigeria,Landing (descent or approach),Military / Government,Nigeria,Africa,7,2,2,5,5,7,0,Human Factor
1986-01-02 00:00:00,Outdoor Aviation,Takeoff (climb),Commercial,New Zealand,Oceania,7,1,1,6,6,7,0,Technical Failure
1986-02-03 00:00:00,Club Aéreo del Personal de Carabineros,Takeoff (climb),Military / Government,Chile,South America,7,2,2,5,5,7,0,Unknown
1986-03-25 00:00:00,Indian Air Force - Bharatiya Vayu Sena,Flight,Operational,World,World,7,3,3,4,4,7,0,Unknown
1986-04-04 00:00:00,Drayton Associates,Flight,Business,United States of America,North America,7,2,2,5,5,7,0,Weather
1986-04-04 00:00:00,Sudanese Air Force - Al Quwwat al-Jawwiya As-Sudaniya,Flight,Military / Government,South Sudan,Africa,14,2,2,12,5,7,7,Unknown
1986-04-29 00:00:00,Peruvian Navy - Aviación Naval,Flight,Military / Government,Peru,South America,7,7,7,0,0,7,0,Unknown
1986-05-18 00:00:00,Argentinian Navy - Armada Argentina,Flight,Military / Government,Argentina,South America,7,2,2,5,5,7,0,Unknown
1986-08-28 00:00:00,Denver Air Center,Takeoff (climb),Commercial,United States of America,North America,7,1,1,6,6,7,0,Human Factor
1986-10-11 00:00:00,Carlos de Lima Lozada,Takeoff (climb),Business,Venezuela,South America,7,2,2,5,5,7,0,Technical Failure
1987-05-25 00:00:00,Missionary Aviation Fellowship - MAF,Landing (descent or approach),Commercial,Indonesia,Asia,30,2,2,28,5,7,23,Unknown
1988-08-31 00:00:00,CAAC - Civil Aviation Administration of China,Landing (descent or approach),Commercial,China,Asia,89,11,6,78,1,7,82,Human Factor
1988-09-12 00:00:00,Transportes Aéreos Mercantiles Ecuatorianos - TAME,Takeoff (climb),Operational,Ecuador,South America,7,7,7,0,0,7,0,Technical Failure
1988-11-17 00:00:00,JC Air,Takeoff (climb),Commercial,France,Europe,7,1,1,6,6,7,0,Human Factor
1988-12-12 00:00:00,Yugoslav Air Force - Ratno Vazduhoplovstvo i Protivvazdušna Odbrana,Landing (descent or approach),Humanitarian,Armenia,Asia,7,7,7,0,0,7,0,Human Factor
1989-02-24 00:00:00,Predator,Landing (descent or approach),Commercial,Finland,Europe,8,1,1,7,6,7,1,Human Factor
1989-04-22 00:00:00,Private German,Flight,Business,Germany,Europe,7,1,1,6,6,7,0,Human Factor
1989-08-10 00:00:00,Soviet Air Force - Voyenno-vozdushnye sily CCCP,Flight,Operational,Russia,Asia,7,7,7,0,0,7,0,Technical Failure
1989-09-11 00:00:00,Cuban Air Force - Fuerzas Armadas Revolucionaras,Landing (descent or approach),Operational,Cuba,Central America,8,8,7,0,0,7,1,Unknown
1989-09-26 00:00:00,Skylink Airlines,Landing (descent or approach),Commercial,Canada,North America,7,2,2,5,5,7,0,Human Factor
1989-11-30 00:00:00,Procuraduría General de la República,Takeoff (climb),Military / Government,Mexico,Central America,7,2,2,5,5,7,0,Unknown
1989-12-28 00:00:00,TAROM - Transporturile Aeriene Române,Flight,Humanitarian,Romania,Europe,7,6,6,1,1,7,0,Terrorism
1989-12-30 00:00:00,Air Fiordland,Flight,Commercial,New Zealand,Oceania,7,1,1,6,6,7,0,Human Factor
1990-01-19 00:00:00,Eastman Kodak,Landing (descent or approach),Business,United States of America,North America,7,2,2,5,5,7,0,Human Factor
1990-03-18 00:00:00,SAHSA - Servicios Aéreos de Honduras SA,Landing (descent or approach),Commercial,Honduras,Central America,32,3,1,29,6,7,25,Weather
1990-03-21 00:00:00,Aerocauca Colombia - Aerovias del Cauca,Flight,Specialised Services,Colombia,South America,7,2,2,5,5,7,0,Unknown
1990-04-26 00:00:00,Manila Aero Transport System - MATS,Takeoff (climb),Operational,Philippines,Asia,24,2,0,22,7,7,17,Technical Failure
1990-05-05 00:00:00,Soviet Air Force - Voyenno-vozdushnye sily CCCP,Flight,Military / Government,Russia,Asia,7,7,7,0,0,7,0,Unknown
1990-05-30 00:00:00,Taboca Mining Company,Landing (descent or approach),Business,Brazil,South America,7,2,2,5,5,7,0,Human Factor
1991-03-18 00:00:00,Consul Táxi Aéreo,Landing (descent or approach),Commercial,Brazil,South America,7,2,2,5,5,7,0,Unknown
1991-05-13 00:00:00,Air Grand Canyon,Flight,Commercial,United States of America,North America,7,1,1,6,6,7,0,Technical Failure
1991-09-16 00:00:00,LACOL Colombia - Lineas Aéreas Colombianas,Landing (descent or approach),Operational,Colombia,South America,7,3,3,4,4,7,0,Human Factor
1991-10-08 00:00:00,FBG - Fahrzeugbetriebesgesellschaft,Landing (descent or approach),Commercial,Germany,Europe,7,1,1,6,6,7,0,Technical Failure
1991-10-29 00:00:00,AZAL-Agro,Flight,Commercial,Azerbaijan,Asia,7,2,2,5,5,7,0,Terrorism
1992-01-11 00:00:00,George N. Derenia,Takeoff (climb),Business,United States of America,North America,7,1,1,6,6,7,0,Human Factor
1992-01-26 00:00:00,Rally Parts,Flight,Commercial,Kenya,Africa,7,1,1,6,6,7,0,Other
1992-01-27 00:00:00,Air Rainbow,Takeoff (climb),Commercial,Canada,North America,9,1,1,8,6,7,2,Weather
1992-02-16 00:00:00,Andrew %26 Williamson Sales Company,Landing (descent or approach),Commercial,United States of America,North America,7,2,2,5,5,7,0,Human Factor
1992-03-24 00:00:00,Golden Star Air Cargo,Landing (descent or approach),Operational,Greece,Europe,7,3,3,4,4,7,0,Human Factor
1992-04-10 00:00:00,Taiwan Airlines,Takeoff (climb),Commercial,Taiwan,Asia,10,2,1,8,6,7,3,Technical Failure
1992-11-30 00:00:00,United States Air Force - USAF,Flight,Operational,United States of America,North America,7,7,7,0,0,7,0,Unknown
1993-02-03 00:00:00,Lockheed Aeronautical System Company,Takeoff (climb),Specialised Services,United States of America,North America,7,7,7,0,0,7,0,Human Factor
1993-06-11 00:00:00,Monarch Airlines,Landing (descent or approach),Commercial,Australia,Oceania,7,2,2,5,5,7,0,Human Factor
1993-07-05 00:00:00,Ilyushin,Takeoff (climb),Specialised Services,Russia,Asia,9,9,7,0,0,7,2,Technical Failure
1993-07-24 00:00:00,Aeronáutica Civil de Colombia,Takeoff (climb),Military / Government,Colombia,South America,7,3,3,4,4,7,0,Technical Failure
1993-09-05 00:00:00,Cambridge Aviation,Flight,Business,United States of America,North America,7,2,2,5,5,7,0,Human Factor
1993-11-10 00:00:00,Air Manitoba,Takeoff (climb),Commercial,Canada,North America,7,3,3,4,4,7,0,Technical Failure
1993-12-03 00:00:00,Arctic Wings %26 Rotors,Takeoff (climb),Commercial,Canada,North America,7,1,1,6,6,7,0,Technical Failure
1994-01-19 00:00:00,Russian Air Force - Voyenno-vozdushnye sily Rossii,Takeoff (climb),Operational,Russia,Asia,10,7,5,3,2,7,3,Technical Failure
1994-02-26 00:00:00,Mexican Air Force - Fuerza Aérea Mexicana,Flight,Military / Government,Mexico,Central America,7,7,7,0,0,7,0,Unknown
1994-05-28 00:00:00,Trans Oriente Colombia - Transportes Aéreos Regular Secundario Oriental,Takeoff (climb),Commercial,Colombia,South America,29,3,3,26,4,7,22,Technical Failure
1994-06-23 00:00:00,Wings of Alaska,Takeoff (climb),Commercial,United States of America,North America,11,1,0,10,7,7,4,Human Factor
1994-06-30 00:00:00,Airbus Industrie,Takeoff (climb),Specialised Services,France,Europe,7,7,7,0,0,7,0,Human Factor
1994-07-31 00:00:00,Air Ukraine,Flight,Humanitarian,Croatia,Europe,7,6,6,1,1,7,0,Terrorism
1994-10-19 00:00:00,Mono Max Aviation,Landing (descent or approach),Commercial,France,Europe,7,1,1,6,6,7,0,Human Factor
1994-10-30 00:00:00,Yakutavia,Takeoff (climb),Commercial,Russia,Asia,19,2,0,17,7,7,12,Other
1994-11-22 00:00:00,South West Air - PNG,Flight,Commercial,Papua New Guinea,Oceania,7,1,1,6,6,7,0,Human Factor
1994-12-17 00:00:00,Servivensa - Servicios Avensa - Servicios Aerovias Venezolanas,Landing (descent or approach),Commercial,Venezuela,South America,15,3,3,12,4,7,8,Human Factor
1994-12-26 00:00:00,Air France,Parking,Commercial,France,Europe,170,7,0,163,7,7,163,Terrorism
1995-02-10 00:00:00,Antonov Design Bureau,Flight,Specialised Services,Ukraine,Europe,7,7,7,0,0,7,0,Human Factor
1995-03-23 00:00:00,CAAC - Flying College,Flight,Operational,China,Asia,7,7,7,0,0,7,0,Human Factor
1995-03-28 00:00:00,Guillermo Justiniano,Takeoff (climb),Business,Bolivia,South America,7,1,1,6,6,7,0,Technical Failure
1995-04-21 00:00:00,Bolivian Air Force - Fuerza Aérea Boliviana,Flight,Military / Government,Bolivia,South America,7,2,2,5,5,7,0,Unknown
1995-05-03 00:00:00,American Jet International,Flight,Commercial,Ecuador,South America,7,2,2,5,5,7,0,Human Factor
1995-09-02 00:00:00,Royal Air Force - RAF,Flight,Operational,Canada,North America,7,7,7,0,0,7,0,Human Factor
1995-10-22 00:00:00,German Air Force - Deutsche Luftwaffe,Takeoff (climb),Military / Government,Portugal,Europe,7,7,7,0,0,7,0,Technical Failure
1995-11-13 00:00:00,Venezuelan Government,Takeoff (climb),Military / Government,Venezuela,South America,7,2,2,5,5,7,0,Technical Failure
1997-06-10 00:00:00,MIAT Mongolian Airlines - Mongolyn Irgeniy Agaaryn Teever,Landing (descent or approach),Commercial,Mongolia,Asia,12,2,0,10,7,7,5,Weather
1997-10-01 00:00:00,Government of the State of Rio Grande do Sul,Landing (descent or approach),Humanitarian,Brazil,South America,7,2,2,5,5,7,0,Human Factor
1998-02-04 00:00:00,Air Sofia,Takeoff (climb),Operational,Portugal,Europe,7,7,7,0,0,7,0,Human Factor
1998-12-07 00:00:00,Air Satellite,Takeoff (climb),Commercial,Canada,North America,10,2,1,8,6,7,3,Human Factor
1999-02-08 00:00:00,Blue Airlines,Takeoff (climb),Military / Government,Democratic Republic of Congo,Africa,7,7,7,0,0,7,0,Technical Failure
1999-05-08 00:00:00,Vanair,Landing (descent or approach),Commercial,Vanuatu,Oceania,12,1,1,11,6,7,5,Human Factor
1999-07-23 00:00:00,United States Army,Flight,Military / Government,Colombia,South America,7,7,7,0,0,7,0,Human Factor
2000-01-22 00:00:00,Aerodomca - Aeronaves Dominicanas,Flight,Commercial,Dominican Republic,Central America,7,1,1,6,6,7,0,Human Factor
2000-03-22 00:00:00,Spanish Air Force - Ejército del Aire,Flight,Military / Government,Spain,Europe,7,3,3,4,4,7,0,Unknown
2000-06-05 00:00:00,Ghana Airways,Landing (descent or approach),Commercial,Ghana,Africa,54,10,0,44,7,7,47,Human Factor
2000-09-02 00:00:00,Colombian Air Force - Fuerza Aérea Colombiana,Flight,Military / Government,Colombia,South America,7,7,7,0,0,7,0,Human Factor
2000-12-16 00:00:00,Agropecuária J. Caetano,Takeoff (climb),Commercial,Brazil,South America,7,2,2,5,5,7,0,Human Factor
2001-01-28 00:00:00,Rafael Perez,Landing (descent or approach),Business,Dominican Republic,Central America,7,2,2,5,5,7,0,Human Factor
2001-05-22 00:00:00,Russian Air Force - Voyenno-vozdushnye sily Rossii,Takeoff (climb),Military / Government,Russia,Asia,7,7,7,0,0,7,0,Technical Failure
2001-09-24 00:00:00,Association Ouest Promotion,Landing (descent or approach),Commercial,Madagascar,Africa,7,2,2,5,5,7,0,Technical Failure
2002-01-09 00:00:00,United States Marine Corps,Landing (descent or approach),Military / Government,Pakistan,Asia,7,7,7,0,0,7,0,Human Factor
2002-05-04 00:00:00,EAS Airlines - Executive Airline Services,Takeoff (climb),Commercial,Nigeria,Africa,79,8,7,71,0,7,72,Human Factor
2002-10-01 00:00:00,Indian Navy - Bharatiya Nau Sena,Flight,Operational,India,Asia,7,7,7,0,0,7,0,Human Factor
2002-11-07 00:00:00,Dirgantara Air Service,Landing (descent or approach),Commercial,Indonesia,Asia,10,1,1,9,6,7,3,Technical Failure
2003-01-17 00:00:00,Tiramavia,Landing (descent or approach),Operational,Gabon,Africa,7,5,5,2,2,7,0,Technical Failure
2003-06-25 00:00:00,Islamic Republic of Iran Air Force,Flight,Specialised Services,Iran,Asia,7,7,7,0,0,7,0,Technical Failure
2003-12-17 00:00:00,French Air Force - Armée de l'Air,Flight,Humanitarian,France,Europe,7,4,4,3,3,7,0,Human Factor
2004-05-02 00:00:00,Procuraduría General de la República,Flight,Military / Government,Mexico,Central America,7,2,2,5,5,7,0,Weather
2004-05-04 00:00:00,Venezuelan Government,Flight,Military / Government,Venezuela,South America,7,2,2,5,5,7,0,Human Factor
2004-05-11 00:00:00,El Magal Aviation,Flight,Operational,Sudan,Africa,7,7,7,0,0,7,0,Human Factor
2004-05-18 00:00:00,AZAL Cargo Air Company,Takeoff (climb),Operational,China,Asia,7,7,7,0,0,7,0,Unknown
2004-10-14 00:00:00,MK Airlines,Takeoff (climb),Operational,Canada,North America,7,7,7,0,0,7,0,Human Factor
2005-02-03 00:00:00,East/West Cargo,Landing (descent or approach),Operational,Sudan,Africa,7,6,6,1,1,7,0,Technical Failure
2005-02-24 00:00:00,Government of the State of Colima,Flight,Military / Government,Mexico,Central America,7,2,2,5,5,7,0,Technical Failure
2005-06-02 00:00:00,Marsland Aviation,Takeoff (climb),Commercial,Sudan,Africa,42,6,1,36,6,7,35,Technical Failure
2006-08-28 00:00:00,Jason S. Christie,Landing (descent or approach),Business,United States of America,North America,7,1,1,6,6,7,0,Human Factor
2006-11-08 00:00:00,Royal Thai Air Force - Kong Thap Akat Thai,Takeoff (climb),Military / Government,Thailand,Asia,7,3,3,4,4,7,0,Technical Failure
2007-07-29 00:00:00,ATRAN - Aviatrans Cargo Airlines,Takeoff (climb),Operational,Russia,Asia,7,7,7,0,0,7,0,Other
2007-09-29 00:00:00,Business %26 Cargo Company,Flight,Operational,Democratic Republic of Congo,Africa,7,7,7,0,0,7,0,Unknown
2008-06-27 00:00:00,Juba Air Cargo,Flight,Operational,South Sudan,Africa,8,8,7,0,0,7,1,Weather
2008-11-13 00:00:00,British Gulf International Airlines,Flight,Operational,Iraq,Asia,7,7,7,0,0,7,0,Technical Failure
2008-11-16 00:00:00,Pacific Coastal Airlines - PCA,Flight,Commercial,Canada,North America,8,1,1,7,6,7,1,Human Factor
2008-11-27 00:00:00,XL Airways,Landing (descent or approach),Specialised Services,France,Europe,7,2,2,5,5,7,0,Human Factor
2009-04-02 00:00:00,Chemtrad Aviation,Flight,Commercial,Philippines,Asia,7,2,2,5,5,7,0,Human Factor
2009-04-29 00:00:00,Bako Air,Flight,Operational,Democratic Republic of Congo,Africa,7,2,2,5,5,7,0,Unknown
2009-09-22 00:00:00,Islamic Republic of Iran Air Force,Flight,Operational,Iran,Asia,7,7,7,0,0,7,0,Technical Failure
2009-10-29 00:00:00,United States Coast Guard - USCG,Flight,Military / Government,United States of America,North America,7,7,7,0,0,7,0,Human Factor
2010-06-23 00:00:00,Aéropro,Takeoff (climb),Commercial,Canada,North America,7,2,2,5,5,7,0,Human Factor
2011-02-04 00:00:00,Sky Lounge Services,Takeoff (climb),Commercial,Iraq,Asia,7,3,3,4,4,7,0,Human Factor
2011-05-25 00:00:00,Air Charter Services,Flight,Humanitarian,India,Asia,7,2,2,5,5,7,0,Weather
2011-07-09 00:00:00,Advanced Integrated Technology Solutions,Landing (descent or approach),Business,United States of America,North America,7,1,1,6,6,7,0,Human Factor
2011-07-11 00:00:00,Angara Airlines,Landing (descent or approach),Commercial,Russia,Asia,37,4,0,33,7,7,30,Technical Failure
2011-08-14 00:00:00,R. Dominick,Flight,Business,South Africa,Africa,7,1,1,6,6,7,0,Human Factor
2012-06-21 00:00:00,Indonesian Air Force - TNI-AU Tentara Nasional Indonesia - Angkatan Udara,Landing (descent or approach),Operational,Indonesia,Asia,7,7,7,0,0,7,0,Human Factor
2012-07-12 00:00:00,Mauritanian Air Force - Force Aérienne Islamique de Mauritanie,Takeoff (climb),Military / Government,Mauritania,Africa,7,2,2,5,5,7,0,Unknown
2012-11-30 00:00:00,Aéro-Service,Landing (descent or approach),Operational,Congo,Africa,7,6,6,1,1,7,0,Human Factor
2012-12-09 00:00:00,Starwood Management,Flight,Business,Mexico,Central America,7,2,2,5,5,7,0,Unknown
2013-03-04 00:00:00,Compagnie Africaine d'Aviation,Landing (descent or approach),Operational,Democratic Republic of Congo,Africa,10,6,6,4,1,7,3,Human Factor
2013-04-29 00:00:00,National Airlines - National Air Cargo,Takeoff (climb),Operational,Afghanistan,Asia,7,7,7,0,0,7,0,Other
2014-05-31 00:00:00,SK Travel,Takeoff (climb),Business,United States of America,North America,7,3,3,4,4,7,0,Human Factor
2014-08-13 00:00:00,Grupo Andrade,Landing (descent or approach),Business,Brazil,South America,7,2,2,5,5,7,0,Human Factor
2014-08-30 00:00:00,Ukraine Air Alliance,Takeoff (climb),Operational,Algeria,Africa,7,7,7,0,0,7,0,Unknown
2014-10-12 00:00:00,IRIPA - Islamic Republic of Iran Police Aviation,Landing (descent or approach),Military / Government,Iran,Asia,7,3,3,4,4,7,0,Human Factor
2014-12-24 00:00:00,Aerolineas Alas de Colombia,Flight,Commercial,Colombia,South America,7,1,1,6,6,7,0,Human Factor
2015-04-07 00:00:00,Make it Happen Aviation,Landing (descent or approach),Business,United States of America,North America,7,1,1,6,6,7,0,Human Factor
2015-08-29 00:00:00,Nigerian Air Force,Takeoff (climb),Military / Government,Nigeria,Africa,7,4,4,3,3,7,0,Unknown
2015-09-05 00:00:00,Senegalair,Flight,Humanitarian,World,World,7,3,3,4,4,7,0,Human Factor
2016-03-19 00:00:00,Private Brazilian,Takeoff (climb),Business,Brazil,South America,7,1,1,6,6,7,0,Unknown
2016-03-29 00:00:00,Aéro Teknic,Landing (descent or approach),Commercial,Canada,North America,7,1,1,6,6,7,0,Human Factor
2016-05-18 00:00:00,Silk Way Airlines,Takeoff (climb),Operational,Afghanistan,Asia,9,9,7,0,0,7,2,Technical Failure
2017-10-12 00:00:00,Guicango,Flight,Humanitarian,Angola,Africa,7,3,3,4,4,7,0,Technical Failure
2018-12-20 00:00:00,Gomair,Landing (descent or approach),Operational,Democratic Republic of Congo,Africa,7,7,7,0,0,7,0,Unknown
2019-07-15 00:00:00,Air Saguenay,Landing (descent or approach),Commercial,Canada,North America,7,1,1,6,6,7,0,Unknown
2019-09-15 00:00:00,TransPacificos,Takeoff (climb),Commercial,Colombia,South America,9,2,2,7,5,7,2,Other
2019-10-02 00:00:00,The Collings Foundation,Landing (descent or approach),Business,United States of America,North America,13,3,2,10,5,7,6,Human Factor
2020-07-15 00:00:00,Turkish Police - Türk Polis,Flight,Military / Government,Turkey,Asia,7,2,2,5,5,7,0,Unknown
2020-08-22 00:00:00,South West Aviation,Takeoff (climb),Operational,South Sudan,Africa,8,3,3,5,4,7,1,Other
2021-02-09 00:00:00,Paraguay Air Force - Fuerza Aérea Paraguaya,Landing (descent or approach),Military / Government,Paraguay,South America,8,2,2,6,5,7,1,Unknown
2021-02-21 00:00:00,Nigerian Air Force,Landing (descent or approach),Military / Government,Nigeria,Africa,7,2,2,5,5,7,0,Technical Failure
2021-05-29 00:00:00,JL %26 GL Productions LP,Takeoff (climb),Business,United States of America,North America,7,1,1,6,6,7,0,Unknown
2021-09-14 00:00:00,CSM Agropecuária,Takeoff (climb),Business,Brazil,South America,7,2,2,5,5,7,0,Unknown
2022-02-04 00:00:00,Aero Santos,Takeoff (climb),Commercial,Peru,South America,7,1,1,6,6,7,0,Unknown
1920-09-25 00:00:00,Central Aircraft Company,Takeoff (climb),Commercial,United Kingdom,Europe,6,1,1,5,5,6,0,Unknown
1923-05-14 00:00:00,Air Union France,Flight,Commercial,France,Europe,6,2,2,4,4,6,0,Technical Failure
1924-06-08 00:00:00,SCADTA - Sociedad Colombo-Alemana de Transportes Aéreos,Takeoff (climb),Commercial,Colombia,South America,6,2,2,4,4,6,0,Technical Failure
1926-11-06 00:00:00,Lloyd Aéreo Boliviano - LAB Airlines,Landing (descent or approach),Commercial,Bolivia,South America,6,1,1,5,5,6,0,Unknown
1927-11-16 00:00:00,Aero Oy,Flight,Commercial,Finland,Europe,6,2,2,4,4,6,0,Unknown
1927-12-31 00:00:00,L'Aéropostale,Takeoff (climb),Specialised Services,France,Europe,6,6,6,0,0,6,0,Technical Failure
1928-06-18 00:00:00,Roald Amundsen,Flight,Business,World,World,6,4,4,2,2,6,0,Unknown
1928-07-10 00:00:00,Aero Oy,Flight,Commercial,Finland,Europe,6,2,2,4,4,6,0,Unknown
1928-11-14 00:00:00,United States Army Air Corps - USAAC,Flight,Military / Government,United States of America,North America,8,2,0,6,6,6,2,Unknown
1929-09-14 00:00:00,Skyways - Canada,Flight,Commercial,Canada,North America,6,1,1,5,5,6,0,Unknown
1930-07-21 00:00:00,Walcot Air Line,Flight,Commercial,United Kingdom,Europe,6,2,2,4,4,6,0,Technical Failure
1930-08-26 00:00:00,French Air Force - Armée de l'Air,Landing (descent or approach),Operational,France,Europe,6,6,6,0,0,6,0,Human Factor
1930-09-03 00:00:00,Spanish Air Force - Aeronáutica Militar,Landing (descent or approach),Military / Government,Spain,Europe,6,6,6,0,0,6,0,Human Factor
1930-11-21 00:00:00,Societa Anonima di Navigazione Aerea - SANA,Flight,Commercial,Spain,Europe,6,4,4,2,2,6,0,Unknown
1931-07-05 00:00:00,Lucerne Airways,Takeoff (climb),Commercial,United States of America,North America,6,1,1,5,5,6,0,Technical Failure
1931-08-09 00:00:00,American Airways,Takeoff (climb),Commercial,United States of America,North America,6,2,2,4,4,6,0,Technical Failure
1931-09-15 00:00:00,Compagnie Internationale de Navigation Aérienne - CIDNA,Flight,Commercial,Romania,Europe,6,2,2,4,4,6,0,Weather
1931-12-06 00:00:00,KLM Royal Dutch Airlines - Koninklijke Luchtvaart Maatschappij,Takeoff (climb),Commercial,Thailand,Asia,7,3,2,4,4,6,1,Other
1932-12-26 00:00:00,Peruvian Air Force - Fuerza Aérea del Perú,Flight,Military / Government,Peru,South America,6,2,2,4,4,6,0,Unknown
1933-05-09 00:00:00,L'Aéropostale,Flight,Commercial,Spain,Europe,6,3,3,3,3,6,0,Weather
1933-07-18 00:00:00,Aero Espresso Italiana,Flight,Commercial,World,World,6,4,4,2,2,6,0,Unknown
1934-05-09 00:00:00,Air France,Flight,Commercial,France,Europe,6,3,3,3,3,6,0,Unknown
1934-06-11 00:00:00,Panagra - Pan American-Grace Airways,Flight,Commercial,Argentina,South America,10,3,3,7,3,6,4,Weather
1934-08-15 00:00:00,Aeroflot - Russian International Airlines,Takeoff (climb),Commercial,Russia,Asia,7,3,3,4,3,6,1,Human Factor
1935-05-21 00:00:00,United States Navy - USN,Flight,Military / Government,World,World,6,6,6,0,0,6,0,Unknown
1935-07-14 00:00:00,KLM Royal Dutch Airlines - Koninklijke Luchtvaart Maatschappij,Takeoff (climb),Commercial,Netherlands,Europe,20,5,4,15,2,6,14,Technical Failure
1935-10-09 00:00:00,Aero Oy,Flight,Commercial,Finland,Europe,6,2,2,4,4,6,0,Weather
1935-11-29 00:00:00,Laville,Landing (descent or approach),Specialised Services,Russia,Asia,6,6,6,0,0,6,0,Technical Failure
1936-01-21 00:00:00,Air France,Landing (descent or approach),Commercial,France,Europe,6,3,3,3,3,6,0,Technical Failure
1936-02-10 00:00:00,Air France,Flight,Commercial,World,World,6,5,5,1,1,6,0,Unknown
1936-07-27 00:00:00,Aeroflot - Russian International Airlines,Landing (descent or approach),Commercial,Tajikistan,Asia,6,2,2,4,4,6,0,Technical Failure
1936-08-30 00:00:00,Star Air Service,Flight,Commercial,United States of America,North America,6,1,1,5,5,6,0,Unknown
1936-12-04 00:00:00,Deutsche Lufthansa,Flight,Commercial,France,Europe,6,3,3,3,3,6,0,Weather
1936-12-23 00:00:00,Braniff Airways,Landing (descent or approach),Specialised Services,United States of America,North America,6,2,2,4,4,6,0,Technical Failure
1937-06-20 00:00:00,Empresa Nacional de Transporte Aéreo - ENTA,Flight,Commercial,Costa Rica,Central America,6,1,1,5,5,6,0,Unknown
1937-08-12 00:00:00,Polyarnaya Aviatsiya,Flight,Business,Russia,Asia,6,6,6,0,0,6,0,Human Factor
1937-11-23 00:00:00,LOT Polish Airlines - Polskie Linie Lotnicze,Flight,Commercial,Bulgaria,Europe,6,3,3,3,3,6,0,Weather
1938-01-04 00:00:00,Deutsche Lufthansa,Landing (descent or approach),Commercial,Germany,Europe,6,3,3,3,3,6,0,Weather
1938-05-22 00:00:00,Cruzeiro do Sul,Takeoff (climb),Commercial,Brazil,South America,17,3,0,14,6,6,11,Unknown
1938-08-10 00:00:00,Dai Nippon Airlines,Landing (descent or approach),Commercial,Japan,Asia,6,3,3,3,3,6,0,Unknown
1938-11-03 00:00:00,Private French,Flight,Business,France,Europe,6,1,1,5,5,6,0,Unknown
1938-11-14 00:00:00,KLM Royal Dutch Airlines - Koninklijke Luchtvaart Maatschappij,Landing (descent or approach),Commercial,Netherlands,Europe,19,5,4,14,2,6,13,Human Factor
1939-01-27 00:00:00,Air France,Landing (descent or approach),Commercial,Germany,Europe,6,4,4,2,2,6,0,Human Factor
1939-02-12 00:00:00,Marine Airways,Flight,Commercial,United States of America,North America,6,1,1,5,5,6,0,Weather
1939-07-20 00:00:00,Swissair,Flight,Commercial,Germany,Europe,6,2,2,4,4,6,0,Technical Failure
1939-09-04 00:00:00,Royal Air Force - RAF,Flight,Military / Government,Germany,Europe,6,6,6,0,0,6,0,Terrorism
1939-12-14 00:00:00,Royal Air Force - RAF,Flight,Military / Government,Germany,Europe,6,6,6,0,0,6,0,Terrorism
1939-12-14 00:00:00,Royal Air Force - RAF,Flight,Military / Government,Germany,Europe,6,6,6,0,0,6,0,Terrorism
1939-12-14 00:00:00,Royal Air Force - RAF,Flight,Military / Government,Germany,Europe,6,6,6,0,0,6,0,Terrorism
1939-12-14 00:00:00,Royal Air Force - RAF,Flight,Military / Government,Germany,Europe,6,6,6,0,0,6,0,Terrorism
1939-12-14 00:00:00,Royal Air Force - RAF,Flight,Military / Government,Germany,Europe,6,6,6,0,0,6,0,Terrorism
1939-12-18 00:00:00,Royal Air Force - RAF,Flight,Military / Government,World,World,6,6,6,0,0,6,0,Terrorism
1939-12-18 00:00:00,Royal Air Force - RAF,Flight,Military / Government,Germany,Europe,6,6,6,0,0,6,0,Terrorism
1939-12-18 00:00:00,Royal Air Force - RAF,Flight,Military / Government,Germany,Europe,6,6,6,0,0,6,0,Terrorism
1939-12-18 00:00:00,Royal Air Force - RAF,Flight,Military / Government,Germany,Europe,6,6,6,0,0,6,0,Terrorism
1939-12-18 00:00:00,Royal Air Force - RAF,Flight,Military / Government,Germany,Europe,6,6,6,0,0,6,0,Terrorism
1940-01-02 00:00:00,Royal Air Force - RAF,Flight,Military / Government,World,World,6,6,6,0,0,6,0,Terrorism
1940-01-02 00:00:00,Royal Air Force - RAF,Flight,Military / Government,World,World,6,6,6,0,0,6,0,Terrorism
1940-02-21 00:00:00,Royal Air Force - RAF,Flight,Military / Government,World,World,6,6,6,0,0,6,0,Unknown
1940-03-02 00:00:00,Royal Air Force - RAF,Takeoff (climb),Military / Government,United Kingdom,Europe,6,6,6,0,0,6,0,Technical Failure
1940-03-03 00:00:00,Royal Air Force - RAF,Flight,Military / Government,United Kingdom,Europe,6,6,6,0,0,6,0,Weather
1940-04-07 00:00:00,Royal Air Force - RAF,Flight,Military / Government,World,World,6,6,6,0,0,6,0,Terrorism
1940-04-07 00:00:00,Royal Air Force - RAF,Flight,Military / Government,World,World,6,6,6,0,0,6,0,Terrorism
1940-04-12 00:00:00,Royal Air Force - RAF,Flight,Military / Government,Norway,Europe,6,6,6,0,0,6,0,Terrorism
1940-04-12 00:00:00,Royal Air Force - RAF,Flight,Military / Government,Norway,Europe,6,6,6,0,0,6,0,Terrorism
1940-04-12 00:00:00,Royal Air Force - RAF,Flight,Military / Government,Norway,Europe,6,6,6,0,0,6,0,Unknown
1940-04-12 00:00:00,Royal Air Force - RAF,Flight,Military / Government,Norway,Europe,6,6,6,0,0,6,0,Terrorism
1940-04-12 00:00:00,Royal Air Force - RAF,Flight,Military / Government,Norway,Europe,6,6,6,0,0,6,0,Unknown
1940-04-14 00:00:00,Royal Air Force - RAF,Flight,Military / Government,United Kingdom,Europe,6,6,6,0,0,6,0,Unknown
1940-04-18 00:00:00,Royal Air Force - RAF,Flight,Military / Government,World,World,6,6,6,0,0,6,0,Unknown
1940-04-30 00:00:00,Royal Air Force - RAF,Flight,Military / Government,World,World,6,6,6,0,0,6,0,Unknown
1940-04-30 00:00:00,Royal Air Force - RAF,Flight,Military / Government,Norway,Europe,6,6,6,0,0,6,0,Terrorism
1940-05-21 00:00:00,Royal Air Force - RAF,Flight,Military / Government,France,Europe,6,6,6,0,0,6,0,Unknown
1940-05-22 00:00:00,Royal Air Force - RAF,Flight,Military / Government,France,Europe,6,6,6,0,0,6,0,Unknown
1940-05-22 00:00:00,Royal Air Force - RAF,Flight,Military / Government,France,Europe,6,6,6,0,0,6,0,Unknown
1940-05-27 00:00:00,United States Army Air Corps - USAAC,Landing (descent or approach),Military / Government,United States of America,North America,7,2,2,5,4,6,1,Unknown
1940-05-29 00:00:00,German Air Force - Deutsche Luftwaffe,Flight,Military / Government,Norway,Europe,6,6,6,0,0,6,0,Terrorism
1940-06-11 00:00:00,Royal Air Force - RAF,Flight,Military / Government,World,World,6,6,6,0,0,6,0,Unknown
1940-06-14 00:00:00,Royal Air Force - RAF,Flight,Military / Government,France,Europe,6,6,6,0,0,6,0,Unknown
1940-07-12 00:00:00,Royal Air Force - RAF,Flight,Military / Government,World,World,6,6,6,0,0,6,0,Unknown
1940-07-20 00:00:00,Royal Air Force - RAF,Flight,Military / Government,Germany,Europe,6,6,6,0,0,6,0,Terrorism
1940-07-26 00:00:00,Royal Air Force - RAF,Flight,Military / Government,Netherlands,Europe,6,6,6,0,0,6,0,Terrorism
1940-08-12 00:00:00,Royal Australian Air Force - RAAF,Flight,Operational,Australia,Oceania,6,6,6,0,0,6,0,Unknown
1940-08-14 00:00:00,Royal Air Force - RAF,Flight,Operational,United Kingdom,Europe,6,6,6,0,0,6,0,Technical Failure
1940-08-30 00:00:00,Royal Air Force - RAF,Flight,Military / Government,Netherlands,Europe,6,6,6,0,0,6,0,Unknown
1940-09-09 00:00:00,Royal Air Force - RAF,Flight,Military / Government,World,World,6,6,6,0,0,6,0,Unknown
1940-10-24 00:00:00,Regia Aeronautica,Flight,Military / Government,Belgium,Europe,6,6,6,0,0,6,0,Unknown
1940-10-24 00:00:00,Royal Air Force - RAF,Flight,Military / Government,World,World,6,6,6,0,0,6,0,Unknown
1940-10-30 00:00:00,German Air Force - Deutsche Luftwaffe,Flight,Military / Government,Germany,Europe,6,3,3,3,3,6,0,Unknown
1940-11-16 00:00:00,Royal Air Force - RAF,Flight,Military / Government,Netherlands,Europe,6,6,6,0,0,6,0,Terrorism
1940-11-27 00:00:00,Air France,Flight,Operational,World,World,6,5,5,1,1,6,0,Terrorism
1940-11-30 00:00:00,Regia Aeronautica,Landing (descent or approach),Military / Government,Belgium,Europe,6,6,6,0,0,6,0,Unknown
1940-12-22 00:00:00,Royal Air Force - RAF,Flight,Military / Government,United Kingdom,Europe,6,6,6,0,0,6,0,Unknown
1941-02-21 00:00:00,Royal Australian Air Force - RAAF,Flight,Military / Government,Malaysia,Asia,6,6,6,0,0,6,0,Unknown
1941-02-24 00:00:00,Royal Air Force - RAF,Flight,Military / Government,France,Europe,6,6,6,0,0,6,0,Unknown
1941-03-14 00:00:00,Royal Air Force - RAF,Flight,Military / Government,Netherlands,Europe,6,6,6,0,0,6,0,Terrorism
1941-03-14 00:00:00,Aeroflot - Russian International Airlines,Flight,Operational,Uzbekistan,Asia,6,6,6,0,0,6,0,Weather
1941-04-13 00:00:00,Royal Air Force - RAF,Flight,Operational,United Kingdom,Europe,6,6,6,0,0,6,0,Weather
1941-05-12 00:00:00,Royal Air Force - RAF,Flight,Military / Government,Germany,Europe,6,6,6,0,0,6,0,Terrorism
1941-05-16 00:00:00,Royal Air Force - RAF,Flight,Military / Government,Germany,Europe,6,6,6,0,0,6,0,Technical Failure
1941-06-03 00:00:00,Great Western %26 Southern Air Lines,Flight,Commercial,United Kingdom,Europe,6,1,1,5,5,6,0,Terrorism
1941-06-17 00:00:00,Royal Air Force - RAF,Flight,Military / Government,Belgium,Europe,6,6,6,0,0,6,0,Technical Failure
1941-06-27 00:00:00,Royal Air Force - RAF,Flight,Military / Government,Germany,Europe,6,6,6,0,0,6,0,Unknown
1941-07-07 00:00:00,Royal Air Force - RAF,Flight,Military / Government,United Kingdom,Europe,6,2,2,4,4,6,0,Weather
1941-07-24 00:00:00,Royal Canadian Air Force - RCAF,Landing (descent or approach),Military / Government,Canada,North America,6,6,6,0,0,6,0,Human Factor
1941-08-13 00:00:00,Royal Air Force - RAF,Flight,Military / Government,Netherlands,Europe,6,6,6,0,0,6,0,Terrorism
1941-08-27 00:00:00,Aeroflot - Russian International Airlines,Landing (descent or approach),Operational,Turkmenistan,Asia,9,6,4,3,2,6,3,Human Factor
1941-09-09 00:00:00,United States Army Air Forces - USAAF,Flight,Military / Government,United States of America,North America,6,2,2,4,4,6,0,Human Factor
1941-10-02 00:00:00,United States Army Air Forces - USAAF,Flight,Military / Government,United States of America,North America,6,6,6,0,0,6,0,Unknown
1941-10-14 00:00:00,Royal Air Force - RAF,Flight,Military / Government,Belgium,Europe,7,7,6,0,0,6,1,Terrorism
1941-11-16 00:00:00,Royal Air Force - RAF,Flight,Military / Government,Netherlands,Europe,6,6,6,0,0,6,0,Terrorism
1941-12-21 00:00:00,German Air Force - Deutsche Luftwaffe,Flight,Military / Government,Spain,Europe,6,6,6,0,0,6,0,Human Factor
1941-12-29 00:00:00,Royal Netherlands Navy - Marineluchtvaartdienst,Flight,Humanitarian,Indonesia,Asia,6,6,6,0,0,6,0,Unknown
1942-01-10 00:00:00,Royal Netherlands Navy - Marineluchtvaartdienst,Flight,Military / Government,Indonesia,Asia,6,6,6,0,0,6,0,Unknown
1942-01-18 00:00:00,Royal Australian Air Force - RAAF,Takeoff (climb),Military / Government,Australia,Oceania,6,2,2,4,4,6,0,Unknown
1942-02-25 00:00:00,Royal Netherlands Navy - Marineluchtvaartdienst,Flight,Military / Government,Indonesia,Asia,6,6,6,0,0,6,0,Terrorism
1942-02-27 00:00:00,Royal Australian Air Force - RAAF,Landing (descent or approach),Specialised Services,Australia,Oceania,11,11,6,0,0,6,5,Unknown
1942-02-28 00:00:00,VARIG - Viação Aérea Rio Grandense,Takeoff (climb),Commercial,Brazil,South America,21,3,2,18,4,6,15,Unknown
1942-03-03 00:00:00,Royal Air Force - RAF,Flight,Military / Government,Netherlands,Europe,6,6,6,0,0,6,0,Terrorism
1942-03-21 00:00:00,Aeroflot - Russian International Airlines,Flight,Military / Government,Russia,Asia,6,6,6,0,0,6,0,Unknown
1942-04-06 00:00:00,United States Army Air Forces - USAAF,Flight,Military / Government,United States of America,North America,8,8,6,0,0,6,2,Technical Failure
1942-04-08 00:00:00,Royal Air Force - RAF,Flight,Operational,United Kingdom,Europe,6,6,6,0,0,6,0,Weather
1942-04-09 00:00:00,Royal Air Force - RAF,Flight,Military / Government,Germany,Europe,7,7,6,0,0,6,1,Unknown
1942-04-12 00:00:00,United States Navy - USN,Flight,Military / Government,United States of America,North America,7,7,6,0,0,6,1,Human Factor
1942-04-17 00:00:00,Royal Air Force - RAF,Flight,Military / Government,Germany,Europe,7,7,6,0,0,6,1,Terrorism
1942-05-24 00:00:00,United States Army Air Forces - USAAF,Flight,Military / Government,United States of America,North America,6,2,2,4,4,6,0,Human Factor
1942-06-25 00:00:00,Royal Air Force - RAF,Flight,Military / Government,Netherlands,Europe,6,6,6,0,0,6,0,Terrorism
1942-07-04 00:00:00,United States Army Air Forces - USAAF,Flight,Military / Government,Papua New Guinea,Oceania,6,6,6,0,0,6,0,Unknown
1942-07-18 00:00:00,United States Army Air Forces - USAAF,Flight,Other,United States of America,North America,6,6,6,0,0,6,0,Unknown
1942-07-25 00:00:00,Royal New Zealand Air Force - RNZAF,Landing (descent or approach),Military / Government,Tonga,Oceania,6,4,4,2,2,6,0,Human Factor
1942-08-10 00:00:00,Royal Air Force - RAF,Landing (descent or approach),Military / Government,United Kingdom,Europe,6,6,6,0,0,6,0,Unknown
1942-08-12 00:00:00,Aeroflot - Russian International Airlines,Flight,Military / Government,Russia,Asia,6,6,6,0,0,6,0,Terrorism
1942-08-14 00:00:00,German Air Force - Deutsche Luftwaffe,Flight,Military / Government,Iceland,Europe,6,6,6,0,0,6,0,Terrorism
1942-08-16 00:00:00,Royal Air Force - RAF,Flight,Military / Government,United Kingdom,Europe,6,6,6,0,0,6,0,Technical Failure
1942-09-02 00:00:00,United States Army Air Forces - USAAF,Takeoff (climb),Military / Government,United States of America,North America,6,6,6,0,0,6,0,Unknown
1942-09-29 00:00:00,Royal New Zealand Air Force - RNZAF,Flight,Operational,New Zealand,Oceania,7,7,6,0,0,6,1,Human Factor
1942-10-13 00:00:00,Royal Air Force - RAF,Landing (descent or approach),Operational,United Kingdom,Europe,6,6,6,0,0,6,0,Weather
1942-10-24 00:00:00,Avianca,Flight,Commercial,Colombia,South America,6,2,2,4,4,6,0,Unknown
1942-10-30 00:00:00,Royal Air Force - RAF,Flight,Military / Government,United Kingdom,Europe,7,7,6,0,0,6,1,Human Factor
1942-11-13 00:00:00,German Air Force - Deutsche Luftwaffe,Flight,Military / Government,Norway,Europe,6,4,4,2,2,6,0,Unknown
1942-12-13 00:00:00,United States Navy - USN,Flight,Military / Government,United States of America,North America,8,8,6,0,0,6,2,Unknown
1942-12-16 00:00:00,Royal Air Force - RAF,Flight,Military / Government,Libya,Africa,6,6,6,0,0,6,0,Terrorism
1943-01-21 00:00:00,United States Navy - USN,Flight,Military / Government,United States of America,North America,6,6,6,0,0,6,0,Unknown
1943-01-31 00:00:00,Royal Air Force - RAF,Flight,Military / Government,Myanmar,Asia,6,5,5,1,1,6,0,Unknown
1943-02-14 00:00:00,Royal Canadian Air Force - RCAF,Landing (descent or approach),Military / Government,Canada,North America,6,3,3,3,3,6,0,Unknown
1943-02-15 00:00:00,Royal Air Force - RAF,Flight,Military / Government,World,World,6,6,6,0,0,6,0,Terrorism
1943-02-17 00:00:00,Soviet Air Force - Voyenno-vozdushnye sily CCCP,Flight,Military / Government,Russia,Asia,6,6,6,0,0,6,0,Unknown
1943-02-21 00:00:00,Royal Air Force - RAF,Flight,Military / Government,Greece,Europe,6,6,6,0,0,6,0,Terrorism
1943-03-14 00:00:00,United States Navy - USN,Flight,Operational,United States of America,North America,6,6,6,0,0,6,0,Unknown
1943-03-23 00:00:00,Royal Canadian Air Force - RCAF,Flight,Military / Government,Canada,North America,6,6,6,0,0,6,0,Unknown
1943-03-29 00:00:00,LAN Chile - Linea Aérea Nacional de Chile,Flight,Commercial,Chile,South America,6,2,2,4,4,6,0,Human Factor
1943-04-12 00:00:00,United States Army Air Forces - USAAF,Flight,Military / Government,Papua New Guinea,Oceania,10,10,6,0,0,6,4,Terrorism
1943-04-25 00:00:00,Royal Air Force - RAF,Flight,Military / Government,World,World,6,6,6,0,0,6,0,Unknown
1943-04-28 00:00:00,Royal Australian Air Force - RAAF,Flight,Military / Government,World,World,6,6,6,0,0,6,0,Unknown
1943-04-29 00:00:00,Soviet Air Force - Voyenno-vozdushnye sily CCCP,Flight,Military / Government,Russia,Asia,6,6,6,0,0,6,0,Unknown
1943-05-01 00:00:00,Royal Air Force - RAF,Flight,Military / Government,Netherlands,Europe,7,7,6,0,0,6,1,Terrorism
1943-05-10 00:00:00,Royal Air Force - RAF,Flight,Military / Government,Egypt,Africa,6,6,6,0,0,6,0,Technical Failure
1943-05-14 00:00:00,Royal Air Force - RAF,Takeoff (climb),Military / Government,United Kingdom,Europe,8,8,6,0,0,6,2,Unknown
1943-05-17 00:00:00,Royal Air Force - RAF,Flight,Military / Government,Germany,Europe,7,7,6,0,0,6,1,Terrorism
1943-05-20 00:00:00,Aeroflot - Russian International Airlines,Landing (descent or approach),Military / Government,Russia,Asia,6,6,6,0,0,6,0,Human Factor
1943-05-30 00:00:00,United States Army Air Forces - USAAF,Flight,Operational,United States of America,North America,6,6,6,0,0,6,0,Weather
1943-06-09 00:00:00,Soviet Air Force - Voyenno-vozdushnye sily CCCP,Takeoff (climb),Military / Government,Russia,Asia,8,3,2,5,4,6,2,Human Factor
1943-06-26 00:00:00,Royal Air Force - RAF,Flight,Military / Government,Netherlands,Europe,7,7,6,0,0,6,1,Terrorism
1943-07-10 00:00:00,United States Army Air Forces - USAAF,Landing (descent or approach),Military / Government,United States of America,North America,19,4,3,15,3,6,13,Unknown
1943-07-11 00:00:00,Royal Air Force - RAF,Takeoff (climb),Military / Government,Tunisia,Africa,6,4,4,2,2,6,0,Technical Failure
1943-07-11 00:00:00,United States Army Air Forces - USAAF,Flight,Military / Government,Italy,Europe,6,6,6,0,0,6,0,Terrorism
1943-07-13 00:00:00,Royal Air Force - RAF,Flight,Military / Government,Bahamas,Central America,6,6,6,0,0,6,0,Unknown
1943-08-04 00:00:00,Tata Airlines,Flight,Commercial,India,Asia,6,3,3,3,3,6,0,Unknown
1943-08-07 00:00:00,United States Army Air Forces - USAAF,Flight,Operational,India,Asia,6,6,6,0,0,6,0,Unknown
1943-08-08 00:00:00,Aeroflot - Russian International Airlines,Takeoff (climb),Operational,Russia,Asia,6,6,6,0,0,6,0,Human Factor
1943-08-15 00:00:00,Royal Air Force - RAF,Flight,Military / Government,France,Europe,7,7,6,0,0,6,1,Technical Failure
1943-08-15 00:00:00,United States Army Air Forces - USAAF,Landing (descent or approach),Military / Government,Papua New Guinea,Oceania,6,4,4,2,2,6,0,Terrorism
1943-08-27 00:00:00,Aeroflot - Russian International Airlines,Flight,Military / Government,Russia,Asia,6,6,6,0,0,6,0,Terrorism
1943-08-29 00:00:00,United States Navy - USN,Flight,Operational,United States of America,North America,6,6,6,0,0,6,0,Unknown
1943-09-05 00:00:00,United States Army Air Forces - USAAF,Landing (descent or approach),Operational,United States of America,North America,7,7,6,0,0,6,1,Weather
1943-09-14 00:00:00,Aeroflot - Russian International Airlines,Flight,Military / Government,Belarus,Europe,6,6,6,0,0,6,0,Terrorism
1943-09-24 00:00:00,United States Navy - USN,Landing (descent or approach),Operational,United States of America,North America,6,6,6,0,0,6,0,Unknown
1943-10-03 00:00:00,United States Army Air Forces - USAAF,Takeoff (climb),Military / Government,China,Asia,6,6,6,0,0,6,0,Other
1943-10-12 00:00:00,United States Navy - USN,Takeoff (climb),Military / Government,Suriname,South America,6,6,6,0,0,6,0,Unknown
1943-10-16 00:00:00,United States Navy - USN,Flight,Military / Government,Papua New Guinea,Oceania,6,6,6,0,0,6,0,Unknown
1943-10-27 00:00:00,United States Army Air Forces - USAAF,Landing (descent or approach),Operational,United States of America,North America,6,6,6,0,0,6,0,Human Factor
1943-11-04 00:00:00,United States Navy - USN,Takeoff (climb),Military / Government,Morocco,Africa,6,6,6,0,0,6,0,Unknown
1943-11-13 00:00:00,Royal Air Force - RAF,Flight,Military / Government,United Kingdom,Europe,6,6,6,0,0,6,0,Weather
1943-11-28 00:00:00,United States Navy - USN,Takeoff (climb),Operational,United States of America,North America,10,10,6,0,0,6,4,Unknown
1943-12-18 00:00:00,United States Navy - USN,Flight,Operational,United States of America,North America,12,12,6,0,0,6,6,Unknown
1943-12-23 00:00:00,United States Army Air Forces - USAAF,Flight,Military / Government,Papua New Guinea,Oceania,6,6,6,0,0,6,0,Unknown
1943-12-30 00:00:00,United States Navy - USN,Flight,Military / Government,World,World,6,6,6,0,0,6,0,Unknown
1944-01-18 00:00:00,Royal Air Force - RAF,Flight,Operational,United Kingdom,Europe,6,6,6,0,0,6,0,Unknown
1944-01-21 00:00:00,Royal Air Force - RAF,Flight,Operational,United Kingdom,Europe,6,6,6,0,0,6,0,Unknown
1944-01-22 00:00:00,United States Navy - USN,Takeoff (climb),Military / Government,Vanuatu,Oceania,9,9,6,0,0,6,3,Unknown
1944-01-24 00:00:00,United States Army Air Forces - USAAF,Flight,Military / Government,United States of America,North America,6,6,6,0,0,6,0,Unknown
1944-02-12 00:00:00,Aeroflot - Russian International Airlines,Takeoff (climb),Operational,Russia,Asia,6,4,4,2,2,6,0,Human Factor
1944-02-17 00:00:00,Aeroflot - Russian International Airlines,Flight,Military / Government,Estonia,Europe,6,6,6,0,0,6,0,Unknown
1944-02-25 00:00:00,Private French,Flight,Business,Morocco,Africa,6,2,2,4,4,6,0,Unknown
1944-03-02 00:00:00,United States Army Air Forces - USAAF,Flight,Operational,United Kingdom,Europe,6,6,6,0,0,6,0,Unknown
1944-03-06 00:00:00,Royal Netherlands East Indies Air Force - ML-KNIL,Flight,Military / Government,Indonesia,Asia,6,6,6,0,0,6,0,Unknown
1944-03-08 00:00:00,United States Army Air Forces - USAAF,Flight,Military / Government,United Kingdom,Europe,6,6,6,0,0,6,0,Unknown
1944-03-08 00:00:00,United States Army Air Forces - USAAF,Flight,Military / Government,United Kingdom,Europe,6,6,6,0,0,6,0,Unknown
1944-03-15 00:00:00,Royal Air Force - RAF,Flight,Military / Government,Switzerland,Europe,7,7,6,0,0,6,1,Terrorism
1944-03-18 00:00:00,United States Army Air Forces - USAAF,Flight,Military / Government,Germany,Europe,10,10,6,0,0,6,4,Terrorism
1944-03-19 00:00:00,United States Army Air Forces - USAAF,Flight,Military / Government,France,Europe,6,6,6,0,0,6,0,Terrorism
1944-03-25 00:00:00,United States Army Air Forces - USAAF,Flight,Military / Government,World,World,6,6,6,0,0,6,0,Terrorism
1944-04-05 00:00:00,Royal Air Force - RAF,Flight,Operational,United Kingdom,Europe,6,6,6,0,0,6,0,Technical Failure
1944-04-06 00:00:00,Pan American World Airways - PAA,Takeoff (climb),Commercial,United States of America,North America,6,3,3,3,3,6,0,Human Factor
1944-04-21 00:00:00,Royal Air Force - RAF,Flight,Operational,United Kingdom,Europe,7,7,6,0,0,6,1,Unknown
1944-04-25 00:00:00,Royal Air Force - RAF,Flight,Military / Government,United Kingdom,Europe,7,7,6,0,0,6,1,Terrorism
1944-05-05 00:00:00,United States Army Air Forces - USAAF,Flight,Operational,United States of America,North America,8,8,6,0,0,6,2,Unknown
1944-05-06 00:00:00,United States Army Air Forces - USAAF,Landing (descent or approach),Operational,United States of America,North America,6,6,6,0,0,6,0,Human Factor
1944-05-14 00:00:00,Soviet Air Force - Voyenno-vozdushnye sily CCCP,Flight,Specialised Services,Russia,Asia,6,6,6,0,0,6,0,Unknown
1944-05-14 00:00:00,Soviet Air Force - Voyenno-vozdushnye sily CCCP,Flight,Specialised Services,Russia,Asia,6,6,6,0,0,6,0,Unknown
1944-05-21 00:00:00,United States Navy - USN,Flight,Military / Government,World,World,8,8,6,0,0,6,2,Unknown
1944-05-22 00:00:00,Royal Air Force - RAF,Flight,Military / Government,Netherlands,Europe,7,7,6,0,0,6,1,Terrorism
1944-05-22 00:00:00,Royal Air Force - RAF,Flight,Military / Government,Netherlands,Europe,7,7,6,0,0,6,1,Terrorism
1944-06-06 00:00:00,United States Army Air Forces - USAAF,Flight,Military / Government,United Kingdom,Europe,6,6,6,0,0,6,0,Unknown
1944-06-06 00:00:00,United States Army Air Forces - USAAF,Flight,Military / Government,United Kingdom,Europe,6,6,6,0,0,6,0,Unknown
1944-06-06 00:00:00,United States Army Air Forces - USAAF,Flight,Military / Government,United Kingdom,Europe,6,6,6,0,0,6,0,Unknown
1944-06-08 00:00:00,China National Aviation Corporation - CNAC,Landing (descent or approach),Operational,China,Asia,6,3,3,3,3,6,0,Human Factor
1944-06-13 00:00:00,Royal Air Force - RAF,Flight,Military / Government,Netherlands,Europe,7,7,6,0,0,6,1,Terrorism
1944-06-13 00:00:00,Royal Air Force - RAF,Flight,Operational,United Kingdom,Europe,6,6,6,0,0,6,0,Unknown
1944-06-13 00:00:00,Royal Air Force - RAF,Flight,Military / Government,Netherlands,Europe,7,7,6,0,0,6,1,Terrorism
1944-06-23 00:00:00,Royal Netherlands East Indies Air Force - ML-KNIL,Flight,Military / Government,Timor Leste,Asia,6,6,6,0,0,6,0,Terrorism
1944-07-01 00:00:00,United States Navy - USN,Takeoff (climb),Operational,Bahamas,Central America,6,6,6,0,0,6,0,Human Factor
1944-07-13 00:00:00,Aeroflot - Russian International Airlines,Flight,Military / Government,Belarus,Europe,6,6,6,0,0,6,0,Human Factor
1944-07-18 00:00:00,United States Army Air Forces - USAAF,Flight,Operational,United States of America,North America,6,6,6,0,0,6,0,Unknown
1944-07-20 00:00:00,Aeroflot - Russian International Airlines,Flight,Operational,Kazakhstan,Asia,6,4,4,2,2,6,0,Human Factor
1944-07-24 00:00:00,United States Army Air Forces - USAAF,Flight,Military / Government,World,World,6,6,6,0,0,6,0,Unknown
1944-07-24 00:00:00,United States Army Air Forces - USAAF,Flight,Military / Government,Myanmar,Asia,6,5,5,1,1,6,0,Weather
1944-08-09 00:00:00,Royal Air Force - RAF,Flight,Military / Government,France,Europe,6,6,6,0,0,6,0,Terrorism
1944-09-13 00:00:00,Royal Air Force - RAF,Takeoff (climb),Military / Government,Italy,Europe,6,6,6,0,0,6,0,Human Factor
1944-09-13 00:00:00,Royal Air Force - RAF,Takeoff (climb),Military / Government,Italy,Europe,6,6,6,0,0,6,0,Human Factor
1944-09-15 00:00:00,United States Navy - USN,Landing (descent or approach),Military / Government,United States of America,North America,8,8,6,0,0,6,2,Human Factor
1944-09-18 00:00:00,Faucett,Flight,Commercial,Peru,South America,6,1,1,5,5,6,0,Unknown
1944-09-19 00:00:00,Royal Air Force - RAF,Flight,Military / Government,Netherlands,Europe,8,8,6,0,0,6,2,Terrorism
1944-09-21 00:00:00,Royal Air Force - RAF,Takeoff (climb),Military / Government,Italy,Europe,6,6,6,0,0,6,0,Unknown
1944-09-30 00:00:00,United States Army Air Forces - USAAF,Flight,Operational,United States of America,North America,6,6,6,0,0,6,0,Unknown
1944-10-04 00:00:00,Royal Air Force - RAF,Flight,Operational,United Kingdom,Europe,7,7,6,0,0,6,1,Technical Failure
1944-10-19 00:00:00,Royal Air Force - RAF,Flight,Operational,United Kingdom,Europe,7,7,6,0,0,6,1,Human Factor
1944-10-20 00:00:00,United States Army Air Forces - USAAF,Flight,Military / Government,Sweden,Europe,6,6,6,0,0,6,0,Unknown
1944-10-29 00:00:00,Soviet Air Force - Voyenno-vozdushnye sily CCCP,Flight,Military / Government,Russia,Asia,7,7,6,0,0,6,1,Unknown
1944-10-30 00:00:00,United States Army Air Forces - USAAF,Flight,Military / Government,France,Europe,6,6,6,0,0,6,0,Weather
1944-11-24 00:00:00,United States Army Air Forces - USAAF,Flight,Military / Government,Indonesia,Asia,6,4,4,2,2,6,0,Weather
1944-12-21 00:00:00,Aeroflot - Russian International Airlines,Flight,Military / Government,Poland,Europe,6,6,6,0,0,6,0,Terrorism
1944-12-22 00:00:00,United States Army Air Forces - USAAF,Flight,Military / Government,United Kingdom,Europe,7,4,3,3,3,6,1,Weather
1944-12-25 00:00:00,United States Navy - USN,Landing (descent or approach),Military / Government,United States of America,North America,10,10,6,0,0,6,4,Unknown
1945-01-06 00:00:00,Royal Air Force - RAF,Flight,Operational,United Kingdom,Europe,6,6,6,0,0,6,0,Human Factor
1945-01-07 00:00:00,United States Army Air Forces - USAAF,Flight,Military / Government,Myanmar,Asia,6,6,6,0,0,6,0,Unknown
1945-01-13 00:00:00,Aeroflot - Russian International Airlines,Landing (descent or approach),Operational,Russia,Asia,6,5,5,1,1,6,0,Human Factor
1945-01-22 00:00:00,Aeroflot - Russian International Airlines,Flight,Commercial,Russia,Asia,6,4,4,2,2,6,0,Human Factor
1945-02-01 00:00:00,Royal Air Force - RAF,Landing (descent or approach),Other,United Kingdom,Europe,9,9,6,0,0,6,3,Weather
1945-02-06 00:00:00,United States Army Air Forces - USAAF,Flight,Military / Government,France,Europe,6,6,6,0,0,6,0,Unknown
1945-02-14 00:00:00,United States Army Air Forces - USAAF,Flight,Military / Government,Philippines,Asia,6,6,6,0,0,6,0,Unknown
1945-02-17 00:00:00,Royal Australian Air Force - RAAF,Flight,Military / Government,Papua New Guinea,Oceania,8,6,4,2,2,6,2,Unknown
1945-02-27 00:00:00,United States Navy - USN,Landing (descent or approach),Military / Government,World,World,9,9,6,0,0,6,3,Weather
1945-03-12 00:00:00,United States Army Air Forces - USAAF,Takeoff (climb),Military / Government,Philippines,Asia,6,6,6,0,0,6,0,Unknown
1945-03-13 00:00:00,United States Army Air Forces - USAAF,Flight,Military / Government,United States of America,North America,6,6,6,0,0,6,0,Weather
1945-04-03 00:00:00,United States Army Air Forces - USAAF,Flight,Military / Government,Germany,Europe,6,2,2,4,4,6,0,Terrorism
1945-04-22 00:00:00,Royal Air Force - RAF,Takeoff (climb),Military / Government,United Kingdom,Europe,6,6,6,0,0,6,0,Unknown
1945-04-27 00:00:00,Page Airways,Takeoff (climb),Commercial,United States of America,North America,13,2,0,11,6,6,7,Technical Failure
1945-04-28 00:00:00,Royal Air Force - RAF,Flight,Military / Government,World,World,6,5,5,1,1,6,0,Unknown
1945-05-03 00:00:00,Royal Air Force - RAF,Flight,Military / Government,Myanmar,Asia,6,6,6,0,0,6,0,Unknown
1945-05-05 00:00:00,United States Army Air Forces - USAAF,Landing (descent or approach),Military / Government,Australia,Oceania,6,4,4,2,2,6,0,Human Factor
1945-05-18 00:00:00,Royal Air Force - RAF,Flight,Operational,United Kingdom,Europe,6,6,6,0,0,6,0,Human Factor
1945-05-22 00:00:00,Royal Air Force - RAF,Flight,Military / Government,Myanmar,Asia,6,6,6,0,0,6,0,Unknown
1945-06-09 00:00:00,Royal New Zealand Air Force - RNZAF,Flight,Military / Government,Papua New Guinea,Oceania,6,6,6,0,0,6,0,Unknown
1945-06-13 00:00:00,Royal Air Force - RAF,Flight,Military / Government,India,Asia,7,5,4,2,2,6,1,Technical Failure
1945-06-13 00:00:00,United States Army Air Forces - USAAF,Flight,Military / Government,World,World,6,6,6,0,0,6,0,Unknown
1945-06-21 00:00:00,Royal Canadian Air Force - RCAF,Flight,Military / Government,Myanmar,Asia,6,6,6,0,0,6,0,Unknown
1945-06-27 00:00:00,United States Army Air Forces - USAAF,Flight,Military / Government,Myanmar,Asia,6,4,4,2,2,6,0,Unknown
1945-06-30 00:00:00,Royal Canadian Air Force - RCAF,Takeoff (climb),Military / Government,Canada,North America,11,11,6,0,0,6,5,Human Factor
1945-07-03 00:00:00,Royal Canadian Air Force - RCAF,Takeoff (climb),Operational,Canada,North America,11,11,6,0,0,6,5,Human Factor
1945-07-08 00:00:00,Royal Air Force - RAF,Landing (descent or approach),Military / Government,Kenya,Africa,6,6,6,0,0,6,0,Human Factor
1945-07-14 00:00:00,Royal Air Force - RAF,Flight,Operational,United Kingdom,Europe,7,7,6,0,0,6,1,Weather
1945-07-26 00:00:00,Royal Air Force - RAF,Flight,Operational,India,Asia,6,6,6,0,0,6,0,Human Factor
1945-08-02 00:00:00,United States Navy - USN,Flight,Operational,United States of America,North America,6,6,6,0,0,6,0,Unknown
1945-08-13 00:00:00,United States Army Air Forces - USAAF,Flight,Military / Government,Japan,Asia,7,7,6,0,0,6,1,Terrorism
1945-08-28 00:00:00,Royal New Zealand Air Force - RNZAF,Flight,Military / Government,Papua New Guinea,Oceania,6,6,6,0,0,6,0,Human Factor
1945-09-10 00:00:00,Faucett,Takeoff (climb),Commercial,Peru,South America,6,2,2,4,4,6,0,Unknown
1945-09-28 00:00:00,United States Army Air Forces - USAAF,Flight,Military / Government,China,Asia,6,4,4,2,2,6,0,Weather
1945-10-05 00:00:00,United States Army Air Forces - USAAF,Flight,Military / Government,China,Asia,6,4,4,2,2,6,0,Unknown
1945-10-06 00:00:00,Royal Air Force - RAF,Flight,Military / Government,Myanmar,Asia,6,6,6,0,0,6,0,Technical Failure
1945-10-13 00:00:00,Soviet Air Force - Voyenno-vozdushnye sily CCCP,Flight,Military / Government,Poland,Europe,6,6,6,0,0,6,0,Unknown
1945-10-13 00:00:00,United States Army Air Forces - USAAF,Flight,Military / Government,World,World,6,6,6,0,0,6,0,Unknown
1945-10-27 00:00:00,United States Army Air Forces - USAAF,Flight,Military / Government,United States of America,North America,10,2,0,8,6,6,4,Technical Failure
1945-11-14 00:00:00,Royal Air Force - RAF,Landing (descent or approach),Operational,Libya,Africa,6,6,6,0,0,6,0,Human Factor
1945-12-04 00:00:00,Aktiebolaget Aerotransport - ABA,Landing (descent or approach),Operational,Sweden,Europe,6,6,6,0,0,6,0,Human Factor
1946-02-01 00:00:00,Royal Air Force - RAF,Flight,Operational,United Kingdom,Europe,6,6,6,0,0,6,0,Weather
1946-02-03 00:00:00,Royal Air Force - RAF,Flight,Military / Government,United Kingdom,Europe,6,3,3,3,3,6,0,Human Factor
1946-02-04 00:00:00,Royal Air Force - RAF,Flight,Operational,United Kingdom,Europe,6,6,6,0,0,6,0,Weather
1946-02-21 00:00:00,Royal Air Force - RAF,Flight,Specialised Services,United Kingdom,Europe,6,6,6,0,0,6,0,Unknown
1946-03-31 00:00:00,United States Navy - USN,Landing (descent or approach),Military / Government,New Caledonia,Oceania,6,2,2,4,4,6,0,Unknown
1946-04-01 00:00:00,Railway Air Services,Landing (descent or approach),Commercial,United Kingdom,Europe,6,2,2,4,4,6,0,Human Factor
1946-04-02 00:00:00,Aeroflot - Russian International Airlines,Flight,Commercial,Russia,Asia,6,4,4,2,2,6,0,Human Factor
1946-06-25 00:00:00,Royal Air Force - RAF,Landing (descent or approach),Operational,United Kingdom,Europe,6,4,4,2,2,6,0,Technical Failure
1946-06-27 00:00:00,Royal Air Force - RAF,Flight,Operational,United Kingdom,Europe,6,6,6,0,0,6,0,Human Factor
1946-07-08 00:00:00,Royal Air Force - RAF,Takeoff (climb),Operational,United Kingdom,Europe,6,6,6,0,0,6,0,Human Factor
1946-08-07 00:00:00,United States Navy - USN,Flight,Operational,United States of America,North America,6,6,6,0,0,6,0,Unknown
1946-08-24 00:00:00,Misrair,Takeoff (climb),Commercial,Egypt,Africa,9,2,2,7,4,6,3,Unknown
1946-09-06 00:00:00,Aeroflot - Russian International Airlines,Landing (descent or approach),Operational,Turkmenistan,Asia,6,4,4,2,2,6,0,Human Factor
1946-09-20 00:00:00,United States Navy - USN,Takeoff (climb),Military / Government,Mexico,Central America,6,6,6,0,0,6,0,Unknown
1946-11-20 00:00:00,Royal Air Force - RAF,Landing (descent or approach),Military / Government,Egypt,Africa,6,6,6,0,0,6,0,Human Factor
1947-03-01 00:00:00,Guinea Air Traders,Landing (descent or approach),Commercial,Papua New Guinea,Oceania,6,1,1,5,5,6,0,Human Factor
1947-03-20 00:00:00,United States Army Air Forces - USAAF,Flight,Military / Government,Ethiopia,Africa,6,4,4,2,2,6,0,Unknown
1947-04-10 00:00:00,Belgian Air Force - Force Aérienne Belge - Belgische Luchtmacht,Flight,Military / Government,United Kingdom,Europe,6,3,3,3,3,6,0,Unknown
1947-04-13 00:00:00,British South American Airways - BSAA,Landing (descent or approach),Commercial,Senegal,Africa,15,6,0,9,6,6,9,Human Factor
1947-05-19 00:00:00,United States Army Air Forces - USAAF,Flight,Military / Government,Canada,North America,6,6,6,0,0,6,0,Unknown
1947-05-28 00:00:00,Royal Netherlands Air Force - Koninklijke Luchtmacht,Takeoff (climb),Operational,Netherlands,Europe,6,6,6,0,0,6,0,Human Factor
1947-05-28 00:00:00,Royal Netherlands Air Force - Koninklijke Luchtmacht,Takeoff (climb),Operational,Netherlands,Europe,6,6,6,0,0,6,0,Human Factor
1947-06-25 00:00:00,United States Army Air Forces - USAAF,Flight,Military / Government,Philippines,Asia,6,2,2,4,4,6,0,Human Factor
1947-07-03 00:00:00,United States Army Air Forces - USAAF,Flight,Military / Government,World,World,6,6,6,0,0,6,0,Weather
1947-07-16 00:00:00,British Overseas Airways Corporation - BOAC,Landing (descent or approach),Commercial,Iraq,Asia,18,6,6,12,0,6,12,Human Factor
1947-07-26 00:00:00,Brazilian Air Force - Força Aérea Brasileira,Flight,Operational,Brazil,South America,6,6,6,0,0,6,0,Unknown
1947-08-05 00:00:00,SATA Air Açores,Takeoff (climb),Commercial,Portugal,Europe,6,1,1,5,5,6,0,Unknown
1947-09-17 00:00:00,Hellenic Air Force - Elleniki Polemiki Aeroporia,Flight,Military / Government,Greece,Europe,6,6,6,0,0,6,0,Unknown
1947-10-04 00:00:00,French Air Force - Armée de l'Air,Takeoff (climb),Military / Government,Madagascar,Africa,7,2,2,5,4,6,1,Human Factor
1947-10-25 00:00:00,Institut Géographique National,Flight,Specialised Services,France,Europe,6,4,4,2,2,6,0,Human Factor
1947-11-17 00:00:00,United States Air Force - USAF,Flight,Military / Government,United States of America,North America,6,6,6,0,0,6,0,Unknown
1947-12-16 00:00:00,United States Navy - USN,Flight,Operational,United States of America,North America,7,7,6,0,0,6,1,Human Factor
1947-12-30 00:00:00,Aeroflot - Russian International Airlines,Flight,Operational,Russia,Asia,6,4,4,2,2,6,0,Human Factor
1948-03-13 00:00:00,Cruzeiro do Sul,Flight,Commercial,Brazil,South America,6,3,3,3,3,6,0,Unknown
1948-06-10 00:00:00,Hargreaves Airways,Landing (descent or approach),Commercial,United Kingdom,Europe,8,2,2,6,4,6,2,Human Factor
1948-07-14 00:00:00,British Overseas Airways Corporation - BOAC,Landing (descent or approach),Operational,France,Europe,6,4,4,2,2,6,0,Weather
1948-07-21 00:00:00,Royal Netherlands Air Force - Koninklijke Luchtmacht,Flight,Military / Government,United Kingdom,Europe,6,6,6,0,0,6,0,Human Factor
1948-07-27 00:00:00,United States Air Force - USAF,Takeoff (climb),Military / Government,Yemen,Asia,6,6,6,0,0,6,0,Unknown
1948-09-04 00:00:00,Aeroflot - Russian International Airlines,Takeoff (climb),Commercial,Russia,Asia,25,5,1,20,5,6,19,Human Factor
1948-10-01 00:00:00,Indonesian Air Force - TNI-AU Tentara Nasional Indonesia - Angkatan Udara,Takeoff (climb),Military / Government,Indonesia,Asia,6,5,5,1,1,6,0,Unknown
1948-11-01 00:00:00,Polyarnaya Aviatsiya,Landing (descent or approach),Operational,Russia,Asia,6,6,6,0,0,6,0,Technical Failure
1949-01-07 00:00:00,United States Air Force - USAF,Landing (descent or approach),Military / Government,United Kingdom,Europe,6,4,4,2,2,6,0,Human Factor
1949-02-02 00:00:00,Saint Lawrence Airways,Takeoff (climb),Commercial,Canada,North America,10,2,2,8,4,6,4,Unknown
1949-03-05 00:00:00,United States Air Force - USAF,Takeoff (climb),Military / Government,Japan,Asia,22,2,0,20,6,6,16,Unknown
1949-04-23 00:00:00,Union of Burma Airways,Flight,Commercial,Myanmar,Asia,6,2,2,4,4,6,0,Unknown
1949-09-17 00:00:00,Royal Air Force - RAF,Landing (descent or approach),Operational,United Kingdom,Europe,6,6,6,0,0,6,0,Human Factor
1949-10-01 00:00:00,SNCASE - Société Nationale de Constructions Aéronautiques du Sud-Est,Flight,Specialised Services,France,Europe,6,6,6,0,0,6,0,Other
1949-10-06 00:00:00,Indian Air Force - Bharatiya Vayu Sena,Flight,Military / Government,Turkey,Asia,8,8,6,0,0,6,2,Technical Failure
1949-10-25 00:00:00,Argentinian Air Force - Fuerza Aérea Argentina,Flight,Military / Government,Argentina,South America,9,5,3,4,3,6,3,Technical Failure
1949-10-28 00:00:00,Superior Oil Corporation,Takeoff (climb),Business,United Kingdom,Europe,7,3,2,4,4,6,1,Unknown
1949-11-09 00:00:00,Lineas Aéreas de Transporte Nacional - LATN,Takeoff (climb),Commercial,Paraguay,South America,6,1,1,5,5,6,0,Unknown
1949-11-14 00:00:00,Maszovlet,Landing (descent or approach),Commercial,Hungary,Europe,7,6,5,1,1,6,1,Human Factor
1949-11-22 00:00:00,United States Air Force - USAF,Flight,Military / Government,United States of America,North America,6,6,6,0,0,6,0,Human Factor
1949-12-02 00:00:00,Bataafse Petroleum Maatschappij - BPM,Landing (descent or approach),Military / Government,Indonesia,Asia,11,5,4,6,2,6,5,Unknown
1949-12-12 00:00:00,Capital Airlines,Landing (descent or approach),Commercial,United States of America,North America,23,3,2,20,4,6,17,Human Factor
1949-12-19 00:00:00,Aerovias Brasil,Flight,Operational,Brazil,South America,6,3,3,3,3,6,0,Unknown
1950-03-15 00:00:00,Royal Air Force - RAF,Flight,Military / Government,United Kingdom,Europe,6,6,6,0,0,6,0,Human Factor
1950-03-23 00:00:00,Royal Air Force - RAF,Landing (descent or approach),Operational,United Kingdom,Europe,6,6,6,0,0,6,0,Human Factor
1950-03-26 00:00:00,North American Aviation,Flight,Business,United States of America,North America,6,6,6,0,0,6,0,Technical Failure
1950-04-16 00:00:00,Worldair Carriers,Flight,Operational,Switzerland,Europe,6,5,5,1,1,6,0,Human Factor
1950-05-07 00:00:00,Royal Australian Air Force - RAAF,Landing (descent or approach),Military / Government,Australia,Oceania,7,7,6,0,0,6,1,Technical Failure
1950-05-22 00:00:00,Bulgarian Air Force - Bulgarski Voennov Azdushni Sili,Flight,Military / Government,Bulgaria,Europe,7,7,6,0,0,6,1,Weather
1950-07-29 00:00:00,United States Air Force - USAF,Flight,Operational,United States of America,North America,6,5,5,1,1,6,0,Human Factor
1950-10-13 00:00:00,Northwest Airlines,Flight,Operational,United States of America,North America,6,3,3,3,3,6,0,Technical Failure
1950-11-16 00:00:00,United States Air Force - USAF,Flight,Operational,United States of America,North America,10,10,6,0,0,6,4,Human Factor
1950-12-09 00:00:00,Air Atlas,Flight,Commercial,France,Europe,9,3,3,6,3,6,3,Human Factor
1951-01-09 00:00:00,Aeroflot - Russian International Airlines,Landing (descent or approach),Operational,Russia,Asia,6,5,5,1,1,6,0,Human Factor
1951-01-11 00:00:00,United States Air Force - USAF,Landing (descent or approach),Operational,United States of America,North America,11,11,6,0,0,6,5,Technical Failure
1951-04-22 00:00:00,United States Navy - USN,Flight,Operational,Japan,Asia,6,6,6,0,0,6,0,Technical Failure
1951-04-30 00:00:00,United States Air Force - USAF,Flight,Military / Government,North Korea,Asia,6,6,6,0,0,6,0,Terrorism
1951-06-08 00:00:00,French Navy,Takeoff (climb),Military / Government,Morocco,Africa,6,6,6,0,0,6,0,Unknown
1951-08-02 00:00:00,French Air Force - Armée de l'Air,Takeoff (climb),Military / Government,Vietnam,Asia,13,2,0,11,6,6,7,Unknown
1951-08-13 00:00:00,United States Air Force - USAF,Takeoff (climb),Specialised Services,United States of America,North America,6,6,6,0,0,6,0,Unknown
1951-08-13 00:00:00,Royal Air Force - RAF,Flight,Operational,United Kingdom,Europe,7,7,6,0,0,6,1,Human Factor
1951-09-25 00:00:00,Czech Air Force - Ceské Vojenské Letectvo,Flight,Military / Government,Czech Republic,Europe,6,6,6,0,0,6,0,Unknown
1951-10-01 00:00:00,Aeroflot - Russian International Airlines,Flight,Commercial,Russia,Asia,15,4,4,11,2,6,9,Human Factor
1951-10-30 00:00:00,United States Air Force - USAF,Landing (descent or approach),Military / Government,United States of America,North America,6,2,2,4,4,6,0,Human Factor
1951-11-23 00:00:00,Royal Canadian Air Force - RCAF,Takeoff (climb),Military / Government,Canada,North America,7,2,2,5,4,6,1,Human Factor
1951-11-24 00:00:00,El Al Israel Airlines,Landing (descent or approach),Operational,Switzerland,Europe,7,7,6,0,0,6,1,Human Factor
1951-12-25 00:00:00,Turkish Air Force - Türk Hava Kuvvetleri,Takeoff (climb),Military / Government,Turkey,Asia,6,6,6,0,0,6,0,Weather
1952-01-01 00:00:00,Air France,Flight,Commercial,Madagascar,Africa,11,3,0,8,6,6,5,Unknown
1952-01-05 00:00:00,United States Air Force - USAF,Taxiing,Military / Government,United Kingdom,Europe,10,10,6,0,0,6,4,Unknown
1952-04-04 00:00:00,United States Air Force - USAF,Landing (descent or approach),Operational,United States of America,North America,6,6,6,0,0,6,0,Human Factor
1952-04-05 00:00:00,Aeroflot - Russian International Airlines,Takeoff (climb),Operational,Russia,Asia,6,6,6,0,0,6,0,Technical Failure
1952-04-14 00:00:00,United States Navy - USN,Landing (descent or approach),Operational,United States of America,North America,10,10,6,0,0,6,4,Human Factor
1952-05-24 00:00:00,Loide Aéreo Nacional,Takeoff (climb),Operational,Brazil,South America,6,6,6,0,0,6,0,Technical Failure
1952-06-14 00:00:00,Morton Air Services,Flight,Commercial,United Kingdom,Europe,8,1,1,7,5,6,2,Technical Failure
1952-07-22 00:00:00,Royal Canadian Air Force - RCAF,Flight,Operational,Canada,North America,6,6,6,0,0,6,0,Unknown
1952-07-23 00:00:00,Brazilian Air Force - Força Aérea Brasileira,Flight,Operational,Brazil,South America,8,8,6,0,0,6,2,Unknown
1952-09-28 00:00:00,Polyarnaya Aviatsiya,Landing (descent or approach),Military / Government,Russia,Asia,6,4,4,2,2,6,0,Human Factor
1952-10-06 00:00:00,United States Navy - USN,Landing (descent or approach),Military / Government,Canada,North America,8,8,6,0,0,6,2,Human Factor
1952-10-27 00:00:00,Royal Australian Air Force - RAAF,Flight,Other,Australia,Oceania,6,4,4,2,2,6,0,Technical Failure
1952-11-04 00:00:00,Brazilian Air Force - Força Aérea Brasileira,Landing (descent or approach),Military / Government,Brazil,South America,6,2,2,4,4,6,0,Unknown
1952-12-10 00:00:00,United States Air Force - USAF,Flight,Military / Government,United States of America,North America,6,5,5,1,1,6,0,Weather
1953-01-23 00:00:00,Aeroflot - Russian International Airlines,Takeoff (climb),Operational,Russia,Asia,6,6,6,0,0,6,0,Human Factor
1953-02-13 00:00:00,French Air Force - Armée de l'Air,Flight,Specialised Services,France,Europe,6,3,3,3,3,6,0,Unknown
1953-03-29 00:00:00,United States Air Force - USAF,Takeoff (climb),Military / Government,Portugal,Europe,15,15,6,0,0,6,9,Technical Failure
1953-04-20 00:00:00,Royal Canadian Air Force - RCAF,Flight,Military / Government,Canada,North America,7,7,6,0,0,6,1,Unknown
1953-04-24 00:00:00,United States Air Force - USAF,Flight,Operational,United States of America,North America,6,6,6,0,0,6,0,Human Factor
1953-05-15 00:00:00,United States Air Force - USAF,Flight,Operational,Germany,Europe,6,6,6,0,0,6,0,Human Factor
1953-05-24 00:00:00,Meteor Air Transport,Landing (descent or approach),Operational,United States of America,North America,7,5,5,2,1,6,1,Technical Failure
1953-06-22 00:00:00,Royal Air Force - RAF,Takeoff (climb),Operational,United Kingdom,Europe,6,6,6,0,0,6,0,Human Factor
1953-07-07 00:00:00,United States Navy - USN,Flight,Operational,United States of America,North America,6,6,6,0,0,6,0,Technical Failure
1953-08-08 00:00:00,Siamese Airways,Flight,Commercial,Thailand,Asia,6,1,1,5,5,6,0,Human Factor
1953-09-08 00:00:00,Colombian Air Force - Fuerza Aérea Colombiana,Flight,Military / Government,Colombia,South America,6,1,1,5,5,6,0,Unknown
1953-11-27 00:00:00,United States Air Force - USAF,Landing (descent or approach),Military / Government,France,Europe,6,6,6,0,0,6,0,Technical Failure
1953-12-04 00:00:00,Royal Air Force - RAF,Landing (descent or approach),Operational,United Kingdom,Europe,7,7,6,0,0,6,1,Human Factor
1953-12-15 00:00:00,Misrair,Takeoff (climb),Commercial,Egypt,Africa,6,5,5,1,1,6,0,Unknown
1954-01-26 00:00:00,French Navy,Flight,Operational,France,Europe,6,6,6,0,0,6,0,Unknown
1954-01-27 00:00:00,Aeroflot - Russian International Airlines,Flight,Other,Armenia,Asia,6,6,6,0,0,6,0,Weather
1954-04-24 00:00:00,Servicios Aéreos de Chiapas,Takeoff (climb),Commercial,Mexico,Central America,6,2,2,4,4,6,0,Unknown
1954-08-29 00:00:00,Argentinian Air Force - Fuerza Aérea Argentina,Flight,Military / Government,Argentina,South America,6,2,2,4,4,6,0,Unknown
1954-09-12 00:00:00,Cruzeiro do Sul,Landing (descent or approach),Commercial,Brazil,South America,30,4,0,26,6,6,24,Human Factor
1954-10-08 00:00:00,Brazilian Air Force - Força Aérea Brasileira,Flight,Military / Government,Brazil,South America,6,6,6,0,0,6,0,Unknown
1954-11-12 00:00:00,Aeroflot - Russian International Airlines,Takeoff (climb),Commercial,Russia,Asia,15,5,2,10,4,6,9,Human Factor
1955-01-18 00:00:00,Royal Air Force - RAF,Flight,Military / Government,Kuwait,Asia,6,2,2,4,4,6,0,Unknown
1955-02-19 00:00:00,Royal Air Force - RAF,Flight,Operational,Kenya,Africa,6,6,6,0,0,6,0,Human Factor
1955-02-26 00:00:00,Argentinian Government,Takeoff (climb),Military / Government,Argentina,South America,7,3,2,4,4,6,1,Technical Failure
1955-03-07 00:00:00,Private Mexican,Flight,Business,Mexico,Central America,6,2,2,4,4,6,0,Unknown
1955-04-09 00:00:00,Royal Australian Air Force - RAAF,Flight,Humanitarian,Australia,Oceania,6,4,4,2,2,6,0,Human Factor
1955-06-07 00:00:00,Associated Airways,Flight,Specialised Services,Canada,North America,6,2,2,4,4,6,0,Other
1955-06-26 00:00:00,Royal Air Force - RAF,Flight,Operational,Germany,Europe,6,6,6,0,0,6,0,Human Factor
1955-09-13 00:00:00,United States Air Force - USAF,Takeoff (climb),Military / Government,United States of America,North America,6,2,2,4,4,6,0,Technical Failure
1955-12-01 00:00:00,Cruzeiro do Sul,Takeoff (climb),Commercial,Brazil,South America,6,4,4,2,2,6,0,Technical Failure
1955-12-21 00:00:00,Aeroflot - Russian International Airlines,Flight,Operational,Kazakhstan,Asia,6,5,5,1,1,6,0,Technical Failure
1956-03-12 00:00:00,United States Air Force - USAF,Takeoff (climb),Operational,Canada,North America,6,6,6,0,0,6,0,Unknown
1956-04-09 00:00:00,Cordova Airlines,Flight,Commercial,United States of America,North America,6,1,1,5,5,6,0,Human Factor
1956-04-22 00:00:00,Aeroflot - Russian International Airlines,Takeoff (climb),Operational,Georgia,Asia,6,5,5,1,1,6,0,Unknown
1956-07-06 00:00:00,United States Air Force - USAF,Flight,Military / Government,Canada,North America,6,6,6,0,0,6,0,Technical Failure
1956-12-13 00:00:00,Royal Jordanian Air Force,Flight,Military / Government,Turkey,Asia,6,2,2,4,4,6,0,Unknown
1957-01-10 00:00:00,United States Air Force - USAF,Landing (descent or approach),Operational,United States of America,North America,9,9,6,0,0,6,3,Human Factor
1957-02-23 00:00:00,VASP - Viação Aérea de São Paulo,Flight,Operational,Brazil,South America,6,2,2,4,4,6,0,Unknown
1957-04-12 00:00:00,United States Navy - USN,Takeoff (climb),Operational,United States of America,North America,8,8,6,0,0,6,2,Unknown
1957-04-26 00:00:00,Bulgarian Air Force - Bulgarski Voennov Azdushni Sili,Landing (descent or approach),Operational,Bulgaria,Europe,6,6,6,0,0,6,0,Human Factor
1957-06-06 00:00:00,French Air Force - Armée de l'Air,Flight,Military / Government,France,Europe,6,2,2,4,4,6,0,Unknown
1957-06-19 00:00:00,French Air Force - Armée de l'Air,Landing (descent or approach),Military / Government,Algeria,Africa,6,6,6,0,0,6,0,Human Factor
1957-07-01 00:00:00,Adastra Airways - Adastra Aerial Surveys,Landing (descent or approach),Specialised Services,Australia,Oceania,6,3,3,3,3,6,0,Technical Failure
1957-07-10 00:00:00,C.R. Vose Company,Takeoff (climb),Business,United States of America,North America,6,2,2,4,4,6,0,Human Factor
1957-08-07 00:00:00,Polyarnaya Aviatsiya,Flight,Operational,Russia,Asia,6,6,6,0,0,6,0,Technical Failure
1957-08-11 00:00:00,Spanish Air Force - Ejército del Aire,Landing (descent or approach),Military / Government,Spain,Europe,6,6,6,0,0,6,0,Unknown
1957-10-06 00:00:00,Standard Oil,Flight,Business,United States of America,North America,6,2,2,4,4,6,0,Human Factor
1957-10-11 00:00:00,Philippine Aviation Development Company - PADC,Flight,Business,Philippines,Asia,6,1,1,5,5,6,0,Human Factor
1957-11-03 00:00:00,Karl Herfurtner Luftreederei,Takeoff (climb),Operational,Germany,Europe,10,7,6,3,0,6,4,Human Factor
1957-11-15 00:00:00,United States Air Force - USAF,Flight,Specialised Services,United States of America,North America,10,10,6,0,0,6,4,Human Factor
1957-12-07 00:00:00,Scottish Airlines,Flight,Operational,Libya,Africa,6,2,2,4,4,6,0,Technical Failure
1957-12-12 00:00:00,United States Air Force - USAF,Flight,Military / Government,Japan,Asia,6,6,6,0,0,6,0,Unknown
1958-02-01 00:00:00,United States Navy - USN,Flight,Operational,United States of America,North America,8,8,6,0,0,6,2,Human Factor
1958-03-13 00:00:00,Uruguayan Air Force - Fuerza Aérea Uruguaya,Flight,Military / Government,Brazil,South America,6,2,2,4,4,6,0,Human Factor
1958-06-03 00:00:00,United States Air Force - USAF,Takeoff (climb),Operational,United States of America,North America,8,8,6,0,0,6,2,Unknown
1958-07-04 00:00:00,United States Air Force - USAF,Flight,Military / Government,World,World,9,7,4,2,2,6,3,Technical Failure
1958-07-15 00:00:00,German Air Force - Deutsche Luftwaffe,Flight,Specialised Services,Germany,Europe,6,6,6,0,0,6,0,Unknown
1958-08-25 00:00:00,Servicios Aéreos de Chiapas,Landing (descent or approach),Commercial,Mexico,Central America,6,2,2,4,4,6,0,Human Factor
1958-09-19 00:00:00,United States Air Force - USAF,Flight,Military / Government,France,Europe,6,6,6,0,0,6,0,Unknown
1958-10-05 00:00:00,Spanish Air Force - Ejército del Aire,Flight,Military / Government,Spain,Europe,6,3,3,3,3,6,0,Unknown
1958-10-19 00:00:00,French Air Force - Armée de l'Air,Takeoff (climb),Military / Government,Malawi,Africa,6,6,6,0,0,6,0,Unknown
1958-10-22 00:00:00,United States Air Force - USAF,Landing (descent or approach),Military / Government,United States of America,North America,6,4,4,2,2,6,0,Human Factor
1958-12-02 00:00:00,Hunting-Clan Air Transport,Flight,Specialised Services,United Kingdom,Europe,6,6,6,0,0,6,0,Human Factor
1959-01-31 00:00:00,Soviet Air Force - Voyenno-vozdushnye sily CCCP,Takeoff (climb),Operational,Belarus,Europe,7,7,6,0,0,6,1,Technical Failure
1959-08-03 00:00:00,Kalinga Airlines,Flight,Operational,India,Asia,6,3,3,3,3,6,0,Human Factor
1959-09-21 00:00:00,Brazilian Air Force - Força Aérea Brasileira,Takeoff (climb),Military / Government,Brazil,South America,6,6,6,0,0,6,0,Unknown
1959-12-04 00:00:00,Brazilian Air Force - Força Aérea Brasileira,Flight,Operational,Brazil,South America,6,6,6,0,0,6,0,Unknown
1960-01-13 00:00:00,Utah Construction %26 Mining Company,Flight,Business,United States of America,North America,6,2,2,4,4,6,0,Human Factor
1960-01-15 00:00:00,French Air Force - Armée de l'Air,Flight,Military / Government,Algeria,Africa,6,5,5,1,1,6,0,Weather
1960-02-03 00:00:00,United States Air Force - USAF,Takeoff (climb),Operational,United States of America,North America,6,6,6,0,0,6,0,Weather
1960-03-15 00:00:00,German Air Force - Deutsche Luftwaffe,Flight,Military / Government,Italy,Europe,6,6,6,0,0,6,0,Human Factor
1960-03-15 00:00:00,Agencia Interamericana de Aviación - AIDA Colombia,Flight,Commercial,Colombia,South America,13,3,2,10,4,6,7,Unknown
1960-07-07 00:00:00,Royal Air Force - RAF,Landing (descent or approach),Military / Government,United Kingdom,Europe,6,5,5,1,1,6,0,Human Factor
1960-07-11 00:00:00,United States Air Force - USAF,Takeoff (climb),Military / Government,Panama,Central America,6,1,1,5,5,6,0,Unknown
1960-07-22 00:00:00,East German Air Force - Luftstreitkräfte der Nationalen Volksarmee,Flight,Other,Germany,Europe,6,6,6,0,0,6,0,Human Factor
1960-08-01 00:00:00,TAM Bolivia - Transporte Aéreo Militar Boliviano,Landing (descent or approach),Military / Government,Bolivia,South America,6,2,2,4,4,6,0,Unknown
1960-08-25 00:00:00,LOT Polish Airlines - Polskie Linie Lotnicze,Flight,Military / Government,Poland,Europe,6,6,6,0,0,6,0,Unknown
1960-09-22 00:00:00,Paraense Transportes Aéreos,Takeoff (climb),Operational,Brazil,South America,6,4,4,2,2,6,0,Unknown
1960-09-30 00:00:00,United States Air Force - USAF,Flight,Military / Government,United States of America,North America,6,2,2,4,4,6,0,Human Factor
1960-10-20 00:00:00,French Air Force - Armée de l'Air,Flight,Military / Government,Algeria,Africa,6,1,1,5,5,6,0,Unknown
1960-11-15 00:00:00,United States Navy - USN,Landing (descent or approach),Military / Government,Philippines,Asia,6,3,3,3,3,6,0,Unknown
1961-01-22 00:00:00,United States Navy - USN,Landing (descent or approach),Military / Government,United States of America,North America,22,4,0,18,6,6,16,Human Factor
1961-01-27 00:00:00,French Navy,Takeoff (climb),Military / Government,Senegal,Africa,6,3,3,3,3,6,0,Unknown
1961-01-28 00:00:00,American Airlines,Flight,Operational,United States of America,North America,6,6,6,0,0,6,0,Unknown
1961-02-20 00:00:00,Royal Air Force - RAF,Flight,Operational,United Kingdom,Europe,6,6,6,0,0,6,0,Human Factor
1961-03-22 00:00:00,United States Air Force - USAF,Flight,Specialised Services,United States of America,North America,6,6,6,0,0,6,0,Unknown
1961-03-30 00:00:00,United States Air Force - USAF,Flight,Operational,United States of America,North America,8,8,6,0,0,6,2,Human Factor
1961-04-18 00:00:00,United States Navy - USN,Takeoff (climb),Military / Government,United States of America,North America,18,4,0,14,6,6,12,Unknown
1961-04-30 00:00:00,Brazilian Air Force - Força Aérea Brasileira,Takeoff (climb),Military / Government,Brazil,South America,6,6,6,0,0,6,0,Unknown
1961-06-15 00:00:00,Chilean Air Force - Fuerza Aérea de Chile,Flight,Operational,Chile,South America,6,6,6,0,0,6,0,Unknown
1961-07-21 00:00:00,Alaska Airlines,Landing (descent or approach),Operational,United States of America,North America,6,6,6,0,0,6,0,Human Factor
1961-08-13 00:00:00,Air America,Flight,Military / Government,Laos,Asia,6,2,2,4,4,6,0,Human Factor
1961-09-22 00:00:00,Aeroflot - Russian International Airlines,Flight,Operational,Russia,Asia,6,4,4,2,2,6,0,Human Factor
1961-10-10 00:00:00,Peruvian Air Force - Fuerza Aérea del Perú,Flight,Military / Government,Peru,South America,7,2,1,5,5,6,1,Technical Failure
1961-11-21 00:00:00,Bay of Plenty Airways,Flight,Commercial,New Zealand,Oceania,6,1,1,5,5,6,0,Weather
1962-01-22 00:00:00,Corporación Boliviana de Fomento,Takeoff (climb),Operational,Bolivia,South America,6,4,4,2,2,6,0,Human Factor
1962-01-26 00:00:00,Air National Guard,Flight,Military / Government,United States of America,North America,6,3,3,3,3,6,0,Weather
1962-02-04 00:00:00,Air America,Flight,Military / Government,Laos,Asia,6,3,3,3,3,6,0,Terrorism
1962-05-09 00:00:00,United States Air Force - USAF,Takeoff (climb),Operational,United States of America,North America,6,6,6,0,0,6,0,Technical Failure
1962-07-09 00:00:00,TMA of Lebanon - Trans Mediterranean Airways,Takeoff (climb),Operational,Italy,Europe,6,6,6,0,0,6,0,Technical Failure
1962-07-14 00:00:00,Air Lloyd,Flight,Commercial,Switzerland,Europe,6,2,2,4,4,6,0,Weather
1962-07-23 00:00:00,United States Navy - USN,Flight,Operational,United States of America,North America,10,10,6,0,0,6,4,Unknown
1963-01-15 00:00:00,Cruzeiro do Sul,Landing (descent or approach),Commercial,Brazil,South America,45,5,1,40,5,6,39,Technical Failure
1963-02-05 00:00:00,Portuguese Air Force - Força Aerea Portuguesa,Takeoff (climb),Military / Government,Mozambique,Africa,13,2,0,11,6,6,7,Unknown
1963-05-28 00:00:00,Austrian Air Force - Österreichische Luftstreitkräfte,Landing (descent or approach),Operational,Austria,Europe,6,1,1,5,5,6,0,Unknown
1963-07-02 00:00:00,Colombian Air Force - Fuerza Aérea Colombiana,Landing (descent or approach),Military / Government,Colombia,South America,9,2,2,7,4,6,3,Unknown
1963-07-15 00:00:00,Air Madagascar,Takeoff (climb),Commercial,Madagascar,Africa,12,4,4,8,2,6,6,Unknown
1963-07-17 00:00:00,Air America,Flight,Operational,Laos,Asia,6,6,6,0,0,6,0,Human Factor
1963-08-04 00:00:00,United States Army,Flight,Military / Government,South Korea,Asia,6,1,1,5,5,6,0,Unknown
1963-08-28 00:00:00,United States Air Force - USAF,Flight,Operational,World,World,6,6,6,0,0,6,0,Human Factor
1963-10-09 00:00:00,Aeronaves de Panama,Takeoff (climb),Operational,France,Europe,6,6,6,0,0,6,0,Human Factor
1963-11-15 00:00:00,Aeroflot - Russian International Airlines,Flight,Operational,Russia,Asia,6,4,4,2,2,6,0,Weather
1963-12-07 00:00:00,Aeroflot - Russian International Airlines,Takeoff (climb),Operational,Russia,Asia,6,6,6,0,0,6,0,Technical Failure
1964-02-06 00:00:00,United States Navy - USN,Landing (descent or approach),Military / Government,United States of America,North America,8,8,6,0,0,6,2,Unknown
1964-03-21 00:00:00,Fabick Machinery Company,Flight,Business,United States of America,North America,6,2,2,4,4,6,0,Human Factor
1964-04-13 00:00:00,Soviet Air Force - Voyenno-vozdushnye sily CCCP,Landing (descent or approach),Operational,Azerbaijan,Asia,6,6,6,0,0,6,0,Human Factor
1964-04-20 00:00:00,Italian Air Force - Aeronautica Militare Italiana,Takeoff (climb),Military / Government,Italy,Europe,6,6,6,0,0,6,0,Unknown
1964-04-25 00:00:00,Air National Guard,Takeoff (climb),Operational,United States of America,North America,6,6,6,0,0,6,0,Human Factor
1964-05-09 00:00:00,United States Air Force - USAF,Flight,Military / Government,United States of America,North America,6,6,6,0,0,6,0,Weather
1964-07-27 00:00:00,Republic of China Air Force,Flight,Operational,Taiwan,Asia,6,6,6,0,0,6,0,Unknown
1964-07-27 00:00:00,Republic of China Air Force,Flight,Operational,Taiwan,Asia,6,6,6,0,0,6,0,Unknown
1964-07-27 00:00:00,Republic of China Air Force,Flight,Operational,Taiwan,Asia,6,6,6,0,0,6,0,Unknown
1964-11-29 00:00:00,Air Congo,Takeoff (climb),Commercial,Democratic Republic of Congo,Africa,14,3,3,11,3,6,8,Other
1964-12-29 00:00:00,Linea Aérea Sud Americana,Flight,Operational,Costa Rica,Central America,6,5,5,1,1,6,0,Human Factor
1965-01-11 00:00:00,United States Air Force - USAF,Takeoff (climb),Military / Government,United States of America,North America,6,6,6,0,0,6,0,Unknown
1965-02-28 00:00:00,Private American,Flight,Business,United States of America,North America,6,2,2,4,4,6,0,Human Factor
1965-03-24 00:00:00,United States Air Force - USAF,Flight,Operational,United States of America,North America,6,6,6,0,0,6,0,Technical Failure
1965-04-24 00:00:00,United States Air Force - USAF,Landing (descent or approach),Military / Government,Thailand,Asia,6,6,6,0,0,6,0,Weather
1965-08-26 00:00:00,Soviet Air Force - Voyenno-vozdushnye sily CCCP,Flight,Military / Government,Ukraine,Europe,6,6,6,0,0,6,0,Unknown
1965-08-26 00:00:00,Soviet Air Force - Voyenno-vozdushnye sily CCCP,Flight,Military / Government,Ukraine,Europe,6,6,6,0,0,6,0,Unknown
1965-10-06 00:00:00,Austrian Air Force - Österreichische Luftstreitkräfte,Takeoff (climb),Operational,Austria,Europe,6,2,2,4,4,6,0,Unknown
1965-12-06 00:00:00,Central Airways,Flight,Business,United States of America,North America,6,2,2,4,4,6,0,Human Factor
1965-12-12 00:00:00,United States Air Force - USAF,Takeoff (climb),Operational,Germany,Europe,6,5,5,1,1,6,0,Unknown
1965-12-24 00:00:00,United States Air Force - USAF,Flight,Military / Government,Laos,Asia,6,6,6,0,0,6,0,Unknown
1966-01-13 00:00:00,United States Air Force - USAF,Flight,Military / Government,Vietnam,Asia,6,6,6,0,0,6,0,Human Factor
1966-01-13 00:00:00,United States Air Force - USAF,Flight,Military / Government,Greece,Europe,10,2,2,8,4,6,4,Human Factor
1966-02-01 00:00:00,United States Marine Corps,Flight,Military / Government,Vietnam,Asia,6,6,6,0,0,6,0,Technical Failure
1966-02-02 00:00:00,United States Navy - USN,Landing (descent or approach),Military / Government,Antarctica,Antarctica,6,6,6,0,0,6,0,Unknown
1966-03-10 00:00:00,Pacific Western Airlines - PWA,Landing (descent or approach),Commercial,United States of America,North America,7,1,0,6,6,6,1,Human Factor
1966-03-20 00:00:00,Private American,Flight,Business,United States of America,North America,6,1,1,5,5,6,0,Human Factor
1966-03-28 00:00:00,Private Cuban,Takeoff (climb),Humanitarian,Cuba,Central America,6,2,2,4,4,6,0,Unknown
1966-06-03 00:00:00,United States Air Force - USAF,Flight,Military / Government,Laos,Asia,6,6,6,0,0,6,0,Unknown
1966-06-25 00:00:00,Union of Burma Airways,Landing (descent or approach),Commercial,Myanmar,Asia,45,4,0,41,6,6,39,Unknown
1966-08-13 00:00:00,Aeronaves de Mexico,Landing (descent or approach),Operational,Mexico,Central America,6,6,6,0,0,6,0,Human Factor
1966-08-27 00:00:00,Brazilian Air Force - Força Aérea Brasileira,,Military / Government,Brazil,South America,6,6,6,0,0,6,0,Unknown
1966-09-07 00:00:00,Aeroflot - Russian International Airlines,Flight,Specialised Services,Tajikistan,Asia,6,2,2,4,4,6,0,Technical Failure
1966-09-24 00:00:00,Adastra Airways - Adastra Aerial Surveys,Landing (descent or approach),Specialised Services,Australia,Oceania,6,1,1,5,5,6,0,Technical Failure
1966-12-16 00:00:00,Soviet Air Force - Voyenno-vozdushnye sily CCCP,Landing (descent or approach),Military / Government,Uzbekistan,Asia,7,7,6,0,0,6,1,Human Factor
1967-01-14 00:00:00,Aeroflot - Russian International Airlines,Takeoff (climb),Operational,Russia,Asia,6,6,6,0,0,6,0,Technical Failure
1967-03-05 00:00:00,United States Coast Guard - USCG,Flight,Military / Government,World,World,6,6,6,0,0,6,0,Unknown
1967-03-08 00:00:00,Compagnie Air Transport - CAT,Takeoff (climb),Operational,Pakistan,Asia,6,6,6,0,0,6,0,Technical Failure
1967-03-30 00:00:00,Delta Airlines,Landing (descent or approach),Operational,United States of America,North America,6,6,6,0,0,6,0,Human Factor
1967-04-13 00:00:00,United States Air Force - USAF,Takeoff (climb),Military / Government,Vietnam,Asia,8,8,6,0,0,6,2,Human Factor
1967-04-27 00:00:00,Royal Canadian Air Force - RCAF,Takeoff (climb),Operational,Canada,North America,6,6,6,0,0,6,0,Technical Failure
1967-06-06 00:00:00,Iraqi Air Force - Al Quwwat al Jawwiya al Iraqiya,Flight,Military / Government,Israel,Asia,6,6,6,0,0,6,0,Terrorism
1967-08-11 00:00:00,Private American,Flight,Business,Colombia,South America,6,2,2,4,4,6,0,Technical Failure
1967-08-21 00:00:00,China Airlines,Flight,Operational,World,World,9,2,0,7,6,6,3,Unknown
1967-08-29 00:00:00,Aeroflot - Russian International Airlines,Takeoff (climb),Commercial,Russia,Asia,13,2,0,11,6,6,7,Technical Failure
1967-09-22 00:00:00,General Air,Flight,Commercial,Italy,Europe,6,2,2,4,4,6,0,Technical Failure
1967-11-02 00:00:00,United States Air Force - USAF,Takeoff (climb),Military / Government,United States of America,North America,8,8,6,0,0,6,2,Technical Failure
1967-12-01 00:00:00,Aeroflot - Russian International Airlines,Landing (descent or approach),Commercial,Russia,Asia,14,2,0,12,6,6,8,Human Factor
1967-12-15 00:00:00,Royal Air Force - RAF,Flight,Operational,Malaysia,Asia,6,6,6,0,0,6,0,Human Factor
1968-01-20 00:00:00,Aero Flight,Flight,Operational,United States of America,North America,6,2,2,4,4,6,0,Human Factor
1968-01-21 00:00:00,Royal Thai Air Force - Kong Thap Akat Thai,Flight,Specialised Services,Thailand,Asia,6,2,2,4,4,6,0,Human Factor
1968-03-02 00:00:00,United States Air Force - USAF,Landing (descent or approach),Military / Government,Vietnam,Asia,11,5,0,6,6,6,5,Human Factor
1968-03-08 00:00:00,Private American,Flight,Business,United States of America,North America,6,1,1,5,5,6,0,Unknown
1968-03-13 00:00:00,M Air,Landing (descent or approach),Operational,United States of America,North America,6,2,2,4,4,6,0,Human Factor
1968-05-25 00:00:00,Soviet Air Force - Voyenno-vozdushnye sily CCCP,Flight,Military / Government,World,World,6,6,6,0,0,6,0,Unknown
1968-06-13 00:00:00,Pan American World Airways - PAA,Landing (descent or approach),Commercial,India,Asia,63,10,1,53,5,6,57,Human Factor
1968-06-18 00:00:00,Piaggio Aerospace,Landing (descent or approach),Operational,Spain,Europe,6,1,1,5,5,6,0,Human Factor
1968-06-19 00:00:00,Teterboro Aircraft,Flight,Business,United States of America,North America,6,1,1,5,5,6,0,Weather
1968-07-03 00:00:00,BKS Air Transport,Landing (descent or approach),Operational,United Kingdom,Europe,8,3,3,5,3,6,2,Technical Failure
1968-08-09 00:00:00,United States Air Force - USAF,Takeoff (climb),Military / Government,United States of America,North America,31,4,0,27,6,6,25,Unknown
1968-09-21 00:00:00,French Air Force - Armée de l'Air,Flight,Operational,France,Europe,6,1,1,5,5,6,0,Unknown
1968-10-22 00:00:00,United States Air Force - USAF,Flight,Operational,Taiwan,Asia,6,6,6,0,0,6,0,Human Factor
1968-11-02 00:00:00,Aeroflot - Russian International Airlines,Landing (descent or approach),Operational,Russia,Asia,6,6,6,0,0,6,0,Human Factor
1968-11-07 00:00:00,Government of the Province of Entre Ríos,Landing (descent or approach),Military / Government,Argentina,South America,6,2,2,4,4,6,0,Unknown
1968-11-09 00:00:00,Taxi Aéreo Sabanero,Landing (descent or approach),Commercial,Colombia,South America,7,1,1,6,5,6,1,Unknown
1968-11-11 00:00:00,Compañía Tabasqueña de Aviación,Flight,Commercial,Mexico,Central America,6,2,2,4,4,6,0,Human Factor
1968-12-13 00:00:00,United States Air Force - USAF,Flight,Military / Government,Laos,Asia,7,7,6,0,0,6,1,Human Factor
1968-12-31 00:00:00,United States Air Force - USAF,Landing (descent or approach),Military / Government,United States of America,North America,6,2,2,4,4,6,0,Human Factor
1969-01-06 00:00:00,Suse Company,Flight,Business,United States of America,North America,6,2,2,4,4,6,0,Human Factor
1969-01-21 00:00:00,United States Air Force - USAF,Takeoff (climb),Operational,United States of America,North America,6,6,6,0,0,6,0,Human Factor
1969-01-31 00:00:00,Agua y Energía Eléctrica,Takeoff (climb),Business,Argentina,South America,6,2,2,4,4,6,0,Unknown
1969-03-06 00:00:00,United States Navy - USN,Landing (descent or approach),Operational,United States of America,North America,6,6,6,0,0,6,0,Human Factor
1969-03-24 00:00:00,Royal Air Force - RAF,Takeoff (climb),Operational,United Kingdom,Europe,6,6,6,0,0,6,0,Human Factor
1969-05-10 00:00:00,United States Air Force - USAF,Takeoff (climb),Military / Government,Guam Island,Asia,6,6,6,0,0,6,0,Technical Failure
1969-05-18 00:00:00,United States Navy - USN,Flight,Operational,Vietnam,Asia,6,6,6,0,0,6,0,Human Factor
1969-05-18 00:00:00,United States Air Force - USAF,Landing (descent or approach),Military / Government,Vietnam,Asia,6,6,6,0,0,6,0,Terrorism
1969-06-23 00:00:00,United States Air Force - USAF,Landing (descent or approach),Military / Government,Vietnam,Asia,6,6,6,0,0,6,0,Terrorism
1969-07-27 00:00:00,United States Air Force - USAF,Takeoff (climb),Military / Government,Guam Island,Asia,6,6,6,0,0,6,0,Technical Failure
1969-10-01 00:00:00,Soviet Air Force - Voyenno-vozdushnye sily CCCP,Flight,Operational,Russia,Asia,7,7,6,0,0,6,1,Human Factor
1969-10-08 00:00:00,United States Air Force - USAF,Landing (descent or approach),Military / Government,Vietnam,Asia,6,6,6,0,0,6,0,Technical Failure
1969-10-09 00:00:00,United States Air Force - USAF,Takeoff (climb),Operational,United States of America,North America,6,6,6,0,0,6,0,Unknown
1969-10-11 00:00:00,United States Air Force - USAF,Takeoff (climb),Military / Government,Vietnam,Asia,10,10,6,0,0,6,4,Technical Failure
1969-12-23 00:00:00,Laos Air Charter,Landing (descent or approach),Commercial,Laos,Asia,19,3,2,16,4,6,13,Human Factor
1970-03-24 00:00:00,Royal Thai Police,Flight,Military / Government,Thailand,Asia,6,2,2,4,4,6,0,Unknown
1970-04-10 00:00:00,United States Air Force - USAF,Landing (descent or approach),Military / Government,Laos,Asia,6,6,6,0,0,6,0,Human Factor
1970-04-27 00:00:00,United States Air Force - USAF,Takeoff (climb),Military / Government,Vietnam,Asia,8,8,6,0,0,6,2,Technical Failure
1970-05-09 00:00:00,Executive Jet Aviation - USA,Landing (descent or approach),Business,United States of America,North America,6,2,2,4,4,6,0,Human Factor
1970-05-26 00:00:00,Aeroservicios,Landing (descent or approach),Commercial,Honduras,Central America,6,2,2,4,4,6,0,Weather
1970-07-30 00:00:00,United States Air Force - USAF,Flight,Operational,United States of America,North America,6,6,6,0,0,6,0,Unknown
1970-12-01 00:00:00,Taxi Aéreo de Santander del Sur,Flight,Commercial,Colombia,South America,8,1,1,7,5,6,2,Technical Failure
1970-12-04 00:00:00,Nicaraguayan Air Force - Fuerza Aérea - Ejercito de Nicaragua,Flight,Military / Government,Costa Rica,Central America,6,3,3,3,3,6,0,Human Factor
1970-12-31 00:00:00,Aeroflot - Russian International Airlines,Takeoff (climb),Commercial,Russia,Asia,84,6,5,78,1,6,78,Human Factor
1971-01-15 00:00:00,French Navy,Landing (descent or approach),Military / Government,France,Europe,9,9,6,0,0,6,3,Human Factor
1971-01-22 00:00:00,Heitkamp,Takeoff (climb),Business,Germany,Europe,6,2,2,4,4,6,0,Human Factor
1971-02-03 00:00:00,Newberry Flying Service,Landing (descent or approach),Commercial,United States of America,North America,6,1,1,5,5,6,0,Human Factor
1971-02-19 00:00:00,Colombian Air Force - Fuerza Aérea Colombiana,Landing (descent or approach),Military / Government,Colombia,South America,35,6,1,29,5,6,29,Unknown
1971-02-19 00:00:00,Aero Palas,Flight,Operational,Peru,South America,6,6,6,0,0,6,0,Unknown
1971-03-17 00:00:00,Air America,Landing (descent or approach),Commercial,Vietnam,Asia,6,2,2,4,4,6,0,Human Factor
1971-05-28 00:00:00,Colorado Aviation,Flight,Business,United States of America,North America,6,1,1,5,5,6,0,Human Factor
1971-06-03 00:00:00,United States Air Force - USAF,Landing (descent or approach),Operational,Spain,Europe,6,6,6,0,0,6,0,Technical Failure
1971-06-17 00:00:00,SAVCO - Servicios Aéreos Virgen de Copacabana,Flight,Operational,Chile,South America,6,4,4,2,2,6,0,Human Factor
1971-07-24 00:00:00,Air Ivoire,Takeoff (climb),Commercial,Mali,Africa,6,3,3,3,3,6,0,Unknown
1971-08-11 00:00:00,MAP - Ministerstvo Aviatsionnoi Promyshlennosti - Minaviaprom,Flight,Operational,Russia,Asia,6,5,5,1,1,6,0,Other
1971-10-11 00:00:00,Aeroflot - Russian International Airlines,Flight,Commercial,Russia,Asia,8,2,1,6,5,6,2,Human Factor
1971-10-16 00:00:00,Alpena Flying Services,Landing (descent or approach),Commercial,United States of America,North America,6,2,2,4,4,6,0,Human Factor
1971-10-30 00:00:00,Severn Enterprises,Takeoff (climb),Business,Canada,North America,6,1,1,5,5,6,0,Terrorism
1971-11-13 00:00:00,Aeroflot - Russian International Airlines,Landing (descent or approach),Commercial,Ukraine,Europe,11,4,4,7,2,6,5,Human Factor
1971-12-14 00:00:00,United States Army,Takeoff (climb),Military / Government,Vietnam,Asia,6,2,2,4,4,6,0,Technical Failure
1972-01-17 00:00:00,United States Navy - USN,Flight,Military / Government,Italy,Europe,6,6,6,0,0,6,0,Weather
1972-02-01 00:00:00,PENAS,Flight,Commercial,Indonesia,Asia,9,3,1,6,5,6,3,Human Factor
1972-03-14 00:00:00,ATESA - Aero Taxis Ecuatorianos,Flight,Operational,Ecuador,South America,7,7,6,0,0,6,1,Human Factor
1972-04-20 00:00:00,Servicio Aéreo de Transportes Comerciales - SATCO,Flight,Operational,Peru,South America,6,2,2,4,4,6,0,Human Factor
1972-04-25 00:00:00,United States Air Force - USAF,Flight,Military / Government,Vietnam,Asia,6,6,6,0,0,6,0,Terrorism
1972-05-03 00:00:00,United States Air Force - USAF,Flight,Military / Government,Vietnam,Asia,6,6,6,0,0,6,0,Terrorism
1972-05-08 00:00:00,Aerotecnica - ATSA,Flight,Commercial,Venezuela,South America,6,2,2,4,4,6,0,Unknown
1972-05-26 00:00:00,Soviet Air Force - Voyenno-vozdushnye sily CCCP,Flight,Operational,Lithuania,Europe,7,7,6,0,0,6,1,Human Factor
1972-06-05 00:00:00,United States Air Force - USAF,Flight,Military / Government,Taiwan,Asia,6,6,6,0,0,6,0,Technical Failure
1972-06-30 00:00:00,French Air Force - Armée de l'Air,Takeoff (climb),Other,French Polynesia,Oceania,6,4,4,2,2,6,0,Technical Failure
1972-07-08 00:00:00,Western Construction %26 Lumber Company,Flight,Business,Canada,North America,6,1,1,5,5,6,0,Human Factor
1972-07-20 00:00:00,Aerotransportes Entre Rios,Flight,Operational,Chile,South America,6,6,6,0,0,6,0,Unknown
1972-09-07 00:00:00,Piper Aircraft Corporation,Landing (descent or approach),Business,United States of America,North America,6,2,2,4,4,6,0,Unknown
1972-10-23 00:00:00,Private American,Landing (descent or approach),Business,United States of America,North America,6,1,1,5,5,6,0,Human Factor
1972-10-23 00:00:00,Soviet Air Force - Voyenno-vozdushnye sily CCCP,Landing (descent or approach),Operational,Russia,Asia,6,6,6,0,0,6,0,Human Factor
1972-12-05 00:00:00,Egyptair,Flight,Operational,Egypt,Africa,6,3,3,3,3,6,0,Technical Failure
1973-01-28 00:00:00,Impulsora de la Cuenca de Papaloapan,Takeoff (climb),Commercial,Mexico,Central America,6,2,2,4,4,6,0,Unknown
1973-04-13 00:00:00,Rusk Aviation,Takeoff (climb),Operational,United States of America,North America,6,1,1,5,5,6,0,Technical Failure
1973-04-16 00:00:00,Playpen South,Flight,Business,United States of America,North America,6,1,1,5,5,6,0,Human Factor
1973-04-19 00:00:00,Air Iowa,Landing (descent or approach),Commercial,United States of America,North America,6,1,1,5,5,6,0,Technical Failure
1973-04-25 00:00:00,Soviet Air Force - Voyenno-vozdushnye sily CCCP,Landing (descent or approach),Operational,Russia,Asia,6,6,6,0,0,6,0,Human Factor
1973-05-05 00:00:00,Private Mexican,Flight,Business,Mexico,Central America,6,1,1,5,5,6,0,Unknown
1973-05-11 00:00:00,Charter Flight,Landing (descent or approach),Commercial,United States of America,North America,6,2,2,4,4,6,0,Human Factor
1973-06-03 00:00:00,Tupolev Industries - GKAP Tupolev OKB,Flight,Operational,France,Europe,6,6,6,0,0,6,0,Human Factor
1973-09-07 00:00:00,Líder Taxi Aéreo,Takeoff (climb),Commercial,Brazil,South America,8,2,2,6,4,6,2,Unknown
1973-09-08 00:00:00,World Airways,Flight,Operational,United States of America,North America,6,3,3,3,3,6,0,Human Factor
1973-09-20 00:00:00,Robert Airways,Takeoff (climb),Commercial,United States of America,North America,6,1,1,5,5,6,0,Human Factor
1973-09-21 00:00:00,United States Coast Guard - USCG,Flight,Military / Government,World,World,6,6,6,0,0,6,0,Other
1973-11-02 00:00:00,Lineas Aéreas La Urraca,Landing (descent or approach),Commercial,Colombia,South America,16,4,3,12,3,6,10,Technical Failure
1973-12-21 00:00:00,TAM Bolivia - Transporte Aéreo Militar Boliviano,Landing (descent or approach),Operational,Peru,South America,9,3,1,6,5,6,3,Human Factor
1974-01-20 00:00:00,Marc-Land,Flight,Business,United States of America,North America,6,1,1,5,5,6,0,Human Factor
1974-01-24 00:00:00,Togolese Air Force - Forces aériennes togolaises,Landing (descent or approach),Military / Government,Togo,Africa,19,2,2,17,4,6,13,Unknown
1974-02-13 00:00:00,Yacimientos Petroliferos Fiscales Bolivianos - YPFB,Takeoff (climb),Business,Peru,South America,7,2,2,5,4,6,1,Unknown
1974-04-20 00:00:00,United States Air Force - USAF,Landing (descent or approach),Operational,Guam Island,Asia,6,6,6,0,0,6,0,Human Factor
1974-04-30 00:00:00,Metro Airlines,Takeoff (climb),Commercial,United States of America,North America,12,2,1,10,5,6,6,Human Factor
1974-07-02 00:00:00,Republic of Korea Air Force,Flight,Operational,South Korea,Asia,6,6,6,0,0,6,0,Technical Failure
1974-07-09 00:00:00,Egyptair,Landing (descent or approach),Operational,Egypt,Africa,6,6,6,0,0,6,0,Human Factor
1974-08-20 00:00:00,Brazilian Air Force - Força Aérea Brasileira,Landing (descent or approach),Military / Government,Brazil,South America,6,2,2,4,4,6,0,Unknown
1974-10-01 00:00:00,Winship Air Services,Landing (descent or approach),Commercial,United States of America,North America,6,2,2,4,4,6,0,Human Factor
1974-10-03 00:00:00,Guatemalan Air Force - Fuerza Aérea Guatemalteca,Takeoff (climb),Humanitarian,Guatemala,Central America,6,2,2,4,4,6,0,Technical Failure
1974-11-14 00:00:00,Aeroflot - Russian International Airlines,Takeoff (climb),Specialised Services,Ukraine,Europe,6,6,6,0,0,6,0,Technical Failure
1974-11-21 00:00:00,Private Colombian,Landing (descent or approach),Business,Colombia,South America,6,1,1,5,5,6,0,Human Factor
1975-04-26 00:00:00,Stribling-Puckett,Takeoff (climb),Business,United States of America,North America,9,1,1,8,5,6,3,Human Factor
1975-04-27 00:00:00,Private Iranian,Flight,Business,Iran,Asia,6,1,1,5,5,6,0,Unknown
1975-04-28 00:00:00,Executive Air Wing,Landing (descent or approach),Commercial,Liberia,Africa,6,1,1,5,5,6,0,Unknown
1975-05-11 00:00:00,Aircraft Specialties Company,Takeoff (climb),Operational,United States of America,North America,6,3,3,3,3,6,0,Technical Failure
1975-06-13 00:00:00,Transportes Colombiana de Aviacion - TAVINA,Flight,Commercial,Colombia,South America,6,1,1,5,5,6,0,Unknown
1975-07-26 00:00:00,United States Air Force - USAF,Flight,Operational,United States of America,North America,6,6,6,0,0,6,0,Technical Failure
1975-08-28 00:00:00,Argentinian Air Force - Fuerza Aérea Argentina,Takeoff (climb),Military / Government,Argentina,South America,121,7,0,114,6,6,115,Terrorism
1975-09-15 00:00:00,Aeroflot - Russian International Airlines,Flight,Specialised Services,Russia,Asia,6,3,3,3,3,6,0,Weather
1975-09-27 00:00:00,Aerotransportes Entre Rios,Takeoff (climb),Operational,United States of America,North America,10,6,4,4,2,6,4,Human Factor
1975-10-10 00:00:00,Charles D. Thompson,Flight,Business,United States of America,North America,6,1,1,5,5,6,0,Human Factor
1975-10-10 00:00:00,MAP - Ministerstvo Aviatsionnoi Promyshlennosti - Minaviaprom,Takeoff (climb),Operational,Russia,Asia,6,6,6,0,0,6,0,Technical Failure
1975-10-22 00:00:00,Aeroflot - Russian International Airlines,Landing (descent or approach),Commercial,Russia,Asia,6,4,4,2,2,6,0,Human Factor
1975-11-04 00:00:00,McJunkin Corporation,Takeoff (climb),Business,United States of America,North America,6,2,2,4,4,6,0,Technical Failure
1975-12-04 00:00:00,Richel Air,Landing (descent or approach),Commercial,Canada,North America,6,1,1,5,5,6,0,Unknown
1976-01-03 00:00:00,Winship Air Services,Landing (descent or approach),Commercial,United States of America,North America,8,2,2,6,4,6,2,Human Factor
1976-01-30 00:00:00,Aeroflot - Russian International Airlines,Landing (descent or approach),Operational,Kyrgyzstan,Asia,6,6,6,0,0,6,0,Human Factor
1976-03-01 00:00:00,TAROM - Transporturile Aeriene Române,Landing (descent or approach),Commercial,Romania,Europe,9,4,3,5,3,6,3,Human Factor
1976-03-24 00:00:00,Aeroflot - Russian International Airlines,Flight,Specialised Services,Turkmenistan,Asia,6,6,6,0,0,6,0,Human Factor
1976-04-15 00:00:00,Chartair - USA,Flight,Commercial,United States of America,North America,6,1,1,5,5,6,0,Weather
1976-08-27 00:00:00,Aeronaves del Peru,Flight,Operational,Peru,South America,6,6,6,0,0,6,0,Unknown
1976-11-01 00:00:00,United States Navy - USN,Landing (descent or approach),Operational,Japan,Asia,6,6,6,0,0,6,0,Unknown
1976-11-21 00:00:00,Pacific Western Airlines - PWA,Landing (descent or approach),Operational,Democratic Republic of Congo,Africa,6,6,6,0,0,6,0,Human Factor
1976-12-27 00:00:00,Transportes Aéreos Itenez,Takeoff (climb),Operational,Bolivia,South America,6,4,4,2,2,6,0,Other
1977-02-11 00:00:00,Catlin Aviation,Flight,Operational,United States of America,North America,6,1,1,5,5,6,0,Human Factor
1977-04-05 00:00:00,Aeroflot - Russian International Airlines,Flight,Operational,Russia,Asia,6,6,6,0,0,6,0,Human Factor
1977-04-14 00:00:00,NFD Luftverkehrs - Nürnberger Flugdienst,Landing (descent or approach),Commercial,Germany,Europe,6,2,2,4,4,6,0,Human Factor
1977-05-14 00:00:00,IAS Cargo Airlines,Landing (descent or approach),Operational,Zambia,Africa,6,5,5,1,1,6,0,Technical Failure
1977-05-28 00:00:00,Athabaska Airways,Takeoff (climb),Commercial,Canada,North America,6,2,2,4,4,6,0,Weather
1977-05-28 00:00:00,Athabaska Airways,Takeoff (climb),Commercial,Canada,North America,6,2,2,4,4,6,0,Weather
1977-07-08 00:00:00,Aeroflot - Russian International Airlines,Takeoff (climb),Operational,Georgia,Asia,7,7,6,0,0,6,1,Human Factor
1977-07-16 00:00:00,Stanley Aviation,Landing (descent or approach),Business,United States of America,North America,6,1,1,5,5,6,0,Weather
1977-07-27 00:00:00,Alpha Flug,Takeoff (climb),Humanitarian,Bulgaria,Europe,6,2,2,4,4,6,0,Technical Failure
1977-07-29 00:00:00,Royal Thai Air Force - Kong Thap Akat Thai,Flight,Military / Government,Thailand,Asia,6,6,6,0,0,6,0,Unknown
1977-08-07 00:00:00,Líneas Aéreas del Estado - LADE,Landing (descent or approach),Military / Government,Argentina,South America,6,4,4,2,2,6,0,Human Factor
1977-08-07 00:00:00,Spanish Air Force - Ejército del Aire,Landing (descent or approach),Operational,Spain,Europe,10,10,6,0,0,6,4,Unknown
1977-08-11 00:00:00,Galaxy Aviation,Flight,Business,United States of America,North America,6,1,1,5,5,6,0,Human Factor
1977-09-04 00:00:00,Chilean Navy,Landing (descent or approach),Military / Government,Chile,South America,6,6,6,0,0,6,0,Unknown
1977-09-04 00:00:00,Chilean Navy,Landing (descent or approach),Military / Government,Chile,South America,6,6,6,0,0,6,0,Unknown
1977-09-23 00:00:00,Private Brazilian,Flight,Business,Brazil,South America,6,1,1,5,5,6,0,Unknown
1977-10-20 00:00:00,L %26 J Company,Landing (descent or approach),Commercial,United States of America,North America,26,2,2,24,4,6,20,Technical Failure
1977-11-24 00:00:00,Kirkway Corporation,Landing (descent or approach),Business,United States of America,North America,6,1,1,5,5,6,0,Human Factor
1978-02-19 00:00:00,Charles E. Daniels,Flight,Business,United States of America,North America,7,1,1,6,5,6,1,Human Factor
1978-02-27 00:00:00,Chevron Oil Company,Landing (descent or approach),Business,United States of America,North America,6,2,2,4,4,6,0,Human Factor
1978-03-08 00:00:00,Pan Egypt,Landing (descent or approach),Commercial,Egypt,Africa,6,1,1,5,5,6,0,Unknown
1978-03-22 00:00:00,Lake Havasu Aviation,Flight,Commercial,United States of America,North America,6,1,1,5,5,6,0,Human Factor
1978-03-26 00:00:00,James E. Ferguson,Flight,Business,United States of America,North America,6,1,1,5,5,6,0,Human Factor
1978-03-30 00:00:00,Soviet Air Force - Voyenno-vozdushnye sily CCCP,Takeoff (climb),Operational,Russia,Asia,6,6,6,0,0,6,0,Unknown
1978-04-30 00:00:00,Royal Thai Air Force - Kong Thap Akat Thai,Takeoff (climb),Military / Government,Thailand,Asia,6,2,2,4,4,6,0,Unknown
1978-07-10 00:00:00,Great Western Mineral Corporation,Takeoff (climb),Business,United States of America,North America,6,1,1,5,5,6,0,Technical Failure
1978-07-12 00:00:00,Southwest Aircraft Leasing,Flight,Business,United States of America,North America,6,1,1,5,5,6,0,Weather
1978-08-08 00:00:00,Christian Demaria,Landing (descent or approach),Business,Bahamas,Central America,6,1,1,5,5,6,0,Human Factor
1978-08-25 00:00:00,Special Jet,Landing (descent or approach),Commercial,United States of America,North America,6,1,1,5,5,6,0,Human Factor
1978-09-09 00:00:00,Air Taxi,Takeoff (climb),Commercial,United States of America,North America,6,1,1,5,5,6,0,Technical Failure
1978-09-13 00:00:00,Alaska Travel,Flight,Commercial,United States of America,North America,6,1,1,5,5,6,0,Human Factor
1978-09-26 00:00:00,Air Caribbean,Landing (descent or approach),Commercial,Puerto Rico,Central America,6,1,1,5,5,6,0,Other
1978-10-19 00:00:00,W. C. Wilcox,Flight,Business,Mexico,Central America,6,1,1,5,5,6,0,Human Factor
1978-11-30 00:00:00,United States Air Force - USAF,Flight,Military / Government,United States of America,North America,6,6,6,0,0,6,0,Weather
1979-01-19 00:00:00,Massey Ferguson,Landing (descent or approach),Business,United States of America,North America,6,2,2,4,4,6,0,Unknown
1979-01-30 00:00:00,VARIG - Viação Aérea Rio Grandense,Flight,Operational,World,World,6,6,6,0,0,6,0,Technical Failure
1979-07-23 00:00:00,TMA of Lebanon - Trans Mediterranean Airways,Landing (descent or approach),Operational,Lebanon,Asia,6,6,6,0,0,6,0,Human Factor
1979-09-04 00:00:00,Labrador Airways,Landing (descent or approach),Commercial,Canada,North America,8,1,1,7,5,6,2,Human Factor
1979-09-06 00:00:00,Gulf-Air Aviation,Takeoff (climb),Commercial,Canada,North America,6,1,1,5,5,6,0,Unknown
1979-09-11 00:00:00,China Airlines,Takeoff (climb),Operational,Taiwan,Asia,6,6,6,0,0,6,0,Unknown
1979-10-09 00:00:00,Great Shield Air,Takeoff (climb),Commercial,Canada,North America,6,1,1,5,5,6,0,Other
1979-12-09 00:00:00,Soviet Air Force - Voyenno-vozdushnye sily CCCP,Takeoff (climb),Military / Government,Uzbekistan,Asia,6,4,4,2,2,6,0,Human Factor
1979-12-11 00:00:00,Private Argentinian,Flight,Business,Argentina,South America,6,1,1,5,5,6,0,Unknown
1980-01-13 00:00:00,J. P. D. Partnership,Flight,Business,United States of America,North America,6,1,1,5,5,6,0,Human Factor
1980-03-24 00:00:00,Caspair,Flight,Commercial,Kenya,Africa,6,1,1,5,5,6,0,Unknown
1980-03-24 00:00:00,Tomahawk Airways,Flight,Commercial,Canada,North America,9,1,1,8,5,6,3,Unknown
1980-04-17 00:00:00,United States Navy - USN,Landing (descent or approach),Operational,Samoa,Oceania,6,6,6,0,0,6,0,Human Factor
1980-05-05 00:00:00,Rallye Deutschland,Flight,Business,Austria,Europe,6,1,1,5,5,6,0,Unknown
1980-05-28 00:00:00,Lake Aviation,Takeoff (climb),Operational,United States of America,North America,6,1,1,5,5,6,0,Human Factor
1980-06-01 00:00:00,Mary G. Richert,Flight,Business,United States of America,North America,6,1,1,5,5,6,0,Human Factor
1980-07-24 00:00:00,French Air Force - Armée de l'Air,Takeoff (climb),Military / Government,France,Europe,6,1,1,5,5,6,0,Unknown
1980-09-04 00:00:00,Companhia Textil Ferreira Guimaraes,Landing (descent or approach),Business,Brazil,South America,6,1,1,5,5,6,0,Human Factor
1980-09-12 00:00:00,John Matthews,Landing (descent or approach),Business,United States of America,North America,6,1,1,5,5,6,0,Human Factor
1980-09-22 00:00:00,Iraqi Air Force - Al Quwwat al Jawwiya al Iraqiya,Flight,Military / Government,Iran,Asia,6,6,6,0,0,6,0,Terrorism
1980-09-28 00:00:00,Air Fecteau,Takeoff (climb),Humanitarian,Canada,North America,6,1,1,5,5,6,0,Unknown
1980-10-28 00:00:00,Aeroflot - Russian International Airlines,Landing (descent or approach),Operational,Afghanistan,Asia,6,6,6,0,0,6,0,Human Factor
1980-11-03 00:00:00,Soviet Air Force - Voyenno-vozdushnye sily CCCP,Landing (descent or approach),Military / Government,Russia,Asia,6,6,6,0,0,6,0,Human Factor
1980-11-04 00:00:00,Venezuelan Air Force - Fuerza Aérea Venezolana,Takeoff (climb),Operational,Venezuela,South America,6,6,6,0,0,6,0,Technical Failure
1980-11-27 00:00:00,Private American,Landing (descent or approach),Business,United States of America,North America,6,1,1,5,5,6,0,Human Factor
1981-01-08 00:00:00,SAHSA - Servicios Aéreos de Honduras SA,Takeoff (climb),Operational,Guatemala,Central America,6,6,6,0,0,6,0,Human Factor
1981-03-04 00:00:00,Líneas Aéreas Riojanas,Flight,Commercial,Argentina,South America,6,2,2,4,4,6,0,Human Factor
1981-03-15 00:00:00,United States Air Force - USAF,Landing (descent or approach),Military / Government,United States of America,North America,24,4,0,20,6,6,18,Human Factor
1981-07-15 00:00:00,Crowley Maritime Corporation,Landing (descent or approach),Business,United States of America,North America,6,2,2,4,4,6,0,Human Factor
1981-07-30 00:00:00,Air BC - Air British Colombia,Flight,Commercial,Canada,North America,6,1,1,5,5,6,0,Human Factor
1981-07-30 00:00:00,Air BC - Air British Colombia,Flight,Commercial,Canada,North America,6,1,1,5,5,6,0,Human Factor
1981-08-01 00:00:00,Hemet Exploration,Flight,Specialised Services,Mozambique,Africa,6,3,3,3,3,6,0,Terrorism
1981-08-24 00:00:00,Soviet Air Force - Voyenno-vozdushnye sily CCCP,Flight,Other,Russia,Asia,6,6,6,0,0,6,0,Human Factor
1982-01-12 00:00:00,Soviet Air Force - Voyenno-vozdushnye sily CCCP,Flight,Operational,Russia,Asia,6,6,6,0,0,6,0,Technical Failure
1982-04-20 00:00:00,Campbell Taggart Inc.,Flight,Business,United States of America,North America,7,2,2,5,4,6,1,Human Factor
1982-05-14 00:00:00,Lineas Aéreas Petroleras,Landing (descent or approach),Commercial,Colombia,South America,6,2,2,4,4,6,0,Unknown
1982-07-08 00:00:00,Aeroflot - Russian International Airlines,Flight,Military / Government,Ukraine,Europe,6,2,2,4,4,6,0,Human Factor
1982-07-08 00:00:00,United States Navy - USN,Flight,Operational,United States of America,North America,6,6,6,0,0,6,0,Human Factor
1982-08-31 00:00:00,Republic of China Air Force,Takeoff (climb),Military / Government,Taiwan,Asia,12,2,0,10,6,6,6,Unknown
1982-09-12 00:00:00,Pat Griffin Company,Takeoff (climb),Business,United States of America,North America,6,1,1,5,5,6,0,Technical Failure
1982-10-18 00:00:00,Hessenatie-Sotramat Aviation,Flight,Commercial,Belgium,Europe,6,1,1,5,5,6,0,Unknown
1983-01-27 00:00:00,Mitsumarq,Landing (descent or approach),Business,United States of America,North America,7,2,2,5,4,6,1,Human Factor
1983-02-13 00:00:00,Upali Air,Flight,Business,Malaysia,Asia,6,3,3,3,3,6,0,Unknown
1983-02-13 00:00:00,United States Air Force - USAF,Parking,Military / Government,United States of America,North America,6,6,6,0,0,6,0,Technical Failure
1983-03-29 00:00:00,Aeroflot - Russian International Airlines,Takeoff (climb),Commercial,Georgia,Asia,18,3,2,15,4,6,12,Technical Failure
1983-04-19 00:00:00,Japan Air Self-Defense Force - Kōkū Jieitai,Flight,Operational,Japan,Asia,6,6,6,0,0,6,0,Human Factor
1983-06-28 00:00:00,United States Air Force - USAF,Flight,Operational,United States of America,North America,6,5,5,1,1,6,0,Unknown
1983-07-20 00:00:00,Technical Computer Services,Landing (descent or approach),Business,United States of America,North America,6,1,1,5,5,6,0,Human Factor
1983-11-20 00:00:00,Walley Construction Company,Landing (descent or approach),Business,United States of America,North America,6,1,1,5,5,6,0,Technical Failure
1984-01-17 00:00:00,Táxi Aéreo Candeias,Takeoff (climb),Commercial,Brazil,South America,10,2,2,8,4,6,4,Technical Failure
1984-01-24 00:00:00,Pelita Air Service,Landing (descent or approach),Commercial,Indonesia,Asia,9,2,2,7,4,6,3,Human Factor
1984-01-30 00:00:00,Gee Bee Aero,Landing (descent or approach),Operational,United States of America,North America,6,2,2,4,4,6,0,Human Factor
1984-02-24 00:00:00,Taxi Aéreo del Guaviare,Flight,Commercial,Colombia,South America,6,1,1,5,5,6,0,Technical Failure
1984-03-05 00:00:00,Anderson Tile %26 Carpet,Landing (descent or approach),Business,United States of America,North America,6,1,1,5,5,6,0,Human Factor
1984-03-31 00:00:00,Associated Air Service,Landing (descent or approach),Operational,Bahamas,Central America,6,1,1,5,5,6,0,Unknown
1984-07-14 00:00:00,Schröter Verwaltungs,Landing (descent or approach),Business,United States of America,North America,6,2,2,4,4,6,0,Human Factor
1984-08-27 00:00:00,Soviet Air Force - Voyenno-vozdushnye sily CCCP,Flight,Military / Government,Russia,Asia,6,6,6,0,0,6,0,Human Factor
1984-10-19 00:00:00,Wapiti Aviation,Flight,Commercial,Canada,North America,10,2,1,8,5,6,4,Human Factor
1984-11-23 00:00:00,French Air Force - Armée de l'Air,Flight,Operational,France,Europe,6,6,6,0,0,6,0,Human Factor
1985-02-11 00:00:00,Specialty Coating Systems,Takeoff (climb),Business,United States of America,North America,6,1,1,5,5,6,0,Human Factor
1985-03-29 00:00:00,Royal Canadian Air Force - RCAF,Flight,Operational,Canada,North America,6,4,4,2,2,6,0,Human Factor
1985-09-13 00:00:00,William D. Champion,Landing (descent or approach),Business,United States of America,North America,6,1,1,5,5,6,0,Human Factor
1986-02-17 00:00:00,Aeroflot - Russian International Airlines,Flight,Operational,Antarctica,Antarctica,6,6,6,0,0,6,0,Technical Failure
1986-03-26 00:00:00,Wing Air Service,Landing (descent or approach),Business,Bahamas,Central America,6,1,1,5,5,6,0,Unknown
1986-05-07 00:00:00,Kaiser Steel Corporation,Flight,Business,United States of America,North America,6,2,2,4,4,6,0,Weather
1986-05-08 00:00:00,Private American,Takeoff (climb),Business,United States of America,North America,6,1,1,5,5,6,0,Technical Failure
1986-07-04 00:00:00,National Argentinian Police,Flight,Military / Government,Argentina,South America,6,2,2,4,4,6,0,Human Factor
1986-08-21 00:00:00,Idaho Helicopters,Flight,Commercial,United States of America,North America,6,1,1,5,5,6,0,Human Factor
1986-09-03 00:00:00,Peninsula Airways,Takeoff (climb),Humanitarian,Australia,Oceania,6,1,1,5,5,6,0,Technical Failure
1986-10-17 00:00:00,Private Swiss,Flight,Business,Italy,Europe,6,1,1,5,5,6,0,Human Factor
1986-10-17 00:00:00,Private Swiss,Flight,Business,Italy,Europe,6,1,1,5,5,6,0,Human Factor
1986-11-02 00:00:00,RapidAir,Landing (descent or approach),Commercial,France,Europe,6,1,1,5,5,6,0,Unknown
1986-12-10 00:00:00,Teledyne Industries,Landing (descent or approach),Business,United States of America,North America,6,2,2,4,4,6,0,Human Factor
1986-12-15 00:00:00,CAAC - Civil Aviation Administration of China,Landing (descent or approach),Commercial,China,Asia,44,7,0,37,6,6,38,Weather
1987-03-13 00:00:00,United States Air Force - USAF,Landing (descent or approach),Operational,United States of America,North America,6,6,6,0,0,6,0,Other
1987-09-02 00:00:00,Afghan Republican Air Force - Afghan Hanai Qurah,Landing (descent or approach),Military / Government,Afghanistan,Asia,8,3,3,5,3,6,2,Terrorism
1987-09-30 00:00:00,Aero Servicio de Sonora,Landing (descent or approach),Commercial,United States of America,North America,6,1,1,5,5,6,0,Human Factor
1987-10-14 00:00:00,Zimex Aviation,Flight,Humanitarian,Angola,Africa,6,4,4,2,2,6,0,Terrorism
1987-10-20 00:00:00,Hastingwood Hotels,Takeoff (climb),Business,United Kingdom,Europe,6,1,1,5,5,6,0,Technical Failure
1987-11-15 00:00:00,Private Philippine,Landing (descent or approach),Business,Philippines,Asia,6,2,2,4,4,6,0,Human Factor
1987-12-23 00:00:00,SouthCentral Air,Takeoff (climb),Commercial,United States of America,North America,8,1,1,7,5,6,2,Human Factor
1988-02-19 00:00:00,Mexican Navy - Armada de México,Flight,Military / Government,Mexico,Central America,6,6,6,0,0,6,0,Unknown
1988-02-25 00:00:00,Iraqi Air Force - Al Quwwat al Jawwiya al Iraqiya,Flight,Military / Government,World,World,6,6,6,0,0,6,0,Terrorism
1988-04-16 00:00:00,Chaillotine Air Service,Flight,Business,France,Europe,6,1,1,5,5,6,0,Unknown
1988-04-20 00:00:00,Soviet Air Force - Voyenno-vozdushnye sily CCCP,Takeoff (climb),Operational,Russia,Asia,6,6,6,0,0,6,0,Human Factor
1988-05-24 00:00:00,Aeronica - Aerolineas Nicaraguenses,Flight,Operational,Panama,Central America,6,6,6,0,0,6,0,Human Factor
1988-06-08 00:00:00,Ecuadorian Navy - Aviación Naval Ecuatoriana,Takeoff (climb),Military / Government,Ecuador,South America,6,2,2,4,4,6,0,Unknown
1988-06-08 00:00:00,United States Air Force - USAF,Landing (descent or approach),Operational,United States of America,North America,6,6,6,0,0,6,0,Unknown
1988-07-02 00:00:00,German Air Force - Deutsche Luftwaffe,Landing (descent or approach),Military / Government,France,Europe,6,6,6,0,0,6,0,Technical Failure
1988-07-21 00:00:00,Angola Air Charter,Landing (descent or approach),Operational,Nigeria,Africa,6,6,6,0,0,6,0,Human Factor
1988-08-19 00:00:00,MD Air Services,Landing (descent or approach),Commercial,Bahamas,Central America,6,2,2,4,4,6,0,Human Factor
1988-10-04 00:00:00,Aeroflot - Russian International Airlines,Landing (descent or approach),Operational,Russia,Asia,6,6,6,0,0,6,0,Human Factor
1988-10-11 00:00:00,United States Air Force - USAF,Landing (descent or approach),Operational,United States of America,North America,16,6,6,10,0,6,10,Unknown
1988-11-14 00:00:00,Wasawings,Landing (descent or approach),Commercial,Finland,Europe,12,2,2,10,4,6,6,Human Factor
1988-11-18 00:00:00,M %26 L Aircraft,Landing (descent or approach),Business,United States of America,North America,6,1,1,5,5,6,0,Human Factor
1988-12-07 00:00:00,Aeroflot - Russian International Airlines,Landing (descent or approach),Commercial,Russia,Asia,14,2,2,12,4,6,8,Human Factor
1989-03-13 00:00:00,Soviet Air Force - Voyenno-vozdushnye sily CCCP,Flight,Operational,Ukraine,Europe,6,6,6,0,0,6,0,Other
1989-05-05 00:00:00,Aero Cozumel,Landing (descent or approach),Commercial,Mexico,Central America,19,2,0,17,6,6,13,Technical Failure
1989-05-17 00:00:00,Royal Malaysia Police - Polis Diraja Malaysia,Landing (descent or approach),Military / Government,Malaysia,Asia,6,1,1,5,5,6,0,Technical Failure
1989-06-11 00:00:00,Aerotaca Colombia - Aerotaxi Casanare,Flight,Commercial,Colombia,South America,22,2,0,20,6,6,16,Human Factor
1989-06-18 00:00:00,Ariana Afghan Airlines,Landing (descent or approach),Commercial,Iran,Asia,39,4,1,35,5,6,33,Terrorism
1989-08-02 00:00:00,Rainbow Properties,Takeoff (climb),Business,United States of America,North America,6,1,1,5,5,6,0,Technical Failure
1989-08-21 00:00:00,Sioux Narrows Airways,Takeoff (climb),Commercial,Canada,North America,6,1,1,5,5,6,0,Unknown
1989-09-15 00:00:00,James Holmes,Landing (descent or approach),Business,United States of America,North America,6,1,1,5,5,6,0,Human Factor
1989-09-26 00:00:00,Nile Safaris Aviation,Takeoff (climb),Commercial,Sudan,Africa,6,1,1,5,5,6,0,Unknown
1989-11-05 00:00:00,Aerosucre Colombia,Flight,Operational,Colombia,South America,6,3,3,3,3,6,0,Human Factor
1989-12-15 00:00:00,Aero Venture,Takeoff (climb),Business,United States of America,North America,6,1,1,5,5,6,0,Human Factor
1989-12-26 00:00:00,United Express,Landing (descent or approach),Commercial,United States of America,North America,6,2,2,4,4,6,0,Human Factor
1990-05-29 00:00:00,Bernard Bouchayer,Landing (descent or approach),Business,Algeria,Africa,6,1,1,5,5,6,0,Human Factor
1990-06-13 00:00:00,Colombian National Army - Ejército Nacional de Colombia,Flight,Military / Government,Colombia,South America,6,2,2,4,4,6,0,Unknown
1991-01-05 00:00:00,Ronnie Ray Shanks,Takeoff (climb),Business,United States of America,North America,6,1,1,5,5,6,0,Human Factor
1991-03-11 00:00:00,Luft-Taxi Emsland,Landing (descent or approach),Commercial,Germany,Europe,7,1,1,6,5,6,1,Human Factor
1991-04-04 00:00:00,Central Mountain Air,Flight,Commercial,Canada,North America,7,3,3,4,3,6,1,Human Factor
1991-06-30 00:00:00,Richard E. Stahl,Flight,Business,United States of America,North America,6,1,1,5,5,6,0,Technical Failure
1991-08-06 00:00:00,Fiji Air Services,Landing (descent or approach),Commercial,Cook Islands,Oceania,10,2,1,8,5,6,4,Unknown
1991-10-11 00:00:00,LANSA Colombia - Lineas Aéreas Nacionales,Landing (descent or approach),Humanitarian,Guatemala,Central America,6,2,2,4,4,6,0,Human Factor
1991-11-09 00:00:00,Argentinian Navy - Armada Argentina,Takeoff (climb),Humanitarian,Argentina,South America,8,2,2,6,4,6,2,Unknown
1992-02-08 00:00:00,Jet-Air Bedarfsluftverkehrsunternehmen,Landing (descent or approach),Commercial,Germany,Europe,6,1,1,5,5,6,0,Human Factor
1992-03-05 00:00:00,Stephen R. Neece,Flight,Business,United States of America,North America,6,1,1,5,5,6,0,Human Factor
1992-06-24 00:00:00,William G. Whitehead,Takeoff (climb),Business,United States of America,North America,6,1,1,5,5,6,0,Human Factor
1992-07-28 00:00:00,Crasa Taxi Aéreo,Flight,Commercial,Brazil,South America,6,2,2,4,4,6,0,Human Factor
1992-07-30 00:00:00,Bristol Bay Lodge,Flight,Commercial,United States of America,North America,7,1,0,6,6,6,1,Human Factor
1992-10-07 00:00:00,United States Air Force - USAF,Flight,Operational,United States of America,North America,6,6,6,0,0,6,0,Unknown
1992-11-21 00:00:00,James D. Huber,Flight,Business,United States of America,North America,6,1,1,5,5,6,0,Human Factor
1992-11-30 00:00:00,United States Air Force - USAF,Flight,Operational,United States of America,North America,6,6,6,0,0,6,0,Unknown
1992-12-15 00:00:00,Milne Bay Air - MBA,Flight,Commercial,Papua New Guinea,Oceania,6,1,1,5,5,6,0,Human Factor
1993-01-27 00:00:00,Trans Service Airlift - TSA,Takeoff (climb),Operational,Democratic Republic of Congo,Africa,21,3,0,18,6,6,15,Technical Failure
1993-02-07 00:00:00,Taxi Aéreo Florianópolis,Landing (descent or approach),Commercial,Brazil,South America,6,2,2,4,4,6,0,Human Factor
1993-02-28 00:00:00,Formosa Airlines,Landing (descent or approach),Commercial,Taiwan,Asia,6,2,2,4,4,6,0,Weather
1993-03-05 00:00:00,Private Nicaraguan,Flight,Business,Nicaragua,Central America,6,1,1,5,5,6,0,Unknown
1993-03-23 00:00:00,TAM Brasil - Taxi Aéreo Marilia - Transportes Aéreos Regionais,Flight,Commercial,Brazil,South America,6,2,2,4,4,6,0,Human Factor
1993-03-30 00:00:00,Royal Thai Air Force - Kong Thap Akat Thai,Landing (descent or approach),Specialised Services,Thailand,Asia,6,5,5,1,1,6,0,Technical Failure
1993-04-02 00:00:00,Durst,Flight,Business,Germany,Europe,6,1,1,5,5,6,0,Unknown
1993-08-23 00:00:00,Russian Air Force - Voyenno-vozdushnye sily Rossii,Flight,Military / Government,Russia,Asia,6,6,6,0,0,6,0,Technical Failure
1993-09-17 00:00:00,Hibiscus Air,Landing (descent or approach),Commercial,Australia,Oceania,10,1,0,9,6,6,4,Human Factor
1993-10-27 00:00:00,Wideroe - Wideroe's Flyveselskap,Landing (descent or approach),Commercial,Norway,Europe,19,2,2,17,4,6,13,Human Factor
1994-03-21 00:00:00,Aurukun Air Services,Takeoff (climb),Commercial,Australia,Oceania,6,1,1,5,5,6,0,Human Factor
1994-07-17 00:00:00,Trans Island Air - Aero Services Barbados,Landing (descent or approach),Commercial,Martinique,Central America,6,1,1,5,5,6,0,Human Factor
1994-08-03 00:00:00,Les Ailes de Charlevoix,Takeoff (climb),Commercial,Canada,North America,6,1,1,5,5,6,0,Technical Failure
1994-08-07 00:00:00,Uyak Air Services,Flight,Commercial,United States of America,North America,7,1,1,6,5,6,1,Human Factor
1994-08-19 00:00:00,Emidio Simone,Landing (descent or approach),Business,Canada,North America,6,1,1,5,5,6,0,Human Factor
1994-09-23 00:00:00,HeavyLift Cargo Airlines,Takeoff (climb),Operational,China,Asia,12,6,3,6,3,6,6,Technical Failure
1995-01-16 00:00:00,Angola Air Force - Força Aérea Nacional Angolana,Flight,Military / Government,Angola,Africa,6,6,6,0,0,6,0,Terrorism
1995-03-29 00:00:00,Kiwi West Aviation,Takeoff (climb),Commercial,New Zealand,Oceania,6,2,2,4,4,6,0,Human Factor
1995-05-13 00:00:00,United States Air Force - USAF,Flight,Military / Government,United States of America,North America,6,6,6,0,0,6,0,Technical Failure
1995-05-29 00:00:00,Senegalair,Landing (descent or approach),Commercial,Senegal,Africa,10,2,2,8,4,6,4,Technical Failure
1995-06-02 00:00:00,Lineas Aéreas Entre Rios - LAER,Landing (descent or approach),Commercial,Argentina,South America,7,2,2,5,4,6,1,Technical Failure
1995-08-31 00:00:00,Malian Air Force - Force Aérienne de la République du Mali,Landing (descent or approach),Operational,Greece,Europe,6,6,6,0,0,6,0,Technical Failure
1995-09-20 00:00:00,Walsten Air Service,Landing (descent or approach),Commercial,Canada,North America,6,1,1,5,5,6,0,Human Factor
1995-09-29 00:00:00,Indonesian National Police - Kepolisian Negara Republik Indonesia,Flight,Military / Government,Indonesia,Asia,6,2,2,4,4,6,0,Unknown
1995-11-26 00:00:00,Bolivian Air Force - Fuerza Aérea Boliviana,Takeoff (climb),Military / Government,Bolivia,South America,6,2,2,4,4,6,0,Unknown
1995-12-21 00:00:00,Insured Titles of Tuscaloosa,Flight,Business,United States of America,North America,6,1,1,5,5,6,0,Human Factor
1996-04-05 00:00:00,Formosa Airlines,Landing (descent or approach),Commercial,Taiwan,Asia,17,2,0,15,6,6,11,Human Factor
1996-04-26 00:00:00,Nozaki Sangyo,Landing (descent or approach),Business,Japan,Asia,6,1,1,5,5,6,0,Human Factor
1996-10-03 00:00:00,Malu Aviation,Takeoff (climb),Commercial,Democratic Republic of Congo,Africa,21,2,2,19,4,6,15,Unknown
1996-10-06 00:00:00,GOSNII GA - Gosudarstvenny Issledovatelny Institut Grazhdanskoi Aviatsii,Landing (descent or approach),Operational,Angola,Africa,19,6,0,13,6,6,13,Human Factor
1996-12-22 00:00:00,Airborne Express,Flight,Specialised Services,United States of America,North America,6,3,3,3,3,6,0,Human Factor
1997-03-02 00:00:00,Chapi Air Travel,Flight,Commercial,Venezuela,South America,6,1,1,5,5,6,0,Unknown
1997-05-15 00:00:00,Azerbaijan Airlines - AZAL Airlines,Landing (descent or approach),Operational,Azerbaijan,Asia,6,6,6,0,0,6,0,Terrorism
1997-05-22 00:00:00,IPTN Casa-Nurtanio,Flight,Specialised Services,Indonesia,Asia,6,6,6,0,0,6,0,Technical Failure
1997-11-18 00:00:00,S.K. Griessels %26 R.D. Makin Partnership,Landing (descent or approach),Business,Mozambique,Africa,7,1,1,6,5,6,1,Weather
1998-02-02 00:00:00,Steel Authority of India,Landing (descent or approach),Business,India,Asia,6,1,1,5,5,6,0,Human Factor
1998-03-02 00:00:00,Dean E. Sorensen,Flight,Business,United States of America,North America,6,1,1,5,5,6,0,Human Factor
1998-03-10 00:00:00,Air Memphis,Takeoff (climb),Operational,Kenya,Africa,6,6,6,0,0,6,0,Unknown
1998-07-30 00:00:00,Alliance Air,Takeoff (climb),Commercial,India,Asia,6,3,3,3,3,6,0,Human Factor
1998-10-26 00:00:00,Air Mapeko,Flight,Operational,Angola,Africa,6,6,6,0,0,6,0,Unknown
1999-04-07 00:00:00,Turkish Airlines - THY Türk Hava Yollari,Flight,Operational,Turkey,Asia,6,6,6,0,0,6,0,Human Factor
1999-08-10 00:00:00,Gibalco Air Services,Landing (descent or approach),Commercial,Liberia,Africa,6,1,1,5,5,6,0,Unknown
1999-09-16 00:00:00,Procafe,Landing (descent or approach),Business,Guatemala,Central America,6,1,1,5,5,6,0,Weather
1999-10-24 00:00:00,Venezuelan Army - Ejército Bolivariano,Flight,Military / Government,Venezuela,South America,6,3,3,3,3,6,0,Unknown
1999-10-25 00:00:00,Sunjet Aviation,Flight,Commercial,United States of America,North America,6,2,2,4,4,6,0,Technical Failure
1999-11-10 00:00:00,Congolese Air Force - Force Aérienne de la République Démocratique du Congo,Taxiing,Military / Government,Democratic Republic of Congo,Africa,6,6,6,0,0,6,0,Other
1999-12-07 00:00:00,Grant Aviation,Flight,Commercial,United States of America,North America,6,1,1,5,5,6,0,Human Factor
1999-12-09 00:00:00,College of the Ozarks,Landing (descent or approach),Business,United States of America,North America,6,2,2,4,4,6,0,Human Factor
1999-12-29 00:00:00,Guinea Ecuatorial Airlines - GEASA,Flight,Operational,Turkey,Asia,6,2,2,4,4,6,0,Unknown
2000-02-01 00:00:00,Islamic Republic of Iran Air Force,Takeoff (climb),Operational,Iran,Asia,6,6,6,0,0,6,0,Technical Failure
2000-03-24 00:00:00,Sky Cabs,Landing (descent or approach),Operational,Sri Lanka,Asia,8,8,6,0,0,6,2,Technical Failure
2000-05-10 00:00:00,Price Aircraft Company,Landing (descent or approach),Business,United States of America,North America,6,2,2,4,4,6,0,Human Factor
2000-06-03 00:00:00,Private German,Flight,Business,France,Europe,6,1,1,5,5,6,0,Weather
2000-10-26 00:00:00,Nigerian Air Force,Landing (descent or approach),Military / Government,Nigeria,Africa,6,1,1,5,5,6,0,Unknown
2001-01-12 00:00:00,Udélio Scodro,Flight,Business,Brazil,South America,6,2,2,4,4,6,0,Human Factor
2001-12-14 00:00:00,Eagle Air - Uganda,Flight,Commercial,Democratic Republic of Congo,Africa,6,2,2,4,4,6,0,Unknown
2002-01-19 00:00:00,Air Fiordland,Flight,Commercial,New Zealand,Oceania,6,1,1,5,5,6,0,Human Factor
2002-05-25 00:00:00,Trigana Air Service,Flight,Commercial,Indonesia,Asia,6,4,4,2,2,6,0,Human Factor
2003-01-31 00:00:00,Euro Asia Aviation,Landing (descent or approach),Operational,Timor Leste,Asia,6,4,4,2,2,6,0,Human Factor
2003-04-04 00:00:00,FS Corsair,Landing (descent or approach),Business,United States of America,North America,7,2,2,5,4,6,1,Human Factor
2003-09-19 00:00:00,Mexican Air Force - Fuerza Aérea Mexicana,Flight,Military / Government,Mexico,Central America,6,6,6,0,0,6,0,Unknown
2004-02-24 00:00:00,City-Jet Luftfahrt,Landing (descent or approach),Humanitarian,Italy,Europe,6,3,3,3,3,6,0,Human Factor
2004-05-07 00:00:00,Kush Air,Takeoff (climb),Humanitarian,South Sudan,Africa,10,2,1,8,5,6,4,Other
2004-07-02 00:00:00,Air Ambulance by Air Trek,Takeoff (climb),Humanitarian,Panama,Central America,6,2,2,4,4,6,0,Unknown
2004-07-28 00:00:00,D %26 R Henderson,Landing (descent or approach),Business,Australia,Oceania,6,1,1,5,5,6,0,Human Factor
2004-08-03 00:00:00,Aviation Flight Standards,Takeoff (climb),Business,United States of America,North America,6,1,1,5,5,6,0,Human Factor
2004-11-27 00:00:00,Presidential Airways,Flight,Military / Government,Afghanistan,Asia,6,3,3,3,3,6,0,Human Factor
2005-01-08 00:00:00,Services Air,Landing (descent or approach),Operational,Uganda,Africa,6,6,6,0,0,6,0,Technical Failure
2005-03-27 00:00:00,J2W Aviation,Landing (descent or approach),Business,United States of America,North America,6,1,1,5,5,6,0,Human Factor
2005-05-08 00:00:00,Borealis Taxi Aéreo,Landing (descent or approach),Commercial,Argentina,South America,9,2,2,7,4,6,3,Human Factor
2005-07-16 00:00:00,GG Aircraft,Flight,Commercial,Costa Rica,Central America,6,1,1,5,5,6,0,Unknown
2006-02-03 00:00:00,Weekend Air Charter Services,Landing (descent or approach),Commercial,United States of America,North America,6,1,1,5,5,6,0,Human Factor
2006-02-16 00:00:00,Hasit Trockenmörtel,Landing (descent or approach),Business,Iraq,Asia,6,1,1,5,5,6,0,Human Factor
2006-03-09 00:00:00,Argentinian Air Force - Fuerza Aérea Argentina,Takeoff (climb),Humanitarian,Bolivia,South America,6,2,2,4,4,6,0,Technical Failure
2006-04-23 00:00:00,Kharkov State Aircraft Manufacturing Company - KSAMC,Landing (descent or approach),Humanitarian,Cameroon,Africa,6,6,6,0,0,6,0,Technical Failure
2006-07-07 00:00:00,Mango Airlines,Flight,Operational,Democratic Republic of Congo,Africa,6,6,6,0,0,6,0,Technical Failure
2006-07-29 00:00:00,Quantum Leap Skydiving Center,Takeoff (climb),Humanitarian,United States of America,North America,8,1,1,7,5,6,2,Technical Failure
2006-10-25 00:00:00,Services %26 Transports Aériens,Takeoff (climb),Commercial,Madagascar,Africa,6,2,2,4,4,6,0,Technical Failure
2006-11-18 00:00:00,Aerosucre Colombia,Landing (descent or approach),Operational,Colombia,South America,6,3,3,3,3,6,0,Human Factor
2007-03-17 00:00:00,UTAir,Landing (descent or approach),Commercial,Russia,Asia,57,7,0,50,6,6,51,Human Factor
2007-06-04 00:00:00,Marlin Air,Takeoff (climb),Humanitarian,United States of America,North America,6,2,2,4,4,6,0,Human Factor
2007-08-16 00:00:00,Seawind Aviation,Flight,Commercial,United States of America,North America,9,1,0,8,6,6,3,Human Factor
2008-01-05 00:00:00,Servant Air,Takeoff (climb),Commercial,United States of America,North America,10,1,1,9,5,6,4,Technical Failure
2008-02-01 00:00:00,Blue Sky Airways,Landing (descent or approach),Business,United States of America,North America,6,1,1,5,5,6,0,Human Factor
2008-07-21 00:00:00,United States Air Force - USAF,Flight,Operational,Guam Island,Asia,6,6,6,0,0,6,0,Technical Failure
2009-03-01 00:00:00,Command Air - Venezuela,Landing (descent or approach),Commercial,Venezuela,South America,6,2,2,4,4,6,0,Human Factor
2009-04-09 00:00:00,Aviastar Mandiri,Landing (descent or approach),Operational,Indonesia,Asia,6,6,6,0,0,6,0,Human Factor
2009-08-26 00:00:00,Aero Fret Business,Landing (descent or approach),Operational,Congo,Africa,6,5,5,1,1,6,0,Unknown
2009-10-21 00:00:00,AZZA Air Transport,Takeoff (climb),Operational,United Arab Emirates,Asia,6,6,6,0,0,6,0,Technical Failure
2009-11-28 00:00:00,Seair Seaplanes - Seair Services,Takeoff (climb),Commercial,Canada,North America,8,1,0,7,6,6,2,Other
2010-03-01 00:00:00,Private Chilean,Landing (descent or approach),Humanitarian,Chile,South America,6,1,1,5,5,6,0,Human Factor
2010-09-07 00:00:00,Colombian Air Force - Fuerza Aérea Colombiana,Flight,Military / Government,Colombia,South America,6,2,2,4,4,6,0,Unknown
2011-01-14 00:00:00,Construtora Meio Norte,Landing (descent or approach),Business,Brazil,South America,6,1,1,5,5,6,0,Human Factor
2011-01-20 00:00:00,Ecuadorian Air Force - Fuerza Aérea Ecuatoriana,Flight,Military / Government,Ecuador,South America,6,6,6,0,0,6,0,Unknown
2011-02-10 00:00:00,Manx2,Landing (descent or approach),Commercial,Ireland,Europe,12,2,2,10,4,6,6,Human Factor
2011-02-22 00:00:00,Maparca Compañía Aérea,Flight,Commercial,Venezuela,South America,6,1,1,5,5,6,0,Human Factor
2011-03-05 00:00:00,Voronezh Aircraft Production Association - VASO Airlines,Flight,Specialised Services,Russia,Asia,6,6,6,0,0,6,0,Human Factor
2011-08-14 00:00:00,NJX Partnership,Flight,Business,South Africa,Africa,6,1,1,5,5,6,0,Human Factor
2011-10-18 00:00:00,Nepalese Army,Flight,Humanitarian,Nepal,Asia,6,1,1,5,5,6,0,Unknown
2011-11-23 00:00:00,Ponderosa Aviation,Takeoff (climb),Business,United States of America,North America,6,1,1,5,5,6,0,Human Factor
2012-06-07 00:00:00,Roadside Ventures,Flight,Business,United States of America,North America,6,1,1,5,5,6,0,Human Factor
2012-09-30 00:00:00,Evram,Takeoff (climb),Business,Austria,Europe,8,1,1,7,5,6,2,Human Factor
2012-10-01 00:00:00,Private Australian,Flight,Business,Australia,Oceania,6,1,1,5,5,6,0,Human Factor
2012-11-09 00:00:00,Algerian Air Force - Al Quwwat Aljawwija Aljaza'Eriiya,Flight,Military / Government,France,Europe,6,5,5,1,1,6,0,Weather
2013-01-04 00:00:00,Transaero 5074,Flight,Commercial,Venezuela,South America,6,2,2,4,4,6,0,Unknown
2013-04-30 00:00:00,Procuraduría General de la República,Takeoff (climb),Military / Government,Mexico,Central America,6,2,2,4,4,6,0,Technical Failure
2013-11-19 00:00:00,Aircraft Guaranty Corporation Trustee,Flight,Business,France,Europe,6,1,1,5,5,6,0,Human Factor
2014-09-21 00:00:00,Egyptian Air Force and Air Defence Command,Landing (descent or approach),Operational,Egypt,Africa,7,7,6,0,0,6,1,Technical Failure
2014-11-14 00:00:00,Private Mexican,Flight,Business,Mexico,Central America,6,1,1,5,5,6,0,Unknown
2014-12-28 00:00:00,AG Air,Flight,Operational,Democratic Republic of Congo,Africa,6,6,6,0,0,6,0,Unknown
2015-01-20 00:00:00,Olimp Air,Landing (descent or approach),Commercial,Kazakhstan,Asia,7,3,3,4,3,6,1,Weather
2015-08-23 00:00:00,Air Saguenay,Flight,Commercial,Canada,North America,6,1,1,5,5,6,0,Human Factor
2016-04-06 00:00:00,Japan Air Self-Defense Force - Kōkū Jieitai,Landing (descent or approach),Specialised Services,Japan,Asia,6,6,6,0,0,6,0,Human Factor
2016-07-16 00:00:00,Private Bolivian,Landing (descent or approach),Business,Bolivia,South America,6,1,1,5,5,6,0,Unknown
2016-08-14 00:00:00,Oxford University Aircraft Charters,Landing (descent or approach),Business,United States of America,North America,6,1,1,5,5,6,0,Human Factor
2016-12-29 00:00:00,Superior Beverage Group,Takeoff (climb),Business,United States of America,North America,6,1,1,5,5,6,0,Human Factor
2017-03-27 00:00:00,ETA Air Charter,Landing (descent or approach),Commercial,Zimbabwe,Africa,6,2,2,4,4,6,0,Human Factor
2017-07-01 00:00:00,Sky King Flying Service,Flight,Business,United States of America,North America,6,1,1,5,5,6,0,Unknown
2017-11-15 00:00:00,Khabarovsk Airlines,Landing (descent or approach),Commercial,Russia,Asia,7,2,2,5,4,6,1,Technical Failure
2017-12-31 00:00:00,Sydney Seaplanes,Flight,Commercial,Australia,Oceania,6,1,1,5,5,6,0,Human Factor
2019-04-16 00:00:00,Archipiélagos Servicios Aéreos,Takeoff (climb),Commercial,Chile,South America,6,1,1,5,5,6,0,Unknown
2019-10-23 00:00:00,Beneficiadora de Metalicos,Flight,Business,Mexico,Central America,6,1,1,5,5,6,0,Unknown
2020-07-05 00:00:00,Brooks Seaplane Service,Flight,Commercial,United States of America,North America,6,1,1,5,5,6,0,Human Factor
2020-07-19 00:00:00,Feniks,Flight,Military / Government,Russia,Asia,6,2,2,4,4,6,0,Unknown
2020-07-31 00:00:00,High Adventure Air Charter,Takeoff (climb),Commercial,United States of America,North America,6,1,1,5,5,6,0,Unknown
2021-02-21 00:00:00,Mexican Air Force - Fuerza Aérea Mexicana,Takeoff (climb),Military / Government,Mexico,Central America,6,2,2,4,4,6,0,Unknown
2021-03-27 00:00:00,Private Mexican,Takeoff (climb),Business,Mexico,Central America,7,1,1,6,5,6,1,Unknown
2021-04-07 00:00:00,Private Ecuadorian,Flight,Humanitarian,Ecuador,South America,6,2,2,4,4,6,0,Unknown
2021-07-26 00:00:00,Tarco Aircraft Funding,Landing (descent or approach),Business,United States of America,North America,6,2,2,4,4,6,0,Unknown
2021-08-05 00:00:00,Southeast Aviation,Flight,Commercial,United States of America,North America,6,1,1,5,5,6,0,Unknown
2021-09-22 00:00:00,LPS Flight Checks %26 Systems,Flight,Specialised Services,Russia,Asia,6,6,6,0,0,6,0,Unknown
1918-06-08 00:00:00,Handley Page Aircraft Company Ltd,Takeoff (climb),Specialised Services,United Kingdom,Europe,6,6,5,0,0,5,1,Technical Failure
1919-04-22 00:00:00,Royal Air Force - RAF,Takeoff (climb),Operational,United Kingdom,Europe,7,2,2,5,3,5,2,Unknown
1921-09-03 00:00:00,United States Army Air Service - USAAS,Flight,Military / Government,United States of America,North America,5,2,2,3,3,5,0,Weather
1921-09-06 00:00:00,Compagnie Franco-Roumaine de Navigation Aérienne,Landing (descent or approach),Commercial,France,Europe,5,1,1,4,4,5,0,Human Factor
1921-10-03 00:00:00,Royal Air Force - RAF,Takeoff (climb),Operational,United Kingdom,Europe,5,5,5,0,0,5,0,Weather
1922-04-07 00:00:00,Compagnie des Grands Express Aériens - CGEA,Flight,Commercial,France,Europe,5,2,2,3,3,5,0,Human Factor
1922-07-16 00:00:00,Compagnie Franco-Roumaine de Navigation Aérienne,Takeoff (climb),Commercial,France,Europe,5,1,1,4,4,5,0,Technical Failure
1923-04-21 00:00:00,United States Army Air Service - USAAS,Takeoff (climb),Military / Government,United States of America,North America,5,5,5,0,0,5,0,Weather
1923-09-14 00:00:00,Daimler Airway,Flight,Commercial,United Kingdom,Europe,5,2,2,3,3,5,0,Human Factor
1925-03-22 00:00:00,Zakavia,Takeoff (climb),Commercial,Georgia,Asia,5,2,2,3,3,5,0,Unknown
1926-07-01 00:00:00,Compagnie Internationale de Navigation Aérienne - CIDNA,Flight,Commercial,Czech Republic,Europe,6,2,1,4,4,5,1,Technical Failure
1926-07-24 00:00:00,Deutsche Lufthansa,Landing (descent or approach),Commercial,Germany,Europe,5,1,1,4,4,5,0,Unknown
1926-09-29 00:00:00,French Air Force - Armée de l'Air,Flight,Operational,France,Europe,5,5,5,0,0,5,0,Technical Failure
1927-07-27 00:00:00,Deutsche Lufthansa,Flight,Commercial,Germany,Europe,5,2,2,3,3,5,0,Technical Failure
1928-09-02 00:00:00,Compagnie Internationale de Navigation Aérienne - CIDNA,Takeoff (climb),Commercial,France,Europe,5,3,3,2,2,5,0,Technical Failure
1928-11-23 00:00:00,Spokane Airways,Landing (descent or approach),Commercial,United States of America,North America,6,3,3,3,2,5,1,Human Factor
1928-12-01 00:00:00,Sunbeam Air Transport Company,Flight,Operational,United States of America,North America,5,1,1,4,4,5,0,Unknown
1929-01-08 00:00:00,Société Provençale de Constructions Aéronautiques,Landing (descent or approach),Specialised Services,France,Europe,5,5,5,0,0,5,0,Unknown
1929-04-09 00:00:00,Mexicana de Aviación,Takeoff (climb),Commercial,Mexico,Central America,5,1,1,4,4,5,0,Technical Failure
1929-04-21 00:00:00,Maddux Airlines,Flight,Commercial,United States of America,North America,5,2,2,3,3,5,0,Human Factor
1929-05-22 00:00:00,L'Aéropostale,Takeoff (climb),Commercial,Algeria,Africa,6,3,2,3,3,5,1,Other
1929-06-29 00:00:00,Bodensee Aerolloyd,Landing (descent or approach),Commercial,Germany,Europe,7,1,1,6,4,5,2,Human Factor
1929-09-17 00:00:00,L'Aéropostale,Flight,Commercial,Morocco,Africa,5,2,2,3,3,5,0,Unknown
1929-12-20 00:00:00,United States Army Air Corps - USAAC,Takeoff (climb),Military / Government,United States of America,North America,5,4,4,1,1,5,0,Unknown
1929-12-24 00:00:00,Aero Espresso Italiana,Flight,Operational,Greece,Europe,5,5,5,0,0,5,0,Technical Failure
1929-12-30 00:00:00,Transcontinental Air Transport - TAT,Landing (descent or approach),Commercial,United States of America,North America,5,2,2,3,3,5,0,Unknown
1930-01-02 00:00:00,Tanner Air Livery,Flight,Specialised Services,United States of America,North America,5,1,1,4,4,5,0,Human Factor
1930-01-02 00:00:00,Tanner Air Livery,Flight,Specialised Services,United States of America,North America,5,1,1,4,4,5,0,Human Factor
1930-01-27 00:00:00,Universal Airlines,Landing (descent or approach),Commercial,United States of America,North America,5,1,1,4,4,5,0,Unknown
1930-07-07 00:00:00,Deutsche Lufthansa,Flight,Commercial,Denmark,Europe,8,3,1,5,4,5,3,Technical Failure
1930-07-10 00:00:00,Cross Airways,Takeoff (climb),Commercial,United States of America,North America,5,1,1,4,4,5,0,Weather
1930-09-09 00:00:00,Government of the State of Yucatán,Flight,Military / Government,Mexico,Central America,5,2,2,3,3,5,0,Unknown
1931-07-01 00:00:00,John Maher,Flight,Business,Canada,North America,5,1,1,4,4,5,0,Technical Failure
1931-10-09 00:00:00,Corporación Aeronautica de Transportes,Flight,Commercial,Mexico,Central America,5,1,1,4,4,5,0,Unknown
1931-11-05 00:00:00,"New York, Philadelphia and Washington Airway Corporation",Landing (descent or approach),Commercial,United States of America,North America,5,1,1,4,4,5,0,Unknown
1932-10-27 00:00:00,Aeroflot - Russian International Airlines,Flight,Operational,Russia,Asia,7,3,3,4,2,5,2,Human Factor
1932-11-02 00:00:00,Deutsche Lufthansa,Flight,Commercial,Germany,Europe,5,2,2,3,3,5,0,Human Factor
1933-02-19 00:00:00,Canadian Airways,Takeoff (climb),Commercial,Canada,North America,5,2,2,3,3,5,0,Unknown
1933-04-23 00:00:00,Air Orient,Flight,Commercial,Italy,Europe,8,3,3,5,2,5,3,Weather
1933-05-21 00:00:00,Colombian Air Force - Fuerza Aérea Colombiana,Takeoff (climb),Military / Government,Colombia,South America,5,2,2,3,3,5,0,Technical Failure
1933-08-09 00:00:00,United States Navy - USN,Flight,Operational,United States of America,North America,6,6,5,0,0,5,1,Technical Failure
1933-08-29 00:00:00,Transcontinental %26 Western Air - TWA,Flight,Commercial,United States of America,North America,5,2,2,3,3,5,0,Weather
1933-12-14 00:00:00,Union Airways,Flight,Commercial,South Africa,Africa,6,2,2,4,3,5,1,Human Factor
1934-04-15 00:00:00,TsAGI - Tsentralniy Aerogidrodinamicheskiy Institut,Takeoff (climb),Specialised Services,Russia,Asia,5,5,5,0,0,5,0,Technical Failure
1934-04-26 00:00:00,Aeroflot - Russian International Airlines,Flight,Commercial,Tajikistan,Asia,5,2,2,3,3,5,0,Technical Failure
1934-07-04 00:00:00,Fred Symington,Flight,Business,United States of America,North America,5,1,1,4,4,5,0,Technical Failure
1934-08-31 00:00:00,Rapid Air Transport,Flight,Commercial,United States of America,North America,5,1,1,4,4,5,0,Weather
1934-09-10 00:00:00,Iraqi Air Force - Al Quwwat al Jawwiya al Iraqiya,Flight,Military / Government,Iraq,Asia,5,2,2,3,3,5,0,Unknown
1934-11-06 00:00:00,Deutsche Reichsbahn Gesellschaft,Flight,Operational,Poland,Europe,5,5,5,0,0,5,0,Unknown
1934-11-12 00:00:00,French Navy,Flight,Operational,France,Europe,5,4,4,1,1,5,0,Unknown
1935-03-29 00:00:00,Deutsche Lufthansa,Flight,Operational,Russia,Asia,5,5,5,0,0,5,0,Unknown
1935-05-06 00:00:00,Transcontinental %26 Western Air - TWA,Landing (descent or approach),Commercial,United States of America,North America,11,3,2,8,3,5,6,Weather
1935-07-28 00:00:00,Colombian Air Force - Fuerza Aérea Colombiana,Flight,Military / Government,Colombia,South America,5,2,2,3,3,5,0,Technical Failure
1935-10-02 00:00:00,Holyman's Airways,Flight,Commercial,Australia,Oceania,5,2,2,3,3,5,0,Unknown
1936-03-14 00:00:00,LAN Chile - Linea Aérea Nacional de Chile,Takeoff (climb),Commercial,Chile,South America,5,1,1,4,4,5,0,Unknown
1936-03-26 00:00:00,Commercial Air Hire,Flight,Military / Government,United Kingdom,Europe,5,1,1,4,4,5,0,Unknown
1936-04-01 00:00:00,Regia Aeronautica,Flight,Operational,Italy,Europe,5,5,5,0,0,5,0,Unknown
1936-04-05 00:00:00,United States Army Air Corps - USAAC,Flight,Military / Government,United States of America,North America,5,5,5,0,0,5,0,Unknown
1936-09-09 00:00:00,French Air Force - Armée de l'Air,Flight,Military / Government,France,Europe,5,5,5,0,0,5,0,Unknown
1936-09-20 00:00:00,Regia Aeronautica,Flight,Military / Government,Italy,Europe,6,5,4,1,1,5,1,Unknown
1936-12-07 00:00:00,Air France,Flight,Commercial,World,World,5,5,5,0,0,5,0,Technical Failure
1937-01-12 00:00:00,Western Air Express,Landing (descent or approach),Commercial,United States of America,North America,13,3,1,10,4,5,8,Human Factor
1937-02-19 00:00:00,Airlines of Australia,Flight,Commercial,Australia,Oceania,7,2,2,5,3,5,2,Weather
1937-03-24 00:00:00,Imperial Airways,Flight,Commercial,France,Europe,6,5,4,1,1,5,1,Human Factor
1937-05-19 00:00:00,Lioré-et-Olivier Industries,Takeoff (climb),Specialised Services,France,Europe,10,10,5,0,0,5,5,Technical Failure
1937-08-01 00:00:00,Wideroe - Wideroe's Flyveselskap,Flight,Commercial,Norway,Europe,5,1,1,4,4,5,0,Unknown
1937-08-06 00:00:00,Aeroflot - Russian International Airlines,Flight,Commercial,Romania,Europe,5,3,3,2,2,5,0,Technical Failure
1937-08-08 00:00:00,Air Commerciale,Flight,Commercial,Portugal,Europe,5,1,1,4,4,5,0,Technical Failure
1937-10-22 00:00:00,Türk Hava Kurumu - THK,Landing (descent or approach),Commercial,Turkey,Asia,5,2,2,3,3,5,0,Unknown
1938-02-02 00:00:00,United States Navy - USN,Flight,Military / Government,United States of America,North America,6,2,2,4,3,5,1,Human Factor
1938-02-25 00:00:00,French Air Force - Armée de l'Air,Landing (descent or approach),Operational,France,Europe,5,5,5,0,0,5,0,Technical Failure
1938-04-05 00:00:00,Royal Air Force - RAF,Landing (descent or approach),Operational,United Kingdom,Europe,5,5,5,0,0,5,0,Unknown
1938-04-20 00:00:00,French Air Force - Armée de l'Air,Flight,Military / Government,France,Europe,5,5,5,0,0,5,0,Unknown
1938-05-10 00:00:00,French Air Force - Armée de l'Air,Landing (descent or approach),Operational,France,Europe,5,5,5,0,0,5,0,Weather
1938-05-29 00:00:00,Royal Australian Air Force - RAAF,Flight,Operational,Australia,Oceania,5,5,5,0,0,5,0,Unknown
1938-07-27 00:00:00,French Air Force - Armée de l'Air,Flight,Operational,France,Europe,5,5,5,0,0,5,0,Unknown
1938-08-07 00:00:00,Royal Air Force - RAF,Flight,Operational,United Kingdom,Europe,5,5,5,0,0,5,0,Unknown
1938-08-29 00:00:00,North Queensland Airways,Landing (descent or approach),Commercial,Australia,Oceania,9,1,1,8,4,5,4,Human Factor
1938-10-04 00:00:00,Soviet Air Force - Voyenno-vozdushnye sily CCCP,Flight,Military / Government,Russia,Asia,5,3,3,2,2,5,0,Human Factor
1938-10-06 00:00:00,Royal Air Force - RAF,Flight,Operational,United Kingdom,Europe,5,5,5,0,0,5,0,Weather
1938-10-16 00:00:00,Swedish Air Force - Flygvapnet,Flight,Humanitarian,Sweden,Europe,5,1,1,4,4,5,0,Unknown
1938-11-29 00:00:00,United Airlines,Flight,Commercial,United States of America,North America,7,3,2,4,3,5,2,Technical Failure
1938-12-23 00:00:00,United States Army Air Corps - USAAC,Flight,Military / Government,United States of America,North America,5,5,5,0,0,5,0,Unknown
1939-01-07 00:00:00,Swissair,Landing (descent or approach),Commercial,France,Europe,17,5,3,12,2,5,12,Human Factor
1939-04-22 00:00:00,French Air Force - Armée de l'Air,Landing (descent or approach),Military / Government,France,Europe,5,5,5,0,0,5,0,Human Factor
1939-04-22 00:00:00,French Air Force - Armée de l'Air,Landing (descent or approach),Military / Government,France,Europe,5,5,5,0,0,5,0,Human Factor
1939-08-06 00:00:00,Catholic Mission of the Holy Ghost,Takeoff (climb),Business,Papua New Guinea,Oceania,5,1,1,4,4,5,0,Other
1939-08-15 00:00:00,British Airways,Flight,Commercial,Denmark,Europe,6,2,1,4,4,5,1,Technical Failure
1939-09-04 00:00:00,Royal Air Force - RAF,Flight,Military / Government,Germany,Europe,5,5,5,0,0,5,0,Terrorism
1939-09-08 00:00:00,Royal Air Force - RAF,Flight,Operational,United Kingdom,Europe,5,5,5,0,0,5,0,Human Factor
1939-10-02 00:00:00,Royal Air Force - RAF,Flight,Military / Government,World,World,5,5,5,0,0,5,0,Unknown
1939-10-10 00:00:00,SCADTA - Sociedad Colombo-Alemana de Transportes Aéreos,Flight,Commercial,Colombia,South America,5,2,2,3,3,5,0,Unknown
1939-10-25 00:00:00,Royal Air Force - RAF,Flight,Military / Government,World,World,5,5,5,0,0,5,0,Unknown
1939-10-30 00:00:00,Royal Air Force - RAF,Flight,Operational,United Kingdom,Europe,5,5,5,0,0,5,0,Human Factor
1939-11-11 00:00:00,Royal Air Force - RAF,Flight,Military / Government,France,Europe,5,5,5,0,0,5,0,Unknown
1939-11-28 00:00:00,Royal Air Force - RAF,Flight,Operational,United Kingdom,Europe,5,5,5,0,0,5,0,Unknown
1939-12-01 00:00:00,Royal Air Force - RAF,Flight,Operational,World,World,5,5,5,0,0,5,0,Unknown
1939-12-18 00:00:00,Royal Air Force - RAF,Flight,Military / Government,World,World,5,5,5,0,0,5,0,Terrorism
1939-12-18 00:00:00,Royal Air Force - RAF,Takeoff (climb),Military / Government,Australia,Oceania,5,3,3,2,2,5,0,Technical Failure
1939-12-18 00:00:00,Royal Air Force - RAF,Flight,Military / Government,Germany,Europe,5,5,5,0,0,5,0,Terrorism
1939-12-18 00:00:00,Royal Air Force - RAF,Flight,Military / Government,Germany,Europe,5,5,5,0,0,5,0,Terrorism
1939-12-21 00:00:00,British Airways,Flight,Commercial,Libya,Africa,11,5,2,6,3,5,6,Technical Failure
1940-01-18 00:00:00,Royal Air Force - RAF,Flight,Operational,United Kingdom,Europe,5,5,5,0,0,5,0,Weather
1940-02-27 00:00:00,German Air Force - Deutsche Luftwaffe,Flight,Military / Government,United Kingdom,Europe,5,5,5,0,0,5,0,Terrorism
1940-02-27 00:00:00,German Air Force - Deutsche Luftwaffe,Flight,Military / Government,United Kingdom,Europe,5,5,5,0,0,5,0,Terrorism
1940-03-08 00:00:00,Royal Air Force - RAF,Takeoff (climb),Operational,United Kingdom,Europe,5,5,5,0,0,5,0,Unknown
1940-03-12 00:00:00,Royal Air Force - RAF,Flight,Operational,United Kingdom,Europe,5,5,5,0,0,5,0,Unknown
1940-03-20 00:00:00,Royal Air Force - RAF,Flight,Military / Government,Germany,Europe,5,5,5,0,0,5,0,Terrorism
1940-04-04 00:00:00,Royal Air Force - RAF,Landing (descent or approach),Operational,United Kingdom,Europe,7,7,5,0,0,5,2,Unknown
1940-04-05 00:00:00,Royal Air Force - RAF,Flight,Operational,United Kingdom,Europe,5,5,5,0,0,5,0,Unknown
1940-04-12 00:00:00,Royal Air Force - RAF,Flight,Military / Government,World,World,5,5,5,0,0,5,0,Unknown
1940-04-22 00:00:00,British Overseas Airways Corporation - BOAC,Flight,Commercial,United Kingdom,Europe,5,3,3,2,2,5,0,Human Factor
1940-04-23 00:00:00,Royal Air Force - RAF,Flight,Military / Government,World,World,5,5,5,0,0,5,0,Unknown
1940-04-30 00:00:00,Royal Air Force - RAF,Flight,Military / Government,World,World,5,5,5,0,0,5,0,Unknown
1940-04-30 00:00:00,Royal Air Force - RAF,Flight,Military / Government,Norway,Europe,5,5,5,0,0,5,0,Terrorism
1940-05-01 00:00:00,Royal Air Force - RAF,Flight,Operational,United Kingdom,Europe,8,8,5,0,0,5,3,Unknown
1940-05-13 00:00:00,Royal Netherlands Navy - Marineluchtvaartdienst,Flight,Military / Government,Netherlands,Europe,5,5,5,0,0,5,0,Terrorism
1940-05-16 00:00:00,Royal Air Force - RAF,Flight,Military / Government,France,Europe,5,5,5,0,0,5,0,Unknown
1940-05-21 00:00:00,Royal Air Force - RAF,Flight,Military / Government,France,Europe,5,5,5,0,0,5,0,Unknown
1940-06-17 00:00:00,Royal Air Force - RAF,Landing (descent or approach),Military / Government,United Kingdom,Europe,5,5,5,0,0,5,0,Unknown
1940-08-15 00:00:00,German Air Force - Deutsche Luftwaffe,Flight,Military / Government,United Kingdom,Europe,5,5,5,0,0,5,0,Terrorism
1940-08-15 00:00:00,German Air Force - Deutsche Luftwaffe,Flight,Military / Government,United Kingdom,Europe,5,5,5,0,0,5,0,Terrorism
1940-08-21 00:00:00,German Air Force - Deutsche Luftwaffe,Flight,Military / Government,United Kingdom,Europe,5,5,5,0,0,5,0,Terrorism
1940-09-02 00:00:00,Royal Air Force - RAF,Flight,Military / Government,Netherlands,Europe,6,6,5,0,0,5,1,Human Factor
1940-09-09 00:00:00,Royal Air Force - RAF,Flight,Military / Government,United Kingdom,Europe,6,6,5,0,0,5,1,Unknown
1940-10-09 00:00:00,Royal Air Force - RAF,Landing (descent or approach),Military / Government,United Kingdom,Europe,5,5,5,0,0,5,0,Human Factor
1940-10-16 00:00:00,Royal Air Force - RAF,Flight,Operational,United Kingdom,Europe,5,5,5,0,0,5,0,Human Factor
1940-10-17 00:00:00,Royal Air Force - RAF,Flight,Military / Government,United Kingdom,Europe,6,6,5,0,0,5,1,Other
1940-10-19 00:00:00,Royal Air Force - RAF,Flight,Military / Government,Libya,Africa,5,5,5,0,0,5,0,Unknown
1940-11-10 00:00:00,Royal Air Force - RAF,Takeoff (climb),Military / Government,Kenya,Africa,5,2,2,3,3,5,0,Human Factor
1940-11-14 00:00:00,Royal Air Force - RAF,Flight,Military / Government,World,World,5,5,5,0,0,5,0,Unknown
1940-12-16 00:00:00,Royal Air Force - RAF,Flight,Military / Government,United Kingdom,Europe,5,5,5,0,0,5,0,Technical Failure
1941-01-20 00:00:00,China National Aviation Corporation - CNAC,Flight,Commercial,China,Asia,6,4,3,2,2,5,1,Weather
1941-01-28 00:00:00,Royal Australian Air Force - RAAF,Flight,Humanitarian,Australia,Oceania,5,3,3,2,2,5,0,Technical Failure
1941-03-13 00:00:00,Royal Air Force - RAF,Takeoff (climb),Military / Government,United Kingdom,Europe,6,6,5,0,0,5,1,Terrorism
1941-03-21 00:00:00,Royal Air Force - RAF,Flight,Operational,United Kingdom,Europe,5,5,5,0,0,5,0,Human Factor
1941-04-23 00:00:00,Royal Air Force - RAF,Flight,Military / Government,France,Europe,6,6,5,0,0,5,1,Unknown
1941-05-16 00:00:00,United States Army Air Corps - USAAC,Flight,Military / Government,United States of America,North America,5,5,5,0,0,5,0,Unknown
1941-06-09 00:00:00,Royal Air Force - RAF,Flight,Military / Government,United Kingdom,Europe,5,5,5,0,0,5,0,Human Factor
1941-07-30 00:00:00,Ala Littoria,Takeoff (climb),Commercial,Italy,Europe,25,5,0,20,5,5,20,Technical Failure
1941-07-31 00:00:00,Royal Air Force - RAF,Flight,Military / Government,United Kingdom,Europe,6,6,5,0,0,5,1,Unknown
1941-08-19 00:00:00,Royal Netherlands Navy - Marineluchtvaartdienst,Flight,Military / Government,Norway,Europe,5,5,5,0,0,5,0,Unknown
1941-08-23 00:00:00,Royal Canadian Air Force - RCAF,Takeoff (climb),Military / Government,United Kingdom,Europe,7,7,5,0,0,5,2,Unknown
1941-08-30 00:00:00,Royal Netherlands Navy - Marineluchtvaartdienst,Flight,Military / Government,Norway,Europe,5,5,5,0,0,5,0,Unknown
1941-08-30 00:00:00,Royal Netherlands Navy - Marineluchtvaartdienst,Flight,Military / Government,Norway,Europe,5,5,5,0,0,5,0,Unknown
1941-09-26 00:00:00,Compania Aramayo de Mines,Flight,Commercial,Bolivia,South America,5,2,2,3,3,5,0,Technical Failure
1941-10-13 00:00:00,Royal Netherlands East Indies Air Force - ML-KNIL,Takeoff (climb),Military / Government,Indonesia,Asia,5,4,4,1,1,5,0,Technical Failure
1941-10-13 00:00:00,Royal Air Force - RAF,Flight,Military / Government,Belgium,Europe,7,7,5,0,0,5,2,Terrorism
1941-10-14 00:00:00,Royal Air Force - RAF,Flight,Military / Government,Belgium,Europe,7,7,5,0,0,5,2,Terrorism
1941-10-23 00:00:00,Royal Air Force - RAF,Landing (descent or approach),Operational,Canada,North America,5,5,5,0,0,5,0,Unknown
1941-10-24 00:00:00,United States Army Air Forces - USAAF,Flight,Military / Government,United States of America,North America,5,5,5,0,0,5,0,Weather
1941-11-04 00:00:00,Royal Canadian Air Force - RCAF,Flight,Military / Government,Canada,North America,5,5,5,0,0,5,0,Human Factor
1941-11-18 00:00:00,Royal Air Force - RAF,Takeoff (climb),Operational,United Kingdom,Europe,5,5,5,0,0,5,0,Human Factor
1941-12-06 00:00:00,Royal Netherlands Navy - Marineluchtvaartdienst,Flight,Military / Government,Indonesia,Asia,5,5,5,0,0,5,0,Unknown
1941-12-09 00:00:00,Aeroflot - Russian International Airlines,Takeoff (climb),Operational,Russia,Asia,6,5,5,1,0,5,1,Human Factor
1941-12-10 00:00:00,United States Army Air Forces - USAAF,Flight,Military / Government,Philippines,Asia,5,5,5,0,0,5,0,Terrorism
1942-01-07 00:00:00,Royal Air Force - RAF,Flight,Operational,United Kingdom,Europe,5,5,5,0,0,5,0,Human Factor
1942-01-26 00:00:00,KNILM - Koninklijke Nederlandse Indies Luchtvaart Maatschappij,Flight,Military / Government,Indonesia,Asia,5,5,5,0,0,5,0,Terrorism
1942-02-01 00:00:00,South African Air Force,Flight,Specialised Services,South Africa,Africa,5,5,5,0,0,5,0,Human Factor
1942-02-11 00:00:00,Royal Australian Air Force - RAAF,Flight,Operational,Australia,Oceania,5,5,5,0,0,5,0,Weather
1942-02-18 00:00:00,Royal Air Force - RAF,Takeoff (climb),Military / Government,United Kingdom,Europe,5,5,5,0,0,5,0,Unknown
1942-02-19 00:00:00,United States Army Air Forces - USAAF,Flight,Military / Government,Indonesia,Asia,5,5,5,0,0,5,0,Terrorism
1942-02-23 00:00:00,Royal Netherlands Navy - Marineluchtvaartdienst,Landing (descent or approach),Military / Government,Indonesia,Asia,5,5,5,0,0,5,0,Unknown
1942-02-27 00:00:00,Honduran Air Force - Fuerza Aérea Hondureña,Flight,Military / Government,Honduras,Central America,5,5,5,0,0,5,0,Unknown
1942-03-08 00:00:00,United States Navy - USN,Takeoff (climb),Military / Government,United States of America,North America,5,5,5,0,0,5,0,Unknown
1942-03-14 00:00:00,Royal Air Force - RAF,Flight,Military / Government,Netherlands,Europe,7,7,5,0,0,5,2,Terrorism
1942-03-26 00:00:00,Royal Air Force - RAF,Flight,Military / Government,Netherlands,Europe,7,7,5,0,0,5,2,Terrorism
1942-04-18 00:00:00,United States Army Air Forces - USAAF,Flight,Military / Government,Papua New Guinea,Oceania,7,7,5,0,0,5,2,Terrorism
1942-05-03 00:00:00,Royal Air Force - RAF,Flight,Military / Government,Denmark,Europe,7,7,5,0,0,5,2,Terrorism
1942-05-07 00:00:00,Union Airways,Landing (descent or approach),Commercial,New Zealand,Oceania,5,2,2,3,3,5,0,Weather
1942-05-13 00:00:00,Royal Air Force - RAF,Flight,Operational,United Kingdom,Europe,5,5,5,0,0,5,0,Unknown
1942-05-19 00:00:00,Royal Air Force - RAF,Flight,Operational,United Kingdom,Europe,5,5,5,0,0,5,0,Unknown
1942-05-22 00:00:00,German Air Force - Deutsche Luftwaffe,Flight,Military / Government,Norway,Europe,5,4,4,1,1,5,0,Unknown
1942-05-22 00:00:00,Royal New Zealand Air Force - RNZAF,Flight,Military / Government,United Kingdom,Europe,6,6,5,0,0,5,1,Human Factor
1942-06-07 00:00:00,United States Army Air Forces - USAAF,Flight,Operational,United States of America,North America,5,5,5,0,0,5,0,Unknown
1942-06-17 00:00:00,Royal Australian Air Force - RAAF,Flight,Military / Government,World,World,5,5,5,0,0,5,0,Technical Failure
1942-06-18 00:00:00,Aeroflot - Russian International Airlines,Landing (descent or approach),Military / Government,Russia,Asia,7,5,3,2,2,5,2,Human Factor
1942-06-24 00:00:00,Royal Air Force - RAF,Flight,Operational,United Kingdom,Europe,5,5,5,0,0,5,0,Technical Failure
1942-07-03 00:00:00,Royal Air Force - RAF,Flight,Military / Government,Netherlands,Europe,7,7,5,0,0,5,2,Terrorism
1942-07-15 00:00:00,United States Army Air Forces - USAAF,Takeoff (climb),Operational,United States of America,North America,5,5,5,0,0,5,0,Unknown
1942-07-29 00:00:00,Royal Air Force - RAF,Flight,Military / Government,World,World,5,5,5,0,0,5,0,Unknown
1942-08-02 00:00:00,Royal Air Force - RAF,Flight,Operational,United Kingdom,Europe,5,5,5,0,0,5,0,Human Factor
1942-08-11 00:00:00,Royal Australian Air Force - RAAF,Flight,Operational,Australia,Oceania,5,5,5,0,0,5,0,Unknown
1942-08-13 00:00:00,Royal Canadian Air Force - RCAF,Landing (descent or approach),Operational,Canada,North America,5,5,5,0,0,5,0,Unknown
1942-08-20 00:00:00,United States Navy - USN,Landing (descent or approach),Operational,Panama,Central America,9,9,5,0,0,5,4,Human Factor
1942-08-23 00:00:00,Royal Air Force - RAF,Flight,Operational,United Kingdom,Europe,5,5,5,0,0,5,0,Human Factor
1942-08-26 00:00:00,United States Army Air Forces - USAAF,Flight,Operational,United States of America,North America,5,5,5,0,0,5,0,Technical Failure
1942-08-29 00:00:00,Royal Air Force - RAF,Flight,Military / Government,Netherlands,Europe,7,7,5,0,0,5,2,Terrorism
1942-09-06 00:00:00,Royal Air Force - RAF,Flight,Operational,United Kingdom,Europe,5,5,5,0,0,5,0,Human Factor
1942-09-13 00:00:00,Royal Air Force - RAF,Takeoff (climb),Military / Government,United Kingdom,Europe,5,5,5,0,0,5,0,Technical Failure
1942-09-14 00:00:00,Royal Australian Air Force - RAAF,Landing (descent or approach),Military / Government,Papua New Guinea,Oceania,5,5,5,0,0,5,0,Unknown
1942-09-15 00:00:00,Royal Australian Air Force - RAAF,Flight,Military / Government,Indonesia,Asia,5,5,5,0,0,5,0,Terrorism
1942-09-20 00:00:00,Royal Air Force - RAF,Flight,Operational,United Kingdom,Europe,5,5,5,0,0,5,0,Human Factor
1942-10-01 00:00:00,Royal Australian Air Force - RAAF,Flight,Military / Government,Indonesia,Asia,5,5,5,0,0,5,0,Unknown
1942-10-06 00:00:00,Royal Air Force - RAF,Takeoff (climb),Military / Government,United Kingdom,Europe,7,7,5,0,0,5,2,Unknown
1942-11-02 00:00:00,United States Navy - USN,Landing (descent or approach),Military / Government,Canada,North America,9,9,5,0,0,5,4,Weather
1942-11-05 00:00:00,German Air Force - Deutsche Luftwaffe,Flight,Military / Government,Norway,Europe,5,5,5,0,0,5,0,Unknown
1942-11-07 00:00:00,Royal Canadian Air Force - RCAF,Flight,Military / Government,Canada,North America,5,5,5,0,0,5,0,Unknown
1942-11-11 00:00:00,Aeroflot - Russian International Airlines,Flight,Commercial,Azerbaijan,Asia,6,5,5,1,0,5,1,Human Factor
1942-11-14 00:00:00,Royal Air Force - RAF,Landing (descent or approach),Operational,United Kingdom,Europe,5,5,5,0,0,5,0,Unknown
1942-11-20 00:00:00,Royal Air Force - RAF,Flight,Operational,United Kingdom,Europe,6,6,5,0,0,5,1,Human Factor
1942-11-20 00:00:00,Royal Air Force - RAF,Flight,Operational,United Kingdom,Europe,5,5,5,0,0,5,0,Human Factor
1942-11-24 00:00:00,United States Army Air Forces - USAAF,Flight,Operational,World,World,5,5,5,0,0,5,0,Unknown
1942-11-28 00:00:00,Royal Air Force - RAF,Flight,Operational,United Kingdom,Europe,5,5,5,0,0,5,0,Human Factor
1942-11-29 00:00:00,United States Army Air Forces - USAAF,Landing (descent or approach),Military / Government,Algeria,Africa,5,5,5,0,0,5,0,Human Factor
1942-12-05 00:00:00,Royal Air Force - RAF,Flight,Operational,United Kingdom,Europe,5,5,5,0,0,5,0,Unknown
1942-12-10 00:00:00,Royal Air Force - RAF,Flight,Operational,United Kingdom,Europe,6,6,5,0,0,5,1,Human Factor
1942-12-19 00:00:00,Royal New Zealand Air Force - RNZAF,Flight,Military / Government,Solomon Islands,Oceania,5,5,5,0,0,5,0,Unknown
1942-12-20 00:00:00,Royal Air Force - RAF,Flight,Military / Government,Tunisia,Africa,6,6,5,0,0,5,1,Unknown
1942-12-24 00:00:00,Royal Australian Air Force - RAAF,Flight,Military / Government,Timor Leste,Asia,5,5,5,0,0,5,0,Terrorism
1942-12-27 00:00:00,Royal Australian Air Force - RAAF,Flight,Military / Government,Timor Leste,Asia,5,5,5,0,0,5,0,Terrorism
1943-01-01 00:00:00,Royal Air Force - RAF,Flight,Operational,United Kingdom,Europe,5,5,5,0,0,5,0,Human Factor
1943-01-08 00:00:00,Royal Canadian Air Force - RCAF,Landing (descent or approach),Operational,Canada,North America,5,5,5,0,0,5,0,Technical Failure
1943-01-16 00:00:00,United States Navy - USN,Flight,Military / Government,United States of America,North America,5,5,5,0,0,5,0,Unknown
1943-01-23 00:00:00,Aeroflot - Russian International Airlines,Landing (descent or approach),Operational,Russia,Asia,10,7,3,3,2,5,5,Human Factor
1943-01-26 00:00:00,Royal Australian Air Force - RAAF,Flight,Operational,Australia,Oceania,5,5,5,0,0,5,0,Unknown
1943-02-12 00:00:00,Royal Air Force - RAF,Flight,Military / Government,United Kingdom,Europe,5,5,5,0,0,5,0,Human Factor
1943-02-13 00:00:00,Royal Air Force - RAF,Flight,Operational,United Kingdom,Europe,5,5,5,0,0,5,0,Unknown
1943-02-14 00:00:00,Royal Air Force - RAF,Flight,Military / Government,France,Europe,7,7,5,0,0,5,2,Technical Failure
1943-02-15 00:00:00,Royal Air Force - RAF,Flight,Operational,United Kingdom,Europe,5,5,5,0,0,5,0,Weather
1943-02-23 00:00:00,United States Army Air Forces - USAAF,Flight,Military / Government,Egypt,Africa,5,5,5,0,0,5,0,Unknown
1943-02-25 00:00:00,United States Navy - USN,Takeoff (climb),Military / Government,United States of America,North America,11,11,5,0,0,5,6,Unknown
1943-02-28 00:00:00,United States Army Air Forces - USAAF,Flight,Operational,United States of America,North America,5,5,5,0,0,5,0,Unknown
1943-03-01 00:00:00,Royal Air Force - RAF,Flight,Military / Government,United Kingdom,Europe,5,5,5,0,0,5,0,Technical Failure
1943-03-08 00:00:00,Soviet Air Force - Voyenno-vozdushnye sily CCCP,Flight,Military / Government,Russia,Asia,5,5,5,0,0,5,0,Unknown
1943-03-13 00:00:00,United States Army Air Forces - USAAF,Flight,Operational,United States of America,North America,5,5,5,0,0,5,0,Unknown
1943-03-29 00:00:00,Royal Air Force - RAF,Flight,Military / Government,United Kingdom,Europe,5,5,5,0,0,5,0,Technical Failure
1943-03-29 00:00:00,Royal Air Force - RAF,Flight,Operational,United Kingdom,Europe,5,5,5,0,0,5,0,Unknown
1943-04-03 00:00:00,Royal Australian Air Force - RAAF,Flight,Military / Government,Indonesia,Asia,5,5,5,0,0,5,0,Terrorism
1943-04-05 00:00:00,Royal Netherlands East Indies Air Force - ML-KNIL,Landing (descent or approach),Military / Government,Australia,Oceania,5,5,5,0,0,5,0,Unknown
1943-04-08 00:00:00,Royal Air Force - RAF,Flight,Operational,United Kingdom,Europe,5,5,5,0,0,5,0,Weather
1943-04-17 00:00:00,Royal Australian Air Force - RAAF,Flight,Military / Government,Australia,Oceania,5,5,5,0,0,5,0,Unknown
1943-04-18 00:00:00,Regia Aeronautica,Flight,Operational,Italy,Europe,5,5,5,0,0,5,0,Terrorism
1943-04-20 00:00:00,Royal Australian Air Force - RAAF,Takeoff (climb),Military / Government,Australia,Oceania,5,5,5,0,0,5,0,Human Factor
1943-04-20 00:00:00,Royal Australian Air Force - RAAF,Takeoff (climb),Military / Government,Australia,Oceania,5,5,5,0,0,5,0,Human Factor
1943-04-28 00:00:00,Royal Netherlands East Indies Air Force - ML-KNIL,Flight,Military / Government,Indonesia,Asia,5,5,5,0,0,5,0,Terrorism
1943-04-29 00:00:00,Air France,Landing (descent or approach),Operational,France,Europe,5,3,3,2,2,5,0,Technical Failure
1943-05-05 00:00:00,Royal Canadian Air Force - RCAF,Takeoff (climb),Military / Government,Canada,North America,6,6,5,0,0,5,1,Unknown
1943-05-07 00:00:00,Royal Australian Air Force - RAAF,Flight,Military / Government,Indonesia,Asia,5,5,5,0,0,5,0,Terrorism
1943-05-12 00:00:00,United States Army Air Forces - USAAF,Flight,Operational,Papua New Guinea,Oceania,5,4,4,1,1,5,0,Weather
1943-05-14 00:00:00,United States Navy - USN,Flight,Operational,United States of America,North America,5,5,5,0,0,5,0,Unknown
1943-05-17 00:00:00,United States Army Air Forces - USAAF,Flight,Military / Government,Netherlands,Europe,6,6,5,0,0,5,1,Terrorism
1943-05-17 00:00:00,United States Army Air Forces - USAAF,Flight,Military / Government,Netherlands,Europe,6,6,5,0,0,5,1,Terrorism
1943-05-17 00:00:00,Royal Air Force - RAF,Flight,Operational,United Kingdom,Europe,5,5,5,0,0,5,0,Human Factor
1943-05-17 00:00:00,Royal Air Force - RAF,Flight,Military / Government,Germany,Europe,7,7,5,0,0,5,2,Terrorism
1943-05-17 00:00:00,Royal Air Force - RAF,Flight,Operational,United Kingdom,Europe,7,7,5,0,0,5,2,Human Factor
1943-05-24 00:00:00,Royal Air Force - RAF,Flight,Military / Government,Netherlands,Europe,5,5,5,0,0,5,0,Terrorism
1943-05-24 00:00:00,Royal Air Force - RAF,Flight,Military / Government,Netherlands,Europe,5,5,5,0,0,5,0,Terrorism
1943-05-31 00:00:00,Royal Air Force - RAF,Flight,Operational,United Kingdom,Europe,5,5,5,0,0,5,0,Human Factor
1943-05-31 00:00:00,Royal Air Force - RAF,Flight,Operational,United Kingdom,Europe,5,5,5,0,0,5,0,Human Factor
1943-05-31 00:00:00,United States Army Air Forces - USAAF,Flight,Operational,United States of America,North America,5,5,5,0,0,5,0,Unknown
1943-06-03 00:00:00,Aeroflot - Russian International Airlines,Flight,Operational,Russia,Asia,8,5,4,3,1,5,3,Human Factor
1943-06-17 00:00:00,Royal Air Force - RAF,Flight,Operational,United Kingdom,Europe,5,5,5,0,0,5,0,Technical Failure
1943-06-27 00:00:00,Royal New Zealand Air Force - RNZAF,Flight,Military / Government,World,World,5,5,5,0,0,5,0,Technical Failure
1943-07-03 00:00:00,United States Navy - USN,Flight,Operational,United States of America,North America,5,5,5,0,0,5,0,Unknown
1943-07-06 00:00:00,Royal Australian Air Force - RAAF,Flight,Operational,Australia,Oceania,5,5,5,0,0,5,0,Unknown
1943-07-06 00:00:00,Royal Australian Air Force - RAAF,Flight,Operational,Australia,Oceania,5,5,5,0,0,5,0,Unknown
1943-07-07 00:00:00,Royal New Zealand Air Force - RNZAF,Flight,Military / Government,Solomon Islands,Oceania,5,5,5,0,0,5,0,Terrorism
1943-07-09 00:00:00,United States Army Air Forces - USAAF,Flight,Specialised Services,United States of America,North America,5,5,5,0,0,5,0,Human Factor
1943-07-09 00:00:00,Royal Australian Air Force - RAAF,Flight,Military / Government,Indonesia,Asia,5,5,5,0,0,5,0,Human Factor
1943-07-10 00:00:00,United States Army Air Forces - USAAF,Flight,Military / Government,Italy,Europe,5,5,5,0,0,5,0,Terrorism
1943-07-11 00:00:00,United States Army Air Forces - USAAF,Flight,Military / Government,Italy,Europe,5,5,5,0,0,5,0,Terrorism
1943-07-11 00:00:00,United States Army Air Forces - USAAF,Flight,Military / Government,Italy,Europe,5,5,5,0,0,5,0,Terrorism
1943-07-11 00:00:00,United States Army Air Forces - USAAF,Flight,Military / Government,Italy,Europe,5,5,5,0,0,5,0,Terrorism
1943-07-11 00:00:00,United States Army Air Forces - USAAF,Flight,Military / Government,Italy,Europe,5,5,5,0,0,5,0,Terrorism
1943-07-11 00:00:00,United States Army Air Forces - USAAF,Flight,Military / Government,Italy,Europe,5,5,5,0,0,5,0,Terrorism
1943-07-30 00:00:00,Aeroflot - Russian International Airlines,Flight,Military / Government,Belarus,Europe,7,6,5,1,0,5,2,Terrorism
1943-07-30 00:00:00,Royal Netherlands Navy - Marineluchtvaartdienst,Flight,Military / Government,Netherlands,Europe,5,5,5,0,0,5,0,Unknown
1943-08-01 00:00:00,United States Army Air Forces - USAAF,Flight,Military / Government,Romania,Europe,9,9,5,0,0,5,4,Terrorism
1943-08-02 00:00:00,United States Army Air Forces - USAAF,Flight,Operational,United States of America,North America,5,5,5,0,0,5,0,Weather
1943-08-04 00:00:00,Royal Air Force - RAF,Flight,Military / Government,World,World,11,11,5,0,0,5,6,Terrorism
1943-08-09 00:00:00,Royal Air Force - RAF,Flight,Operational,United Kingdom,Europe,5,5,5,0,0,5,0,Weather
1943-08-17 00:00:00,Royal Air Force - RAF,Flight,Military / Government,France,Europe,7,7,5,0,0,5,2,Terrorism
1943-08-19 00:00:00,United States Army Air Forces - USAAF,Flight,Military / Government,United States of America,North America,5,4,4,1,1,5,0,Unknown
1943-08-22 00:00:00,Aeroflot - Russian International Airlines,Flight,Military / Government,Belarus,Europe,6,6,5,0,0,5,1,Technical Failure
1943-08-28 00:00:00,Royal New Zealand Air Force - RNZAF,Flight,Operational,New Zealand,Oceania,5,5,5,0,0,5,0,Human Factor
1943-09-20 00:00:00,Aeroflot - Russian International Airlines,Landing (descent or approach),Operational,Russia,Asia,5,4,4,1,1,5,0,Human Factor
1943-09-23 00:00:00,United States Army Air Forces - USAAF,Flight,Military / Government,United States of America,North America,6,4,4,2,1,5,1,Technical Failure
1943-09-23 00:00:00,Royal Air Force - RAF,Flight,Operational,United Kingdom,Europe,5,5,5,0,0,5,0,Unknown
1943-10-01 00:00:00,United States Army Air Forces - USAAF,Takeoff (climb),Military / Government,United States of America,North America,5,5,5,0,0,5,0,Unknown
1943-10-05 00:00:00,Royal Air Force - RAF,Flight,Military / Government,United Kingdom,Europe,7,7,5,0,0,5,2,Terrorism
1943-10-14 00:00:00,Royal Air Force - RAF,Flight,Operational,United Kingdom,Europe,5,5,5,0,0,5,0,Technical Failure
1943-10-15 00:00:00,Royal Australian Air Force - RAAF,Flight,Military / Government,World,World,5,5,5,0,0,5,0,Unknown
1943-10-19 00:00:00,Royal Air Force - RAF,Flight,Military / Government,World,World,6,6,5,0,0,5,1,Technical Failure
1943-10-21 00:00:00,United States Army Air Forces - USAAF,Landing (descent or approach),Operational,United States of America,North America,5,5,5,0,0,5,0,Technical Failure
1943-10-23 00:00:00,United States Army Air Forces - USAAF,Flight,Operational,China,Asia,5,2,2,3,3,5,0,Unknown
1943-11-08 00:00:00,Royal Air Force - RAF,Flight,Operational,United Kingdom,Europe,5,5,5,0,0,5,0,Human Factor
1943-11-11 00:00:00,Royal Air Force - RAF,Landing (descent or approach),Military / Government,United Kingdom,Europe,5,1,1,4,4,5,0,Human Factor
1943-11-11 00:00:00,Royal Air Force - RAF,Landing (descent or approach),Operational,United Kingdom,Europe,5,5,5,0,0,5,0,Technical Failure
1943-11-19 00:00:00,United States Navy - USN,Flight,Military / Government,Solomon Islands,Oceania,7,7,5,0,0,5,2,Unknown
1943-11-20 00:00:00,Royal Air Force - RAF,Flight,Operational,United Kingdom,Europe,5,5,5,0,0,5,0,Unknown
1943-11-30 00:00:00,United States Army Air Forces - USAAF,Flight,Operational,United Kingdom,Europe,5,5,5,0,0,5,0,Human Factor
1943-12-01 00:00:00,United States Army Air Forces - USAAF,Flight,Operational,United States of America,North America,5,5,5,0,0,5,0,Human Factor
1943-12-01 00:00:00,Royal Air Force - RAF,Flight,Operational,United Kingdom,Europe,5,5,5,0,0,5,0,Unknown
1943-12-14 00:00:00,German Air Force - Deutsche Luftwaffe,Flight,Military / Government,France,Europe,5,5,5,0,0,5,0,Unknown
1943-12-17 00:00:00,United States Army Air Forces - USAAF,Flight,Military / Government,Ireland,Europe,5,5,5,0,0,5,0,Human Factor
1943-12-30 00:00:00,Royal Air Force - RAF,Flight,Operational,United Kingdom,Europe,5,5,5,0,0,5,0,Technical Failure
1944-01-03 00:00:00,United States Army Air Forces - USAAF,Flight,Operational,United States of America,North America,5,4,4,1,1,5,0,Human Factor
1944-01-04 00:00:00,Royal Netherlands East Indies Air Force - ML-KNIL,Flight,Military / Government,Indonesia,Asia,5,5,5,0,0,5,0,Terrorism
1944-01-07 00:00:00,United States Army Air Forces - USAAF,Flight,Military / Government,United Kingdom,Europe,10,10,5,0,0,5,5,Technical Failure
1944-01-07 00:00:00,United States Army Air Forces - USAAF,Flight,Operational,United Kingdom,Europe,11,3,1,8,4,5,6,Human Factor
1944-01-15 00:00:00,Deutsche Lufthansa,Landing (descent or approach),Commercial,Serbia,Europe,5,2,2,3,3,5,0,Human Factor
1944-01-16 00:00:00,United States Army Air Forces - USAAF,Takeoff (climb),Military / Government,United States of America,North America,10,10,5,0,0,5,5,Unknown
1944-01-21 00:00:00,United States Army Air Forces - USAAF,Takeoff (climb),Military / Government,Yemen,Asia,10,10,5,0,0,5,5,Unknown
1944-01-21 00:00:00,United States Navy - USN,Takeoff (climb),Operational,Brazil,South America,10,10,5,0,0,5,5,Terrorism
1944-01-22 00:00:00,Royal Air Force - RAF,Flight,Military / Government,Netherlands,Europe,7,7,5,0,0,5,2,Terrorism
1944-01-31 00:00:00,United States Army Air Forces - USAAF,Flight,Military / Government,China,Asia,5,5,5,0,0,5,0,Weather
1944-02-08 00:00:00,United States Army Air Forces - USAAF,Landing (descent or approach),Military / Government,United States of America,North America,5,5,5,0,0,5,0,Human Factor
1944-02-13 00:00:00,Aeroflot - Russian International Airlines,Flight,Military / Government,Russia,Asia,5,5,5,0,0,5,0,Unknown
1944-02-15 00:00:00,Royal Air Force - RAF,Flight,Military / Government,Netherlands,Europe,7,7,5,0,0,5,2,Terrorism
1944-02-15 00:00:00,Royal Air Force - RAF,Flight,Operational,United Kingdom,Europe,5,5,5,0,0,5,0,Technical Failure
1944-02-20 00:00:00,Royal Air Force - RAF,Flight,Military / Government,Germany,Europe,7,7,5,0,0,5,2,Terrorism
1944-03-02 00:00:00,Royal Air Force - RAF,Flight,Military / Government,Italy,Europe,10,10,5,0,0,5,5,Terrorism
1944-03-03 00:00:00,Royal Air Force - RAF,Flight,Military / Government,Germany,Europe,8,8,5,0,0,5,3,Terrorism
1944-03-04 00:00:00,Royal Air Force - RAF,Flight,Military / Government,France,Europe,5,5,5,0,0,5,0,Terrorism
1944-03-04 00:00:00,United States Army Air Forces - USAAF,Landing (descent or approach),Operational,United Kingdom,Europe,5,3,3,2,2,5,0,Human Factor
1944-03-06 00:00:00,United States Army Air Forces - USAAF,Flight,Military / Government,Netherlands,Europe,10,10,5,0,0,5,5,Terrorism
1944-03-07 00:00:00,Royal Australian Air Force - RAAF,Flight,Operational,Australia,Oceania,5,5,5,0,0,5,0,Human Factor
1944-03-11 00:00:00,United States Army Air Forces - USAAF,Flight,Military / Government,United States of America,North America,5,4,4,1,1,5,0,Unknown
1944-03-22 00:00:00,Royal Air Force - RAF,Flight,Military / Government,Netherlands,Europe,7,7,5,0,0,5,2,Terrorism
1944-03-24 00:00:00,Royal Air Force - RAF,Flight,Military / Government,Germany,Europe,7,7,5,0,0,5,2,Terrorism
1944-03-31 00:00:00,United States Army Air Forces - USAAF,Flight,Military / Government,United States of America,North America,5,5,5,0,0,5,0,Unknown
1944-04-01 00:00:00,Royal Air Force - RAF,Flight,Military / Government,World,World,5,5,5,0,0,5,0,Terrorism
1944-04-02 00:00:00,United States Army Air Forces - USAAF,Flight,Military / Government,World,World,5,5,5,0,0,5,0,Unknown
1944-04-02 00:00:00,Royal Canadian Air Force - RCAF,Takeoff (climb),Operational,United Kingdom,Europe,5,5,5,0,0,5,0,Other
1944-04-03 00:00:00,Royal Australian Air Force - RAAF,Flight,Military / Government,Australia,Oceania,5,5,5,0,0,5,0,Unknown
1944-04-05 00:00:00,German Air Force - Deutsche Luftwaffe,Flight,Military / Government,France,Europe,5,5,5,0,0,5,0,Terrorism
1944-04-11 00:00:00,United States Army Air Forces - USAAF,Flight,Military / Government,France,Europe,7,7,5,0,0,5,2,Terrorism
1944-04-11 00:00:00,Royal Air Force - RAF,Flight,Military / Government,Netherlands,Europe,7,7,5,0,0,5,2,Terrorism
1944-04-17 00:00:00,Deutsche Lufthansa,Takeoff (climb),Commercial,Serbia,Europe,7,3,1,4,4,5,2,Terrorism
1944-04-18 00:00:00,Royal Air Force - RAF,Flight,Operational,Lebanon,Asia,5,5,5,0,0,5,0,Human Factor
1944-04-25 00:00:00,Royal Air Force - RAF,Flight,Military / Government,Netherlands,Europe,7,7,5,0,0,5,2,Unknown
1944-04-25 00:00:00,Royal Air Force - RAF,Flight,Military / Government,United Kingdom,Europe,5,5,5,0,0,5,0,Human Factor
1944-04-28 00:00:00,United States Army Air Forces - USAAF,Flight,Military / Government,France,Europe,8,8,5,0,0,5,3,Unknown
1944-05-12 00:00:00,United States Army Air Forces - USAAF,Flight,Operational,United Kingdom,Europe,5,5,5,0,0,5,0,Human Factor
1944-05-12 00:00:00,United States Army Air Forces - USAAF,Flight,Operational,United Kingdom,Europe,5,5,5,0,0,5,0,Human Factor
1944-05-14 00:00:00,United States Army Air Forces - USAAF,Flight,Specialised Services,United States of America,North America,5,5,5,0,0,5,0,Unknown
1944-05-14 00:00:00,United States Army Air Forces - USAAF,Flight,Military / Government,Italy,Europe,5,5,5,0,0,5,0,Unknown
1944-05-19 00:00:00,United States Army Air Forces - USAAF,Flight,Military / Government,Germany,Europe,9,9,5,0,0,5,4,Unknown
1944-06-06 00:00:00,United States Army Air Forces - USAAF,Flight,Military / Government,United Kingdom,Europe,6,6,5,0,0,5,1,Unknown
1944-06-06 00:00:00,United States Army Air Forces - USAAF,Flight,Military / Government,France,Europe,23,5,5,18,0,5,18,Terrorism
1944-06-08 00:00:00,United States Army Air Forces - USAAF,Flight,Military / Government,World,World,10,10,5,0,0,5,5,Unknown
1944-06-11 00:00:00,United States Army Air Forces - USAAF,Flight,Military / Government,Myanmar,Asia,6,6,5,0,0,5,1,Unknown
1944-06-13 00:00:00,Royal Air Force - RAF,Flight,Operational,United Kingdom,Europe,5,5,5,0,0,5,0,Unknown
1944-06-13 00:00:00,Royal Air Force - RAF,Flight,Military / Government,Netherlands,Europe,8,8,5,0,0,5,3,Terrorism
1944-06-13 00:00:00,Royal Netherlands Navy - Marineluchtvaartdienst,Flight,Military / Government,France,Europe,5,5,5,0,0,5,0,Terrorism
1944-06-14 00:00:00,Royal New Zealand Air Force - RNZAF,Flight,Military / Government,Papua New Guinea,Oceania,5,5,5,0,0,5,0,Technical Failure
1944-06-28 00:00:00,United States Army Air Forces - USAAF,Takeoff (climb),Operational,United States of America,North America,5,5,5,0,0,5,0,Technical Failure
1944-07-12 00:00:00,United States Navy - USN,Flight,Military / Government,Morocco,Africa,9,9,5,0,0,5,4,Technical Failure
1944-07-17 00:00:00,United States Navy - USN,Landing (descent or approach),Military / Government,Ecuador,South America,13,13,5,0,0,5,8,Unknown
1944-07-21 00:00:00,United States Army Air Forces - USAAF,Flight,Military / Government,United States of America,North America,5,5,5,0,0,5,0,Unknown
1944-07-21 00:00:00,United States Army Air Forces - USAAF,Flight,Military / Government,United States of America,North America,5,5,5,0,0,5,0,Unknown
1944-07-21 00:00:00,United States Army Air Forces - USAAF,Flight,Military / Government,United States of America,North America,5,5,5,0,0,5,0,Unknown
1944-07-21 00:00:00,Royal Air Force - RAF,Flight,Operational,United Kingdom,Europe,5,5,5,0,0,5,0,Unknown
1944-07-24 00:00:00,United States Navy - USN,Flight,Military / Government,Indonesia,Asia,5,5,5,0,0,5,0,Unknown
1944-07-29 00:00:00,Royal Air Force - RAF,Flight,Military / Government,France,Europe,7,7,5,0,0,5,2,Terrorism
1944-08-12 00:00:00,Royal Australian Air Force - RAAF,Flight,Operational,Australia,Oceania,7,7,5,0,0,5,2,Terrorism
1944-08-15 00:00:00,United States Army Air Forces - USAAF,Flight,Military / Government,Netherlands,Europe,10,10,5,0,0,5,5,Unknown
1944-09-02 00:00:00,Deutsche Lufthansa,Landing (descent or approach),Commercial,Serbia,Europe,5,3,3,2,2,5,0,Terrorism
1944-09-09 00:00:00,Royal New Zealand Air Force - RNZAF,Flight,Military / Government,Solomon Islands,Oceania,5,5,5,0,0,5,0,Unknown
1944-09-15 00:00:00,United States Army Air Forces - USAAF,Flight,Operational,India,Asia,5,5,5,0,0,5,0,Unknown
1944-09-17 00:00:00,United States Army Air Forces - USAAF,Flight,Military / Government,Netherlands,Europe,5,4,4,1,1,5,0,Terrorism
1944-09-17 00:00:00,United States Army Air Forces - USAAF,Flight,Military / Government,Netherlands,Europe,5,4,4,1,1,5,0,Terrorism
1944-09-18 00:00:00,United States Army Air Forces - USAAF,Flight,Military / Government,Netherlands,Europe,5,5,5,0,0,5,0,Terrorism
1944-09-19 00:00:00,Royal Air Force - RAF,Flight,Military / Government,Netherlands,Europe,8,4,3,4,2,5,3,Terrorism
1944-09-20 00:00:00,United States Navy - USN,Flight,Operational,United States of America,North America,5,5,5,0,0,5,0,Unknown
1944-10-03 00:00:00,Royal New Zealand Air Force - RNZAF,Flight,Operational,New Zealand,Oceania,5,5,5,0,0,5,0,Human Factor
1944-10-05 00:00:00,Royal New Zealand Air Force - RNZAF,Flight,Military / Government,Solomon Islands,Oceania,5,5,5,0,0,5,0,Technical Failure
1944-10-10 00:00:00,Royal New Zealand Air Force - RNZAF,Flight,Military / Government,Solomon Islands,Oceania,5,5,5,0,0,5,0,Human Factor
1944-10-26 00:00:00,Royal New Zealand Air Force - RNZAF,Flight,Military / Government,World,World,5,5,5,0,0,5,0,Technical Failure
1944-10-26 00:00:00,Royal New Zealand Air Force - RNZAF,Landing (descent or approach),Operational,New Zealand,Oceania,5,5,5,0,0,5,0,Human Factor
1944-10-26 00:00:00,United States Army Air Forces - USAAF,Landing (descent or approach),Operational,United States of America,North America,5,5,5,0,0,5,0,Human Factor
1944-11-03 00:00:00,Royal New Zealand Air Force - RNZAF,Flight,Military / Government,Solomon Islands,Oceania,5,5,5,0,0,5,0,Unknown
1944-11-12 00:00:00,United States Army Air Forces - USAAF,Flight,Military / Government,Croatia,Europe,5,5,5,0,0,5,0,Unknown
1944-11-13 00:00:00,Royal Air Force - RAF,Flight,Operational,United Kingdom,Europe,5,5,5,0,0,5,0,Human Factor
1944-11-26 00:00:00,United States Army Air Forces - USAAF,Flight,Military / Government,United Kingdom,Europe,5,5,5,0,0,5,0,Human Factor
1944-11-26 00:00:00,United States Army Air Forces - USAAF,Flight,Military / Government,United Kingdom,Europe,5,5,5,0,0,5,0,Human Factor
1944-12-04 00:00:00,Royal New Zealand Air Force - RNZAF,Landing (descent or approach),Military / Government,Fiji Islands,Oceania,5,5,5,0,0,5,0,Weather
1944-12-06 00:00:00,United States Army Air Forces - USAAF,Landing (descent or approach),Military / Government,Belgium,Europe,5,5,5,0,0,5,0,Unknown
1944-12-09 00:00:00,United States Army Air Forces - USAAF,Flight,Operational,Myanmar,Asia,5,5,5,0,0,5,0,Technical Failure
1944-12-20 00:00:00,United States Army Air Forces - USAAF,Flight,Military / Government,United States of America,North America,5,2,2,3,3,5,0,Human Factor
1944-12-24 00:00:00,Royal Canadian Air Force - RCAF,Flight,Military / Government,Germany,Europe,7,7,5,0,0,5,2,Unknown
1944-12-30 00:00:00,Trans-Canada Air Lines - TCAL,Flight,Operational,World,World,5,4,4,1,1,5,0,Unknown
1945-01-02 00:00:00,United States Army Air Forces - USAAF,Flight,Operational,United Kingdom,Europe,5,5,5,0,0,5,0,Human Factor
1945-01-05 00:00:00,Royal Australian Air Force - RAAF,Flight,Operational,Australia,Oceania,5,5,5,0,0,5,0,Technical Failure
1945-01-06 00:00:00,United States Army Air Forces - USAAF,Flight,Operational,United States of America,North America,5,5,5,0,0,5,0,Technical Failure
1945-01-06 00:00:00,United States Army Air Forces - USAAF,Flight,Military / Government,India,Asia,5,5,5,0,0,5,0,Unknown
1945-01-09 00:00:00,United States Army Air Forces - USAAF,Takeoff (climb),Military / Government,Indonesia,Asia,5,5,5,0,0,5,0,Human Factor
1945-01-10 00:00:00,Royal Air Force - RAF,Flight,Military / Government,United Kingdom,Europe,5,5,5,0,0,5,0,Human Factor
1945-01-21 00:00:00,Royal Air Force - RAF,Takeoff (climb),Military / Government,United Kingdom,Europe,5,5,5,0,0,5,0,Unknown
1945-01-23 00:00:00,United States Army Air Forces - USAAF,Flight,Military / Government,World,World,5,5,5,0,0,5,0,Unknown
1945-01-24 00:00:00,United States Navy - USN,Landing (descent or approach),Military / Government,United States of America,North America,12,12,5,0,0,5,7,Unknown
1945-01-28 00:00:00,United States Navy - USN,Landing (descent or approach),Operational,United States of America,North America,10,10,5,0,0,5,5,Unknown
1945-02-09 00:00:00,United States Army Air Forces - USAAF,Flight,Military / Government,Poland,Europe,9,9,5,0,0,5,4,Human Factor
1945-02-10 00:00:00,Royal Air Force - RAF,Flight,Military / Government,Myanmar,Asia,5,5,5,0,0,5,0,Weather
1945-02-14 00:00:00,Royal Australian Air Force - RAAF,Takeoff (climb),Military / Government,Australia,Oceania,11,11,5,0,0,5,6,Human Factor
1945-02-14 00:00:00,Royal Air Force - RAF,Flight,Military / Government,India,Asia,5,5,5,0,0,5,0,Human Factor
1945-03-01 00:00:00,United States Army Air Forces - USAAF,Flight,Operational,China,Asia,5,5,5,0,0,5,0,Unknown
1945-03-04 00:00:00,Aeroflot - Russian International Airlines,Flight,Operational,Russia,Asia,5,5,5,0,0,5,0,Human Factor
1945-03-05 00:00:00,United States Army Air Forces - USAAF,Flight,Military / Government,Philippines,Asia,5,5,5,0,0,5,0,Unknown
1945-03-13 00:00:00,Royal Air Force - RAF,Flight,Military / Government,United States of America,North America,5,4,4,1,1,5,0,Human Factor
1945-03-19 00:00:00,United States Army Air Forces - USAAF,Flight,Operational,United States of America,North America,5,5,5,0,0,5,0,Unknown
1945-03-24 00:00:00,United States Army Air Forces - USAAF,Flight,Military / Government,Germany,Europe,5,5,5,0,0,5,0,Terrorism
1945-03-24 00:00:00,United States Army Air Forces - USAAF,Flight,Military / Government,Germany,Europe,5,5,5,0,0,5,0,Terrorism
1945-03-24 00:00:00,United States Army Air Forces - USAAF,Flight,Military / Government,Germany,Europe,5,5,5,0,0,5,0,Terrorism
1945-03-24 00:00:00,United States Army Air Forces - USAAF,Flight,Military / Government,Germany,Europe,5,5,5,0,0,5,0,Terrorism
1945-04-06 00:00:00,United States Army Air Forces - USAAF,Flight,Military / Government,Germany,Europe,5,5,5,0,0,5,0,Unknown
1945-04-10 00:00:00,United States Army Air Forces - USAAF,Landing (descent or approach),Military / Government,Germany,Europe,5,5,5,0,0,5,0,Terrorism
1945-04-13 00:00:00,United States Army Air Forces - USAAF,Flight,Military / Government,Germany,Europe,5,5,5,0,0,5,0,Unknown
1945-04-13 00:00:00,United States Army Air Forces - USAAF,Flight,Military / Government,Germany,Europe,5,5,5,0,0,5,0,Unknown
1945-04-21 00:00:00,United States Army Air Forces - USAAF,Flight,Military / Government,Germany,Europe,5,5,5,0,0,5,0,Unknown
1945-04-30 00:00:00,United States Army Air Forces - USAAF,Takeoff (climb),Military / Government,United States of America,North America,14,3,0,11,5,5,9,Technical Failure
1945-05-03 00:00:00,United States Army Air Forces - USAAF,Flight,Military / Government,Italy,Europe,5,5,5,0,0,5,0,Unknown
1945-05-04 00:00:00,Royal Australian Air Force - RAAF,Flight,Operational,Australia,Oceania,5,5,5,0,0,5,0,Unknown
1945-05-27 00:00:00,Royal New Zealand Air Force - RNZAF,Flight,Military / Government,Solomon Islands,Oceania,5,5,5,0,0,5,0,Human Factor
1945-06-02 00:00:00,Royal Air Force - RAF,Flight,Military / Government,India,Asia,5,5,5,0,0,5,0,Weather
1945-06-11 00:00:00,United States Army Air Forces - USAAF,Flight,Military / Government,World,World,5,5,5,0,0,5,0,Unknown
1945-06-18 00:00:00,United States Navy - USN,Flight,Military / Government,World,World,10,10,5,0,0,5,5,Technical Failure
1945-06-28 00:00:00,United States Army Air Forces - USAAF,Flight,Military / Government,Indonesia,Asia,5,5,5,0,0,5,0,Unknown
1945-07-01 00:00:00,United States Army Air Forces - USAAF,Flight,Military / Government,United States of America,North America,5,5,5,0,0,5,0,Weather
1945-07-04 00:00:00,United States Army Air Forces - USAAF,Flight,Military / Government,China,Asia,5,5,5,0,0,5,0,Unknown
1945-07-13 00:00:00,Royal Air Force - RAF,Flight,Military / Government,Bangladesh,Asia,5,5,5,0,0,5,0,Technical Failure
1945-07-13 00:00:00,Royal Air Force - RAF,Flight,Military / Government,Myanmar,Asia,5,5,5,0,0,5,0,Human Factor
1945-07-14 00:00:00,United States Army Air Forces - USAAF,Flight,Military / Government,Myanmar,Asia,5,5,5,0,0,5,0,Unknown
1945-07-23 00:00:00,Royal Canadian Air Force - RCAF,Landing (descent or approach),Operational,Canada,North America,7,7,5,0,0,5,2,Human Factor
1945-07-25 00:00:00,Royal Air Force - RAF,Flight,Operational,Myanmar,Asia,5,5,5,0,0,5,0,Unknown
1945-07-30 00:00:00,Royal Air Force - RAF,Flight,Military / Government,Myanmar,Asia,5,5,5,0,0,5,0,Weather
1945-08-04 00:00:00,United States Navy - USN,Flight,Military / Government,Indonesia,Asia,5,5,5,0,0,5,0,Unknown
1945-08-11 00:00:00,United States Army Air Forces - USAAF,Flight,Operational,United States of America,North America,5,5,5,0,0,5,0,Human Factor
1945-09-07 00:00:00,United States Army Air Forces - USAAF,Takeoff (climb),Military / Government,Northern Mariana Islands,Oceania,11,11,5,0,0,5,6,Unknown
1945-09-14 00:00:00,Royal Australian Air Force - RAAF,Landing (descent or approach),Operational,Australia,Oceania,5,5,5,0,0,5,0,Technical Failure
1945-09-17 00:00:00,United States Army Air Forces - USAAF,Landing (descent or approach),Military / Government,Japan,Asia,5,5,5,0,0,5,0,Human Factor
1945-10-10 00:00:00,United States Army Air Forces - USAAF,Flight,Military / Government,Papua New Guinea,Oceania,5,5,5,0,0,5,0,Weather
1945-10-24 00:00:00,Faucett,Takeoff (climb),Commercial,Peru,South America,5,1,1,4,4,5,0,Unknown
1945-10-29 00:00:00,United States Army Air Forces - USAAF,Landing (descent or approach),Military / Government,United States of America,North America,7,6,5,1,0,5,2,Human Factor
1945-11-01 00:00:00,United States Army Air Forces - USAAF,Flight,Military / Government,United States of America,North America,5,5,5,0,0,5,0,Weather
1945-11-04 00:00:00,Royal Canadian Air Force - RCAF,Flight,Humanitarian,Germany,Europe,5,5,5,0,0,5,0,Human Factor
1945-11-29 00:00:00,Eskisehir Tayyare Fabrikasi,Flight,Specialised Services,Turkey,Asia,5,5,5,0,0,5,0,Unknown
1945-12-10 00:00:00,United States Army Air Forces - USAAF,Landing (descent or approach),Military / Government,France,Europe,8,5,2,3,3,5,3,Weather
1946-01-14 00:00:00,Royal Air Force - RAF,Flight,Military / Government,Indonesia,Asia,5,5,5,0,0,5,0,Weather
1946-01-24 00:00:00,Royal Air Force - RAF,Flight,Military / Government,United Kingdom,Europe,5,5,5,0,0,5,0,Technical Failure
1946-02-02 00:00:00,United States Army Air Forces - USAAF,Flight,Military / Government,France,Europe,5,5,5,0,0,5,0,Human Factor
1946-02-02 00:00:00,Royal Air Force - RAF,Flight,Military / Government,Myanmar,Asia,5,5,5,0,0,5,0,Weather
1946-02-12 00:00:00,Royal Air Force - RAF,Flight,Military / Government,Myanmar,Asia,5,5,5,0,0,5,0,Human Factor
1946-03-22 00:00:00,Aeroflot - Russian International Airlines,Takeoff (climb),Operational,Russia,Asia,5,5,5,0,0,5,0,Weather
1946-03-29 00:00:00,Royal Air Force - RAF,Flight,Operational,Myanmar,Asia,6,2,2,4,3,5,1,Human Factor
1946-05-16 00:00:00,Royal Air Force - RAF,Landing (descent or approach),Operational,United Kingdom,Europe,5,5,5,0,0,5,0,Technical Failure
1946-07-02 00:00:00,Royal Air Force - RAF,Flight,Military / Government,United Kingdom,Europe,5,2,2,3,3,5,0,Human Factor
1946-07-11 00:00:00,Trans World Airlines - TWA,Flight,Operational,United States of America,North America,6,6,5,0,0,5,1,Technical Failure
1946-07-24 00:00:00,Royal Air Force - RAF,Flight,Operational,United Kingdom,Europe,5,5,5,0,0,5,0,Human Factor
1946-08-07 00:00:00,Hellenic Air Force - Elleniki Polemiki Aeroporia,Landing (descent or approach),Operational,Greece,Europe,6,2,1,4,4,5,1,Technical Failure
1946-08-19 00:00:00,United States Army Air Forces - USAAF,Flight,Operational,Slovenia,Europe,5,2,2,3,3,5,0,Terrorism
1946-08-22 00:00:00,United States Army Air Forces - USAAF,Flight,Military / Government,Germany,Europe,5,5,5,0,0,5,0,Unknown
1946-08-30 00:00:00,Royal Air Force - RAF,Flight,Humanitarian,United Kingdom,Europe,5,2,2,3,3,5,0,Weather
1946-09-06 00:00:00,Royal Air Force - RAF,Landing (descent or approach),Operational,United Kingdom,Europe,5,5,5,0,0,5,0,Unknown
1946-09-30 00:00:00,United States Navy - USN,Takeoff (climb),Military / Government,United States of America,North America,5,5,5,0,0,5,0,Unknown
1946-10-11 00:00:00,United States Army Air Forces - USAAF,Flight,Military / Government,United States of America,North America,5,5,5,0,0,5,0,Unknown
1946-10-11 00:00:00,United States Army Air Forces - USAAF,Flight,Operational,Brazil,South America,5,5,5,0,0,5,0,Unknown
1946-10-15 00:00:00,French Air Force - Armée de l'Air,Takeoff (climb),Military / Government,France,Europe,5,5,5,0,0,5,0,Human Factor
1946-11-05 00:00:00,Aeroflot - Russian International Airlines,Landing (descent or approach),Operational,Russia,Asia,5,5,5,0,0,5,0,Technical Failure
1946-11-29 00:00:00,Brazilian Air Force - Força Aérea Brasileira,Flight,Operational,Brazil,South America,5,5,5,0,0,5,0,Human Factor
1946-11-30 00:00:00,Argentinian Air Force - Fuerza Aérea Argentina,Takeoff (climb),Military / Government,Argentina,South America,18,3,3,15,2,5,13,Technical Failure
1946-12-03 00:00:00,Shell Company of Ecuador,Flight,Business,Ecuador,South America,5,1,1,4,4,5,0,Weather
1946-12-15 00:00:00,Central Air Transport - China,Flight,Commercial,China,Asia,5,3,3,2,2,5,0,Unknown
1947-01-14 00:00:00,United States Navy - USN,Landing (descent or approach),Military / Government,United States of America,North America,7,7,5,0,0,5,2,Technical Failure
1947-03-19 00:00:00,TACA International Airlines - Transportes Aéreos Centro Americanos,Flight,Commercial,Colombia,South America,5,2,2,3,3,5,0,Unknown
1947-05-22 00:00:00,United States Army Air Forces - USAAF,Landing (descent or approach),Operational,United States of America,North America,7,7,5,0,0,5,2,Unknown
1947-06-11 00:00:00,Flota Aerea Mercante Argentina - FAMA,Landing (descent or approach),Commercial,Brazil,South America,18,5,3,13,2,5,13,Unknown
1947-07-22 00:00:00,United States Navy - USN,Landing (descent or approach),Military / Government,United States of America,North America,5,5,5,0,0,5,0,Human Factor
1947-08-05 00:00:00,Gidrometeosluzhba,Flight,Operational,Russia,Asia,5,3,3,2,2,5,0,Human Factor
1947-09-28 00:00:00,Indian Air Force - Bharatiya Vayu Sena,Landing (descent or approach),Military / Government,India,Asia,20,5,5,15,0,5,15,Unknown
1947-10-10 00:00:00,United States Air Force - USAF,Flight,Military / Government,Peru,South America,5,5,5,0,0,5,0,Unknown
1947-11-02 00:00:00,Philippines Air Express,Flight,Operational,Philippines,Asia,5,2,2,3,3,5,0,Unknown
1947-11-13 00:00:00,United States Air Force - USAF,Flight,Operational,United States of America,North America,10,10,5,0,0,5,5,Unknown
1947-11-18 00:00:00,Trans World Airlines - TWA,Landing (descent or approach),Operational,United States of America,North America,5,5,5,0,0,5,0,Human Factor
1947-12-24 00:00:00,SABENA - Société Anonyme Belge d'Exploitation de la Navigation Aérienne,Takeoff (climb),Commercial,Democratic Republic of Congo,Africa,5,3,3,2,2,5,0,Technical Failure
1947-12-28 00:00:00,Servicio Aéreo Panini,Landing (descent or approach),Commercial,Mexico,Central America,10,3,2,7,3,5,5,Technical Failure
1948-01-13 00:00:00,Eastern Airlines,Landing (descent or approach),Commercial,United States of America,North America,9,3,2,6,3,5,4,Human Factor
1948-01-25 00:00:00,Société Indochinoise de Transports Aériens - SITA,Flight,Operational,World,World,5,3,3,2,2,5,0,Unknown
1948-02-06 00:00:00,United States Air Force - USAF,Flight,Military / Government,United States of America,North America,5,3,3,2,2,5,0,Unknown
1948-07-08 00:00:00,Argentinian Navy - Armada Argentina,Flight,Military / Government,Argentina,South America,5,5,5,0,0,5,0,Unknown
1948-07-14 00:00:00,Aerovias Brasil,Takeoff (climb),Operational,Brazil,South America,5,3,3,2,2,5,0,Human Factor
1948-07-20 00:00:00,SNCAC - Société Nationale de Constructions Aéronautiques du Centre,Landing (descent or approach),Specialised Services,France,Europe,5,5,5,0,0,5,0,Technical Failure
1948-08-19 00:00:00,Royal Air Force - RAF,Flight,Operational,Malaysia,Asia,5,5,5,0,0,5,0,Technical Failure
1948-08-20 00:00:00,Czech Air Force - Ceské Vojenské Letectvo,Landing (descent or approach),Military / Government,Czech Republic,Europe,6,3,3,3,2,5,1,Weather
1948-09-14 00:00:00,Argentinian Navy - Armada Argentina,Flight,Military / Government,Argentina,South America,5,5,5,0,0,5,0,Unknown
1948-09-19 00:00:00,Royal Air Force - RAF,Takeoff (climb),Military / Government,Germany,Europe,5,5,5,0,0,5,0,Human Factor
1948-10-24 00:00:00,Israeli Air Force - Heyl Ha'avir,Landing (descent or approach),Military / Government,Israel,Asia,5,3,3,2,2,5,0,Technical Failure
1948-11-02 00:00:00,United States Air Force - USAF,Landing (descent or approach),Military / Government,Germany,Europe,5,3,3,2,2,5,0,Unknown
1948-11-12 00:00:00,Royal Air Force - RAF,Flight,Military / Government,Malaysia,Asia,5,5,5,0,0,5,0,Human Factor
1948-12-06 00:00:00,Jack E. Langley,Flight,Business,United States of America,North America,5,1,1,4,4,5,0,Unknown
1949-01-20 00:00:00,Alaska Airlines,Flight,Commercial,United States of America,North America,6,3,2,3,3,5,1,Human Factor
1949-01-23 00:00:00,United States Navy - USN,Flight,Military / Government,United States of America,North America,6,6,5,0,0,5,1,Unknown
1949-02-05 00:00:00,Avianca,Landing (descent or approach),Commercial,Colombia,South America,16,4,2,12,3,5,11,Unknown
1949-03-05 00:00:00,Royal Air Force - RAF,Landing (descent or approach),Military / Government,Spain,Europe,7,7,5,0,0,5,2,Technical Failure
1949-03-11 00:00:00,Institut Géographique National,Flight,Specialised Services,Cameroon,Africa,5,5,5,0,0,5,0,Weather
1949-03-31 00:00:00,Dow Chemical Company,Landing (descent or approach),Business,Canada,North America,6,2,2,4,3,5,1,Unknown
1949-04-03 00:00:00,Colombian Air Force - Fuerza Aérea Colombiana,Flight,Military / Government,Colombia,South America,5,5,5,0,0,5,0,Unknown
1949-04-26 00:00:00,Rijksluchtvaartschool - RLS,Flight,Operational,Netherlands,Europe,5,5,5,0,0,5,0,Technical Failure
1949-07-16 00:00:00,Royal Air Force - RAF,Takeoff (climb),Military / Government,Germany,Europe,5,5,5,0,0,5,0,Human Factor
1949-07-26 00:00:00,Misrair,Takeoff (climb),Commercial,Egypt,Africa,5,2,2,3,3,5,0,Unknown
1949-08-02 00:00:00,VARIG - Viação Aérea Rio Grandense,Flight,Commercial,Brazil,South America,36,6,1,30,4,5,31,Technical Failure
1949-08-27 00:00:00,SABENA - Société Anonyme Belge d'Exploitation de la Navigation Aérienne,Takeoff (climb),Commercial,Democratic Republic of Congo,Africa,20,3,3,17,2,5,15,Human Factor
1949-09-13 00:00:00,United States Air Force - USAF,Landing (descent or approach),Military / Government,United States of America,North America,5,5,5,0,0,5,0,Unknown
1949-09-15 00:00:00,United States Air Force - USAF,Takeoff (climb),Operational,United States of America,North America,13,13,5,0,0,5,8,Technical Failure
1949-09-26 00:00:00,Royal Australian Air Force - RAAF,Flight,Operational,Australia,Oceania,5,5,5,0,0,5,0,Unknown
1949-09-27 00:00:00,Flota Aerea Mercante Argentina - FAMA,Landing (descent or approach),Humanitarian,Argentina,South America,25,5,3,20,2,5,20,Technical Failure
1949-10-09 00:00:00,World-Wide Airways,Flight,Commercial,Canada,North America,5,1,1,4,4,5,0,Unknown
1949-10-16 00:00:00,United States Air Force - USAF,Flight,Military / Government,United States of America,North America,5,5,5,0,0,5,0,Human Factor
1949-10-23 00:00:00,United States Air Force - USAF,Flight,Military / Government,United States of America,North America,5,5,5,0,0,5,0,Unknown
1949-11-20 00:00:00,Royal Air Force - RAF,Takeoff (climb),Military / Government,Singapore,Asia,12,8,2,4,3,5,7,Weather
1949-11-29 00:00:00,Air France,Landing (descent or approach),Commercial,France,Europe,38,5,3,33,2,5,33,Human Factor
1949-12-04 00:00:00,Civil Air Transport,Flight,Operational,China,Asia,5,5,5,0,0,5,0,Unknown
1950-01-12 00:00:00,Royal Air Force - RAF,Takeoff (climb),Operational,United Kingdom,Europe,5,5,5,0,0,5,0,Technical Failure
1950-02-14 00:00:00,United States Air Force - USAF,Flight,Military / Government,Canada,North America,16,16,5,0,0,5,11,Technical Failure
1950-02-27 00:00:00,CSA Czech Airlines - Československé Státní Aerolinie,Flight,Commercial,Czech Republic,Europe,31,4,3,27,2,5,26,Human Factor
1950-03-15 00:00:00,Royal Air Force - RAF,Landing (descent or approach),Operational,United Kingdom,Europe,6,6,5,0,0,5,1,Human Factor
1950-08-13 00:00:00,MVD - Ministerstvo Vnutrennikh Del,Flight,Operational,Russia,Asia,5,5,5,0,0,5,0,Human Factor
1950-08-30 00:00:00,Ontario Provincial Air Service,Flight,Commercial,Canada,North America,6,2,2,4,3,5,1,Technical Failure
1950-09-12 00:00:00,United States Air Force - USAF,Flight,Military / Government,United States of America,North America,5,5,5,0,0,5,0,Unknown
1950-09-26 00:00:00,Spanish Air Force - Ejército del Aire,Takeoff (climb),Military / Government,Spain,Europe,5,5,5,0,0,5,0,Unknown
1950-09-29 00:00:00,Spanish Air Force - Ejército del Aire,Flight,Operational,Spain,Europe,17,5,4,12,1,5,12,Unknown
1950-10-14 00:00:00,Royal Air Force - RAF,Flight,Operational,United Kingdom,Europe,5,5,5,0,0,5,0,Human Factor
1950-10-15 00:00:00,Royal Air Force - RAF,Landing (descent or approach),Operational,United Kingdom,Europe,5,5,5,0,0,5,0,Human Factor
1950-11-09 00:00:00,United States Air Force - USAF,Landing (descent or approach),Specialised Services,Japan,Asia,10,10,5,0,0,5,5,Terrorism
1950-11-24 00:00:00,Royal Air Force - RAF,Flight,Operational,United Kingdom,Europe,6,6,5,0,0,5,1,Human Factor
1950-11-27 00:00:00,United States Navy - USN,Flight,Operational,United States of America,North America,5,5,5,0,0,5,0,Technical Failure
1950-12-20 00:00:00,Royal Air Force - RAF,Landing (descent or approach),Military / Government,Libya,Africa,34,7,5,27,0,5,29,Technical Failure
1950-12-22 00:00:00,Spanish Air Force - Ejército del Aire,Flight,Military / Government,Spain,Europe,5,5,5,0,0,5,0,Unknown
1951-02-03 00:00:00,United States Air Force - USAF,Takeoff (climb),Operational,United Kingdom,Europe,8,8,5,0,0,5,3,Unknown
1951-05-27 00:00:00,Hellenic Air Force - Elleniki Polemiki Aeroporia,Takeoff (climb),Military / Government,South Korea,Asia,5,5,5,0,0,5,0,Unknown
1951-05-30 00:00:00,United States Navy - USN,Landing (descent or approach),Military / Government,South Korea,Asia,5,5,5,0,0,5,0,Unknown
1951-06-21 00:00:00,United States Navy - USN,Landing (descent or approach),Operational,United States of America,North America,10,10,5,0,0,5,5,Unknown
1951-07-01 00:00:00,United States Air Force - USAF,Landing (descent or approach),Military / Government,United States of America,North America,26,2,0,24,5,5,21,Weather
1951-07-20 00:00:00,Compagnie Aérienne de Transports Indochinois - CATI,Landing (descent or approach),Operational,Vietnam,Asia,5,3,3,2,2,5,0,Unknown
1951-08-10 00:00:00,Directorate of Geodesy and Cartography,Flight,Specialised Services,Kazakhstan,Asia,5,5,5,0,0,5,0,Technical Failure
1951-08-11 00:00:00,Air France,Flight,Specialised Services,France,Europe,5,5,5,0,0,5,0,Human Factor
1951-09-07 00:00:00,Aeroflot - Russian International Airlines,Flight,Operational,Ukraine,Europe,5,5,5,0,0,5,0,Other
1951-09-27 00:00:00,United States Air Force - USAF,Landing (descent or approach),Military / Government,Japan,Asia,5,5,5,0,0,5,0,Human Factor
1951-10-06 00:00:00,Indian Air Force - Bharatiya Vayu Sena,Flight,Military / Government,Turkey,Asia,7,7,5,0,0,5,2,Weather
1951-11-09 00:00:00,United States Air Force - USAF,Landing (descent or approach),Operational,United States of America,North America,5,5,5,0,0,5,0,Unknown
1951-11-19 00:00:00,Devlet Hava Yollari - DHY,Landing (descent or approach),Commercial,Egypt,Africa,5,4,4,1,1,5,0,Human Factor
1951-12-04 00:00:00,United States Air Force - USAF,Flight,Military / Government,United States of America,North America,5,2,2,3,3,5,0,Human Factor
1952-01-22 00:00:00,Aerodex,Takeoff (climb),Specialised Services,United States of America,North America,5,2,2,3,3,5,0,Technical Failure
1952-01-22 00:00:00,Royal Air Force - RAF,Landing (descent or approach),Military / Government,United Kingdom,Europe,6,6,5,0,0,5,1,Technical Failure
1952-02-26 00:00:00,United States Air Force - USAF,Landing (descent or approach),Military / Government,United States of America,North America,21,4,0,17,5,5,16,Human Factor
1952-02-28 00:00:00,United States Air Force - USAF,Flight,Military / Government,North Korea,Asia,12,12,5,0,0,5,7,Technical Failure
1952-03-21 00:00:00,United States Air Force - USAF,Flight,Military / Government,North Korea,Asia,5,5,5,0,0,5,0,Unknown
1952-04-07 00:00:00,United States Air Force - USAF,Flight,Military / Government,North Korea,Asia,5,5,5,0,0,5,0,Unknown
1952-04-21 00:00:00,United States Air Force - USAF,Flight,Military / Government,United States of America,North America,5,5,5,0,0,5,0,Unknown
1952-05-13 00:00:00,VASP - Viação Aérea de São Paulo,Takeoff (climb),Commercial,Brazil,South America,22,3,2,19,3,5,17,Technical Failure
1952-06-27 00:00:00,United States Navy - USN,Takeoff (climb),Military / Government,United States of America,North America,5,5,5,0,0,5,0,Unknown
1952-07-24 00:00:00,United States Air Force - USAF,Landing (descent or approach),Military / Government,Japan,Asia,5,5,5,0,0,5,0,Unknown
1952-11-06 00:00:00,Union Aéromaritime de Transport - UAT,Flight,Operational,Chad,Africa,6,5,4,1,1,5,1,Unknown
1952-11-30 00:00:00,Czech Air Force - Ceské Vojenské Letectvo,Landing (descent or approach),Operational,Czech Republic,Europe,5,5,5,0,0,5,0,Human Factor
1952-12-12 00:00:00,French Navy,Flight,Military / Government,France,Europe,5,5,5,0,0,5,0,Human Factor
1953-01-05 00:00:00,Royal Air Force - RAF,Landing (descent or approach),Operational,United Kingdom,Europe,12,12,5,0,0,5,7,Human Factor
1953-01-21 00:00:00,Central BC Airways,Flight,Commercial,Canada,North America,6,1,0,5,5,5,1,Weather
1953-01-23 00:00:00,Aeroflot - Russian International Airlines,Landing (descent or approach),Operational,Russia,Asia,5,5,5,0,0,5,0,Human Factor
1953-01-29 00:00:00,Royal Canadian Air Force - RCAF,Flight,Military / Government,Canada,North America,5,5,5,0,0,5,0,Unknown
1953-02-10 00:00:00,United States Air Force - USAF,Landing (descent or approach),Operational,Germany,Europe,5,5,5,0,0,5,0,Human Factor
1953-05-27 00:00:00,Royal New Zealand Air Force - RNZAF,Takeoff (climb),Military / Government,New Zealand,Oceania,5,4,4,1,1,5,0,Human Factor
1953-09-25 00:00:00,Devlet Hava Yollari - DHY,Takeoff (climb),Commercial,Turkey,Asia,21,5,4,16,1,5,16,Technical Failure
1953-10-01 00:00:00,United States Air Force - USAF,Flight,Military / Government,United States of America,North America,6,5,5,1,0,5,1,Human Factor
1953-11-04 00:00:00,Aeroflot - Russian International Airlines,Landing (descent or approach),Operational,Russia,Asia,5,5,5,0,0,5,0,Human Factor
1953-11-15 00:00:00,United States Air Force - USAF,Flight,Military / Government,World,World,5,5,5,0,0,5,0,Unknown
1953-11-17 00:00:00,United States Air Force - USAF,Flight,Operational,United States of America,North America,5,4,4,1,1,5,0,Technical Failure
1954-01-31 00:00:00,Colombian Air Force - Fuerza Aérea Colombiana,Landing (descent or approach),Military / Government,Colombia,South America,16,3,2,13,3,5,11,Unknown
1954-03-22 00:00:00,Royal Air Force - RAF,Flight,Operational,Kenya,Africa,5,5,5,0,0,5,0,Human Factor
1954-04-07 00:00:00,French Navy,Flight,Military / Government,Spain,Europe,12,3,0,9,5,5,7,Technical Failure
1954-04-08 00:00:00,United States Air Force - USAF,Takeoff (climb),Operational,Japan,Asia,11,11,5,0,0,5,6,Technical Failure
1954-04-30 00:00:00,Darbhanga Aviation,Takeoff (climb),Commercial,India,Asia,11,3,3,8,2,5,6,Technical Failure
1954-07-06 00:00:00,Portuguese Air Force - Força Aerea Portuguesa,Flight,Military / Government,Portugal,Europe,5,2,2,3,3,5,0,Unknown
1954-07-23 00:00:00,Gordon Air Services,Flight,Commercial,United States of America,North America,5,1,1,4,4,5,0,Unknown
1954-09-01 00:00:00,United States Fish %26 Wildlife Service,Flight,Military / Government,United States of America,North America,6,1,1,5,4,5,1,Unknown
1954-09-25 00:00:00,Aoki Aviation,Flight,Commercial,Japan,Asia,5,1,1,4,4,5,0,Unknown
1954-09-30 00:00:00,Royal Air Force - RAF,Flight,Operational,United Kingdom,Europe,5,4,4,1,1,5,0,Technical Failure
1954-10-11 00:00:00,Aeroclube de São Paulo,Takeoff (climb),Business,Brazil,South America,5,1,1,4,4,5,0,Unknown
1954-11-06 00:00:00,Italian Air Force - Aeronautica Militare Italiana,Flight,Operational,Italy,Europe,5,5,5,0,0,5,0,Human Factor
1954-11-20 00:00:00,Plymouth Oil Company,Flight,Business,United States of America,North America,5,2,2,3,3,5,0,Human Factor
1955-01-13 00:00:00,Aeroflot - Russian International Airlines,Takeoff (climb),Operational,Russia,Asia,5,5,5,0,0,5,0,Terrorism
1955-01-26 00:00:00,Brazilian Air Force - Força Aérea Brasileira,Flight,Military / Government,Brazil,South America,5,5,5,0,0,5,0,Unknown
1955-01-31 00:00:00,Agencia Interamericana de Aviación - AIDA Colombia,Landing (descent or approach),Operational,Colombia,South America,8,4,1,4,4,5,3,Unknown
1955-03-04 00:00:00,Polyarnaya Aviatsiya,Flight,Commercial,Russia,Asia,26,6,4,20,1,5,21,Human Factor
1955-03-06 00:00:00,Real Aerovias,Landing (descent or approach),Commercial,Brazil,South America,21,3,1,18,4,5,16,Human Factor
1955-03-09 00:00:00,United States Air Force - USAF,Flight,Military / Government,United States of America,North America,5,3,3,2,2,5,0,Human Factor
1955-07-05 00:00:00,Indian Air Force - Bharatiya Vayu Sena,Flight,Operational,India,Asia,8,8,5,0,0,5,3,Unknown
1955-07-08 00:00:00,Japan Maritime Self-Defense Force - Kaijō Jieitai,Landing (descent or approach),Operational,Japan,Asia,5,5,5,0,0,5,0,Unknown
1955-07-28 00:00:00,Royal Air Force - RAF,Flight,Operational,Germany,Europe,5,2,2,3,3,5,0,Human Factor
1955-07-28 00:00:00,United States Navy - USN,,Operational,United States of America,North America,5,5,5,0,0,5,0,Unknown
1955-08-03 00:00:00,Pacific Western Airlines - PWA,Flight,Commercial,Canada,North America,5,2,2,3,3,5,0,Unknown
1955-08-23 00:00:00,United States Air Force - USAF,Takeoff (climb),Operational,United States of America,North America,11,11,5,0,0,5,6,Technical Failure
1955-08-25 00:00:00,United States Air Force - USAF,Landing (descent or approach),Military / Government,Portugal,Europe,5,5,5,0,0,5,0,Unknown
1955-09-13 00:00:00,Royal Air Force - RAF,Landing (descent or approach),Operational,United Kingdom,Europe,5,5,5,0,0,5,0,Human Factor
1956-01-11 00:00:00,French Air Force - Armée de l'Air,Flight,Military / Government,Algeria,Africa,5,5,5,0,0,5,0,Unknown
1956-02-04 00:00:00,MacRobertson Miller Airlines,Flight,Humanitarian,Australia,Oceania,5,1,1,4,4,5,0,Weather
1956-02-21 00:00:00,United States Air Force - USAF,Landing (descent or approach),Operational,United States of America,North America,5,5,5,0,0,5,0,Unknown
1956-04-02 00:00:00,Northwest Airlines,Takeoff (climb),Commercial,United States of America,North America,38,6,1,32,4,5,33,Human Factor
1956-07-31 00:00:00,Italian Air Force - Aeronautica Militare Italiana,Takeoff (climb),Military / Government,Italy,Europe,5,5,5,0,0,5,0,Unknown
1956-08-08 00:00:00,Sky Spray,Landing (descent or approach),Military / Government,United States of America,North America,5,5,5,0,0,5,0,Technical Failure
1956-08-10 00:00:00,Italian Air Force - Aeronautica Militare Italiana,Takeoff (climb),Operational,Italy,Europe,5,5,5,0,0,5,0,Technical Failure
1956-09-17 00:00:00,United States Air Force - USAF,Flight,Military / Government,United States of America,North America,7,7,5,0,0,5,2,Technical Failure
1956-10-22 00:00:00,United States Air Force - USAF,Flight,Military / Government,Spain,Europe,5,1,1,4,4,5,0,Unknown
1956-12-12 00:00:00,Air France,Flight,Operational,France,Europe,5,5,5,0,0,5,0,Unknown
1956-12-21 00:00:00,French Air Force - Armée de l'Air,,Military / Government,France,Europe,5,2,2,3,3,5,0,Unknown
1957-03-02 00:00:00,Alaska Airlines,Flight,Commercial,United States of America,North America,5,3,3,2,2,5,0,Human Factor
1957-04-13 00:00:00,Servicios Aéreos de Chiapas,Takeoff (climb),Operational,Mexico,Central America,5,3,3,2,2,5,0,Technical Failure
1957-04-26 00:00:00,French Air Force - Armée de l'Air,Landing (descent or approach),Specialised Services,France,Europe,5,5,5,0,0,5,0,Unknown
1957-06-11 00:00:00,Turkish Air Force - Türk Hava Kuvvetleri,Flight,Military / Government,Turkey,Asia,5,5,5,0,0,5,0,Unknown
1957-07-18 00:00:00,United States Air Force - USAF,Takeoff (climb),Military / Government,United States of America,North America,8,8,5,0,0,5,3,Technical Failure
1957-08-13 00:00:00,French Air Force - Armée de l'Air,Takeoff (climb),Military / Government,Madagascar,Africa,5,3,3,2,2,5,0,Unknown
1957-08-17 00:00:00,Aeroflot - Russian International Airlines,Landing (descent or approach),Operational,Ukraine,Europe,5,5,5,0,0,5,0,Human Factor
1957-08-31 00:00:00,United States Air Force - USAF,Landing (descent or approach),Military / Government,United States of America,North America,15,4,0,11,5,5,10,Human Factor
1957-09-20 00:00:00,Royal Air Force - RAF,Flight,Operational,United Kingdom,Europe,5,5,5,0,0,5,0,Technical Failure
1957-09-27 00:00:00,Brazilian Air Force - Força Aérea Brasileira,Takeoff (climb),Military / Government,Brazil,South America,5,5,5,0,0,5,0,Unknown
1957-10-07 00:00:00,French Navy,Takeoff (climb),Military / Government,France,Europe,5,4,4,1,1,5,0,Human Factor
1957-10-23 00:00:00,French Navy,Landing (descent or approach),Military / Government,Mauritania,Africa,11,11,5,0,0,5,6,Unknown
1957-12-17 00:00:00,United States Air Force - USAF,Landing (descent or approach),Military / Government,Germany,Europe,6,6,5,0,0,5,1,Human Factor
1957-12-22 00:00:00,Paraguay Air Services,Flight,Operational,Brazil,South America,5,2,2,3,3,5,0,Terrorism
1958-02-01 00:00:00,Loide Aéreo Nacional,Takeoff (climb),Commercial,Brazil,South America,73,5,2,68,3,5,68,Technical Failure
1958-05-14 00:00:00,United States Navy - USN,Flight,Military / Government,United States of America,North America,5,5,5,0,0,5,0,Technical Failure
1958-06-25 00:00:00,Indian Airlines,Flight,Operational,India,Asia,7,3,3,4,2,5,2,Human Factor
1958-07-06 00:00:00,Cuban Air Force - Fuerza Aérea del Ejército de Cuba,Landing (descent or approach),Military / Government,Cuba,Central America,9,2,2,7,3,5,4,Unknown
1958-09-08 00:00:00,United States Air Force - USAF,Landing (descent or approach),Operational,United States of America,North America,7,7,5,0,0,5,2,Human Factor
1958-09-29 00:00:00,Middle East Airlines - MEA,Flight,Operational,World,World,5,5,5,0,0,5,0,Unknown
1958-11-25 00:00:00,United States Air Force - USAF,Takeoff (climb),Operational,United States of America,North America,7,7,5,0,0,5,2,Human Factor
1958-11-25 00:00:00,French Air Force - Armée de l'Air,Flight,Military / Government,France,Europe,5,1,1,4,4,5,0,Unknown
1958-12-18 00:00:00,Sri Lanka Air Force,Takeoff (climb),Military / Government,Sri Lanka,Asia,5,2,2,3,3,5,0,Technical Failure
1958-12-21 00:00:00,Royal Canadian Air Force - RCAF,Flight,Military / Government,Italy,Europe,5,5,5,0,0,5,0,Human Factor
1959-01-06 00:00:00,SAHSA - Servicios Aéreos de Honduras SA,Flight,Commercial,Honduras,Central America,5,3,3,2,2,5,0,Human Factor
1959-02-18 00:00:00,Southern Cross Airways,Flight,Operational,Chile,South America,5,5,5,0,0,5,0,Technical Failure
1959-02-28 00:00:00,United States Air Force - USAF,Flight,Operational,United States of America,North America,5,5,5,0,0,5,0,Unknown
1959-03-12 00:00:00,Indian Airlines,Flight,Operational,India,Asia,7,3,3,4,2,5,2,Human Factor
1959-04-24 00:00:00,Aeroflot - Russian International Airlines,Flight,Specialised Services,Russia,Asia,8,8,5,0,0,5,3,Technical Failure
1959-05-02 00:00:00,Austria-Flugdienst,Takeoff (climb),Commercial,Spain,Europe,5,3,3,2,2,5,0,Human Factor
1959-05-29 00:00:00,Royal Air Force - RAF,Landing (descent or approach),Military / Government,Sudan,Africa,30,5,5,25,0,5,25,Technical Failure
1959-06-23 00:00:00,United States Air Force - USAF,Flight,Operational,United States of America,North America,5,5,5,0,0,5,0,Weather
1959-07-10 00:00:00,Uruguayan Air Force - Fuerza Aérea Uruguaya,Flight,Operational,Uruguay,South America,5,5,5,0,0,5,0,Unknown
1959-07-24 00:00:00,German Air Force - Deutsche Luftwaffe,Takeoff (climb),Military / Government,Turkey,Asia,5,5,5,0,0,5,0,Unknown
1959-08-15 00:00:00,American Airlines,Landing (descent or approach),Operational,United States of America,North America,5,5,5,0,0,5,0,Human Factor
1959-11-04 00:00:00,Wheeler Airlines,Flight,Operational,Canada,North America,5,5,5,0,0,5,0,Technical Failure
1959-12-17 00:00:00,Royal Netherlands Navy - Marineluchtvaartdienst,Landing (descent or approach),Military / Government,Indonesia,Asia,8,8,5,0,0,5,3,Unknown
1960-01-20 00:00:00,Italian Air Force - Aeronautica Militare Italiana,Takeoff (climb),Military / Government,Italy,Europe,5,5,5,0,0,5,0,Unknown
1960-03-16 00:00:00,All Nippon Airways,Takeoff (climb),Commercial,Japan,Asia,40,5,2,35,3,5,35,Human Factor
1960-05-03 00:00:00,Navegação Aérea Brasileira - NAB,Landing (descent or approach),Operational,Puerto Rico,Central America,5,5,5,0,0,5,0,Human Factor
1960-05-05 00:00:00,Aeroflot - Russian International Airlines,Flight,Operational,Russia,Asia,5,5,5,0,0,5,0,Weather
1960-06-27 00:00:00,United States Air Force - USAF,Flight,Operational,United States of America,North America,5,5,5,0,0,5,0,Technical Failure
1960-09-20 00:00:00,Colombian Air Force - Fuerza Aérea Colombiana,Landing (descent or approach),Military / Government,Colombia,South America,5,1,1,4,4,5,0,Unknown
1960-10-30 00:00:00,Aeroflot - Russian International Airlines,Takeoff (climb),Operational,Russia,Asia,5,5,5,0,0,5,0,Weather
1960-11-11 00:00:00,Aeroflot - Russian International Airlines,Takeoff (climb),Operational,Russia,Asia,6,5,5,1,0,5,1,Human Factor
1960-12-19 00:00:00,Bulgarian Air Force - Bulgarski Voennov Azdushni Sili,Landing (descent or approach),Military / Government,Bulgaria,Europe,5,5,5,0,0,5,0,Human Factor
1961-01-02 00:00:00,Royal Netherlands Air Force - Koninklijke Luchtmacht,Flight,Operational,Indonesia,Asia,5,5,5,0,0,5,0,Technical Failure
1961-01-15 00:00:00,United States Air Force - USAF,Landing (descent or approach),Military / Government,United States of America,North America,5,5,5,0,0,5,0,Human Factor
1961-01-17 00:00:00,Aeroflot - Russian International Airlines,Flight,Other,Russia,Asia,5,5,5,0,0,5,0,Human Factor
1961-02-10 00:00:00,South African Air Force,Flight,Military / Government,South Africa,Africa,5,5,5,0,0,5,0,Unknown
1961-02-28 00:00:00,United States Air Force - USAF,Takeoff (climb),Operational,United States of America,North America,5,5,5,0,0,5,0,Technical Failure
1961-03-16 00:00:00,Aeroflot - Russian International Airlines,Takeoff (climb),Commercial,Russia,Asia,51,10,2,41,3,5,46,Technical Failure
1961-04-17 00:00:00,Air Taxi Company,Flight,Commercial,Iran,Asia,5,1,1,4,4,5,0,Weather
1961-05-05 00:00:00,Argentinian Air Force - Fuerza Aérea Argentina,Flight,Operational,Argentina,South America,5,5,5,0,0,5,0,Unknown
1961-06-05 00:00:00,Aeroflot - Russian International Airlines,Landing (descent or approach),Operational,Russia,Asia,5,5,5,0,0,5,0,Human Factor
1961-06-08 00:00:00,Portuguese Air Force - Força Aerea Portuguesa,Flight,Military / Government,Angola,Africa,5,5,5,0,0,5,0,Unknown
1961-06-13 00:00:00,Air Cameroon,Takeoff (climb),Operational,Cameroon,Africa,5,5,5,0,0,5,0,Human Factor
1961-09-05 00:00:00,Ethiopian Airlines,Takeoff (climb),Commercial,Ethiopia,Africa,19,3,1,16,4,5,14,Technical Failure
1961-10-31 00:00:00,Aeroflot - Russian International Airlines,Landing (descent or approach),Operational,Russia,Asia,5,5,5,0,0,5,0,Human Factor
1961-11-09 00:00:00,United States Navy - USN,Takeoff (climb),Military / Government,Antarctica,Antarctica,9,9,5,0,0,5,4,Human Factor
1961-12-12 00:00:00,Belgian Air Force - Force Aérienne Belge - Belgische Luchtmacht,Flight,Operational,Belgium,Europe,5,5,5,0,0,5,0,Human Factor
1962-01-06 00:00:00,Spanish Air Force - Ejército del Aire,Flight,Military / Government,Spain,Europe,5,5,5,0,0,5,0,Unknown
1962-01-10 00:00:00,Air National Guard,Flight,Operational,United States of America,North America,5,5,5,0,0,5,0,Technical Failure
1962-01-13 00:00:00,Ethiopian Airlines,Takeoff (climb),Commercial,Ethiopia,Africa,18,3,2,15,3,5,13,Unknown
1962-02-12 00:00:00,Air Charter - New Zealand,Flight,Commercial,New Zealand,Oceania,5,1,1,4,4,5,0,Unknown
1962-03-08 00:00:00,Società Aerea Mediterranea - SAM,Flight,Operational,Italy,Europe,5,5,5,0,0,5,0,Human Factor
1962-04-26 00:00:00,Federal Aviation Administration - FAA,Landing (descent or approach),Operational,Kiribati,Oceania,6,4,4,2,1,5,1,Technical Failure
1962-06-04 00:00:00,Aeroflot - Russian International Airlines,Takeoff (climb),Operational,Bulgaria,Europe,5,5,5,0,0,5,0,Technical Failure
1962-07-30 00:00:00,Air France,Takeoff (climb),Operational,France,Europe,8,8,5,0,0,5,3,Human Factor
1962-08-09 00:00:00,United States Navy - USN,Landing (descent or approach),Military / Government,United States of America,North America,19,4,0,15,5,5,14,Weather
1962-08-31 00:00:00,Air America,Flight,Humanitarian,Laos,Asia,5,3,3,2,2,5,0,Unknown
1962-11-07 00:00:00,United States Air Force - USAF,Landing (descent or approach),Military / Government,United States of America,North America,6,2,2,4,3,5,1,Unknown
1962-11-16 00:00:00,Colombian Air Force - Fuerza Aérea Colombiana,Flight,Operational,Colombia,South America,5,5,5,0,0,5,0,Human Factor
1962-11-26 00:00:00,United States Air Force - USAF,Takeoff (climb),Military / Government,United States of America,North America,5,5,5,0,0,5,0,Technical Failure
1962-12-13 00:00:00,Mexican Air Force - Fuerza Aérea Mexicana,Flight,Military / Government,Mexico,Central America,5,2,2,3,3,5,0,Terrorism
1962-12-14 00:00:00,Flying Tiger Line,Landing (descent or approach),Operational,United States of America,North America,5,3,3,2,2,5,0,Human Factor
1963-01-14 00:00:00,Wien Alaska Airlines,Landing (descent or approach),Commercial,United States of America,North America,6,1,1,5,4,5,1,Human Factor
1963-02-14 00:00:00,Royal Air Force - RAF,Flight,Military / Government,Malaysia,Asia,5,5,5,0,0,5,0,Weather
1963-04-29 00:00:00,French Navy,Takeoff (climb),Military / Government,France,Europe,7,1,1,6,4,5,2,Unknown
1963-06-03 00:00:00,Indian Air Force - Bharatiya Vayu Sena,Flight,Military / Government,India,Asia,5,5,5,0,0,5,0,Unknown
1963-06-04 00:00:00,Aerolineas TAO,Flight,Operational,Colombia,South America,5,3,3,2,2,5,0,Unknown
1963-07-13 00:00:00,RCMP - GRC Air Services,Flight,Military / Government,Canada,North America,5,1,1,4,4,5,0,Unknown
1963-08-28 00:00:00,United States Air Force - USAF,Flight,Operational,World,World,5,5,5,0,0,5,0,Human Factor
1963-09-17 00:00:00,PZL-Mielec - WSK Mielec - Wytwórni Sprzetu Komunikacyjnego,Flight,Specialised Services,Poland,Europe,5,5,5,0,0,5,0,Technical Failure
1964-01-04 00:00:00,Aerotaxi Servicios Aéreos,Landing (descent or approach),Commercial,Colombia,South America,5,1,1,4,4,5,0,Unknown
1964-03-12 00:00:00,Frontier Airlines,Landing (descent or approach),Commercial,United States of America,North America,5,3,3,2,2,5,0,Human Factor
1964-04-29 00:00:00,French Air Force - Armée de l'Air,Flight,Operational,France,Europe,5,5,5,0,0,5,0,Human Factor
1964-06-09 00:00:00,Turkish Air Force - Türk Hava Kuvvetleri,Takeoff (climb),Military / Government,Turkey,Asia,5,5,5,0,0,5,0,Technical Failure
1964-06-24 00:00:00,United States Army,Takeoff (climb),Operational,United States of America,North America,20,2,0,18,5,5,15,Technical Failure
1964-07-03 00:00:00,United States Coast Guard - USCG,Landing (descent or approach),Military / Government,United States of America,North America,5,5,5,0,0,5,0,Human Factor
1964-07-07 00:00:00,Private American,Takeoff (climb),Commercial,United States of America,North America,5,1,1,4,4,5,0,Human Factor
1964-09-03 00:00:00,Indonesian Air Force - TNI-AU Tentara Nasional Indonesia - Angkatan Udara,Flight,Military / Government,World,World,5,5,5,0,0,5,0,Unknown
1964-09-08 00:00:00,United States Navy - USN,Flight,Military / Government,World,World,13,13,5,0,0,5,8,Unknown
1964-11-03 00:00:00,Mustang Aviation,Flight,Commercial,United States of America,North America,5,1,1,4,4,5,0,Human Factor
1964-11-05 00:00:00,United States Air Force - USAF,Takeoff (climb),Operational,United States of America,North America,5,5,5,0,0,5,0,Unknown
1964-12-19 00:00:00,United States Air Force - USAF,Landing (descent or approach),Operational,Canada,North America,5,5,5,0,0,5,0,Human Factor
1965-02-20 00:00:00,JAT Yugoslav Airlines - Jugoslovenski Aerotransport,Landing (descent or approach),Operational,Serbia,Europe,5,5,5,0,0,5,0,Unknown
1965-03-05 00:00:00,Biltmore Mobile Homes Company,Flight,Business,United States of America,North America,5,2,2,3,3,5,0,Technical Failure
1965-03-25 00:00:00,United States Air Force - USAF,Landing (descent or approach),Military / Government,Philippines,Asia,5,5,5,0,0,5,0,Human Factor
1965-04-23 00:00:00,Aaxico Airlines - American Air Export %26 Import Company,Flight,Operational,United States of America,North America,5,5,5,0,0,5,0,Human Factor
1965-05-03 00:00:00,French Air Force - Armée de l'Air,Flight,Operational,France,Europe,5,5,5,0,0,5,0,Unknown
1965-05-10 00:00:00,Aeroflot - Russian International Airlines,Flight,Military / Government,Russia,Asia,6,1,1,5,4,5,1,Human Factor
1965-06-03 00:00:00,United States Air Force - USAF,Takeoff (climb),Operational,United States of America,North America,5,5,5,0,0,5,0,Technical Failure
1965-06-18 00:00:00,United States Air Force - USAF,Flight,Military / Government,World,World,6,6,5,0,0,5,1,Human Factor
1965-06-19 00:00:00,Cubana de Aviación,Flight,Operational,Cuba,Central America,5,5,5,0,0,5,0,Terrorism
1965-07-13 00:00:00,Boone County Aviation,Takeoff (climb),Commercial,United States of America,North America,5,1,1,4,4,5,0,Human Factor
1965-09-16 00:00:00,Indonesian Air Force - TNI-AU Tentara Nasional Indonesia - Angkatan Udara,Flight,Military / Government,Malaysia,Asia,5,5,5,0,0,5,0,Terrorism
1965-12-15 00:00:00,Air National Guard,Landing (descent or approach),Military / Government,United States of America,North America,5,5,5,0,0,5,0,Human Factor
1965-12-20 00:00:00,United States Air Force - USAF,Landing (descent or approach),Military / Government,Vietnam,Asia,5,5,5,0,0,5,0,Terrorism
1966-01-06 00:00:00,United States Air Force - USAF,Landing (descent or approach),Military / Government,Vietnam,Asia,5,5,5,0,0,5,0,Terrorism
1966-03-10 00:00:00,TMA of Lebanon - Trans Mediterranean Airways,Flight,Operational,Greece,Europe,5,5,5,0,0,5,0,Human Factor
1966-03-11 00:00:00,Northern Natural Gas Company,Flight,Business,United States of America,North America,8,2,1,6,4,5,3,Technical Failure
1966-04-23 00:00:00,Royal Canadian Air Force - RCAF,Flight,Operational,Canada,North America,6,5,4,1,1,5,1,Unknown
1966-05-11 00:00:00,Lamb Rental Tours,Takeoff (climb),Business,United States of America,North America,5,2,2,3,3,5,0,Human Factor
1966-05-17 00:00:00,United States Air Force - USAF,Landing (descent or approach),Operational,United States of America,North America,5,4,4,1,1,5,0,Human Factor
1966-05-17 00:00:00,United States Air Force - USAF,Flight,Military / Government,Vietnam,Asia,5,5,5,0,0,5,0,Terrorism
1966-08-26 00:00:00,Japan Domestic Airlines,Takeoff (climb),Operational,Japan,Asia,5,5,5,0,0,5,0,Human Factor
1966-08-29 00:00:00,Turkish Air Force - Türk Hava Kuvvetleri,Flight,Operational,Turkey,Asia,9,9,5,0,0,5,4,Unknown
1966-09-26 00:00:00,Jim Robbins Airborne Division,Flight,Business,United States of America,North America,5,1,1,4,4,5,0,Human Factor
1966-10-02 00:00:00,United States Air Force - USAF,Flight,Military / Government,Vietnam,Asia,5,5,5,0,0,5,0,Terrorism
1966-10-12 00:00:00,United States Air Force - USAF,Flight,Operational,United States of America,North America,6,6,5,0,0,5,1,Human Factor
1967-01-10 00:00:00,Cubana de Aviación,Takeoff (climb),Military / Government,Cuba,Central America,5,2,2,3,3,5,0,Weather
1967-01-12 00:00:00,Air America,Flight,Commercial,Vietnam,Asia,5,1,1,4,4,5,0,Weather
1967-01-31 00:00:00,United States Air Force - USAF,Flight,Military / Government,Laos,Asia,5,5,5,0,0,5,0,Terrorism
1967-03-06 00:00:00,Aeroflot - Russian International Airlines,Takeoff (climb),Operational,Russia,Asia,6,6,5,0,0,5,1,Human Factor
1967-03-23 00:00:00,United States Air Force - USAF,Taxiing,Military / Government,Vietnam,Asia,6,6,5,0,0,5,1,Human Factor
1967-04-02 00:00:00,Trans Caribbean Enterprises,Landing (descent or approach),Business,Peru,South America,5,2,2,3,3,5,0,Unknown
1967-05-08 00:00:00,Private American,Flight,Business,United States of America,North America,5,1,1,4,4,5,0,Human Factor
1967-06-27 00:00:00,French Air Force - Armée de l'Air,Flight,Military / Government,Germany,Europe,5,2,2,3,3,5,0,Unknown
1967-07-08 00:00:00,United States Air Force - USAF,Landing (descent or approach),Military / Government,Vietnam,Asia,6,6,5,0,0,5,1,Technical Failure
1967-07-20 00:00:00,United States Air Force - USAF,Flight,Military / Government,Vietnam,Asia,5,5,5,0,0,5,0,Terrorism
1967-08-21 00:00:00,National Flights Services,Takeoff (climb),Commercial,United States of America,North America,5,1,1,4,4,5,0,Technical Failure
1967-08-31 00:00:00,French Air Force - Armée de l'Air,Flight,Military / Government,France,Europe,5,2,2,3,3,5,0,Unknown
1967-09-15 00:00:00,Private American,Landing (descent or approach),Business,Canada,North America,6,1,0,5,5,5,1,Human Factor
1967-09-27 00:00:00,United States Navy - USN,Landing (descent or approach),Operational,United States of America,North America,5,5,5,0,0,5,0,Unknown
1967-10-05 00:00:00,Normoyle-Berg %26 Associates,Flight,Business,Canada,North America,5,1,1,4,4,5,0,Human Factor
1967-10-08 00:00:00,United States Navy - USN,Landing (descent or approach),Military / Government,Vietnam,Asia,5,5,5,0,0,5,0,Human Factor
1967-10-10 00:00:00,United States Army,Flight,Military / Government,United States of America,North America,5,2,2,3,3,5,0,Technical Failure
1967-10-12 00:00:00,Aeroflot - Russian International Airlines,Landing (descent or approach),Operational,Russia,Asia,5,4,4,1,1,5,0,Technical Failure
1967-10-15 00:00:00,United States Air Force - USAF,Landing (descent or approach),Military / Government,Vietnam,Asia,6,6,5,0,0,5,1,Human Factor
1967-11-07 00:00:00,Mexican Air Force - Fuerza Aérea Mexicana,Flight,Military / Government,Mexico,Central America,5,2,2,3,3,5,0,Technical Failure
1968-01-21 00:00:00,North American Aircraft Trading,Landing (descent or approach),Operational,Nigeria,Africa,5,5,5,0,0,5,0,Unknown
1968-02-22 00:00:00,Aerotaxi Servicios Aéreos,Flight,Commercial,Colombia,South America,5,1,1,4,4,5,0,Technical Failure
1968-03-09 00:00:00,Aeroflot - Russian International Airlines,Flight,Operational,Armenia,Asia,5,5,5,0,0,5,0,Human Factor
1968-04-08 00:00:00,British Overseas Airways Corporation - BOAC,Landing (descent or approach),Commercial,United Kingdom,Europe,127,11,1,116,4,5,122,Technical Failure
1968-04-22 00:00:00,Aeroflot - Russian International Airlines,Landing (descent or approach),Operational,Russia,Asia,5,5,5,0,0,5,0,Human Factor
1968-07-18 00:00:00,Aerolineas Flecha Austral - AFA,Flight,Operational,Chile,South America,5,3,3,2,2,5,0,Unknown
1968-08-31 00:00:00,Westwing,Flight,Commercial,Norway,Europe,5,1,1,4,4,5,0,Human Factor
1968-09-06 00:00:00,United States Air Force - USAF,Landing (descent or approach),Military / Government,Vietnam,Asia,5,5,5,0,0,5,0,Terrorism
1968-09-20 00:00:00,French Navy,Landing (descent or approach),Operational,United Kingdom,Europe,5,5,5,0,0,5,0,Human Factor
1968-09-22 00:00:00,Aeroflot - Russian International Airlines,Flight,Military / Government,Russia,Asia,8,2,1,6,4,5,3,Human Factor
1968-11-20 00:00:00,London Properties,Landing (descent or approach),Specialised Services,United States of America,North America,5,1,1,4,4,5,0,Human Factor
1968-11-23 00:00:00,Aerotaxi Servicios Aéreos,Flight,Commercial,Colombia,South America,6,1,1,5,4,5,1,Unknown
1968-12-21 00:00:00,Metropolitan Mooney,Flight,Business,United States of America,North America,5,1,1,4,4,5,0,Technical Failure
1969-03-16 00:00:00,United States Army,Flight,Military / Government,Vietnam,Asia,5,2,2,3,3,5,0,Human Factor
1969-03-29 00:00:00,Beaudoin Steul,Flight,Business,United States of America,North America,5,1,1,4,4,5,0,Weather
1969-07-23 00:00:00,Chilean Air Force - Fuerza Aérea de Chile,Landing (descent or approach),Military / Government,Chile,South America,5,2,2,3,3,5,0,Technical Failure
1969-07-26 00:00:00,Trans World Airlines - TWA,Landing (descent or approach),Operational,United States of America,North America,5,5,5,0,0,5,0,Human Factor
1969-08-19 00:00:00,Aeroflot - Russian International Airlines,Flight,Military / Government,Belarus,Europe,5,2,2,3,3,5,0,Human Factor
1969-08-31 00:00:00,Instituto Brasileiro de Reforma Agrária,Landing (descent or approach),Operational,Brazil,South America,6,2,2,4,3,5,1,Technical Failure
1969-09-08 00:00:00,Aeroflot - Russian International Airlines,Taxiing,Operational,Russia,Asia,8,6,5,2,0,5,3,Technical Failure
1969-09-26 00:00:00,Aeroflot - Russian International Airlines,Landing (descent or approach),Commercial,Russia,Asia,6,3,3,3,2,5,1,Technical Failure
1969-09-26 00:00:00,Nordchurchaid,Landing (descent or approach),Humanitarian,Nigeria,Africa,5,5,5,0,0,5,0,Human Factor
1969-10-03 00:00:00,Metro Commuter Airlines,Landing (descent or approach),Commercial,United States of America,North America,7,2,2,5,3,5,2,Human Factor
1969-10-06 00:00:00,United States Air Force - USAF,Flight,Military / Government,Vietnam,Asia,5,5,5,0,0,5,0,Other
1969-10-10 00:00:00,United States Air Force - USAF,Takeoff (climb),Military / Government,Vietnam,Asia,5,5,5,0,0,5,0,Unknown
1969-11-01 00:00:00,Aeroflot - Russian International Airlines,Takeoff (climb),Commercial,Kazakhstan,Asia,26,2,0,24,5,5,21,Human Factor
1969-11-25 00:00:00,Aeroflot - Russian International Airlines,Landing (descent or approach),Commercial,Ukraine,Europe,5,2,2,3,3,5,0,Human Factor
1969-12-17 00:00:00,Winegardner %26 Hammons,Flight,Business,United States of America,North America,5,1,1,4,4,5,0,Technical Failure
1970-01-05 00:00:00,Spantax,Takeoff (climb),Operational,Sweden,Europe,10,3,0,7,5,5,5,Human Factor
1970-02-06 00:00:00,United States Air Force - USAF,Flight,Military / Government,United States of America,North America,5,5,5,0,0,5,0,Technical Failure
1970-02-10 00:00:00,Pilgrim Airlines,Landing (descent or approach),Commercial,United States of America,North America,5,2,2,3,3,5,0,Technical Failure
1970-02-25 00:00:00,Aeroflot - Russian International Airlines,Takeoff (climb),Operational,Russia,Asia,5,5,5,0,0,5,0,Technical Failure
1970-04-02 00:00:00,Roberts Construction,Landing (descent or approach),Business,United States of America,North America,5,1,1,4,4,5,0,Weather
1970-04-08 00:00:00,United States Navy - USN,Flight,Military / Government,Vietnam,Asia,5,5,5,0,0,5,0,Technical Failure
1970-05-06 00:00:00,Somali Airlines,Landing (descent or approach),Commercial,Somalia,Africa,30,4,0,26,5,5,25,Technical Failure
1970-06-06 00:00:00,Aerovias del Valle,Takeoff (climb),Commercial,Costa Rica,Central America,6,2,1,4,4,5,1,Unknown
1970-06-10 00:00:00,Líneas Aéreas del Estado - LADE,Flight,Military / Government,Peru,South America,8,3,2,5,3,5,3,Human Factor
1970-07-03 00:00:00,Reeder Flying Service,Takeoff (climb),Humanitarian,United States of America,North America,27,2,1,25,4,5,22,Human Factor
1970-08-08 00:00:00,Venezuelan Air Force - Fuerza Aérea Venezolana,Flight,Military / Government,Venezuela,South America,5,1,1,4,4,5,0,Unknown
1970-10-19 00:00:00,Colombian Air Force - Fuerza Aérea Colombiana,Landing (descent or approach),Military / Government,Colombia,South America,7,1,1,6,4,5,2,Technical Failure
1970-11-19 00:00:00,German Air Force - Deutsche Luftwaffe,Flight,Military / Government,Germany,Europe,5,5,5,0,0,5,0,Unknown
1970-12-05 00:00:00,Jamair,Takeoff (climb),Commercial,India,Asia,16,4,3,12,2,5,11,Technical Failure
1970-12-06 00:00:00,United States Air Force - USAF,Takeoff (climb),Military / Government,United States of America,North America,5,1,1,4,4,5,0,Weather
1971-01-27 00:00:00,Cousins Properties,Flight,Business,United States of America,North America,5,2,2,3,3,5,0,Unknown
1971-02-10 00:00:00,United States Air Force - USAF,Flight,Military / Government,Vietnam,Asia,5,5,5,0,0,5,0,Human Factor
1971-02-10 00:00:00,United States Air Force - USAF,Flight,Military / Government,Vietnam,Asia,5,5,5,0,0,5,0,Human Factor
1971-03-04 00:00:00,United States Army,Flight,Military / Government,Vietnam,Asia,5,2,2,3,3,5,0,Terrorism
1971-03-31 00:00:00,Western Airlines,Landing (descent or approach),Operational,United States of America,North America,5,5,5,0,0,5,0,Technical Failure
1971-04-16 00:00:00,Scientific Company,Takeoff (climb),Business,United States of America,North America,5,2,2,3,3,5,0,Human Factor
1971-04-25 00:00:00,United States Air Force - USAF,Landing (descent or approach),Military / Government,United States of America,North America,5,5,5,0,0,5,0,Weather
1971-05-11 00:00:00,Aviateca,Takeoff (climb),Commercial,Guatemala,Central America,32,3,3,29,2,5,27,Technical Failure
1971-06-11 00:00:00,United States Navy - USN,Flight,Military / Government,World,World,5,5,5,0,0,5,0,Unknown
1971-08-18 00:00:00,Aeroflot - Russian International Airlines,Flight,Commercial,Russia,Asia,5,2,2,3,3,5,0,Human Factor
1971-08-19 00:00:00,Saint-Félicien Air Service,Flight,Commercial,Canada,North America,5,2,2,3,3,5,0,Unknown
1971-09-15 00:00:00,C%26C Aviation,Landing (descent or approach),Commercial,United States of America,North America,6,1,1,5,4,5,1,Technical Failure
1971-09-16 00:00:00,Yemen Airlines,Flight,Operational,Serbia,Europe,5,2,2,3,3,5,0,Weather
1971-10-19 00:00:00,French Air Force - Armée de l'Air,Flight,Operational,France,Europe,5,5,5,0,0,5,0,Technical Failure
1971-10-21 00:00:00,Private American,Takeoff (climb),Business,United States of America,North America,5,1,1,4,4,5,0,Human Factor
1971-12-17 00:00:00,Indian Air Force - Bharatiya Vayu Sena,Flight,Military / Government,India,Asia,5,5,5,0,0,5,0,Unknown
1971-12-26 00:00:00,Robert Montana,Flight,Business,United States of America,North America,5,1,1,4,4,5,0,Human Factor
1972-02-10 00:00:00,Biman Bangladesh Airlines,Landing (descent or approach),Operational,Bangladesh,Asia,5,5,5,0,0,5,0,Unknown
1972-02-19 00:00:00,United States Air Force - USAF,Takeoff (climb),Military / Government,United States of America,North America,5,5,5,0,0,5,0,Human Factor
1972-02-20 00:00:00,Sun Valley Key Airlines,Flight,Commercial,United States of America,North America,5,1,1,4,4,5,0,Technical Failure
1972-04-22 00:00:00,J%26H Supply Company,Landing (descent or approach),Business,United States of America,North America,5,1,1,4,4,5,0,Human Factor
1972-05-01 00:00:00,Prestolite Electric Company,Landing (descent or approach),Business,United States of America,North America,5,2,2,3,3,5,0,Human Factor
1972-06-24 00:00:00,Prinair - Puerto Rico International Airlines,Landing (descent or approach),Commercial,Puerto Rico,Central America,20,2,2,18,3,5,15,Human Factor
1972-06-29 00:00:00,North Central Airlines,Flight,Commercial,United States of America,North America,5,3,3,2,2,5,0,Human Factor
1972-07-30 00:00:00,United States Air Force - USAF,Flight,Military / Government,Thailand,Asia,6,6,5,0,0,5,1,Weather
1972-08-07 00:00:00,Jerrico,Takeoff (climb),Business,United States of America,North America,5,1,1,4,4,5,0,Technical Failure
1972-10-27 00:00:00,United States Air Force - USAF,Flight,Military / Government,France,Europe,5,5,5,0,0,5,0,Human Factor
1972-12-03 00:00:00,Investment Dynamics,Landing (descent or approach),Business,United States of America,North America,11,2,2,9,3,5,6,Human Factor
1972-12-09 00:00:00,United States Air Force - USAF,Landing (descent or approach),Operational,Guam Island,Asia,8,5,4,3,1,5,3,Human Factor
1972-12-18 00:00:00,Taxi Aéreo de Santander del Sur,Flight,Commercial,Colombia,South America,5,1,1,4,4,5,0,Unknown
1972-12-20 00:00:00,United States Air Force - USAF,Flight,Military / Government,Vietnam,Asia,6,6,5,0,0,5,1,Terrorism
1972-12-31 00:00:00,American Express Leasing,Takeoff (climb),Humanitarian,Puerto Rico,Central America,5,3,3,2,2,5,0,Human Factor
1973-01-02 00:00:00,Pacific Western Airlines - PWA,Landing (descent or approach),Operational,Canada,North America,5,3,3,2,2,5,0,Human Factor
1973-01-03 00:00:00,Morplan Inc.,Landing (descent or approach),Business,United States of America,North America,5,2,2,3,3,5,0,Human Factor
1973-03-15 00:00:00,United States Navy - USN,Flight,Operational,United States of America,North America,5,5,5,0,0,5,0,Unknown
1973-03-27 00:00:00,Taxi Aéreo de Santander del Sur,Takeoff (climb),Commercial,Colombia,South America,5,2,2,3,3,5,0,Unknown
1973-04-10 00:00:00,Lanser,Landing (descent or approach),Business,Germany,Europe,5,2,2,3,3,5,0,Human Factor
1973-04-12 00:00:00,United States Navy - USN,Landing (descent or approach),Operational,United States of America,North America,6,6,5,0,0,5,1,Human Factor
1973-05-25 00:00:00,Clark Equipment Sales,Takeoff (climb),Business,United States of America,North America,5,1,1,4,4,5,0,Technical Failure
1973-06-19 00:00:00,United States Navy - USN,Takeoff (climb),Military / Government,United States of America,North America,5,5,5,0,0,5,0,Unknown
1973-06-26 00:00:00,Cessnyca,Flight,Commercial,Colombia,South America,7,2,1,5,4,5,2,Unknown
1973-07-24 00:00:00,Alii Air Hawaii,Takeoff (climb),Commercial,United States of America,North America,9,1,1,8,4,5,4,Human Factor
1973-08-25 00:00:00,Imperial Iranian Air Force,Flight,Operational,Iran,Asia,5,5,5,0,0,5,0,Unknown
1973-09-10 00:00:00,Royal Air Force - RAF,Takeoff (climb),Operational,United Kingdom,Europe,5,5,5,0,0,5,0,Technical Failure
1973-09-30 00:00:00,Aeronorte,Takeoff (climb),Commercial,Brazil,South America,5,3,3,2,2,5,0,Technical Failure
1973-10-10 00:00:00,Aeroflot - Russian International Airlines,Takeoff (climb),Operational,Turkmenistan,Asia,5,4,4,1,1,5,0,Technical Failure
1973-11-14 00:00:00,King Tire Company,Landing (descent or approach),Business,United States of America,North America,5,1,1,4,4,5,0,Human Factor
1973-11-30 00:00:00,Government of the Province of Misiones,Landing (descent or approach),Military / Government,Argentina,South America,6,1,1,5,4,5,1,Technical Failure
1974-01-10 00:00:00,Interstate Auto and Aircraft Parts,Takeoff (climb),Business,United States of America,North America,6,2,2,4,3,5,1,Technical Failure
1974-03-02 00:00:00,Capital National Corporation,Flight,Business,United States of America,North America,7,1,1,6,4,5,2,Human Factor
1974-03-29 00:00:00,Electro-Enterprises,Flight,Business,United States of America,North America,5,2,2,3,3,5,0,Human Factor
1974-07-06 00:00:00,Soviet Air Force - Voyenno-vozdushnye sily CCCP,Landing (descent or approach),Operational,Russia,Asia,5,5,5,0,0,5,0,Other
1974-07-19 00:00:00,Egyptian Air Force and Air Defence Command,Flight,Military / Government,Egypt,Africa,5,5,5,0,0,5,0,Unknown
1974-07-27 00:00:00,Air America,Flight,Operational,Vietnam,Asia,5,4,4,1,1,5,0,Terrorism
1974-08-05 00:00:00,Laurentian Air Services,Flight,Commercial,Canada,North America,11,3,3,8,2,5,6,Human Factor
1974-09-09 00:00:00,Chilean Air Force - Fuerza Aérea de Chile,Landing (descent or approach),Operational,Chile,South America,6,3,2,3,3,5,1,Human Factor
1974-10-15 00:00:00,Royal Air Lao,Flight,Military / Government,Laos,Asia,5,2,2,3,3,5,0,Unknown
1974-10-17 00:00:00,Webber Airlines,Takeoff (climb),Commercial,United States of America,North America,7,1,0,6,5,5,2,Human Factor
1974-11-18 00:00:00,Turkish Air Force - Türk Hava Kuvvetleri,Takeoff (climb),Military / Government,Turkey,Asia,5,5,5,0,0,5,0,Unknown
1974-11-28 00:00:00,Air Cambodge,Flight,Operational,Vietnam,Asia,5,3,3,2,2,5,0,Terrorism
1974-12-11 00:00:00,Kodiak Airways,Flight,Commercial,United States of America,North America,5,1,1,4,4,5,0,Unknown
1975-01-02 00:00:00,Penhall Company,Takeoff (climb),Business,United States of America,North America,5,1,1,4,4,5,0,Human Factor
1975-01-13 00:00:00,Channel Flying Services,Flight,Commercial,United States of America,North America,5,1,1,4,4,5,0,Unknown
1975-01-17 00:00:00,Royal Thai Police,Landing (descent or approach),Military / Government,Thailand,Asia,5,1,1,4,4,5,0,Unknown
1975-01-25 00:00:00,The Columbus Dispatch Printing Company,Landing (descent or approach),Business,United States of America,North America,5,2,2,3,3,5,0,Human Factor
1975-02-01 00:00:00,Horizon Properties,Landing (descent or approach),Commercial,United States of America,North America,16,2,2,14,3,5,11,Human Factor
1975-02-22 00:00:00,Aerocondor de Colombia - Aerovias Condor,Takeoff (climb),Operational,Colombia,South America,5,5,5,0,0,5,0,Unknown
1975-03-18 00:00:00,Sudan Airways,Flight,Military / Government,Sudan,Africa,6,2,2,4,3,5,1,Unknown
1975-03-31 00:00:00,Royal Nepal Airlines,Takeoff (climb),Commercial,Nepal,Asia,5,1,1,4,4,5,0,Human Factor
1975-04-26 00:00:00,United States Army,Takeoff (climb),Military / Government,United States of America,North America,5,2,2,3,3,5,0,Technical Failure
1975-08-30 00:00:00,Centrais Elétricas de Santa Catarina,Landing (descent or approach),Business,Brazil,South America,6,2,2,4,3,5,1,Human Factor
1975-11-13 00:00:00,Professional Medical Specialities,Landing (descent or approach),Business,United States of America,North America,5,1,1,4,4,5,0,Technical Failure
1975-12-21 00:00:00,George W. Peck,Flight,Business,Mexico,Central America,5,1,1,4,4,5,0,Unknown
1976-01-22 00:00:00,GLAM - Groupe de Liaisons Aériennes Ministérielles,Takeoff (climb),Military / Government,France,Europe,5,2,2,3,3,5,0,Unknown
1976-02-21 00:00:00,Antilles Air Boats,Flight,Commercial,United States of America,Central America,10,1,0,9,5,5,5,Technical Failure
1976-03-18 00:00:00,Cubana de Aviación,Flight,Operational,Cuba,Central America,5,5,5,0,0,5,0,Human Factor
1976-04-02 00:00:00,SATENA - Servicio de Aeronavegacion a Territorios Nacionales,Landing (descent or approach),Commercial,Colombia,South America,16,2,1,14,4,5,11,Weather
1976-04-27 00:00:00,Frontier Flying Service,Flight,Commercial,United States of America,North America,5,1,1,4,4,5,0,Human Factor
1976-06-12 00:00:00,Aeroflot - Russian International Airlines,Landing (descent or approach),Commercial,Russia,Asia,7,2,2,5,3,5,2,Human Factor
1976-07-22 00:00:00,Winship Air Services,Landing (descent or approach),Business,United States of America,North America,5,2,2,3,3,5,0,Technical Failure
1976-07-31 00:00:00,Aeroflot - Russian International Airlines,Flight,Commercial,Russia,Asia,9,2,2,7,3,5,4,Weather
1976-08-02 00:00:00,Korean Air,Takeoff (climb),Operational,Iran,Asia,5,5,5,0,0,5,0,Human Factor
1976-08-03 00:00:00,Sultan of Oman Air Force,Flight,Military / Government,Oman,Asia,5,5,5,0,0,5,0,Unknown
1976-09-06 00:00:00,Soviet Air Force - Voyenno-vozdushnye sily CCCP,Flight,Military / Government,Russia,Asia,6,6,5,0,0,5,1,Unknown
1976-10-13 00:00:00,Private Mexican,Flight,Business,Mexico,Central America,5,2,2,3,3,5,0,Weather
1976-11-09 00:00:00,Taxi Aéreo João Jorge,Landing (descent or approach),Commercial,Brazil,South America,5,2,2,3,3,5,0,Technical Failure
1976-11-12 00:00:00,ALG Aeroleasing,Takeoff (climb),Business,Ireland,Europe,5,1,1,4,4,5,0,Human Factor
1976-11-22 00:00:00,German Air Force - Deutsche Luftwaffe,Flight,Operational,Germany,Europe,5,2,2,3,3,5,0,Human Factor
1976-11-30 00:00:00,U.S. Department of Agriculture,Flight,Military / Government,United States of America,North America,5,2,2,3,3,5,0,Unknown
1976-12-05 00:00:00,Continental Interiors,Landing (descent or approach),Business,United States of America,North America,5,1,1,4,4,5,0,Human Factor
1976-12-07 00:00:00,Aerobueno,Flight,Commercial,Colombia,South America,5,1,1,4,4,5,0,Unknown
1976-12-16 00:00:00,Aeroflot - Russian International Airlines,Flight,Operational,Ukraine,Europe,5,5,5,0,0,5,0,Human Factor
1977-01-13 00:00:00,Japan Airlines,Takeoff (climb),Operational,United States of America,North America,5,5,5,0,0,5,0,Human Factor
1977-01-27 00:00:00,Alpha Flug,Flight,Business,Switzerland,Europe,5,2,2,3,3,5,0,Human Factor
1977-02-22 00:00:00,B-Z Leasing,Flight,Business,United States of America,North America,5,1,1,4,4,5,0,Human Factor
1977-03-02 00:00:00,Transportes Aéreos de Nayarit,Landing (descent or approach),Operational,Mexico,Central America,5,2,2,3,3,5,0,Unknown
1977-03-25 00:00:00,Aeroflot - Russian International Airlines,Flight,Operational,Russia,Asia,5,3,3,2,2,5,0,Human Factor
1977-03-25 00:00:00,Aeroflot - Russian International Airlines,Flight,Operational,Russia,Asia,5,3,3,2,2,5,0,Human Factor
1977-04-04 00:00:00,United States Navy - USN,Flight,Military / Government,United States of America,North America,5,5,5,0,0,5,0,Unknown
1977-04-18 00:00:00,Tidewater Marine Services,Flight,Business,United States of America,North America,5,1,1,4,4,5,0,Human Factor
1977-06-07 00:00:00,El Dorado Leasing,Takeoff (climb),Business,United States of America,North America,5,1,1,4,4,5,0,Human Factor
1977-06-21 00:00:00,Royal Thai Air Force - Kong Thap Akat Thai,Takeoff (climb),Military / Government,Thailand,Asia,12,2,2,10,3,5,7,Unknown
1977-06-25 00:00:00,Orco Aviation,Landing (descent or approach),Business,United States of America,North America,9,1,1,8,4,5,4,Human Factor
1977-06-27 00:00:00,Aviatia Utilitara,Flight,Operational,Romania,Europe,5,2,2,3,3,5,0,Human Factor
1977-07-20 00:00:00,Ethiopian Airlines,Landing (descent or approach),Commercial,Ethiopia,Africa,5,3,3,2,2,5,0,Human Factor
1977-07-31 00:00:00,NSD Corporation,Landing (descent or approach),Business,United States of America,North America,5,1,1,4,4,5,0,Human Factor
1977-09-05 00:00:00,Transportes Aéreos de Nayarit,Takeoff (climb),Commercial,Mexico,Central America,5,1,1,4,4,5,0,Unknown
1977-09-08 00:00:00,Champion Home Builders,Takeoff (climb),Business,United States of America,North America,5,2,2,3,3,5,0,Technical Failure
1977-10-05 00:00:00,Garrett AiResearch,Takeoff (climb),Operational,United States of America,North America,5,1,1,4,4,5,0,Human Factor
1977-11-05 00:00:00,Indian Air Force - Bharatiya Vayu Sena,Landing (descent or approach),Military / Government,India,Asia,20,11,5,9,0,5,15,Unknown
1977-11-19 00:00:00,Ethiopian Airlines,Takeoff (climb),Operational,Italy,Europe,5,3,3,2,2,5,0,Human Factor
1977-12-19 00:00:00,Vieques Air Link,Landing (descent or approach),Commercial,Puerto Rico,Central America,10,1,0,9,5,5,5,Technical Failure
1978-01-03 00:00:00,Fred Philp,Landing (descent or approach),Business,United States of America,North America,5,1,1,4,4,5,0,Human Factor
1978-01-10 00:00:00,Mississippi Charter,Landing (descent or approach),Business,United States of America,North America,5,2,2,3,3,5,0,Human Factor
1978-01-14 00:00:00,United States Navy - USN,Flight,Military / Government,United States of America,North America,5,5,5,0,0,5,0,Unknown
1978-01-20 00:00:00,United States Army,Landing (descent or approach),Military / Government,Turkey,Asia,5,2,2,3,3,5,0,Human Factor
1978-02-12 00:00:00,New World Aviation Corporation,Takeoff (climb),Business,Colombia,South America,5,2,2,3,3,5,0,Unknown
1978-02-21 00:00:00,SATENA - Servicio de Aeronavegacion a Territorios Nacionales,Flight,Military / Government,Colombia,South America,5,5,5,0,0,5,0,Unknown
1978-02-28 00:00:00,Private American,Flight,Business,World,World,5,2,2,3,3,5,0,Unknown
1978-03-31 00:00:00,University of Tennessee,Takeoff (climb),Business,United States of America,North America,5,1,1,4,4,5,0,Human Factor
1978-04-03 00:00:00,Phoenix Aviation - USA,Landing (descent or approach),Commercial,Bahamas,Central America,5,1,1,4,4,5,0,Unknown
1978-06-16 00:00:00,Compañía Minera Autlán,Landing (descent or approach),Business,Mexico,Central America,6,2,2,4,3,5,1,Technical Failure
1978-06-22 00:00:00,Uwe M. Buehl,Takeoff (climb),Business,United States of America,North America,5,1,1,4,4,5,0,Technical Failure
1978-07-13 00:00:00,Coast Air,Flight,Operational,United States of America,North America,5,2,2,3,3,5,0,Human Factor
1978-07-24 00:00:00,Amphibians Air Charters,Flight,Commercial,Kenya,Africa,11,1,0,10,5,5,6,Human Factor
1978-10-03 00:00:00,Leisure Lodges,Takeoff (climb),Business,United States of America,North America,5,3,3,2,2,5,0,Technical Failure
1978-10-19 00:00:00,United States Air Force - USAF,Takeoff (climb),Operational,United States of America,North America,6,6,5,0,0,5,1,Unknown
1978-10-26 00:00:00,United States Navy - USN,Flight,Military / Government,World,World,15,4,0,11,5,5,10,Technical Failure
1978-11-06 00:00:00,Royal Thai Air Force - Kong Thap Akat Thai,Takeoff (climb),Military / Government,Thailand,Asia,5,3,3,2,2,5,0,Unknown
1978-11-17 00:00:00,Romanian Air Force - Fortele Aeriene Române,Landing (descent or approach),Military / Government,Romania,Europe,5,5,5,0,0,5,0,Weather
1978-11-25 00:00:00,Tyee Airlines,Flight,Commercial,United States of America,North America,5,1,1,4,4,5,0,Human Factor
1978-12-04 00:00:00,Inlet Marine,Landing (descent or approach),Business,United States of America,North America,7,2,2,5,3,5,2,Human Factor
1978-12-10 00:00:00,United States Air Force - USAF,Landing (descent or approach),Military / Government,United States of America,North America,5,5,5,0,0,5,0,Technical Failure
1978-12-19 00:00:00,David Brumfield,Takeoff (climb),Business,United States of America,North America,6,1,1,5,4,5,1,Human Factor
1978-12-19 00:00:00,Aeroflot - Russian International Airlines,Takeoff (climb),Operational,Uzbekistan,Asia,5,5,5,0,0,5,0,Human Factor
1979-01-09 00:00:00,AABC Investors,Takeoff (climb),Business,United States of America,North America,5,1,1,4,4,5,0,Human Factor
1979-01-28 00:00:00,Air Rouergue,Landing (descent or approach),Specialised Services,France,Europe,6,2,2,4,3,5,1,Human Factor
1979-01-31 00:00:00,United States Army,Flight,Military / Government,Iran,Asia,7,2,2,5,3,5,2,Unknown
1979-02-14 00:00:00,Southern Copper,Flight,Business,Peru,South America,5,1,1,4,4,5,0,Unknown
1979-02-19 00:00:00,Ethiopian Airlines,Flight,Operational,Eritrea,Africa,5,3,3,2,2,5,0,Terrorism
1979-03-13 00:00:00,Brazilian Air Force - Força Aérea Brasileira,Landing (descent or approach),Military / Government,Brazil,South America,6,6,5,0,0,5,1,Unknown
1979-06-19 00:00:00,Imperial Iranian Air Force,Flight,Operational,Iran,Asia,5,5,5,0,0,5,0,Unknown
1979-06-27 00:00:00,United States Navy - USN,Landing (descent or approach),Military / Government,Philippines,Asia,15,4,0,11,5,5,10,Technical Failure
1979-08-04 00:00:00,Aircraft Line Maintenance,Flight,Operational,Argentina,South America,5,5,5,0,0,5,0,Unknown
1979-08-11 00:00:00,Bahri Aviation,Flight,Operational,Egypt,Africa,5,2,2,3,3,5,0,Unknown
1979-09-19 00:00:00,United States Air Force - USAF,Landing (descent or approach),Operational,United States of America,North America,7,7,5,0,0,5,2,Unknown
1979-10-31 00:00:00,Mexican Air Force - Fuerza Aérea Mexicana,Flight,Operational,Mexico,Central America,5,5,5,0,0,5,0,Unknown
1979-11-01 00:00:00,CFW Construction Company,Landing (descent or approach),Business,United States of America,North America,5,2,2,3,3,5,0,Human Factor
1979-11-02 00:00:00,Bankair,Takeoff (climb),Commercial,United States of America,North America,7,1,1,6,4,5,2,Technical Failure
1979-12-26 00:00:00,Design for Living,Takeoff (climb),Business,United States of America,North America,5,1,1,4,4,5,0,Human Factor
1980-01-18 00:00:00,Royal Thai Air Force - Kong Thap Akat Thai,Flight,Operational,Thailand,Asia,5,5,5,0,0,5,0,Unknown
1980-02-06 00:00:00,Gabonese Government,Landing (descent or approach),Military / Government,Cameroon,Africa,5,2,2,3,3,5,0,Human Factor
1980-02-15 00:00:00,Roberts Construction,Takeoff (climb),Business,United States of America,North America,7,1,1,6,4,5,2,Human Factor
1980-03-14 00:00:00,414 Associates,Flight,Business,United States of America,North America,5,1,1,4,4,5,0,Technical Failure
1980-03-31 00:00:00,Falcon Air,Flight,Commercial,India,Asia,5,2,2,3,3,5,0,Unknown
1980-04-24 00:00:00,United States Air Force - USAF,Landing (descent or approach),Military / Government,Iran,Asia,5,5,5,0,0,5,0,Unknown
1980-07-25 00:00:00,Aeroflot - Russian International Airlines,Flight,Military / Government,Russia,Asia,5,2,2,3,3,5,0,Human Factor
1980-08-30 00:00:00,Aeroflot - Russian International Airlines,Flight,Commercial,Russia,Asia,5,2,2,3,3,5,0,Human Factor
1980-09-14 00:00:00,Private Argentinian,Landing (descent or approach),Commercial,Argentina,South America,5,2,2,3,3,5,0,Unknown
1980-10-16 00:00:00,United States Air Force - USAF,Takeoff (climb),Military / Government,United States of America,North America,5,5,5,0,0,5,0,Unknown
1980-12-06 00:00:00,Solitaire,Landing (descent or approach),Business,United States of America,North America,5,1,1,4,4,5,0,Human Factor
1980-12-12 00:00:00,Soviet Air Force - Voyenno-vozdushnye sily CCCP,Flight,Military / Government,Angola,Africa,5,5,5,0,0,5,0,Terrorism
1980-12-15 00:00:00,Cuban Air Force - Fuerzas Armadas Revolucionaras,Flight,Military / Government,Cuba,Central America,5,2,2,3,3,5,0,Other
1980-12-29 00:00:00,Southern City Aviation,Flight,Business,United States of America,North America,5,1,1,4,4,5,0,Technical Failure
1981-01-21 00:00:00,Georgia Pacific Corporation,Landing (descent or approach),Business,United States of America,North America,5,2,2,3,3,5,0,Human Factor
1981-02-03 00:00:00,George P. Tsiotis,Landing (descent or approach),Business,United States of America,North America,5,1,1,4,4,5,0,Human Factor
1981-02-21 00:00:00,WDL Aviation,Flight,Commercial,France,Europe,5,2,2,3,3,5,0,Unknown
1981-06-04 00:00:00,Immobiliara Uracoa,Takeoff (climb),Business,Venezuela,South America,5,2,2,3,3,5,0,Human Factor
1981-06-04 00:00:00,Private Venezuelan,Landing (descent or approach),Business,Venezuela,South America,5,2,2,3,3,5,0,Human Factor
1981-06-23 00:00:00,Wilbur's Flight Operations,Flight,Commercial,United States of America,North America,5,1,1,4,4,5,0,Human Factor
1981-06-30 00:00:00,G %26 W Aviation,Takeoff (climb),Commercial,United States of America,North America,5,1,1,4,4,5,0,Technical Failure
1981-07-31 00:00:00,Linea Aérea de Transporte Interior Sud Americano - LATISA,Takeoff (climb),Operational,Chile,South America,5,4,4,1,1,5,0,Technical Failure
1981-08-10 00:00:00,Japan Air Self-Defense Force - Kōkū Jieitai,Flight,Operational,Japan,Asia,6,6,5,0,0,5,1,Technical Failure
1981-08-14 00:00:00,Sugar Mountain Aviation,Flight,Business,United States of America,North America,5,1,1,4,4,5,0,Human Factor
1981-09-02 00:00:00,Brigadier Industries,Flight,Business,United States of America,North America,5,1,1,4,4,5,0,Weather
1981-09-06 00:00:00,Brandon Aviation,Flight,Business,United States of America,North America,5,1,1,4,4,5,0,Weather
1981-09-16 00:00:00,Ramaniko Trust,Landing (descent or approach),Business,South Africa,Africa,5,1,1,4,4,5,0,Technical Failure
1981-10-03 00:00:00,Aero Club Cortijo Grande Turre-Almeria,Flight,Business,United Kingdom,Europe,5,1,1,4,4,5,0,Technical Failure
1981-10-12 00:00:00,Royal Moroccan Air Force - Forces Royales Air,Flight,Military / Government,Western Sahara,Africa,5,5,5,0,0,5,0,Terrorism
1981-12-09 00:00:00,Turkish Air Force - Türk Hava Kuvvetleri,Flight,Military / Government,Turkey,Asia,5,5,5,0,0,5,0,Unknown
1982-03-18 00:00:00,Air Security Transport,Flight,Military / Government,United States of America,North America,7,1,1,6,4,5,2,Weather
1982-04-18 00:00:00,Chester Air,Landing (descent or approach),Operational,United States of America,North America,5,2,2,3,3,5,0,Human Factor
1982-05-07 00:00:00,Aeroflot - Russian International Airlines,Flight,Commercial,Russia,Asia,5,3,3,2,2,5,0,Human Factor
1982-05-12 00:00:00,Soviet Air Force - Voyenno-vozdushnye sily CCCP,Landing (descent or approach),Operational,Russia,Asia,5,5,5,0,0,5,0,Human Factor
1982-06-07 00:00:00,Argentinian Air Force - Fuerza Aérea Argentina,Flight,Military / Government,Falkland Islands,South America,5,5,5,0,0,5,0,Terrorism
1982-07-14 00:00:00,Bon Air,Landing (descent or approach),Commercial,South Africa,Africa,5,1,1,4,4,5,0,Human Factor
1982-08-22 00:00:00,Aero Club d'Italia,Flight,Business,Italy,Europe,5,1,1,4,4,5,0,Unknown
1982-09-14 00:00:00,Bolivian Air Force - Fuerza Aérea Boliviana,Flight,Military / Government,Bolivia,South America,5,2,2,3,3,5,0,Unknown
1982-09-18 00:00:00,Central Mountain Air Services,Flight,Commercial,Canada,North America,5,1,1,4,4,5,0,Human Factor
1982-10-16 00:00:00,Colombian Air Force - Fuerza Aérea Colombiana,Flight,Military / Government,World,World,13,4,2,9,3,5,8,Technical Failure
1983-01-03 00:00:00,Key Airlines,Flight,Commercial,United States of America,North America,5,1,1,4,4,5,0,Weather
1983-01-11 00:00:00,Sun Oil Company,Landing (descent or approach),Business,Canada,North America,5,2,2,3,3,5,0,Technical Failure
1983-02-15 00:00:00,Soviet Air Force - Voyenno-vozdushnye sily CCCP,Landing (descent or approach),Military / Government,Afghanistan,Asia,5,5,5,0,0,5,0,Terrorism
1983-02-17 00:00:00,Marden G. Dixon,Takeoff (climb),Business,United States of America,North America,5,1,1,4,4,5,0,Human Factor
1983-03-14 00:00:00,Jamahiriya Air Transport,Takeoff (climb),Operational,Libya,Africa,5,5,5,0,0,5,0,Technical Failure
1983-03-18 00:00:00,Peruvian Air Force - Fuerza Aérea del Perú,Landing (descent or approach),Military / Government,Peru,South America,5,5,5,0,0,5,0,Unknown
1983-06-06 00:00:00,Fort Frances Sportsmen Airways,Takeoff (climb),Commercial,Canada,North America,5,1,1,4,4,5,0,Unknown
1983-06-08 00:00:00,Frigorifico Reyes,Landing (descent or approach),Operational,Bolivia,South America,5,3,3,2,2,5,0,Technical Failure
1983-07-02 00:00:00,Soviet Air Force - Voyenno-vozdushnye sily CCCP,Takeoff (climb),Military / Government,Afghanistan,Asia,5,5,5,0,0,5,0,Terrorism
1983-07-04 00:00:00,Labrador Air Safari,Flight,Commercial,Canada,North America,5,1,1,4,4,5,0,Unknown
1983-08-09 00:00:00,Royal Thai Air Force - Kong Thap Akat Thai,Takeoff (climb),Military / Government,Thailand,Asia,5,5,5,0,0,5,0,Unknown
1984-01-07 00:00:00,Sandinist Air Force - Fuerza Aérea Sandinista,Flight,Military / Government,Nicaragua,Central America,5,5,5,0,0,5,0,Technical Failure
1984-02-24 00:00:00,Bessone Café,Landing (descent or approach),Business,Argentina,South America,5,1,1,4,4,5,0,Unknown
1984-03-21 00:00:00,Kar-San Development,Landing (descent or approach),Business,United States of America,North America,5,1,1,4,4,5,0,Human Factor
1984-03-24 00:00:00,Frigorifico Reyes,Takeoff (climb),Operational,Bolivia,South America,5,3,3,2,2,5,0,Technical Failure
1984-03-26 00:00:00,Hans Georg Nickel,Flight,Business,Italy,Europe,5,1,1,4,4,5,0,Weather
1984-07-03 00:00:00,Peruvian Air Force - Fuerza Aérea del Perú,Flight,Military / Government,Peru,South America,5,5,5,0,0,5,0,Human Factor
1984-07-17 00:00:00,Aeroflot - Russian International Airlines,Takeoff (climb),Military / Government,Russia,Asia,7,2,1,5,4,5,2,Human Factor
1984-07-25 00:00:00,Alaska Air Service,Flight,Commercial,United States of America,North America,5,1,1,4,4,5,0,Unknown
1985-04-20 00:00:00,United States Air Force - USAF,Landing (descent or approach),Military / Government,United States of America,North America,5,3,3,2,2,5,0,Unknown
1985-04-22 00:00:00,Sécurité civile française,Landing (descent or approach),Commercial,France,Europe,5,3,3,2,2,5,0,Human Factor
1985-05-15 00:00:00,TTA - Sociedade de Transportes e Trabalhos Aéreos,Flight,Commercial,Mozambique,Africa,5,1,1,4,4,5,0,Technical Failure
1985-08-23 00:00:00,Hubert Van Pittman,Flight,Business,United States of America,North America,5,1,1,4,4,5,0,Human Factor
1985-08-31 00:00:00,Sunair,Landing (descent or approach),Humanitarian,South Africa,Africa,5,1,1,4,4,5,0,Unknown
1985-10-23 00:00:00,Transportes Aéreos Tropicales - TAT Colombia,Takeoff (climb),Commercial,Colombia,South America,5,1,1,4,4,5,0,Technical Failure
1985-11-11 00:00:00,Hy Flight Associates,Landing (descent or approach),Business,United States of America,North America,5,1,1,4,4,5,0,Human Factor
1985-12-14 00:00:00,Commander Charter,Landing (descent or approach),Business,United States of America,North America,5,1,1,4,4,5,0,Human Factor
1986-01-11 00:00:00,Jayhawk Aircraft Sales,Landing (descent or approach),Business,United States of America,North America,6,1,1,5,4,5,1,Human Factor
1986-01-23 00:00:00,Indonesian Navy - TNI-AL Tentara Nasional Indonesia - Angkatan Laut,Landing (descent or approach),Military / Government,Indonesia,Asia,8,8,5,0,0,5,3,Unknown
1986-03-05 00:00:00,Air Hi Ho,Flight,Business,United States of America,North America,5,2,2,3,3,5,0,Human Factor
1986-04-14 00:00:00,Hy Plains Dressed Beef,Takeoff (climb),Business,United States of America,North America,5,1,1,4,4,5,0,Human Factor
1986-05-17 00:00:00,Aeroflot - Russian International Airlines,Flight,Specialised Services,Russia,Asia,5,5,5,0,0,5,0,Human Factor
1986-07-29 00:00:00,Dansk Totalenterprise,Flight,Business,Denmark,Europe,5,1,1,4,4,5,0,Weather
1986-09-17 00:00:00,Turkish Navy - Türk Deniz Kuvvetleri,Flight,Military / Government,Turkey,Asia,5,5,5,0,0,5,0,Unknown
1986-09-19 00:00:00,Atlantic Southeast Airlines - ASA,Flight,Operational,Brazil,South America,5,2,2,3,3,5,0,Human Factor
1986-09-25 00:00:00,Andrew H. Christensen,Flight,Business,United States of America,North America,5,1,1,4,4,5,0,Human Factor
1986-09-27 00:00:00,Taku Air,Landing (descent or approach),Commercial,Canada,North America,6,1,0,5,5,5,1,Human Factor
1986-11-12 00:00:00,Arctic Trading Company,Takeoff (climb),Commercial,Canada,North America,5,1,1,4,4,5,0,Unknown
1987-01-09 00:00:00,Iraqi Air Force - Al Quwwat al Jawwiya al Iraqiya,Flight,Military / Government,Iran,Asia,6,6,5,0,0,5,1,Terrorism
1987-02-02 00:00:00,Gold-Air,Landing (descent or approach),Commercial,Australia,Oceania,8,1,1,7,4,5,3,Human Factor
1987-02-17 00:00:00,Japan Coast Guard,Takeoff (climb),Military / Government,Japan,Asia,5,2,2,3,3,5,0,Human Factor
1987-04-08 00:00:00,Southern Air Transport,Landing (descent or approach),Operational,United States of America,North America,5,5,5,0,0,5,0,Human Factor
1987-05-13 00:00:00,Sudanese Air Force - Al Quwwat al-Jawwiya As-Sudaniya,Landing (descent or approach),Military / Government,South Sudan,Africa,5,5,5,0,0,5,0,Terrorism
1987-06-14 00:00:00,Private Venezuelan,Takeoff (climb),Business,Venezuela,South America,5,1,1,4,4,5,0,Unknown
1987-06-15 00:00:00,Afghan Republican Air Force - Afghan Hanai Qurah,Flight,Military / Government,Afghanistan,Asia,5,5,5,0,0,5,0,Terrorism
1987-09-20 00:00:00,Air North - Canada,Flight,Commercial,United States of America,North America,5,1,1,4,4,5,0,Human Factor
1987-09-21 00:00:00,Egyptair,Landing (descent or approach),Operational,Egypt,Africa,5,5,5,0,0,5,0,Human Factor
1987-10-07 00:00:00,Blackwing Aviation,Takeoff (climb),Business,United States of America,North America,5,1,1,4,4,5,0,Human Factor
1988-03-30 00:00:00,Tanzania Game Tracker Safaris,Takeoff (climb),Commercial,Tanzania,Africa,5,1,1,4,4,5,0,Human Factor
1988-04-03 00:00:00,Tanner Construction,Flight,Business,United States of America,North America,5,1,1,4,4,5,0,Human Factor
1988-04-04 00:00:00,Private American,Landing (descent or approach),Business,Bahamas,Central America,5,1,1,4,4,5,0,Unknown
1988-06-24 00:00:00,Soviet Air Force - Voyenno-vozdushnye sily CCCP,Takeoff (climb),Military / Government,Afghanistan,Asia,6,6,5,0,0,5,1,Terrorism
1988-07-08 00:00:00,Brazilian Air Force - Força Aérea Brasileira,Flight,Operational,Brazil,South America,9,2,0,7,5,5,4,Unknown
1988-08-23 00:00:00,Kinair Cargo,Landing (descent or approach),Operational,Congo,Africa,5,3,3,2,2,5,0,Unknown
1988-09-27 00:00:00,MAP - Ministerstvo Aviatsionnoi Promyshlennosti - Minaviaprom,Flight,Operational,Russia,Asia,5,5,5,0,0,5,0,Technical Failure
1988-12-08 00:00:00,T %26 G Aviation,Flight,Operational,Mauritania,Africa,5,5,5,0,0,5,0,Terrorism
1988-12-10 00:00:00,Private German,Landing (descent or approach),Business,Germany,Europe,5,1,1,4,4,5,0,Unknown
1989-01-17 00:00:00,Aerolineas La Paz,Flight,Operational,Bolivia,South America,5,3,3,2,2,5,0,Unknown
1989-02-09 00:00:00,TAROM - Transporturile Aeriene Române,Takeoff (climb),Operational,Romania,Europe,5,5,5,0,0,5,0,Human Factor
1989-03-10 00:00:00,Angola Air Force - Força Aérea Nacional Angolana,Flight,Military / Government,Angola,Africa,5,5,5,0,0,5,0,Terrorism
1989-03-11 00:00:00,RTS Service,Takeoff (climb),Business,United States of America,North America,5,1,1,4,4,5,0,Human Factor
1989-03-31 00:00:00,Richardson's Jewellery,Takeoff (climb),Business,United States of America,North America,5,1,1,4,4,5,0,Technical Failure
1989-04-26 00:00:00,Aerosucre Colombia,Takeoff (climb),Operational,Colombia,South America,5,3,3,2,2,5,0,Other
1989-05-01 00:00:00,Aeroflot - Russian International Airlines,Flight,Operational,Russia,Asia,5,2,2,3,3,5,0,Human Factor
1989-05-21 00:00:00,Peruvian Air Force - Fuerza Aérea del Perú,Flight,Military / Government,Peru,South America,5,2,2,3,3,5,0,Unknown
1989-08-28 00:00:00,Bay Land Aviation,Landing (descent or approach),Commercial,United States of America,North America,5,2,2,3,3,5,0,Human Factor
1989-09-22 00:00:00,Aklak Air,Landing (descent or approach),Commercial,Canada,North America,5,1,1,4,4,5,0,Weather
1989-10-06 00:00:00,Westchester Air,Takeoff (climb),Business,United States of America,North America,5,2,2,3,3,5,0,Human Factor
1989-10-14 00:00:00,Royal Saudi Air Force,Landing (descent or approach),Military / Government,Saudi Arabia,Asia,5,2,2,3,3,5,0,Technical Failure
1989-10-20 00:00:00,Tapu ve Kadastro Genel Müdürlügü,Flight,Specialised Services,Turkey,Asia,5,1,1,4,4,5,0,Terrorism
1989-11-27 00:00:00,Tepper Aviation,Landing (descent or approach),Operational,Angola,Africa,5,5,5,0,0,5,0,Human Factor
1989-12-01 00:00:00,United States Army,Landing (descent or approach),Military / Government,United States of America,North America,5,5,5,0,0,5,0,Human Factor
1989-12-06 00:00:00,Mexican Air Force - Fuerza Aérea Mexicana,Flight,Military / Government,Mexico,Central America,5,5,5,0,0,5,0,Unknown
1990-02-14 00:00:00,Williams Aviation,Flight,Business,United States of America,North America,5,1,1,4,4,5,0,Weather
1990-03-23 00:00:00,Luis F. Benítez,Flight,Business,Colombia,South America,5,1,1,4,4,5,0,Unknown
1990-04-12 00:00:00,Wideroe - Wideroe's Flyveselskap,Takeoff (climb),Commercial,Norway,Europe,5,2,2,3,3,5,0,Weather
1990-05-21 00:00:00,Carlos A. Pascolain,Landing (descent or approach),Business,Brazil,South America,5,1,1,4,4,5,0,Human Factor
1990-06-25 00:00:00,Trail Lake Flying Service,Flight,Commercial,United States of America,North America,5,1,1,4,4,5,0,Human Factor
1990-07-15 00:00:00,Indian Air Force - Bharatiya Vayu Sena,Landing (descent or approach),Military / Government,India,Asia,5,5,5,0,0,5,0,Unknown
1990-07-26 00:00:00,Private Australian,Takeoff (climb),Business,Australia,Oceania,6,1,1,5,4,5,1,Human Factor
1990-11-08 00:00:00,G. T. Contractors,Landing (descent or approach),Business,United States of America,North America,5,1,1,4,4,5,0,Human Factor
1990-11-30 00:00:00,Aero Air - USA,Landing (descent or approach),Business,United States of America,North America,6,1,1,5,4,5,1,Human Factor
1990-12-04 00:00:00,Salvadorian Air Force - Fuerza Aérea Salvadoreña,Flight,Military / Government,Salvador,Central America,5,5,5,0,0,5,0,Terrorism
1991-01-11 00:00:00,Belair Táxi Aéreo,Landing (descent or approach),Business,Brazil,South America,5,2,2,3,3,5,0,Weather
1991-02-28 00:00:00,Japan Air Self-Defense Force - Kōkū Jieitai,Flight,Military / Government,Japan,Asia,5,5,5,0,0,5,0,Human Factor
1991-03-06 00:00:00,Spanish Air Force - Ejército del Aire,Flight,Operational,Spain,Europe,5,5,5,0,0,5,0,Unknown
1991-03-18 00:00:00,Aero Coach Aviation International,Landing (descent or approach),Commercial,Bahamas,Central America,5,1,1,4,4,5,0,Unknown
1991-03-29 00:00:00,George Mehl,Landing (descent or approach),Business,United States of America,North America,5,1,1,4,4,5,0,Human Factor
1991-07-10 00:00:00,PTP IV,Flight,Business,Indonesia,Asia,5,1,1,4,4,5,0,Human Factor
1991-10-29 00:00:00,Royal Australian Air Force - RAAF,Flight,Operational,Australia,Oceania,5,5,5,0,0,5,0,Human Factor
1991-10-30 00:00:00,Royal Canadian Air Force - RCAF,Landing (descent or approach),Operational,Canada,North America,18,5,2,13,3,5,13,Human Factor
1991-11-12 00:00:00,Chenoweth Construction Company,Landing (descent or approach),Business,United States of America,North America,5,1,1,4,4,5,0,Human Factor
1991-12-10 00:00:00,Las Vegas Airlines,Flight,Commercial,United States of America,North America,5,1,1,4,4,5,0,Human Factor
1991-12-29 00:00:00,China Airlines,Flight,Operational,Taiwan,Asia,5,5,5,0,0,5,0,Technical Failure
1992-01-06 00:00:00,Tranaca,Landing (descent or approach),Commercial,Venezuela,South America,6,1,1,5,4,5,1,Technical Failure
1992-01-13 00:00:00,J. Meade Williamson,Flight,Business,United States of America,North America,5,1,1,4,4,5,0,Weather
1992-01-25 00:00:00,Air Boniats,Landing (descent or approach),Commercial,Germany,Europe,5,1,1,4,4,5,0,Human Factor
1992-01-26 00:00:00,Croatian Air Force - Hrvatske Zračne Snage,Flight,Military / Government,Croatia,Europe,6,2,2,4,3,5,1,Human Factor
1992-02-06 00:00:00,United States Air Force - USAF,Landing (descent or approach),Operational,United States of America,North America,5,5,5,0,0,5,0,Human Factor
1992-03-02 00:00:00,Frigorifico Santa Rita,Takeoff (climb),Operational,Bolivia,South America,5,3,3,2,2,5,0,Technical Failure
1992-05-03 00:00:00,Jeffrey H. Roth,Flight,Business,United States of America,North America,5,1,1,4,4,5,0,Unknown
1992-06-07 00:00:00,American Eagle,Landing (descent or approach),Commercial,Puerto Rico,Central America,5,2,2,3,3,5,0,Human Factor
1992-07-31 00:00:00,United States Navy - USN,Flight,Operational,World,World,5,5,5,0,0,5,0,Unknown
1992-08-16 00:00:00,Copenhagen Airtaxi,Landing (descent or approach),Commercial,Sweden,Europe,8,1,1,7,4,5,3,Technical Failure
1992-09-11 00:00:00,Solar Sources,Takeoff (climb),Business,United States of America,North America,5,1,1,4,4,5,0,Human Factor
1992-10-23 00:00:00,Brazilian Air Force - Força Aérea Brasileira,Landing (descent or approach),Operational,Brazil,South America,5,2,2,3,3,5,0,Unknown
1992-12-19 00:00:00,William J. Edwards,Takeoff (climb),Business,United States of America,North America,5,1,1,4,4,5,0,Human Factor
1993-02-17 00:00:00,Turkish Air Force - Türk Hava Kuvvetleri,Takeoff (climb),Military / Government,Turkey,Asia,5,2,2,3,3,5,0,Technical Failure
1993-02-21 00:00:00,Private German,Flight,Business,Switzerland,Europe,5,1,1,4,4,5,0,Human Factor
1993-03-25 00:00:00,United States Navy - USN,Flight,Military / Government,World,World,5,5,5,0,0,5,0,Unknown
1993-07-04 00:00:00,Sawyer Aviation,Landing (descent or approach),Business,United States of America,North America,5,2,2,3,3,5,0,Human Factor
1993-07-12 00:00:00,Wilderness Airlines,Takeoff (climb),Commercial,Canada,North America,5,1,1,4,4,5,0,Weather
1993-07-22 00:00:00,Royal Canadian Air Force - RCAF,Landing (descent or approach),Operational,Canada,North America,9,9,5,0,0,5,4,Unknown
1993-07-26 00:00:00,Waglisla Air - Wagair,Landing (descent or approach),Commercial,Canada,North America,5,1,1,4,4,5,0,Human Factor
1993-07-28 00:00:00,Aero Golfe,Takeoff (climb),Commercial,Canada,North America,6,1,1,5,4,5,1,Technical Failure
1993-09-30 00:00:00,Aermar,Landing (descent or approach),Commercial,Italy,Europe,5,1,1,4,4,5,0,Human Factor
1993-10-27 00:00:00,Greenbelt Wood Product Company,Flight,Business,Philippines,Asia,5,1,1,4,4,5,0,Technical Failure
1993-11-06 00:00:00,Roadrunner Airlines,Landing (descent or approach),Business,United States of America,North America,5,1,1,4,4,5,0,Weather
1993-12-15 00:00:00,Martin Aviation,Landing (descent or approach),Commercial,United States of America,North America,5,2,2,3,3,5,0,Human Factor
1994-01-07 00:00:00,United Express,Landing (descent or approach),Commercial,United States of America,North America,8,3,3,5,2,5,3,Human Factor
1994-01-24 00:00:00,Aerowest Flugcenter,Landing (descent or approach),Commercial,Switzerland,Europe,5,1,1,4,4,5,0,Unknown
1994-05-27 00:00:00,Air Oceania Tahiti,Landing (descent or approach),Humanitarian,French Polynesia,Oceania,5,1,1,4,4,5,0,Human Factor
1994-07-06 00:00:00,Heliservicio,Flight,Humanitarian,Spain,Europe,6,4,3,2,2,5,1,Human Factor
1994-07-17 00:00:00,Impulse-Aero,Landing (descent or approach),Commercial,Democratic Republic of Congo,Africa,9,5,2,4,3,5,4,Human Factor
1994-08-27 00:00:00,Drug Enforcement Administration - DEA,Flight,Military / Government,Peru,South America,5,2,2,3,3,5,0,Weather
1994-09-18 00:00:00,Oriental Airlines,Landing (descent or approach),Commercial,Algeria,Africa,39,7,3,32,2,5,34,Human Factor
1994-11-05 00:00:00,Private South African,Flight,Business,South Africa,Africa,5,1,1,4,4,5,0,Unknown
1994-12-06 00:00:00,Transworld Safaris,Flight,Commercial,Kenya,Africa,5,2,2,3,3,5,0,Human Factor
1994-12-10 00:00:00,Ryan Air,Landing (descent or approach),Commercial,United States of America,North America,5,1,1,4,4,5,0,Human Factor
1994-12-21 00:00:00,Air Algérie,Landing (descent or approach),Operational,United Kingdom,Europe,5,3,3,2,2,5,0,Human Factor
1995-01-11 00:00:00,Canada Jet Charters,Landing (descent or approach),Humanitarian,Canada,North America,5,2,2,3,3,5,0,Human Factor
1995-03-20 00:00:00,Richert,Landing (descent or approach),Business,Germany,Europe,5,1,1,4,4,5,0,Human Factor
1995-05-01 00:00:00,Air Sandy,Takeoff (climb),Commercial,Canada,North America,5,1,1,4,4,5,0,Human Factor
1995-05-25 00:00:00,LACOL Colombia - Lineas Aéreas Colombianas,Landing (descent or approach),Operational,Colombia,South America,13,4,2,9,3,5,8,Technical Failure
1995-06-18 00:00:00,White River Air,Takeoff (climb),Commercial,Canada,North America,5,1,1,4,4,5,0,Unknown
1995-09-13 00:00:00,Bimini Air Charter,Landing (descent or approach),Commercial,Bahamas,Central America,9,1,1,8,4,5,4,Human Factor
1995-09-28 00:00:00,American Airpower Heritage Museum,Flight,Business,United States of America,North America,5,2,2,3,3,5,0,Human Factor
1995-10-21 00:00:00,BalmOral Air,Flight,Humanitarian,Angola,Africa,5,2,2,3,3,5,0,Weather
1995-10-24 00:00:00,Pedro Gastón Roberto Rozo Gómez,Takeoff (climb),Business,Colombia,South America,5,2,2,3,3,5,0,Human Factor
1995-11-18 00:00:00,Sri Lanka Air Force,Landing (descent or approach),Military / Government,Sri Lanka,Asia,6,6,5,0,0,5,1,Terrorism
1995-11-28 00:00:00,John C. Hessel,Flight,Business,Canada,North America,5,1,1,4,4,5,0,Human Factor
1996-01-15 00:00:00,Servicios Aéreos AQP,Landing (descent or approach),Commercial,Peru,South America,5,2,2,3,3,5,0,Human Factor
1996-01-29 00:00:00,Soundsair,Landing (descent or approach),Commercial,New Zealand,Oceania,6,1,0,5,5,5,1,Human Factor
1996-02-15 00:00:00,J. Schwarz,Takeoff (climb),Business,Zambia,Africa,5,1,1,4,4,5,0,Unknown
1996-05-29 00:00:00,Mid-South Engineering Company,Takeoff (climb),Specialised Services,United States of America,North America,5,1,1,4,4,5,0,Human Factor
1996-07-17 00:00:00,Tanzania Peoples Defence Forces,Takeoff (climb),Military / Government,Kenya,Africa,5,5,5,0,0,5,0,Unknown
1996-09-18 00:00:00,Krissalan de Aviacion,Takeoff (climb),Operational,Mexico,Central America,5,2,2,3,3,5,0,Human Factor
1996-10-26 00:00:00,TyumenAviaTrans,Landing (descent or approach),Commercial,Russia,Asia,37,4,3,33,2,5,32,Human Factor
1996-11-17 00:00:00,David S. Ladow,Takeoff (climb),Business,United States of America,North America,5,1,1,4,4,5,0,Human Factor
1997-01-31 00:00:00,Skypower Express Airways,Landing (descent or approach),Commercial,Nigeria,Africa,16,3,3,13,2,5,11,Human Factor
1997-02-19 00:00:00,Inversiones Venezuela,Landing (descent or approach),Commercial,Guatemala,Central America,5,3,3,2,2,5,0,Human Factor
1997-04-10 00:00:00,Hageland Aviation Services,Landing (descent or approach),Commercial,United States of America,North America,5,1,1,4,4,5,0,Human Factor
1997-06-07 00:00:00,Disapel Eletro Domésticos,Landing (descent or approach),Business,Brazil,South America,5,2,2,3,3,5,0,Human Factor
1997-09-02 00:00:00,Philippine Aerospace Development Corporation - PADC,Takeoff (climb),Operational,Philippines,Asia,5,5,5,0,0,5,0,Unknown
1997-11-12 00:00:00,Swiss Air Force,Flight,Military / Government,Switzerland,Europe,5,1,1,4,4,5,0,Human Factor
1997-12-20 00:00:00,Hellenic Air Force - Elleniki Polemiki Aeroporia,Flight,Operational,Greece,Europe,5,5,5,0,0,5,0,Human Factor
1998-02-03 00:00:00,Precision Air Services - Precisionair,Takeoff (climb),Commercial,Tanzania,Africa,5,1,1,4,4,5,0,Technical Failure
1998-02-05 00:00:00,Spanish Air Force - Ejército del Aire,Flight,Operational,Spain,Europe,5,5,5,0,0,5,0,Unknown
1998-03-02 00:00:00,Aerochaitén,Takeoff (climb),Commercial,Chile,South America,5,1,1,4,4,5,0,Technical Failure
1998-03-23 00:00:00,Mision Nuevas Tribas,Takeoff (climb),Commercial,Venezuela,South America,5,1,1,4,4,5,0,Unknown
1998-08-02 00:00:00,Afghan Taliban Forces,Landing (descent or approach),Military / Government,Afghanistan,Asia,5,5,5,0,0,5,0,Technical Failure
1998-08-04 00:00:00,Harbour Air Seaplanes,Landing (descent or approach),Commercial,Canada,North America,5,1,1,4,4,5,0,Weather
1998-08-19 00:00:00,Vincent Aviation,Takeoff (climb),Commercial,New Zealand,Oceania,10,1,1,9,4,5,5,Human Factor
1998-09-07 00:00:00,Destiny Leasing,Flight,Business,United States of America,North America,5,1,1,4,4,5,0,Weather
1998-09-09 00:00:00,Rust's Flying Service - Rustair,Flight,Commercial,United States of America,North America,5,1,1,4,4,5,0,Human Factor
1998-12-22 00:00:00,Selva Colombia - Servicios Aéreos del Vaupés,Landing (descent or approach),Operational,Colombia,South America,5,3,3,2,2,5,0,Human Factor
1999-01-11 00:00:00,Air Force of Zimbabwe,Landing (descent or approach),Military / Government,Democratic Republic of Congo,Africa,5,5,5,0,0,5,0,Unknown
1999-01-17 00:00:00,Necon Air,Takeoff (climb),Commercial,Nepal,Asia,12,2,1,10,4,5,7,Human Factor
1999-03-18 00:00:00,Mexican Air Force - Fuerza Aérea Mexicana,Flight,Military / Government,Mexico,Central America,5,2,2,3,3,5,0,Unknown
1999-04-07 00:00:00,Manacá Taxi Aéreo,Landing (descent or approach),Operational,Brazil,South America,5,5,5,0,0,5,0,Human Factor
1999-04-08 00:00:00,Aerotaca Colombia - Aerotaxi Casanare,Flight,Commercial,Colombia,South America,5,2,2,3,3,5,0,Human Factor
1999-05-24 00:00:00,Royal Malaysian Air Force - Tentera Udara Diraja Malaysia,Landing (descent or approach),Operational,Malaysia,Asia,5,5,5,0,0,5,0,Technical Failure
1999-07-07 00:00:00,Hinduja Cargo Services,Takeoff (climb),Operational,Nepal,Asia,5,5,5,0,0,5,0,Human Factor
1999-09-17 00:00:00,Mexican Air Force - Fuerza Aérea Mexicana,Flight,Operational,Mexico,Central America,5,5,5,0,0,5,0,Human Factor
1999-10-12 00:00:00,Aerovias Guayana - Aguaysa,Takeoff (climb),Commercial,Venezuela,South America,8,1,1,7,4,5,3,Technical Failure
1999-11-10 00:00:00,Aliansa Colombia - Aerolíneas Andinas,Flight,Operational,Colombia,South America,5,3,3,2,2,5,0,Weather
1999-12-05 00:00:00,Tashkent Aircraft Production Corporation,Takeoff (climb),Operational,Russia,Asia,7,3,2,4,3,5,2,Technical Failure
2000-01-14 00:00:00,TAM Bolivia - Transporte Aéreo Militar Boliviano,Takeoff (climb),Military / Government,Bolivia,South America,31,7,0,24,5,5,26,Unknown
2000-01-15 00:00:00,Taxi Aéreo Centroamericano - TACSA,Takeoff (climb),Commercial,Costa Rica,Central America,18,3,1,15,4,5,13,Human Factor
2000-01-25 00:00:00,Procuraduría General de la República,Takeoff (climb),Military / Government,Mexico,Central America,5,2,2,3,3,5,0,Unknown
2000-06-14 00:00:00,Air Navigation %26 Trading Company,Landing (descent or approach),Humanitarian,United Kingdom,Europe,5,1,1,4,4,5,0,Human Factor
2000-07-29 00:00:00,Aerial Services India,Landing (descent or approach),Humanitarian,India,Asia,5,2,2,3,3,5,0,Human Factor
2000-08-24 00:00:00,Private German,Flight,Business,Switzerland,Europe,5,1,1,4,4,5,0,Human Factor
2000-09-18 00:00:00,Cape Smythe Air Service,Landing (descent or approach),Commercial,United States of America,North America,10,1,1,9,4,5,5,Human Factor
2000-12-23 00:00:00,VideoVision Broadcast,Takeoff (climb),Business,United Kingdom,Europe,5,1,1,4,4,5,0,Human Factor
2001-02-13 00:00:00,Donald R. Robertson,Landing (descent or approach),Business,United States of America,North America,5,1,1,4,4,5,0,Human Factor
2001-05-17 00:00:00,Líneas Aéreas del Estado - LADE,Takeoff (climb),Operational,Argentina,South America,5,5,5,0,0,5,0,Technical Failure
2001-06-03 00:00:00,Falcon Communications,Landing (descent or approach),Business,United States of America,North America,5,1,1,4,4,5,0,Technical Failure
2001-08-13 00:00:00,Wahkash Contracting,Flight,Business,Canada,North America,5,1,1,4,4,5,0,Human Factor
2001-11-21 00:00:00,Commander Northwest,Flight,Business,United States of America,North America,5,1,1,4,4,5,0,Human Factor
2002-01-04 00:00:00,EPPS Air Service,Takeoff (climb),Commercial,United Kingdom,Europe,5,2,2,3,3,5,0,Human Factor
2002-01-05 00:00:00,Alexander Leasing,Flight,Business,Puerto Rico,Central America,5,1,1,4,4,5,0,Human Factor
2002-01-27 00:00:00,Angola Air Force - Força Aérea Nacional Angolana,Landing (descent or approach),Military / Government,Angola,Africa,40,6,2,34,3,5,35,Weather
2002-05-21 00:00:00,Sky Executive Aviation Services,Landing (descent or approach),Operational,Nigeria,Africa,5,5,5,0,0,5,0,Human Factor
2002-08-15 00:00:00,Sri Lanka Air Force,Takeoff (climb),Specialised Services,Sri Lanka,Asia,5,5,5,0,0,5,0,Technical Failure
2002-10-01 00:00:00,Indian Navy - Bharatiya Nau Sena,Flight,Operational,India,Asia,5,5,5,0,0,5,0,Human Factor
2003-02-06 00:00:00,Pablo Valencia Iragorri,Flight,Business,Colombia,South America,5,1,1,4,4,5,0,Human Factor
2003-07-03 00:00:00,Bowl Aviation,Landing (descent or approach),Business,United States of America,North America,5,1,1,4,4,5,0,Human Factor
2003-10-26 00:00:00,CATA Linea Aérea,Landing (descent or approach),Operational,Argentina,South America,5,4,4,1,1,5,0,Technical Failure
2003-10-29 00:00:00,Robert S. Brown,Flight,Business,United States of America,North America,5,1,1,4,4,5,0,Human Factor
2004-03-16 00:00:00,United States Air Force - USAF,Landing (descent or approach),Military / Government,United States of America,North America,5,1,1,4,4,5,0,Human Factor
2004-04-07 00:00:00,Phoenix Kapitaldienst,Landing (descent or approach),Business,Switzerland,Europe,5,1,1,4,4,5,0,Human Factor
2004-05-05 00:00:00,Aerotransporte Petrolero,Landing (descent or approach),Business,Colombia,South America,7,2,2,5,3,5,2,Human Factor
2004-09-20 00:00:00,Harris Aircraft Services,Flight,Commercial,United States of America,North America,5,1,1,4,4,5,0,Unknown
2004-10-24 00:00:00,Med Flight Air Ambulance,Takeoff (climb),Humanitarian,United States of America,North America,5,2,2,3,3,5,0,Human Factor
2004-11-14 00:00:00,Dash Air Charter,Landing (descent or approach),Business,United States of America,North America,5,1,1,4,4,5,0,Human Factor
2004-12-02 00:00:00,Georgia-Cumberland Conference of Seventh-Day Adventists,Takeoff (climb),Business,United States of America,North America,6,1,1,5,4,5,1,Human Factor
2004-12-14 00:00:00,Hercules,Landing (descent or approach),Business,Mexico,Central America,5,2,2,3,3,5,0,Technical Failure
2005-01-18 00:00:00,Aquila Air,Flight,Business,South Africa,Africa,5,1,1,4,4,5,0,Weather
2005-01-21 00:00:00,Riley Rocket,Takeoff (climb),Business,United States of America,North America,5,1,1,4,4,5,0,Human Factor
2005-02-28 00:00:00,MJM Air,Flight,Commercial,Canada,North America,5,1,1,4,4,5,0,Unknown
2005-03-03 00:00:00,Private German,Takeoff (climb),Business,Italy,Europe,5,2,2,3,3,5,0,Human Factor
2005-06-23 00:00:00,Robert J. Landry,Landing (descent or approach),Business,United States of America,North America,5,1,1,4,4,5,0,Human Factor
2006-03-24 00:00:00,ATESA - Aero Taxis Ecuatorianos,Takeoff (climb),Commercial,Ecuador,South America,14,2,0,12,5,5,9,Technical Failure
2006-05-05 00:00:00,Venezuelan National Guard - Guardia Nacional Bolivariana de Venezuela,Flight,Military / Government,Venezuela,South America,5,4,4,1,1,5,0,Human Factor
2006-06-11 00:00:00,Chadian Air Force - Force Aérienne Tchadienne,Landing (descent or approach),Military / Government,Chad,Africa,0,0,0,0,5,5,-5,Unknown
2006-07-02 00:00:00,Himmelsschreiber Azur,Takeoff (climb),Commercial,Germany,Europe,6,1,1,5,4,5,1,Technical Failure
2006-07-16 00:00:00,MediAir Flugdienst-Ambulanzflüge,Takeoff (climb),Business,Italy,Europe,5,1,1,4,4,5,0,Technical Failure
2006-10-18 00:00:00,Flying Moose,Flight,Specialised Services,United States of America,North America,5,1,1,4,4,5,0,Human Factor
2006-11-13 00:00:00,CPRT Investment,Takeoff (climb),Business,United States of America,North America,5,1,1,4,4,5,0,Human Factor
2006-12-22 00:00:00,Island Times,Flight,Business,United States of America,North America,5,1,1,4,4,5,0,Human Factor
2007-06-28 00:00:00,TAAG Angola Airlines - Transportes Aéreos de Angola,Landing (descent or approach),Commercial,Angola,Africa,78,7,1,71,4,5,73,Human Factor
2007-07-24 00:00:00,Taquan Air,Flight,Commercial,United States of America,North America,5,1,1,4,4,5,0,Human Factor
2007-08-05 00:00:00,Southwest Medevac,Takeoff (climb),Humanitarian,United States of America,North America,5,1,1,4,4,5,0,Human Factor
2007-10-11 00:00:00,RioSur Colombia,Takeoff (climb),Humanitarian,Colombia,South America,5,2,2,3,3,5,0,Unknown
2007-12-09 00:00:00,Minib,Landing (descent or approach),Business,Ukraine,Europe,5,1,1,4,4,5,0,Human Factor
2007-12-30 00:00:00,Indonesian Navy - TNI-AL Tentara Nasional Indonesia - Angkatan Laut,Landing (descent or approach),Military / Government,Indonesia,Asia,7,2,2,5,3,5,2,Technical Failure
2008-03-04 00:00:00,Southwest Orthopedic %26 Sports Medicine Clinic,Takeoff (climb),Business,United States of America,North America,5,2,2,3,3,5,0,Other
2008-03-28 00:00:00,A. D. Williams Engineering,Flight,Business,Canada,North America,5,1,1,4,4,5,0,Technical Failure
2008-03-30 00:00:00,Ross Aviation - UK,Takeoff (climb),Commercial,United Kingdom,Europe,5,2,2,3,3,5,0,Technical Failure
2008-04-08 00:00:00,Vietnam People's Air Force,Landing (descent or approach),Operational,Vietnam,Asia,5,5,5,0,0,5,0,Unknown
2008-06-27 00:00:00,Avialesookhrana,Flight,Specialised Services,Russia,Asia,5,2,2,3,3,5,0,Technical Failure
2008-08-03 00:00:00,Pacific Coastal Airlines - PCA,Flight,Commercial,Canada,North America,7,1,1,6,4,5,2,Human Factor
2008-10-24 00:00:00,AsisMed,Takeoff (climb),Humanitarian,Paraguay,South America,5,2,2,3,3,5,0,Technical Failure
2009-02-16 00:00:00,HESA,Landing (descent or approach),Operational,Iran,Asia,5,5,5,0,0,5,0,Unknown
2009-02-18 00:00:00,Colombian Air Force - Fuerza Aérea Colombiana,Flight,Operational,Colombia,South America,5,5,5,0,0,5,0,Unknown
2009-02-20 00:00:00,Aerolift,Takeoff (climb),Operational,Egypt,Africa,5,5,5,0,0,5,0,Human Factor
2009-03-19 00:00:00,Ecuadorian Air Force - Fuerza Aérea Ecuatoriana,Landing (descent or approach),Operational,Ecuador,South America,5,5,5,0,0,5,0,Human Factor
2009-07-08 00:00:00,Q4 Aviation,Flight,Business,United States of America,North America,5,1,1,4,4,5,0,Weather
2009-09-07 00:00:00,Indonesian Navy - TNI-AL Tentara Nasional Indonesia - Angkatan Laut,Flight,Military / Government,Indonesia,Asia,9,3,2,6,3,5,4,Unknown
2009-10-26 00:00:00,S-Air - Aviakompania S-Air,Landing (descent or approach),Commercial,Belarus,Europe,5,3,3,2,2,5,0,Human Factor
2009-11-23 00:00:00,Italian Air Force - Aeronautica Militare Italiana,Takeoff (climb),Operational,Italy,Europe,5,5,5,0,0,5,0,Unknown
2010-04-13 00:00:00,AeroUnion - Aerotransporte de Carga Union,Landing (descent or approach),Operational,Mexico,Central America,5,5,5,0,0,5,0,Human Factor
2010-07-04 00:00:00,Ohara Flying Service,Takeoff (climb),Humanitarian,United States of America,North America,5,2,2,3,3,5,0,Human Factor
2010-08-09 00:00:00,GCI Communication,Flight,Business,United States of America,North America,9,1,1,8,4,5,4,Human Factor
2010-10-27 00:00:00,Indonesian National Police - Kepolisian Negara Republik Indonesia,Flight,Military / Government,Indonesia,Asia,5,2,2,3,3,5,0,Unknown
2010-11-24 00:00:00,Mexican Air Force - Fuerza Aérea Mexicana,Takeoff (climb),Military / Government,Mexico,Central America,5,5,5,0,0,5,0,Unknown
2010-12-08 00:00:00,Royal Moroccan Police,Flight,Military / Government,Morocco,Africa,5,2,2,3,3,5,0,Human Factor
2011-01-07 00:00:00,Private Venezuelan,Flight,Business,Venezuela,South America,6,1,1,5,4,5,1,Human Factor
2011-02-12 00:00:00,Sabang Merauke Raya Air Charter - SMAC,Flight,Specialised Services,Indonesia,Asia,5,2,2,3,3,5,0,Human Factor
2011-03-16 00:00:00,Carde Equipment Sales,Takeoff (climb),Business,United States of America,North America,6,1,1,5,4,5,1,Human Factor
2011-06-30 00:00:00,Lawrence Bay Airways,Flight,Commercial,Canada,North America,5,1,1,4,4,5,0,Human Factor
2011-12-20 00:00:00,Coolstream Media,Takeoff (climb),Business,United States of America,North America,5,1,1,4,4,5,0,Weather
2012-03-01 00:00:00,Asia Today,Landing (descent or approach),Business,Germany,Europe,5,2,2,3,3,5,0,Human Factor
2012-03-15 00:00:00,Royal Norwegian Air Force - Kongelige Norske Luftforsvaret,Flight,Military / Government,Sweden,Europe,5,4,4,1,1,5,0,Human Factor
2012-03-15 00:00:00,BigTex Trailers,Landing (descent or approach),Business,United States of America,North America,5,1,1,4,4,5,0,Human Factor
2012-06-10 00:00:00,Ukrainska Shkola Pilotov,Landing (descent or approach),Humanitarian,Ukraine,Europe,22,2,0,20,5,5,17,Weather
2012-12-29 00:00:00,Red Wings Airlines,Landing (descent or approach),Operational,Russia,Asia,8,8,5,0,0,5,3,Human Factor
2013-02-03 00:00:00,Z. Air Investimentos e Participações,Flight,Business,Brazil,South America,5,1,1,4,4,5,0,Human Factor
2013-02-13 00:00:00,South Airlines - Pivdenni Avialinii - Yuzhnye Avialinii,Landing (descent or approach),Commercial,Ukraine,Europe,52,8,0,44,5,5,47,Human Factor
2013-02-20 00:00:00,The Vein Guys,Takeoff (climb),Business,United States of America,North America,7,2,0,5,5,5,2,Human Factor
2013-05-30 00:00:00,Chinese Air Force - AFPLA - Chung-Kuo Shan Min Taie Fang Tsun Pu-Tai,Flight,Operational,China,Asia,5,5,5,0,0,5,0,Unknown
2013-11-10 00:00:00,Bearskin Airlines - Bearskin Lake Air Services,Landing (descent or approach),Commercial,Canada,North America,7,2,2,5,3,5,2,Technical Failure
2013-12-04 00:00:00,Heringer Taxi Aéreo,Takeoff (climb),Humanitarian,Brazil,South America,5,1,1,4,4,5,0,Human Factor
2014-03-12 00:00:00,Ambulancias Aéreas de Colombia,Landing (descent or approach),Humanitarian,Colombia,South America,5,2,2,3,3,5,0,Human Factor
2014-03-22 00:00:00,Gadsden Aviation,Flight,Business,United States of America,North America,5,1,1,4,4,5,0,Human Factor
2014-03-28 00:00:00,Indian Air Force - Bharatiya Vayu Sena,Flight,Operational,India,Asia,5,5,5,0,0,5,0,Other
2014-05-08 00:00:00,Aliansa Colombia - Aerolíneas Andinas,Flight,Operational,Colombia,South America,5,2,2,3,3,5,0,Human Factor
2014-05-27 00:00:00,Kowzef S.A.,Landing (descent or approach),Business,Uruguay,South America,9,1,1,8,4,5,4,Human Factor
2014-06-06 00:00:00,Ukrainian Air Force - Povitryani Syly Ukrayini,Flight,Military / Government,Ukraine,Europe,8,8,5,0,0,5,3,Terrorism
2014-08-31 00:00:00,Real Estate School,Landing (descent or approach),Business,United States of America,North America,5,1,1,4,4,5,0,Human Factor
2014-12-12 00:00:00,Sri Lanka Air Force,Landing (descent or approach),Military / Government,Sri Lanka,Asia,5,5,5,0,0,5,0,Unknown
2015-06-02 00:00:00,Aeronaves TSM,Takeoff (climb),Specialised Services,Mexico,Central America,5,2,2,3,3,5,0,Unknown
2015-08-16 00:00:00,E-Med Rescue 24,Landing (descent or approach),Humanitarian,South Africa,Africa,5,2,2,3,3,5,0,Human Factor
2016-02-10 00:00:00,Myanmar Air Force - Tatmadaw Lei,Takeoff (climb),Military / Government,Myanmar,Asia,5,2,2,3,3,5,0,Unknown
2016-04-30 00:00:00,Sudanese Air Force - Al Quwwat al-Jawwiya As-Sudaniya,Landing (descent or approach),Military / Government,Sudan,Africa,5,5,5,0,0,5,0,Unknown
2016-07-20 00:00:00,Joy General Aviation,Takeoff (climb),Commercial,China,Asia,10,2,1,8,4,5,5,Human Factor
2016-10-24 00:00:00,CAE Aviation,Takeoff (climb),Military / Government,Malta,Europe,5,2,2,3,3,5,0,Technical Failure
2016-12-20 00:00:00,Aerosucre Colombia,Takeoff (climb),Operational,Colombia,South America,6,6,5,0,0,5,1,Human Factor
2017-01-19 00:00:00,Hotel Emiliano,Landing (descent or approach),Business,Brazil,South America,5,1,1,4,4,5,0,Human Factor
2017-02-21 00:00:00,Corporate %26 Leisure Aviation,Takeoff (climb),Commercial,Australia,Oceania,5,1,1,4,4,5,0,Human Factor
2017-07-05 00:00:00,Associated Mission Aviation - AMA,Flight,Commercial,Indonesia,Asia,5,2,2,3,3,5,0,Unknown
2017-08-19 00:00:00,Aeroquest,Flight,Commercial,Venezuela,South America,5,2,2,3,3,5,0,Unknown
2017-10-04 00:00:00,East Wing,Flight,Humanitarian,Kazakhstan,Asia,5,3,3,2,2,5,0,Human Factor
2017-12-24 00:00:00,Aviation Transportation,Takeoff (climb),Business,United States of America,North America,5,1,1,4,4,5,0,Human Factor
2018-06-18 00:00:00,Madagascar Trans Air,Takeoff (climb),Operational,Madagascar,Africa,5,1,1,4,4,5,0,Unknown
2018-07-27 00:00:00,Air Kasai,Takeoff (climb),Commercial,Democratic Republic of Congo,Africa,7,2,1,5,4,5,2,Other
2018-08-04 00:00:00,K2 Aviation,Flight,Commercial,United States of America,North America,5,1,1,4,4,5,0,Unknown
2018-08-04 00:00:00,Jeremiah 29:11,Takeoff (climb),Business,United States of America,North America,5,1,1,4,4,5,0,Unknown
2018-08-05 00:00:00,Category III Aviation,Landing (descent or approach),Business,United States of America,North America,5,1,1,4,4,5,0,Human Factor
2018-10-25 00:00:00,Bulldog Flying Club,Flight,Business,World,World,5,2,2,3,3,5,0,Unknown
2018-12-06 00:00:00,United States Marine Corps,Flight,Operational,World,World,5,5,5,0,0,5,0,Unknown
2019-05-13 00:00:00,Mountain Air Service,Flight,Commercial,United States of America,North America,5,1,1,4,4,5,0,Human Factor
2019-07-30 00:00:00,Pakistan Air Force - Pakistan Fiza'ya,Flight,Operational,Pakistan,Asia,5,5,5,0,0,5,0,Unknown
2019-10-03 00:00:00,N700AQ LLC,Landing (descent or approach),Business,United States of America,North America,6,2,2,4,3,5,1,Unknown
2019-10-04 00:00:00,Ukraine Air Alliance,Landing (descent or approach),Operational,Ukraine,Europe,8,5,5,3,0,5,3,Human Factor
2019-11-14 00:00:00,José João Abdalla Filho,Landing (descent or approach),Business,Brazil,South America,10,2,1,8,4,5,5,Human Factor
2019-12-28 00:00:00,Cheyenne Partners,Takeoff (climb),Business,United States of America,North America,6,1,1,5,4,5,1,Unknown
2020-03-11 00:00:00,Aero Hire,Landing (descent or approach),Commercial,Australia,Oceania,5,1,1,4,4,5,0,Unknown
2020-05-04 00:00:00,African Express Airways,Landing (descent or approach),Operational,Somalia,Africa,5,2,2,3,3,5,0,Human Factor
2020-06-05 00:00:00,Larry Ray Pruitt,Flight,Business,United States of America,North America,5,1,1,4,4,5,0,Unknown
2021-03-01 00:00:00,Beidahuang General Airlines,Flight,Other,China,Asia,5,2,2,3,3,5,0,Weather
2021-11-02 00:00:00,Optimum Aviation,Takeoff (climb),Operational,South Sudan,Africa,5,5,5,0,0,5,0,Unknown
2021-11-05 00:00:00,PEC Taxi Aéreo,Landing (descent or approach),Commercial,Brazil,South America,5,2,2,3,3,5,0,Unknown
2021-12-23 00:00:00,Malu Aviation,Landing (descent or approach),Operational,Democratic Republic of Congo,Africa,5,3,3,2,2,5,0,Unknown
2022-02-24 00:00:00,Ukrainian Air Force - Povitryani Syly Ukrayini,Flight,Military / Government,Ukraine,Europe,14,14,5,0,0,5,9,Terrorism
2022-04-20 00:00:00,Richard Hervé Fourcand,Takeoff (climb),Business,Haiti,Central America,5,1,1,4,4,5,0,Unknown
1919-05-04 00:00:00,Regia Aeronautica,Landing (descent or approach),Military / Government,Slovakia,Europe,4,3,3,1,1,4,0,Unknown
1920-02-03 00:00:00,Junkers Flugzeug %26 Motorenwerke,Flight,Specialised Services,Germany,Europe,4,4,4,0,0,4,0,Unknown
1920-04-01 00:00:00,Royal Air Force - RAF,Flight,Military / Government,Sudan,Africa,4,4,4,0,0,4,0,Unknown
1920-04-29 00:00:00,Royal Air Force - RAF,Takeoff (climb),Operational,United Kingdom,Europe,6,6,4,0,0,4,2,Unknown
1920-12-14 00:00:00,Handley Page Transport,Takeoff (climb),Commercial,United Kingdom,Europe,8,2,2,6,2,4,4,Human Factor
1922-10-02 00:00:00,De Havilland Aeroplane Hire Service,Takeoff (climb),Commercial,Italy,Europe,4,1,1,3,3,4,0,Unknown
1923-01-10 00:00:00,French Navy,Flight,Military / Government,France,Europe,5,2,1,3,3,4,1,Technical Failure
1923-01-13 00:00:00,Aeromarine Airways,Flight,Commercial,Cuba,Central America,9,2,0,7,4,4,5,Technical Failure
1925-06-25 00:00:00,KLM Royal Dutch Airlines - Koninklijke Luchtvaart Maatschappij,Flight,Commercial,France,Europe,4,1,1,3,3,4,0,Technical Failure
1925-11-01 00:00:00,Det Danske Luftfartselskab - DDL,Takeoff (climb),Commercial,Denmark,Europe,6,1,1,5,3,4,2,Unknown
1926-04-10 00:00:00,Inland Area Aircraft Depot,Flight,Specialised Services,United Kingdom,Europe,4,4,4,0,0,4,0,Human Factor
1926-10-08 00:00:00,Deutsche Lufthansa,Flight,Commercial,Germany,Europe,4,1,1,3,3,4,0,Unknown
1927-04-19 00:00:00,Royal Air Force - RAF,Takeoff (climb),Military / Government,United Kingdom,Europe,4,4,4,0,0,4,0,Human Factor
1927-05-05 00:00:00,Société Générale des Transports Aériens - SGTA,Flight,Business,World,World,4,4,4,0,0,4,0,Unknown
1927-05-28 00:00:00,United States Army Air Corps - USAAC,Takeoff (climb),Military / Government,United States of America,North America,4,4,4,0,0,4,0,Technical Failure
1927-10-16 00:00:00,Lewis Air Transport,Landing (descent or approach),Commercial,United States of America,North America,4,1,1,3,3,4,0,Technical Failure
1927-10-30 00:00:00,Colonial Air Transport,Takeoff (climb),Commercial,United States of America,North America,4,1,1,3,3,4,0,Unknown
1927-12-23 00:00:00,Frances Wilson Grayson,Flight,Business,United States of America,North America,4,3,3,1,1,4,0,Unknown
1928-07-13 00:00:00,Imperial Airways,Takeoff (climb),Specialised Services,United Kingdom,Europe,6,1,0,5,4,4,2,Technical Failure
1928-08-07 00:00:00,French Air Force - Armée de l'Air,Flight,Military / Government,France,Europe,4,4,4,0,0,4,0,Technical Failure
1928-10-23 00:00:00,George Peck,Flight,Business,United States of America,North America,4,1,1,3,3,4,0,Unknown
1928-12-23 00:00:00,Interstate Airlines,Takeoff (climb),Commercial,United States of America,North America,5,1,1,4,3,4,1,Unknown
1929-03-19 00:00:00,Ford Motor Company,Landing (descent or approach),Specialised Services,United States of America,North America,4,2,2,2,2,4,0,Unknown
1929-03-25 00:00:00,Private American,Flight,Business,United States of America,North America,4,1,1,3,3,4,0,Human Factor
1929-03-29 00:00:00,Standard Airlines,Flight,Commercial,United States of America,North America,4,1,1,3,3,4,0,Weather
1929-08-11 00:00:00,Middle States Airlines - MSA,Takeoff (climb),Operational,United States of America,North America,4,2,2,2,2,4,0,Unknown
1929-08-24 00:00:00,Deutsche Lufthansa,Flight,Commercial,Germany,Europe,5,1,1,4,3,4,1,Weather
1929-08-24 00:00:00,Royal Air Force - RAF,Takeoff (climb),Military / Government,Egypt,Africa,7,2,2,5,2,4,3,Unknown
1929-08-26 00:00:00,Lloyd Aéreo Boliviano - LAB Airlines,Landing (descent or approach),Commercial,Bolivia,South America,4,2,2,2,2,4,0,Human Factor
1929-09-13 00:00:00,French Air Force - Armée de l'Air,Flight,Operational,France,Europe,4,4,4,0,0,4,0,Technical Failure
1929-09-28 00:00:00,Guatemalan Air Force - Fuerza Aérea Guatemalteca,Flight,Operational,Guatemala,Central America,4,2,2,2,2,4,0,Human Factor
1929-09-29 00:00:00,William H. Emery Jr.,Flight,Business,United States of America,North America,4,1,1,3,3,4,0,Weather
1929-10-06 00:00:00,Jack Brooks,Flight,Business,United States of America,North America,4,1,1,3,3,4,0,Unknown
1929-11-04 00:00:00,Corporación Aeronautica de Transportes,Flight,Commercial,Mexico,Central America,4,2,2,2,2,4,0,Unknown
1929-11-09 00:00:00,Alaskan Airways,Flight,Commercial,World,World,4,2,2,2,2,4,0,Human Factor
1930-04-18 00:00:00,Canadian Colonial Airways,Landing (descent or approach),Commercial,United States of America,North America,4,1,1,3,3,4,0,Weather
1930-05-10 00:00:00,L'Aéropostale,Flight,Commercial,Argentina,South America,5,2,2,3,2,4,1,Human Factor
1930-08-26 00:00:00,French Air Force - Armée de l'Air,Landing (descent or approach),Operational,France,Europe,6,6,4,0,0,4,2,Technical Failure
1930-10-02 00:00:00,Compagnie Aérienne Française,Takeoff (climb),Commercial,France,Europe,4,2,2,2,2,4,0,Technical Failure
1930-10-12 00:00:00,L'Aéropostale,Flight,Commercial,Morocco,Africa,4,1,1,3,3,4,0,Weather
1930-12-09 00:00:00,China National Aviation Corporation - CNAC,Takeoff (climb),Commercial,China,Asia,6,2,2,4,2,4,2,Human Factor
1931-01-06 00:00:00,Regia Aeronautica,Takeoff (climb),Military / Government,Guinea Bissau,Africa,4,4,4,0,0,4,0,Unknown
1931-04-02 00:00:00,LAN Chile - Linea Aérea Nacional de Chile,Landing (descent or approach),Commercial,Chile,South America,4,1,1,3,3,4,0,Unknown
1931-06-07 00:00:00,Air Orient,Flight,Commercial,Myanmar,Asia,4,4,4,0,0,4,0,Weather
1931-06-13 00:00:00,Deutsche Lufthansa,Flight,Commercial,Germany,Europe,4,2,2,2,2,4,0,Technical Failure
1931-08-19 00:00:00,Department of Lands %26 Forestry,Flight,Military / Government,Canada,North America,4,1,1,3,3,4,0,Unknown
1931-09-16 00:00:00,Pacific Air Transport,Takeoff (climb),Commercial,United States of America,North America,4,1,1,3,3,4,0,Technical Failure
1931-09-16 00:00:00,United States Navy - USN,Takeoff (climb),Military / Government,Panama,Central America,4,4,4,0,0,4,0,Unknown
1931-09-17 00:00:00,Münchner Photogrammetrie,Flight,Specialised Services,Sweden,Europe,4,1,1,3,3,4,0,Technical Failure
1931-12-31 00:00:00,American Airways,Flight,Commercial,United States of America,North America,5,1,1,4,3,4,1,Human Factor
1932-02-27 00:00:00,Japan Air Transport,Flight,Commercial,Japan,Asia,5,5,4,0,0,4,1,Technical Failure
1932-04-14 00:00:00,Royal Netherlands Navy - Marineluchtvaartdienst,Landing (descent or approach),Military / Government,Indonesia,Asia,4,4,4,0,0,4,0,Unknown
1932-05-10 00:00:00,Aeroflot - Russian International Airlines,Landing (descent or approach),Specialised Services,Russia,Asia,11,2,1,9,3,4,7,Technical Failure
1932-05-12 00:00:00,Brazilian Air Force - Aviação Militar,Flight,Military / Government,Brazil,South America,6,6,4,0,0,4,2,Unknown
1932-05-25 00:00:00,Marcel Goulette,Flight,Business,Italy,Europe,4,2,2,2,2,4,0,Human Factor
1932-06-06 00:00:00,Société des Avions Henry Potez,Landing (descent or approach),Commercial,France,Europe,4,1,1,3,3,4,0,Weather
1932-08-16 00:00:00,French Navy,Flight,Military / Government,Tunisia,Africa,4,4,4,0,0,4,0,Technical Failure
1932-08-16 00:00:00,French Navy,Flight,Military / Government,Tunisia,Africa,4,4,4,0,0,4,0,Technical Failure
1932-09-25 00:00:00,Panair do Brasil,Flight,Humanitarian,Brazil,South America,4,0,0,4,4,4,0,Terrorism
1933-01-11 00:00:00,French Navy,Landing (descent or approach),Operational,Tunisia,Africa,7,7,4,0,0,4,3,Weather
1933-02-08 00:00:00,Aeroflot - Russian International Airlines,Flight,Commercial,Azerbaijan,Asia,5,2,2,3,2,4,1,Human Factor
1933-02-08 00:00:00,Royal Air Force - RAF,Flight,Military / Government,United Kingdom,Europe,5,5,4,0,0,4,1,Weather
1933-04-18 00:00:00,W. N. Gregory,Flight,Business,United States of America,North America,4,1,1,3,3,4,0,Unknown
1933-04-29 00:00:00,Deutsche Lufthansa,Flight,Specialised Services,Germany,Europe,4,3,3,1,1,4,0,Unknown
1933-06-21 00:00:00,Brooks Airways,Flight,Specialised Services,Canada,North America,4,1,1,3,3,4,0,Unknown
1933-06-26 00:00:00,Spanish Navy - Aeronáutica Naval,Flight,Specialised Services,Spain,Europe,6,6,4,0,0,4,2,Unknown
1933-10-26 00:00:00,Gaston Sourdes,Flight,Business,France,Europe,4,1,1,3,3,4,0,Unknown
1933-10-29 00:00:00,Oliver H. Walton,Takeoff (climb),Business,United States of America,North America,4,1,1,3,3,4,0,Unknown
1933-11-09 00:00:00,Pacific Air Transport,Takeoff (climb),Commercial,United States of America,North America,10,3,0,7,4,4,6,Weather
1934-03-06 00:00:00,American Airlines,Flight,Commercial,United States of America,North America,4,1,1,3,3,4,0,Weather
1934-03-10 00:00:00,SCADTA - Sociedad Colombo-Alemana de Transportes Aéreos,Flight,Commercial,Colombia,South America,5,3,3,2,1,4,1,Unknown
1934-04-10 00:00:00,China National Aviation Corporation - CNAC,Flight,Commercial,China,Asia,4,3,3,1,1,4,0,Weather
1934-05-20 00:00:00,Larry Lynch,Landing (descent or approach),Business,United States of America,North America,4,1,1,3,3,4,0,Unknown
1934-09-22 00:00:00,National Aviation Displays,Flight,Operational,United Kingdom,Europe,4,4,4,0,0,4,0,Technical Failure
1934-09-29 00:00:00,London Scottish %26 Provincial Airways,Flight,Commercial,United Kingdom,Europe,4,1,1,3,3,4,0,Weather
1934-11-15 00:00:00,Qantas Airways - Queensland and Northern Territory Aerial Services,Flight,Operational,Australia,Oceania,4,2,2,2,2,4,0,Human Factor
1934-11-17 00:00:00,Pacific Airmotive Corporation,Flight,Business,United States of America,North America,4,1,1,3,3,4,0,Human Factor
1934-12-10 00:00:00,Cubana de Aviación,Landing (descent or approach),Commercial,Cuba,Central America,8,3,2,5,2,4,4,Weather
1935-08-14 00:00:00,Delta Airlines,Flight,Commercial,United States of America,North America,4,2,2,2,2,4,0,Technical Failure
1935-10-30 00:00:00,United Airlines,Takeoff (climb),Specialised Services,United States of America,North America,4,4,4,0,0,4,0,Human Factor
1935-11-02 00:00:00,Air France,Flight,Commercial,Brazil,South America,4,4,4,0,0,4,0,Unknown
1935-11-10 00:00:00,Private American,Flight,Business,United States of America,North America,4,1,1,3,3,4,0,Human Factor
1936-01-13 00:00:00,German Air Force - Deutsche Luftwaffe,Flight,Military / Government,Germany,Europe,5,1,1,4,3,4,1,Weather
1936-01-24 00:00:00,United States Army Air Corps - USAAC,Flight,Operational,United States of America,North America,4,4,4,0,0,4,0,Human Factor
1936-02-15 00:00:00,Deutsche Lufthansa,Flight,Operational,World,World,4,4,4,0,0,4,0,Unknown
1936-07-28 00:00:00,French Air Force - Armée de l'Air,Flight,Operational,France,Europe,5,5,4,0,0,4,1,Weather
1936-08-06 00:00:00,French Air Force - Armée de l'Air,Landing (descent or approach),Operational,France,Europe,4,4,4,0,0,4,0,Unknown
1936-08-10 00:00:00,Imperial Airways,Takeoff (climb),Operational,United Kingdom,Europe,4,4,4,0,0,4,0,Unknown
1936-09-25 00:00:00,Spanish Air Force - Ejército del Aire,Flight,Military / Government,Spain,Europe,4,4,4,0,0,4,0,Unknown
1936-09-29 00:00:00,Blue Bird Air Service,Flight,Commercial,United States of America,North America,4,1,1,3,3,4,0,Unknown
1936-11-07 00:00:00,Lublin Aircraft Factory,Flight,Specialised Services,Poland,Europe,4,2,2,2,2,4,0,Technical Failure
1936-11-17 00:00:00,Deutsche Lufthansa,Landing (descent or approach),Commercial,Germany,Europe,16,3,1,13,3,4,12,Human Factor
1937-01-19 00:00:00,Private Dutch,Flight,Business,France,Europe,4,2,2,2,2,4,0,Technical Failure
1937-02-02 00:00:00,Daily Express Newspaper,Flight,Business,United Kingdom,Europe,4,2,2,2,2,4,0,Human Factor
1937-03-12 00:00:00,Deutsche Lufthansa,Landing (descent or approach),Commercial,Gambia,Africa,4,4,4,0,0,4,0,Unknown
1937-03-27 00:00:00,LAN Chile - Linea Aérea Nacional de Chile,Landing (descent or approach),Commercial,Peru,South America,4,1,1,3,3,4,0,Unknown
1937-05-20 00:00:00,Deutsche Lufthansa,Takeoff (climb),Commercial,Germany,Europe,4,2,2,2,2,4,0,Unknown
1937-05-29 00:00:00,North Eastern Airways,Takeoff (climb),Commercial,United Kingdom,Europe,6,1,1,5,3,4,2,Unknown
1937-06-03 00:00:00,Spanish Nationalist Air Force,Flight,Military / Government,Spain,Europe,4,2,2,2,2,4,0,Unknown
1937-08-10 00:00:00,Eastern Airlines,Takeoff (climb),Commercial,United States of America,North America,9,3,2,6,2,4,5,Other
1937-09-11 00:00:00,Royal Air Force - RAF,Flight,Operational,United Kingdom,Europe,4,4,4,0,0,4,0,Human Factor
1937-10-06 00:00:00,KLM Royal Dutch Airlines - Koninklijke Luchtvaart Maatschappij,Takeoff (climb),Commercial,Indonesia,Asia,11,4,3,7,1,4,7,Technical Failure
1937-11-11 00:00:00,LOT Polish Airlines - Polskie Linie Lotnicze,Landing (descent or approach),Commercial,Poland,Europe,11,2,2,9,2,4,7,Weather
1937-12-04 00:00:00,Ala Littoria,Landing (descent or approach),Commercial,Germany,Europe,17,3,0,14,4,4,13,Unknown
1938-05-27 00:00:00,Ginger Coote Airways,Flight,Commercial,Canada,North America,4,1,1,3,3,4,0,Unknown
1938-07-19 00:00:00,Panagra - Pan American-Grace Airways,Flight,Operational,Argentina,South America,4,4,4,0,0,4,0,Unknown
1938-07-27 00:00:00,Imperial Airways,Takeoff (climb),Commercial,Kenya,Africa,4,4,4,0,0,4,0,Unknown
1938-08-08 00:00:00,Royal Air Force - RAF,Flight,Military / Government,United Kingdom,Europe,4,4,4,0,0,4,0,Human Factor
1938-08-10 00:00:00,Royal Australian Air Force - RAAF,Flight,Operational,Australia,Oceania,5,5,4,0,0,4,1,Human Factor
1938-10-01 00:00:00,Deutsche Lufthansa,Flight,Commercial,Gambia,Africa,4,4,4,0,0,4,0,Unknown
1938-11-01 00:00:00,Royal Air Force - RAF,Flight,Operational,United Kingdom,Europe,4,4,4,0,0,4,0,Unknown
1938-11-22 00:00:00,Ala Littoria,Flight,Commercial,Austria,Europe,5,5,4,0,0,4,1,Weather
1938-11-22 00:00:00,Ala Littoria,Flight,Commercial,Austria,Europe,5,5,4,0,0,4,1,Weather
1938-11-27 00:00:00,Imperial Airways,Flight,Operational,Iraq,Asia,4,4,4,0,0,4,0,Weather
1938-12-09 00:00:00,KLM Royal Dutch Airlines - Koninklijke Luchtvaart Maatschappij,Takeoff (climb),Operational,Netherlands,Europe,4,4,4,0,0,4,0,Human Factor
1939-01-09 00:00:00,Royal Air Force - RAF,Flight,Operational,United Kingdom,Europe,4,4,4,0,0,4,0,Human Factor
1939-01-13 00:00:00,Northwest Airlines,Takeoff (climb),Commercial,United States of America,North America,4,2,2,2,2,4,0,Technical Failure
1939-01-17 00:00:00,SCADTA - Sociedad Colombo-Alemana de Transportes Aéreos,Flight,Specialised Services,Colombia,South America,4,3,3,1,1,4,0,Unknown
1939-01-18 00:00:00,Guinea Airways,Takeoff (climb),Operational,Australia,Oceania,4,3,3,1,1,4,0,Human Factor
1939-03-18 00:00:00,Royal Air Force - RAF,Flight,Operational,United Kingdom,Europe,4,4,4,0,0,4,0,Unknown
1939-04-28 00:00:00,Royal Australian Air Force - RAAF,Landing (descent or approach),Operational,Australia,Oceania,4,4,4,0,0,4,0,Unknown
1939-06-05 00:00:00,Royal Air Force - RAF,Takeoff (climb),Military / Government,Singapore,Asia,8,8,4,0,0,4,4,Technical Failure
1939-08-19 00:00:00,German Air Force - Deutsche Luftwaffe,Flight,Military / Government,Germany,Europe,4,4,4,0,0,4,0,Unknown
1939-09-04 00:00:00,Royal Air Force - RAF,Landing (descent or approach),Operational,United Kingdom,Europe,4,4,4,0,0,4,0,Technical Failure
1939-10-30 00:00:00,Royal Air Force - RAF,Flight,Operational,United Kingdom,Europe,4,4,4,0,0,4,0,Human Factor
1939-11-17 00:00:00,German Air Force - Deutsche Luftwaffe,Flight,Military / Government,Austria,Europe,4,4,4,0,0,4,0,Unknown
1939-12-06 00:00:00,Royal Air Force - RAF,Flight,Military / Government,World,World,4,4,4,0,0,4,0,Unknown
1939-12-12 00:00:00,Air France,Flight,Military / Government,France,Europe,5,5,4,0,0,4,1,Unknown
1939-12-18 00:00:00,Royal Air Force - RAF,Flight,Military / Government,Germany,Europe,5,5,4,0,0,4,1,Terrorism
1939-12-18 00:00:00,Royal Air Force - RAF,Flight,Military / Government,Germany,Europe,5,5,4,0,0,4,1,Terrorism
1939-12-27 00:00:00,Royal Air Force - RAF,Flight,Military / Government,United Kingdom,Europe,4,4,4,0,0,4,0,Technical Failure
1940-01-01 00:00:00,Royal Air Force - RAF,Flight,Military / Government,United Kingdom,Europe,4,4,4,0,0,4,0,Terrorism
1940-01-24 00:00:00,Sociedad Argentina de Navegacion Aérea,Flight,Specialised Services,Argentina,South America,6,6,4,0,0,4,2,Unknown
1940-01-30 00:00:00,German Air Force - Deutsche Luftwaffe,Flight,Military / Government,United Kingdom,Europe,4,4,4,0,0,4,0,Terrorism
1940-02-03 00:00:00,German Air Force - Deutsche Luftwaffe,Flight,Military / Government,United Kingdom,Europe,4,4,4,0,0,4,0,Terrorism
1940-02-13 00:00:00,German Air Force - Deutsche Luftwaffe,Flight,Military / Government,United Kingdom,Europe,4,4,4,0,0,4,0,Terrorism
1940-02-20 00:00:00,Royal Air Force - RAF,Flight,Military / Government,United Kingdom,Europe,6,6,4,0,0,4,2,Unknown
1940-02-21 00:00:00,German Air Force - Deutsche Luftwaffe,Flight,Military / Government,United Kingdom,Europe,4,4,4,0,0,4,0,Terrorism
1940-03-19 00:00:00,Royal Air Force - RAF,Flight,Operational,United Kingdom,Europe,6,6,4,0,0,4,2,Unknown
1940-03-27 00:00:00,Royal Air Force - RAF,Flight,Operational,World,World,4,4,4,0,0,4,0,Unknown
1940-04-08 00:00:00,Royal Air Force - RAF,Flight,Military / Government,United Kingdom,Europe,4,4,4,0,0,4,0,Unknown
1940-04-16 00:00:00,German Air Force - Deutsche Luftwaffe,Flight,Operational,Norway,Europe,4,4,4,0,0,4,0,Human Factor
1940-04-26 00:00:00,Royal Air Force - RAF,Flight,Military / Government,Denmark,Europe,5,5,4,0,0,4,1,Terrorism
1940-05-11 00:00:00,Royal Air Force - RAF,Landing (descent or approach),Military / Government,France,Europe,16,2,0,14,4,4,12,Unknown
1940-05-12 00:00:00,Royal Air Force - RAF,Flight,Military / Government,Germany,Europe,5,5,4,0,0,4,1,Unknown
1940-05-16 00:00:00,Royal Australian Air Force - RAAF,Flight,Military / Government,Australia,Oceania,4,4,4,0,0,4,0,Human Factor
1940-05-20 00:00:00,Royal Air Force - RAF,Flight,Military / Government,Netherlands,Europe,4,4,4,0,0,4,0,Terrorism
1940-05-26 00:00:00,German Air Force - Deutsche Luftwaffe,Flight,Military / Government,Norway,Europe,15,3,3,12,1,4,11,Terrorism
1940-05-26 00:00:00,German Air Force - Deutsche Luftwaffe,Flight,Military / Government,Norway,Europe,15,3,3,12,1,4,11,Terrorism
1940-05-29 00:00:00,Royal Air Force - RAF,Flight,Military / Government,World,World,4,4,4,0,0,4,0,Unknown
1940-06-01 00:00:00,Douglas Aircraft Company,Takeoff (climb),Specialised Services,United States of America,North America,4,4,4,0,0,4,0,Unknown
1940-06-11 00:00:00,Royal Air Force - RAF,Takeoff (climb),Military / Government,United Kingdom,Europe,4,4,4,0,0,4,0,Unknown
1940-06-18 00:00:00,Royal Air Force - RAF,Flight,Military / Government,France,Europe,4,4,4,0,0,4,0,Terrorism
1940-06-20 00:00:00,German Air Force - Deutsche Luftwaffe,Flight,Military / Government,United Kingdom,Europe,4,4,4,0,0,4,0,Human Factor
1940-06-21 00:00:00,Royal Air Force - RAF,Flight,Military / Government,Libya,Africa,5,5,4,0,0,4,1,Unknown
1940-06-21 00:00:00,Royal Air Force - RAF,Landing (descent or approach),Military / Government,United Kingdom,Europe,4,4,4,0,0,4,0,Human Factor
1940-06-26 00:00:00,German Air Force - Deutsche Luftwaffe,Flight,Military / Government,United Kingdom,Europe,4,4,4,0,0,4,0,Terrorism
1940-06-29 00:00:00,German Air Force - Deutsche Luftwaffe,Flight,Military / Government,United Kingdom,Europe,4,4,4,0,0,4,0,Terrorism
1940-07-07 00:00:00,Air France,Flight,Commercial,Vietnam,Asia,4,4,4,0,0,4,0,Terrorism
1940-07-09 00:00:00,Royal Air Force - RAF,Flight,Military / Government,United Kingdom,Europe,5,3,3,2,1,4,1,Human Factor
1940-07-11 00:00:00,German Air Force - Deutsche Luftwaffe,Flight,Military / Government,France,Europe,4,4,4,0,0,4,0,Terrorism
1940-07-19 00:00:00,German Air Force - Deutsche Luftwaffe,Flight,Military / Government,United Kingdom,Europe,6,6,4,0,0,4,2,Terrorism
1940-07-22 00:00:00,Royal New Zealand Air Force - RNZAF,Flight,Operational,New Zealand,Oceania,4,4,4,0,0,4,0,Human Factor
1940-07-24 00:00:00,German Air Force - Deutsche Luftwaffe,Flight,Military / Government,United Kingdom,Europe,4,4,4,0,0,4,0,Terrorism
1940-07-29 00:00:00,Nordiska Aero Transport,Flight,Military / Government,Sweden,Europe,4,1,1,3,3,4,0,Terrorism
1940-08-07 00:00:00,German Air Force - Deutsche Luftwaffe,Flight,Military / Government,Czech Republic,Europe,4,4,4,0,0,4,0,Unknown
1940-08-09 00:00:00,German Air Force - Deutsche Luftwaffe,Flight,Military / Government,United Kingdom,Europe,4,4,4,0,0,4,0,Terrorism
1940-08-11 00:00:00,Royal Air Force - RAF,Flight,Military / Government,Portugal,Europe,4,4,4,0,0,4,0,Terrorism
1940-08-15 00:00:00,German Air Force - Deutsche Luftwaffe,Flight,Military / Government,United Kingdom,Europe,4,4,4,0,0,4,0,Terrorism
1940-08-16 00:00:00,German Air Force - Deutsche Luftwaffe,Flight,Military / Government,United Kingdom,Europe,4,4,4,0,0,4,0,Terrorism
1940-08-24 00:00:00,German Air Force - Deutsche Luftwaffe,Flight,Military / Government,United Kingdom,Europe,4,4,4,0,0,4,0,Terrorism
1940-08-29 00:00:00,Royal Air Force - RAF,Flight,Operational,United Kingdom,Europe,5,5,4,0,0,4,1,Human Factor
1940-08-31 00:00:00,Royal Air Force - RAF,Landing (descent or approach),Operational,World,World,4,4,4,0,0,4,0,Unknown
1940-09-05 00:00:00,German Air Force - Deutsche Luftwaffe,Flight,Military / Government,United Kingdom,Europe,4,4,4,0,0,4,0,Terrorism
1940-09-06 00:00:00,German Air Force - Deutsche Luftwaffe,Flight,Military / Government,United Kingdom,Europe,4,4,4,0,0,4,0,Terrorism
1940-10-05 00:00:00,Royal Air Force - RAF,Flight,Military / Government,United Kingdom,Europe,4,4,4,0,0,4,0,Unknown
1940-10-11 00:00:00,Royal Air Force - RAF,Takeoff (climb),Operational,United Kingdom,Europe,6,6,4,0,0,4,2,Unknown
1940-10-16 00:00:00,Royal Air Force - RAF,Flight,Military / Government,Netherlands,Europe,6,6,4,0,0,4,2,Terrorism
1940-10-21 00:00:00,Royal Air Force - RAF,Flight,Military / Government,United Kingdom,Europe,5,5,4,0,0,4,1,Human Factor
1940-11-06 00:00:00,German Air Force - Deutsche Luftwaffe,Flight,Military / Government,United Kingdom,Europe,4,4,4,0,0,4,0,Terrorism
1940-11-16 00:00:00,German Air Force - Deutsche Luftwaffe,Takeoff (climb),Military / Government,France,Europe,4,4,4,0,0,4,0,Unknown
1940-12-04 00:00:00,Royal Air Force - RAF,Flight,Military / Government,United Kingdom,Europe,4,4,4,0,0,4,0,Unknown
1941-02-24 00:00:00,Royal Air Force - RAF,Flight,Operational,United Kingdom,Europe,4,4,4,0,0,4,0,Unknown
1941-02-25 00:00:00,Royal Netherlands Navy - Marineluchtvaartdienst,Takeoff (climb),Military / Government,United Kingdom,Europe,5,5,4,0,0,4,1,Weather
1941-03-19 00:00:00,Royal Air Force - RAF,Flight,Military / Government,United Kingdom,Europe,4,4,4,0,0,4,0,Weather
1941-03-21 00:00:00,Royal Air Force - RAF,Flight,Military / Government,United Kingdom,Europe,6,6,4,0,0,4,2,Technical Failure
1941-04-20 00:00:00,Royal Air Force - RAF,Flight,Military / Government,United Kingdom,Europe,4,4,4,0,0,4,0,Technical Failure
1941-05-02 00:00:00,Royal Air Force - RAF,Flight,Operational,United Kingdom,Europe,4,4,4,0,0,4,0,Technical Failure
1941-07-03 00:00:00,Swedish Air Force - Flygvapnet,Flight,Operational,Sweden,Europe,4,4,4,0,0,4,0,Human Factor
1941-08-13 00:00:00,Royal Air Force - RAF,Flight,Military / Government,Germany,Europe,6,6,4,0,0,4,2,Terrorism
1941-08-15 00:00:00,Royal Australian Air Force - RAAF,Flight,Operational,Australia,Oceania,4,4,4,0,0,4,0,Human Factor
1941-09-01 00:00:00,Royal Air Force - RAF,Flight,Military / Government,Germany,Europe,6,6,4,0,0,4,2,Terrorism
1941-09-02 00:00:00,Royal Air Force - RAF,Flight,Military / Government,Norway,Europe,4,4,4,0,0,4,0,Human Factor
1941-09-03 00:00:00,Royal Air Force - RAF,Landing (descent or approach),Military / Government,United Kingdom,Europe,5,5,4,0,0,4,1,Human Factor
1941-09-03 00:00:00,Section Civile de Liaisons Aériennes Métropolitaines - SCLAM,Flight,Military / Government,France,Europe,4,2,2,2,2,4,0,Weather
1941-09-09 00:00:00,Royal Air Force - RAF,Flight,Operational,United Kingdom,Europe,4,4,4,0,0,4,0,Human Factor
1941-09-16 00:00:00,Swedish Air Force - Flygvapnet,Flight,Military / Government,Sweden,Europe,4,4,4,0,0,4,0,Other
1941-09-29 00:00:00,Polyarnaya Aviatsiya,Landing (descent or approach),Commercial,Russia,Asia,4,4,4,0,0,4,0,Human Factor
1941-10-23 00:00:00,Royal Air Force - RAF,Landing (descent or approach),Operational,Canada,North America,4,4,4,0,0,4,0,Technical Failure
1941-11-14 00:00:00,Royal Air Force - RAF,Flight,Operational,United Kingdom,Europe,4,4,4,0,0,4,0,Unknown
1941-12-01 00:00:00,Linea Aeropostal Venezolana - LAV,Landing (descent or approach),Commercial,Venezuela,South America,4,2,2,2,2,4,0,Technical Failure
1941-12-02 00:00:00,Royal Netherlands Navy - Marineluchtvaartdienst,Flight,Military / Government,Norway,Europe,4,4,4,0,0,4,0,Unknown
1941-12-08 00:00:00,Royal Australian Air Force - RAAF,Flight,Military / Government,Malaysia,Asia,4,4,4,0,0,4,0,Terrorism
1941-12-08 00:00:00,United States Army Air Forces - USAAF,Takeoff (climb),Military / Government,United States of America,North America,4,4,4,0,0,4,0,Unknown
1941-12-10 00:00:00,Royal Australian Air Force - RAAF,Takeoff (climb),Military / Government,Australia,Oceania,4,4,4,0,0,4,0,Human Factor
1941-12-15 00:00:00,Royal New Zealand Air Force - RNZAF,Flight,Military / Government,New Zealand,Oceania,4,4,4,0,0,4,0,Human Factor
1941-12-16 00:00:00,Royal New Zealand Air Force - RNZAF,Takeoff (climb),Operational,New Zealand,Oceania,4,4,4,0,0,4,0,Weather
1941-12-21 00:00:00,Royal Air Force - RAF,Flight,Operational,United Kingdom,Europe,4,4,4,0,0,4,0,Technical Failure
1941-12-28 00:00:00,Royal Air Force - RAF,Landing (descent or approach),Operational,United Kingdom,Europe,4,4,4,0,0,4,0,Technical Failure
1941-12-29 00:00:00,British Overseas Airways Corporation - BOAC,Takeoff (climb),Commercial,Indonesia,Asia,0,0,0,0,4,4,-4,Other
1942-01-12 00:00:00,Royal Australian Air Force - RAAF,Flight,Military / Government,Indonesia,Asia,4,4,4,0,0,4,0,Terrorism
1942-01-12 00:00:00,Royal Australian Air Force - RAAF,Flight,Military / Government,Indonesia,Asia,4,4,4,0,0,4,0,Terrorism
1942-01-12 00:00:00,Royal Australian Air Force - RAAF,Flight,Military / Government,Indonesia,Asia,4,4,4,0,0,4,0,Terrorism
1942-01-19 00:00:00,Royal Australian Air Force - RAAF,Flight,Military / Government,Papua New Guinea,Oceania,4,4,4,0,0,4,0,Unknown
1942-01-19 00:00:00,Royal Australian Air Force - RAAF,Flight,Specialised Services,Papua New Guinea,Oceania,4,4,4,0,0,4,0,Terrorism
1942-01-22 00:00:00,Royal Air Force - RAF,Landing (descent or approach),Operational,United Kingdom,Europe,4,4,4,0,0,4,0,Unknown
1942-01-26 00:00:00,Royal Australian Air Force - RAAF,Flight,Military / Government,Papua New Guinea,Oceania,4,4,4,0,0,4,0,Terrorism
1942-02-03 00:00:00,United States Army Air Forces - USAAF,Flight,Military / Government,United States of America,North America,4,4,4,0,0,4,0,Weather
1942-02-04 00:00:00,Royal Air Force - RAF,Takeoff (climb),Operational,United Kingdom,Europe,6,6,4,0,0,4,2,Unknown
1942-02-10 00:00:00,Royal Air Force - RAF,Flight,Specialised Services,United Kingdom,Europe,4,4,4,0,0,4,0,Human Factor
1942-02-11 00:00:00,Royal Netherlands Navy - Marineluchtvaartdienst,Flight,Military / Government,Indonesia,Asia,6,6,4,0,0,4,2,Terrorism
1942-02-11 00:00:00,Royal Australian Air Force - RAAF,Flight,Military / Government,Papua New Guinea,Oceania,4,4,4,0,0,4,0,Terrorism
1942-02-14 00:00:00,Royal Australian Air Force - RAAF,Takeoff (climb),Military / Government,Indonesia,Asia,4,4,4,0,0,4,0,Weather
1942-02-18 00:00:00,Royal Air Force - RAF,Takeoff (climb),Military / Government,United Kingdom,Europe,4,4,4,0,0,4,0,Unknown
1942-02-27 00:00:00,Royal Air Force - RAF,Flight,Military / Government,Netherlands,Europe,5,5,4,0,0,4,1,Terrorism
1942-03-03 00:00:00,KNILM - Koninklijke Nederlandse Indies Luchtvaart Maatschappij,Flight,Commercial,Australia,Oceania,12,4,1,8,3,4,8,Terrorism
1942-03-11 00:00:00,Royal Air Force - RAF,Flight,Operational,United Kingdom,Europe,4,4,4,0,0,4,0,Unknown
1942-03-12 00:00:00,Royal Air Force - RAF,Flight,Operational,United Kingdom,Europe,4,4,4,0,0,4,0,Unknown
1942-03-20 00:00:00,German Air Force - Deutsche Luftwaffe,Flight,Military / Government,Austria,Europe,4,4,4,0,0,4,0,Weather
1942-03-23 00:00:00,Royal Australian Air Force - RAAF,Flight,Military / Government,Indonesia,Asia,4,4,4,0,0,4,0,Terrorism
1942-03-25 00:00:00,Royal Air Force - RAF,Flight,Operational,United Kingdom,Europe,4,4,4,0,0,4,0,Human Factor
1942-04-01 00:00:00,United States Army Air Forces - USAAF,Flight,Military / Government,United States of America,North America,6,6,4,0,0,4,2,Unknown
1942-04-14 00:00:00,Royal Australian Air Force - RAAF,Landing (descent or approach),Military / Government,Indonesia,Asia,4,4,4,0,0,4,0,Unknown
1942-04-23 00:00:00,Royal Australian Air Force - RAAF,Flight,Military / Government,World,World,4,4,4,0,0,4,0,Unknown
1942-05-08 00:00:00,Royal Netherlands Navy - Marineluchtvaartdienst,Flight,Military / Government,Netherlands,Europe,4,4,4,0,0,4,0,Unknown
1942-05-12 00:00:00,United States Army Air Forces - USAAF,Flight,Military / Government,United States of America,North America,4,4,4,0,0,4,0,Unknown
1942-05-13 00:00:00,Royal Australian Air Force - RAAF,Flight,Military / Government,Indonesia,Asia,4,4,4,0,0,4,0,Terrorism
1942-05-15 00:00:00,Royal Netherlands Navy - Marineluchtvaartdienst,Flight,Military / Government,Netherlands,Europe,4,4,4,0,0,4,0,Unknown
1942-05-22 00:00:00,Royal Air Force - RAF,Flight,Operational,United Kingdom,Europe,4,4,4,0,0,4,0,Human Factor
1942-05-24 00:00:00,Royal Australian Air Force - RAAF,Flight,Operational,Australia,Oceania,4,4,4,0,0,4,0,Human Factor
1942-05-25 00:00:00,Royal Australian Air Force - RAAF,Flight,Operational,Australia,Oceania,4,4,4,0,0,4,0,Unknown
1942-05-29 00:00:00,Australian National Airways - ANA,Flight,Commercial,Australia,Oceania,4,1,1,3,3,4,0,Unknown
1942-05-30 00:00:00,Royal Netherlands Navy - Marineluchtvaartdienst,Flight,Military / Government,Netherlands,Europe,4,4,4,0,0,4,0,Unknown
1942-06-04 00:00:00,Royal Air Force - RAF,Flight,Military / Government,Netherlands,Europe,7,7,4,0,0,4,3,Terrorism
1942-06-09 00:00:00,Royal Canadian Air Force - RCAF,Flight,Operational,Canada,North America,4,4,4,0,0,4,0,Unknown
1942-06-09 00:00:00,Royal Australian Air Force - RAAF,Flight,Military / Government,Australia,Oceania,4,4,4,0,0,4,0,Technical Failure
1942-06-26 00:00:00,Aeroflot - Russian International Airlines,Flight,Operational,Russia,Asia,4,4,4,0,0,4,0,Terrorism
1942-07-01 00:00:00,Royal Canadian Air Force - RCAF,Flight,Operational,Canada,North America,4,4,4,0,0,4,0,Human Factor
1942-07-04 00:00:00,Royal Australian Air Force - RAAF,Flight,Military / Government,World,World,4,4,4,0,0,4,0,Unknown
1942-07-24 00:00:00,Royal Australian Air Force - RAAF,Flight,Military / Government,Papua New Guinea,Oceania,4,4,4,0,0,4,0,Terrorism
1942-07-30 00:00:00,Royal Australian Air Force - RAAF,Flight,Military / Government,Indonesia,Asia,4,4,4,0,0,4,0,Unknown
1942-08-13 00:00:00,Royal Air Force - RAF,Flight,Military / Government,Ireland,Europe,8,8,4,0,0,4,4,Unknown
1942-08-13 00:00:00,Air France,Landing (descent or approach),Commercial,Algeria,Africa,10,4,0,6,4,4,6,Terrorism
1942-08-20 00:00:00,Royal Air Force - RAF,Flight,Operational,United Kingdom,Europe,4,4,4,0,0,4,0,Human Factor
1942-08-20 00:00:00,Royal Air Force - RAF,Flight,Operational,United Kingdom,Europe,4,4,4,0,0,4,0,Human Factor
1942-08-21 00:00:00,Royal Air Force - RAF,Flight,Operational,United Kingdom,Europe,4,4,4,0,0,4,0,Human Factor
1942-08-29 00:00:00,Royal Air Force - RAF,Flight,Military / Government,Germany,Europe,7,7,4,0,0,4,3,Terrorism
1942-08-30 00:00:00,United States Navy - USN,Flight,Military / Government,United States of America,North America,4,4,4,0,0,4,0,Unknown
1942-09-03 00:00:00,Turkish Air Force - Türk Hava Kuvvetleri,Takeoff (climb),Military / Government,Turkey,Asia,4,4,4,0,0,4,0,Unknown
1942-09-14 00:00:00,Royal Air Force - RAF,Flight,Military / Government,Netherlands,Europe,5,5,4,0,0,4,1,Terrorism
1942-09-21 00:00:00,Royal Air Force - RAF,Flight,Operational,United Kingdom,Europe,4,4,4,0,0,4,0,Unknown
1942-09-24 00:00:00,United States Army Air Forces - USAAF,Flight,Operational,United States of America,North America,4,4,4,0,0,4,0,Human Factor
1942-09-26 00:00:00,British Overseas Airways Corporation - BOAC,Takeoff (climb),Specialised Services,United Kingdom,Europe,4,4,4,0,0,4,0,Unknown
1942-10-09 00:00:00,Royal Australian Air Force - RAAF,Flight,Operational,Australia,Oceania,4,4,4,0,0,4,0,Unknown
1942-10-11 00:00:00,Royal Australian Air Force - RAAF,Flight,Military / Government,Australia,Oceania,4,4,4,0,0,4,0,Unknown
1942-10-15 00:00:00,Royal Air Force - RAF,Flight,Operational,United Kingdom,Europe,4,4,4,0,0,4,0,Human Factor
1942-10-23 00:00:00,Royal Air Force - RAF,Flight,Operational,United Kingdom,Europe,4,4,4,0,0,4,0,Human Factor
1942-10-23 00:00:00,Royal New Zealand Air Force - RNZAF,Flight,Operational,New Zealand,Oceania,4,4,4,0,0,4,0,Human Factor
1942-10-25 00:00:00,Royal Australian Air Force - RAAF,Flight,Military / Government,Indonesia,Asia,4,4,4,0,0,4,0,Unknown
1942-10-27 00:00:00,Royal Australian Air Force - RAAF,Flight,Specialised Services,Australia,Oceania,4,4,4,0,0,4,0,Technical Failure
1942-10-27 00:00:00,Royal Australian Air Force - RAAF,Flight,Military / Government,Papua New Guinea,Oceania,4,4,4,0,0,4,0,Unknown
1942-10-30 00:00:00,Royal Air Force - RAF,Flight,Operational,Canada,North America,4,4,4,0,0,4,0,Human Factor
1942-11-04 00:00:00,Royal Australian Air Force - RAAF,Flight,Military / Government,Australia,Oceania,4,4,4,0,0,4,0,Unknown
1942-11-09 00:00:00,Royal Netherlands Navy - Marineluchtvaartdienst,Flight,Military / Government,Netherlands,Europe,4,4,4,0,0,4,0,Unknown
1942-11-10 00:00:00,Royal Air Force - RAF,Flight,Operational,United Kingdom,Europe,4,4,4,0,0,4,0,Human Factor
1942-11-15 00:00:00,Linee Aeree Transcontinentali Italiane - LATI,Flight,Commercial,World,World,4,4,4,0,0,4,0,Terrorism
1942-11-18 00:00:00,United States Army Air Forces - USAAF,Flight,Operational,United States of America,North America,4,4,4,0,0,4,0,Unknown
1942-11-22 00:00:00,Royal Netherlands Navy - Marineluchtvaartdienst,Flight,Military / Government,World,World,4,4,4,0,0,4,0,Unknown
1942-11-23 00:00:00,Linee Aeree Transcontinentali Italiane - LATI,Flight,Commercial,World,World,4,4,4,0,0,4,0,Terrorism
1942-11-23 00:00:00,Linee Aeree Transcontinentali Italiane - LATI,Flight,Commercial,World,World,4,4,4,0,0,4,0,Terrorism
1942-11-29 00:00:00,United States Army Air Forces - USAAF,Flight,Operational,United States of America,North America,4,4,4,0,0,4,0,Technical Failure
1942-11-30 00:00:00,Royal Air Force - RAF,Landing (descent or approach),Operational,United Kingdom,Europe,4,4,4,0,0,4,0,Human Factor
1942-12-02 00:00:00,United States Army Air Forces - USAAF,Landing (descent or approach),Military / Government,Papua New Guinea,Oceania,9,9,4,0,0,4,5,Unknown
1942-12-05 00:00:00,United States Army Air Forces - USAAF,Landing (descent or approach),Operational,United States of America,North America,4,4,4,0,0,4,0,Unknown
1942-12-06 00:00:00,Royal Air Force - RAF,Flight,Military / Government,Netherlands,Europe,4,4,4,0,0,4,0,Terrorism
1942-12-06 00:00:00,Royal Air Force - RAF,Flight,Military / Government,Netherlands,Europe,4,4,4,0,0,4,0,Terrorism
1942-12-06 00:00:00,Royal Air Force - RAF,Takeoff (climb),Operational,Canada,North America,4,4,4,0,0,4,0,Unknown
1942-12-17 00:00:00,Royal New Zealand Air Force - RNZAF,Flight,Operational,New Zealand,Oceania,4,4,4,0,0,4,0,Human Factor
1942-12-21 00:00:00,Air Travel,Flight,Commercial,New Zealand,Oceania,5,1,0,4,4,4,1,Technical Failure
1942-12-27 00:00:00,Royal Air Force - RAF,Flight,Military / Government,Spain,Europe,4,4,4,0,0,4,0,Unknown
1942-12-27 00:00:00,German Air Force - Deutsche Luftwaffe,Flight,Military / Government,Norway,Europe,6,6,4,0,0,4,2,Unknown
1943-01-06 00:00:00,United States Army Air Forces - USAAF,Flight,Operational,United States of America,North America,4,4,4,0,0,4,0,Technical Failure
1943-01-07 00:00:00,Royal Canadian Air Force - RCAF,Flight,Military / Government,Canada,North America,7,7,4,0,0,4,3,Weather
1943-01-07 00:00:00,United States Army Air Forces - USAAF,Flight,Military / Government,Papua New Guinea,Oceania,7,7,4,0,0,4,3,Terrorism
1943-01-11 00:00:00,Royal Netherlands Navy - Marineluchtvaartdienst,Flight,Operational,United Kingdom,Europe,4,4,4,0,0,4,0,Unknown
1943-01-13 00:00:00,Royal Air Force - RAF,Landing (descent or approach),Operational,United Kingdom,Europe,4,4,4,0,0,4,0,Unknown
1943-01-17 00:00:00,United States Navy - USN,Takeoff (climb),Military / Government,United States of America,North America,8,8,4,0,0,4,4,Unknown
1943-01-22 00:00:00,Royal Air Force - RAF,Flight,Military / Government,World,World,4,4,4,0,0,4,0,Unknown
1943-01-25 00:00:00,Royal New Zealand Air Force - RNZAF,Flight,Operational,New Zealand,Oceania,4,4,4,0,0,4,0,Human Factor
1943-01-27 00:00:00,Royal Netherlands Navy - Marineluchtvaartdienst,Flight,Military / Government,Netherlands,Europe,4,4,4,0,0,4,0,Terrorism
1943-01-30 00:00:00,Royal Air Force - RAF,Flight,Operational,United Kingdom,Europe,4,4,4,0,0,4,0,Unknown
1943-02-04 00:00:00,Royal Air Force - RAF,Flight,Operational,United Kingdom,Europe,4,4,4,0,0,4,0,Human Factor
1943-02-05 00:00:00,Royal Air Force - RAF,Flight,Military / Government,France,Europe,8,8,4,0,0,4,4,Technical Failure
1943-02-08 00:00:00,Royal Air Force - RAF,Flight,Operational,United Kingdom,Europe,4,4,4,0,0,4,0,Unknown
1943-02-15 00:00:00,Royal Air Force - RAF,Flight,Operational,United Kingdom,Europe,4,4,4,0,0,4,0,Human Factor
1943-02-19 00:00:00,Royal Air Force - RAF,Flight,Operational,United Kingdom,Europe,4,4,4,0,0,4,0,Human Factor
1943-02-19 00:00:00,Royal Air Force - RAF,Flight,Operational,United Kingdom,Europe,4,4,4,0,0,4,0,Human Factor
1943-03-06 00:00:00,United States Navy - USN,Landing (descent or approach),Operational,United States of America,North America,4,4,4,0,0,4,0,Unknown
1943-03-10 00:00:00,United States Army Air Forces - USAAF,Landing (descent or approach),Operational,United States of America,North America,4,4,4,0,0,4,0,Unknown
1943-03-12 00:00:00,Royal Air Force - RAF,Landing (descent or approach),Military / Government,Spain,Europe,4,4,4,0,0,4,0,Unknown
1943-03-13 00:00:00,Royal Air Force - RAF,Flight,Operational,Canada,North America,4,3,3,1,1,4,0,Unknown
1943-03-29 00:00:00,Royal Air Force - RAF,Flight,Operational,United Kingdom,Europe,4,4,4,0,0,4,0,Unknown
1943-04-04 00:00:00,Royal Air Force - RAF,Flight,Military / Government,World,World,4,4,4,0,0,4,0,Terrorism
1943-04-06 00:00:00,United States Coast Guard - USCG,Flight,Operational,United States of America,North America,4,4,4,0,0,4,0,Weather
1943-04-11 00:00:00,United States Army Air Forces - USAAF,Flight,Operational,United States of America,North America,4,4,4,0,0,4,0,Unknown
1943-05-07 00:00:00,Regia Aeronautica,Landing (descent or approach),Humanitarian,Italy,Europe,37,5,0,32,4,4,33,Human Factor
1943-05-10 00:00:00,Royal Air Force - RAF,Flight,Operational,United Kingdom,Europe,4,4,4,0,0,4,0,Weather
1943-05-17 00:00:00,United States Army Air Forces - USAAF,Flight,Military / Government,Netherlands,Europe,6,6,4,0,0,4,2,Unknown
1943-05-29 00:00:00,Royal Air Force - RAF,Flight,Operational,United Kingdom,Europe,4,3,3,1,1,4,0,Unknown
1943-06-13 00:00:00,Royal Canadian Air Force - RCAF,Flight,Military / Government,Netherlands,Europe,7,7,4,0,0,4,3,Terrorism
1943-06-13 00:00:00,Royal Australian Air Force - RAAF,Flight,Military / Government,France,Europe,4,4,4,0,0,4,0,Terrorism
1943-06-25 00:00:00,Royal Air Force - RAF,Flight,Operational,Canada,North America,4,4,4,0,0,4,0,Unknown
1943-07-03 00:00:00,United States Navy - USN,Landing (descent or approach),Military / Government,Australia,Oceania,8,8,4,0,0,4,4,Unknown
1943-07-09 00:00:00,United States Army Air Forces - USAAF,Flight,Military / Government,Italy,Europe,4,4,4,0,0,4,0,Terrorism
1943-07-09 00:00:00,United States Army Air Forces - USAAF,Flight,Military / Government,Italy,Europe,4,4,4,0,0,4,0,Terrorism
1943-07-10 00:00:00,United States Army Air Forces - USAAF,Flight,Operational,United States of America,North America,4,4,4,0,0,4,0,Human Factor
1943-07-10 00:00:00,United States Army Air Forces - USAAF,Flight,Operational,United States of America,North America,4,4,4,0,0,4,0,Human Factor
1943-07-10 00:00:00,United States Army Air Forces - USAAF,Flight,Military / Government,Italy,Europe,4,4,4,0,0,4,0,Terrorism
1943-07-11 00:00:00,United States Army Air Forces - USAAF,Flight,Military / Government,Italy,Europe,4,4,4,0,0,4,0,Terrorism
1943-07-11 00:00:00,United States Army Air Forces - USAAF,Flight,Military / Government,Italy,Europe,4,4,4,0,0,4,0,Terrorism
1943-07-13 00:00:00,United States Army Air Forces - USAAF,Flight,Military / Government,Italy,Europe,4,4,4,0,0,4,0,Terrorism
1943-07-13 00:00:00,United States Army Air Forces - USAAF,Flight,Military / Government,India,Asia,4,3,3,1,1,4,0,Unknown
1943-07-13 00:00:00,United States Army Air Forces - USAAF,Flight,Military / Government,Italy,Europe,4,4,4,0,0,4,0,Terrorism
1943-07-13 00:00:00,United States Army Air Forces - USAAF,Flight,Military / Government,Italy,Europe,4,4,4,0,0,4,0,Terrorism
1943-07-17 00:00:00,United States Army Air Forces - USAAF,Flight,Operational,United States of America,North America,4,4,4,0,0,4,0,Human Factor
1943-07-17 00:00:00,United States Army Air Forces - USAAF,Flight,Operational,United States of America,North America,4,4,4,0,0,4,0,Human Factor
1943-07-24 00:00:00,Royal New Zealand Air Force - RNZAF,Flight,Military / Government,Solomon Islands,Oceania,5,5,4,0,0,4,1,Terrorism
1943-07-27 00:00:00,United States Army Air Forces - USAAF,Flight,Military / Government,Oman,Asia,4,4,4,0,0,4,0,Unknown
1943-08-07 00:00:00,Royal Air Force - RAF,Landing (descent or approach),Operational,United Kingdom,Europe,5,5,4,0,0,4,1,Unknown
1943-08-08 00:00:00,United States Army Air Forces - USAAF,Takeoff (climb),Specialised Services,United States of America,North America,5,3,3,2,1,4,1,Technical Failure
1943-08-11 00:00:00,United States Army Air Forces - USAAF,Flight,Military / Government,France,Europe,5,5,4,0,0,4,1,Terrorism
1943-08-15 00:00:00,Royal Australian Air Force - RAAF,Flight,Military / Government,World,World,4,4,4,0,0,4,0,Terrorism
1943-08-18 00:00:00,Royal Air Force - RAF,Flight,Operational,United Kingdom,Europe,4,4,4,0,0,4,0,Unknown
1943-08-18 00:00:00,United States Army Air Forces - USAAF,Flight,Operational,China,Asia,4,4,4,0,0,4,0,Other
1943-08-25 00:00:00,United States Army Air Forces - USAAF,Landing (descent or approach),Military / Government,Australia,Oceania,0,0,4,0,0,4,-4,Unknown
1943-08-27 00:00:00,United States Army Air Forces - USAAF,Flight,Operational,United States of America,North America,4,4,4,0,0,4,0,Unknown
1943-08-28 00:00:00,Royal Air Force - RAF,Flight,Operational,United Kingdom,Europe,4,4,4,0,0,4,0,Human Factor
1943-08-28 00:00:00,Soviet Air Force - Voyenno-vozdushnye sily CCCP,Flight,Military / Government,Russia,Asia,4,4,4,0,0,4,0,Human Factor
1943-08-29 00:00:00,Royal Air Force - RAF,Flight,Military / Government,United Kingdom,Europe,4,4,4,0,0,4,0,Unknown
1943-09-04 00:00:00,Royal Air Force - RAF,Flight,Operational,United Kingdom,Europe,4,2,2,2,2,4,0,Unknown
1943-09-05 00:00:00,United States Army Air Forces - USAAF,Flight,Military / Government,Vanuatu,Oceania,4,4,4,0,0,4,0,Unknown
1943-09-06 00:00:00,Royal Air Force - RAF,Landing (descent or approach),Specialised Services,United Kingdom,Europe,4,4,4,0,0,4,0,Technical Failure
1943-09-23 00:00:00,Royal New Zealand Air Force - RNZAF,Takeoff (climb),Operational,Fiji Islands,Oceania,4,4,4,0,0,4,0,Human Factor
1943-09-27 00:00:00,United States Army Air Forces - USAAF,Flight,Operational,United States of America,North America,4,4,4,0,0,4,0,Technical Failure
1943-10-05 00:00:00,Royal Air Force - RAF,Flight,Operational,United Kingdom,Europe,4,4,4,0,0,4,0,Human Factor
1943-10-24 00:00:00,United States Navy - USN,Landing (descent or approach),Operational,United States of America,North America,7,7,4,0,0,4,3,Human Factor
1943-10-25 00:00:00,Royal Netherlands Navy - Marineluchtvaartdienst,Flight,Military / Government,France,Europe,4,4,4,0,0,4,0,Terrorism
1943-10-27 00:00:00,United States Army Air Forces - USAAF,Flight,Operational,Canada,North America,4,4,4,0,0,4,0,Human Factor
1943-10-28 00:00:00,Royal Netherlands Navy - Marineluchtvaartdienst,Flight,Military / Government,France,Europe,4,4,4,0,0,4,0,Terrorism
1943-11-07 00:00:00,Royal Air Force - RAF,Takeoff (climb),Operational,United Kingdom,Europe,4,4,4,0,0,4,0,Human Factor
1943-11-19 00:00:00,United States Navy - USN,Takeoff (climb),Military / Government,United States of America,North America,4,3,3,1,1,4,0,Unknown
1943-11-21 00:00:00,Royal Air Force - RAF,Flight,Operational,United Kingdom,Europe,4,4,4,0,0,4,0,Technical Failure
1943-11-26 00:00:00,Soviet Air Force - Voyenno-vozdushnye sily CCCP,Flight,Military / Government,Russia,Asia,4,3,3,1,1,4,0,Technical Failure
1943-11-30 00:00:00,United States Army Air Forces - USAAF,Flight,Operational,United Kingdom,Europe,4,4,4,0,0,4,0,Human Factor
1943-12-03 00:00:00,Royal New Zealand Air Force - RNZAF,Landing (descent or approach),Military / Government,Fiji Islands,Oceania,4,4,4,0,0,4,0,Unknown
1943-12-07 00:00:00,Royal New Zealand Air Force - RNZAF,Flight,Military / Government,Solomon Islands,Oceania,5,5,4,0,0,4,1,Unknown
1943-12-14 00:00:00,Royal Air Force - RAF,Flight,Military / Government,Ireland,Europe,5,5,4,0,0,4,1,Human Factor
1943-12-21 00:00:00,United States Army Air Forces - USAAF,Flight,Specialised Services,United States of America,North America,5,5,4,0,0,4,1,Technical Failure
1943-12-23 00:00:00,United States Army Air Forces - USAAF,Takeoff (climb),Military / Government,United Kingdom,Europe,4,4,4,0,0,4,0,Unknown
1943-12-25 00:00:00,Royal Air Force - RAF,Flight,Military / Government,World,World,4,4,4,0,0,4,0,Unknown
1943-12-26 00:00:00,Royal Air Force - RAF,Flight,Operational,United Kingdom,Europe,4,4,4,0,0,4,0,Human Factor
1943-12-28 00:00:00,United States Army Air Forces - USAAF,Flight,Military / Government,United States of America,North America,4,4,4,0,0,4,0,Technical Failure
1944-01-04 00:00:00,Royal Air Force - RAF,Landing (descent or approach),Military / Government,United Kingdom,Europe,4,4,4,0,0,4,0,Technical Failure
1944-01-24 00:00:00,United States Army Air Forces - USAAF,Flight,Military / Government,United States of America,North America,4,4,4,0,0,4,0,Unknown
1944-01-29 00:00:00,United States Army Air Forces - USAAF,Flight,Military / Government,India,Asia,4,4,4,0,0,4,0,Unknown
1944-01-31 00:00:00,United States Army Air Forces - USAAF,Flight,Operational,India,Asia,4,4,4,0,0,4,0,Unknown
1944-02-04 00:00:00,Royal Canadian Air Force - RCAF,Flight,Military / Government,Canada,North America,5,1,1,4,3,4,1,Human Factor
1944-02-07 00:00:00,United States Army Air Forces - USAAF,Flight,Operational,United States of America,North America,4,4,4,0,0,4,0,Human Factor
1944-02-13 00:00:00,United States Army Air Forces - USAAF,Landing (descent or approach),Operational,United States of America,North America,4,4,4,0,0,4,0,Human Factor
1944-02-15 00:00:00,Royal Air Force - RAF,Flight,Military / Government,Netherlands,Europe,7,7,4,0,0,4,3,Terrorism
1944-02-20 00:00:00,United States Army Air Forces - USAAF,Landing (descent or approach),Military / Government,United States of America,North America,4,4,4,0,0,4,0,Human Factor
1944-02-20 00:00:00,United States Army Air Forces - USAAF,Flight,Military / Government,India,Asia,4,4,4,0,0,4,0,Human Factor
1944-03-06 00:00:00,United States Army Air Forces - USAAF,Flight,Military / Government,Netherlands,Europe,10,10,4,0,0,4,6,Terrorism
1944-03-06 00:00:00,United States Army Air Forces - USAAF,Flight,Military / Government,Netherlands,Europe,10,10,4,0,0,4,6,Terrorism
1944-03-20 00:00:00,Royal Netherlands Navy - Marineluchtvaartdienst,Flight,Military / Government,France,Europe,4,4,4,0,0,4,0,Terrorism
1944-03-22 00:00:00,United States Army Air Forces - USAAF,Landing (descent or approach),Military / Government,United States of America,North America,5,5,4,0,0,4,1,Unknown
1944-03-22 00:00:00,United States Army Air Forces - USAAF,Flight,Military / Government,United States of America,North America,9,9,4,0,0,4,5,Unknown
1944-03-24 00:00:00,United States Army Air Forces - USAAF,Flight,Operational,India,Asia,4,4,4,0,0,4,0,Unknown
1944-03-31 00:00:00,Royal Air Force - RAF,Flight,Military / Government,Germany,Europe,7,7,4,0,0,4,3,Terrorism
1944-03-31 00:00:00,United States Army Air Forces - USAAF,Flight,Military / Government,United States of America,North America,4,4,4,0,0,4,0,Unknown
1944-04-16 00:00:00,United States Army Air Forces - USAAF,Flight,Military / Government,Papua New Guinea,Oceania,6,6,4,0,0,4,2,Unknown
1944-04-24 00:00:00,United States Army Air Forces - USAAF,Landing (descent or approach),Military / Government,India,Asia,4,4,4,0,0,4,0,Terrorism
1944-04-25 00:00:00,Royal Air Force - RAF,Flight,Operational,Ireland,Europe,4,4,4,0,0,4,0,Unknown
1944-05-05 00:00:00,Pennsylvania Central Air Lines,Flight,Military / Government,United States of America,North America,4,2,2,2,2,4,0,Human Factor
1944-05-05 00:00:00,United States Army Air Forces - USAAF,Flight,Operational,United States of America,North America,4,4,4,0,0,4,0,Human Factor
1944-05-06 00:00:00,United States Army Air Forces - USAAF,Flight,Operational,United States of America,North America,4,4,4,0,0,4,0,Human Factor
1944-05-13 00:00:00,Royal Air Force - RAF,Flight,Operational,United Kingdom,Europe,4,4,4,0,0,4,0,Weather
1944-05-15 00:00:00,Swedish Air Force - Flygvapnet,Flight,Military / Government,World,World,4,4,4,0,0,4,0,Terrorism
1944-05-22 00:00:00,Royal Australian Air Force - RAAF,Flight,Military / Government,Australia,Oceania,4,4,4,0,0,4,0,Unknown
1944-05-23 00:00:00,Swedish Air Force - Flygvapnet,,Military / Government,World,World,4,4,4,0,0,4,0,Terrorism
1944-05-25 00:00:00,United States Army Air Forces - USAAF,Flight,Military / Government,Myanmar,Asia,5,3,2,2,2,4,1,Unknown
1944-05-26 00:00:00,German Air Force - Deutsche Luftwaffe,Flight,Military / Government,Spain,Europe,4,4,4,0,0,4,0,Terrorism
1944-05-27 00:00:00,Royal Air Force - RAF,Flight,Operational,United Kingdom,Europe,8,8,4,0,0,4,4,Technical Failure
1944-05-31 00:00:00,German Air Force - Deutsche Luftwaffe,Flight,Military / Government,Spain,Europe,4,4,4,0,0,4,0,Unknown
1944-06-06 00:00:00,United States Army Air Forces - USAAF,Flight,Military / Government,France,Europe,4,4,4,0,0,4,0,Terrorism
1944-06-06 00:00:00,United States Army Air Forces - USAAF,Flight,Military / Government,France,Europe,4,4,4,0,0,4,0,Terrorism
1944-06-06 00:00:00,United States Army Air Forces - USAAF,Flight,Military / Government,France,Europe,4,4,4,0,0,4,0,Terrorism
1944-06-07 00:00:00,Swedish Air Force - Flygvapnet,Flight,Military / Government,Sweden,Europe,4,4,4,0,0,4,0,Unknown
1944-06-07 00:00:00,Royal Australian Air Force - RAAF,Flight,Military / Government,Papua New Guinea,Oceania,4,4,4,0,0,4,0,Unknown
1944-06-08 00:00:00,Royal Netherlands Navy - Marineluchtvaartdienst,Flight,Military / Government,United Kingdom,Europe,4,4,4,0,0,4,0,Unknown
1944-06-08 00:00:00,Royal Netherlands Navy - Marineluchtvaartdienst,Flight,Military / Government,United Kingdom,Europe,4,4,4,0,0,4,0,Unknown
1944-06-08 00:00:00,Royal Air Force - RAF,Flight,Military / Government,United Kingdom,Europe,4,4,4,0,0,4,0,Human Factor
1944-06-08 00:00:00,Royal Netherlands Navy - Marineluchtvaartdienst,Flight,Military / Government,France,Europe,4,4,4,0,0,4,0,Terrorism
1944-06-13 00:00:00,Royal Air Force - RAF,Flight,Operational,United Kingdom,Europe,5,5,4,0,0,4,1,Human Factor
1944-06-14 00:00:00,United States Army Air Forces - USAAF,Flight,Military / Government,India,Asia,4,4,4,0,0,4,0,Unknown
1944-06-15 00:00:00,United States Army Air Forces - USAAF,Flight,Military / Government,Myanmar,Asia,4,4,4,0,0,4,0,Weather
1944-06-24 00:00:00,Royal Netherlands Navy - Marineluchtvaartdienst,Flight,Military / Government,France,Europe,4,4,4,0,0,4,0,Terrorism
1944-06-29 00:00:00,United States Army Air Forces - USAAF,Flight,Operational,China,Asia,4,4,4,0,0,4,0,Unknown
1944-07-26 00:00:00,Royal Netherlands Navy - Marineluchtvaartdienst,Flight,Military / Government,France,Europe,4,4,4,0,0,4,0,Terrorism
1944-07-29 00:00:00,Royal Netherlands Navy - Marineluchtvaartdienst,Flight,Military / Government,France,Europe,4,4,4,0,0,4,0,Terrorism
1944-07-30 00:00:00,Royal Air Force - RAF,Flight,Military / Government,Myanmar,Asia,4,4,4,0,0,4,0,Terrorism
1944-08-01 00:00:00,Royal Canadian Air Force - RCAF,Flight,Operational,Canada,North America,4,4,4,0,0,4,0,Unknown
1944-08-08 00:00:00,Royal New Zealand Air Force - RNZAF,Flight,Military / Government,Vanuatu,Oceania,4,4,4,0,0,4,0,Human Factor
1944-08-13 00:00:00,United States Navy - USN,Flight,Military / Government,World,World,4,4,4,0,0,4,0,Unknown
1944-08-19 00:00:00,Royal Netherlands Navy - Marineluchtvaartdienst,Flight,Military / Government,France,Europe,4,4,4,0,0,4,0,Terrorism
1944-08-24 00:00:00,United States Army Air Forces - USAAF,,Military / Government,France,Europe,4,4,4,0,0,4,0,Unknown
1944-09-05 00:00:00,United States Navy - USN,Flight,Operational,World,World,4,4,4,0,0,4,0,Technical Failure
1944-09-09 00:00:00,United States Army Air Forces - USAAF,Takeoff (climb),Military / Government,India,Asia,4,4,4,0,0,4,0,Unknown
1944-09-11 00:00:00,United States Army Air Forces - USAAF,Takeoff (climb),Operational,India,Asia,4,4,4,0,0,4,0,Unknown
1944-09-17 00:00:00,United States Army Air Forces - USAAF,Flight,Military / Government,Netherlands,Europe,5,5,4,0,0,4,1,Terrorism
1944-09-17 00:00:00,United States Army Air Forces - USAAF,Flight,Military / Government,Netherlands,Europe,5,5,4,0,0,4,1,Terrorism
1944-09-17 00:00:00,United States Army Air Forces - USAAF,Flight,Military / Government,Netherlands,Europe,5,5,4,0,0,4,1,Terrorism
1944-09-17 00:00:00,United States Army Air Forces - USAAF,Flight,Military / Government,Netherlands,Europe,4,4,4,0,0,4,0,Terrorism
1944-09-17 00:00:00,United States Army Air Forces - USAAF,Flight,Military / Government,Netherlands,Europe,20,5,4,15,0,4,16,Terrorism
1944-09-18 00:00:00,Royal Air Force - RAF,Flight,Military / Government,World,World,4,4,4,0,0,4,0,Unknown
1944-10-14 00:00:00,Royal Air Force - RAF,Flight,Military / Government,Germany,Europe,7,7,4,0,0,4,3,Unknown
1944-10-15 00:00:00,Royal Australian Air Force - RAAF,Flight,Operational,Australia,Oceania,4,4,4,0,0,4,0,Unknown
1944-10-25 00:00:00,United States Army Air Forces - USAAF,Flight,Military / Government,United Kingdom,Europe,4,4,4,0,0,4,0,Other
1944-10-29 00:00:00,United States Army Air Forces - USAAF,Flight,Operational,China,Asia,4,4,4,0,0,4,0,Technical Failure
1944-10-31 00:00:00,United States Army Air Forces - USAAF,Flight,Military / Government,France,Europe,18,7,4,11,0,4,14,Weather
1944-11-03 00:00:00,Royal Air Force - RAF,Landing (descent or approach),Operational,Canada,North America,4,4,4,0,0,4,0,Unknown
1944-11-07 00:00:00,United States Army Air Forces - USAAF,Flight,Military / Government,France,Europe,4,4,4,0,0,4,0,Human Factor
1944-11-09 00:00:00,United States Army Air Forces - USAAF,Takeoff (climb),Military / Government,United States of America,North America,4,4,4,0,0,4,0,Unknown
1944-11-12 00:00:00,United States Army Air Forces - USAAF,Landing (descent or approach),Operational,United Kingdom,Europe,4,4,4,0,0,4,0,Human Factor
1944-11-13 00:00:00,Aeroflot - Russian International Airlines,Flight,Military / Government,Ukraine,Europe,8,6,4,2,0,4,4,Human Factor
1944-11-13 00:00:00,United States Army Air Forces - USAAF,Flight,Military / Government,World,World,4,4,4,0,0,4,0,Unknown
1944-11-20 00:00:00,Royal Air Force - RAF,Landing (descent or approach),Operational,United Kingdom,Europe,8,8,4,0,0,4,4,Human Factor
1944-11-23 00:00:00,United States Army Air Forces - USAAF,Flight,Operational,World,World,4,4,4,0,0,4,0,Unknown
1944-11-25 00:00:00,United States Army Air Forces - USAAF,Flight,Operational,United States of America,North America,4,4,4,0,0,4,0,Weather
1944-11-27 00:00:00,Royal Air Force - RAF,Flight,Military / Government,Belgium,Europe,4,4,4,0,0,4,0,Terrorism
1944-12-03 00:00:00,United States Army Air Forces - USAAF,Flight,Military / Government,France,Europe,4,4,4,0,0,4,0,Weather
1944-12-06 00:00:00,United States Army Air Forces - USAAF,Landing (descent or approach),Military / Government,Belgium,Europe,4,4,4,0,0,4,0,Unknown
1944-12-06 00:00:00,Royal Air Force - RAF,Flight,Operational,United Kingdom,Europe,4,4,4,0,0,4,0,Human Factor
1944-12-08 00:00:00,Air France,Flight,Commercial,France,Europe,4,3,3,1,1,4,0,Unknown
1944-12-10 00:00:00,United States Army Air Forces - USAAF,Flight,Military / Government,China,Asia,4,4,4,0,0,4,0,Unknown
1944-12-13 00:00:00,United States Army Air Forces - USAAF,Flight,Operational,United States of America,North America,4,4,4,0,0,4,0,Human Factor
1944-12-19 00:00:00,United States Army Air Forces - USAAF,Flight,Operational,Myanmar,Asia,4,4,4,0,0,4,0,Unknown
1944-12-20 00:00:00,Royal New Zealand Air Force - RNZAF,Flight,Military / Government,Papua New Guinea,Oceania,5,5,4,0,0,4,1,Human Factor
1944-12-27 00:00:00,United States Army Air Forces - USAAF,Flight,Military / Government,Belgium,Europe,5,5,4,0,0,4,1,Terrorism
1945-01-02 00:00:00,Royal Air Force - RAF,Flight,Military / Government,United Kingdom,Europe,4,4,4,0,0,4,0,Human Factor
1945-01-04 00:00:00,Panagra - Pan American-Grace Airways,Flight,Business,Peru,South America,4,2,2,2,2,4,0,Human Factor
1945-01-06 00:00:00,China National Aviation Corporation - CNAC,Flight,Operational,Myanmar,Asia,4,4,4,0,0,4,0,Weather
1945-01-08 00:00:00,Royal Air Force - RAF,Flight,Military / Government,France,Europe,4,4,4,0,0,4,0,Terrorism
1945-01-13 00:00:00,Royal Air Force - RAF,Flight,Military / Government,United Kingdom,Europe,4,2,2,2,2,4,0,Human Factor
1945-01-13 00:00:00,Royal Netherlands Navy - Marineluchtvaartdienst,Flight,Military / Government,Belgium,Europe,4,4,4,0,0,4,0,Terrorism
1945-01-13 00:00:00,Royal Netherlands Navy - Marineluchtvaartdienst,Flight,Military / Government,Belgium,Europe,4,4,4,0,0,4,0,Terrorism
1945-01-14 00:00:00,China National Aviation Corporation - CNAC,Flight,Military / Government,Myanmar,Asia,6,6,4,0,0,4,2,Human Factor
1945-01-16 00:00:00,United States Army Air Forces - USAAF,Flight,Military / Government,United States of America,North America,4,4,4,0,0,4,0,Unknown
1945-01-22 00:00:00,French Air Force - Armée de l'Air,Flight,Military / Government,France,Europe,7,7,4,0,0,4,3,Terrorism
1945-01-27 00:00:00,United States Army Air Forces - USAAF,Landing (descent or approach),Military / Government,United States of America,North America,4,4,4,0,0,4,0,Human Factor
1945-02-01 00:00:00,Royal Air Force - RAF,Flight,Operational,United Kingdom,Europe,4,4,4,0,0,4,0,Unknown
1945-02-06 00:00:00,Royal Air Force - RAF,Flight,Operational,World,World,4,4,4,0,0,4,0,Unknown
1945-02-09 00:00:00,Royal Netherlands Navy - Marineluchtvaartdienst,Flight,Military / Government,Belgium,Europe,4,4,4,0,0,4,0,Unknown
1945-02-12 00:00:00,Royal Canadian Air Force - RCAF,Landing (descent or approach),Military / Government,Canada,North America,8,8,4,0,0,4,4,Human Factor
1945-02-13 00:00:00,Royal Air Force - RAF,Landing (descent or approach),Military / Government,India,Asia,4,4,4,0,0,4,0,Human Factor
1945-02-14 00:00:00,United States Army Air Forces - USAAF,Flight,Operational,United States of America,North America,6,5,4,1,0,4,2,Technical Failure
1945-02-17 00:00:00,United States Navy - USN,Flight,Military / Government,World,World,4,4,4,0,0,4,0,Technical Failure
1945-02-18 00:00:00,United States Army Air Forces - USAAF,Takeoff (climb),Military / Government,Iran,Asia,4,4,4,0,0,4,0,Technical Failure
1945-02-22 00:00:00,United States Army Air Forces - USAAF,Flight,Military / Government,France,Europe,4,4,4,0,0,4,0,Terrorism
1945-02-28 00:00:00,United States Army Air Forces - USAAF,Flight,Operational,Australia,Oceania,4,4,4,0,0,4,0,Unknown
1945-03-01 00:00:00,Royal Air Force - RAF,Flight,Military / Government,China,Asia,4,4,4,0,0,4,0,Unknown
1945-03-04 00:00:00,United States Army Air Forces - USAAF,Flight,Military / Government,United Kingdom,Europe,4,4,4,0,0,4,0,Terrorism
1945-03-06 00:00:00,Royal Air Force - RAF,Flight,Operational,United Kingdom,Europe,5,5,4,0,0,4,1,Unknown
1945-03-11 00:00:00,United States Army Air Forces - USAAF,Flight,Military / Government,India,Asia,4,4,4,0,0,4,0,Unknown
1945-03-16 00:00:00,United States Army Air Forces - USAAF,Flight,Military / Government,China,Asia,4,4,4,0,0,4,0,Unknown
1945-03-21 00:00:00,Royal Air Force - RAF,Flight,Military / Government,Belgium,Europe,4,4,4,0,0,4,0,Terrorism
1945-03-24 00:00:00,United States Army Air Forces - USAAF,Flight,Military / Government,Germany,Europe,4,4,4,0,0,4,0,Terrorism
1945-03-24 00:00:00,United States Army Air Forces - USAAF,Flight,Military / Government,Germany,Europe,4,4,4,0,0,4,0,Terrorism
1945-03-24 00:00:00,United States Army Air Forces - USAAF,Flight,Military / Government,Germany,Europe,4,4,4,0,0,4,0,Terrorism
1945-03-24 00:00:00,United States Army Air Forces - USAAF,Flight,Military / Government,Germany,Europe,4,4,4,0,0,4,0,Terrorism
1945-03-24 00:00:00,United States Army Air Forces - USAAF,Flight,Military / Government,Germany,Europe,4,4,4,0,0,4,0,Terrorism
1945-03-28 00:00:00,Royal Air Force - RAF,Landing (descent or approach),Operational,United Kingdom,Europe,4,4,4,0,0,4,0,Unknown
1945-03-31 00:00:00,United States Army Air Forces - USAAF,Landing (descent or approach),Military / Government,United Kingdom,Europe,4,4,4,0,0,4,0,Human Factor
1945-04-04 00:00:00,Royal Air Force - RAF,Flight,Operational,United Kingdom,Europe,4,4,4,0,0,4,0,Unknown
1945-04-06 00:00:00,United States Army Air Forces - USAAF,Flight,Military / Government,Belgium,Europe,4,4,4,0,0,4,0,Unknown
1945-04-06 00:00:00,United States Army Air Forces - USAAF,Flight,Military / Government,Belgium,Europe,4,4,4,0,0,4,0,Unknown
1945-04-07 00:00:00,United States Army Air Forces - USAAF,Flight,Military / Government,China,Asia,4,3,3,1,1,4,0,Unknown
1945-04-09 00:00:00,United States Army Air Forces - USAAF,Flight,Military / Government,Germany,Europe,4,4,4,0,0,4,0,Unknown
1945-04-14 00:00:00,United States Army Air Forces - USAAF,Flight,Military / Government,Germany,Europe,4,4,4,0,0,4,0,Unknown
1945-04-18 00:00:00,United States Army Air Forces - USAAF,Takeoff (climb),Operational,United States of America,North America,5,5,4,0,0,4,1,Technical Failure
1945-04-18 00:00:00,United States Army Air Forces - USAAF,Flight,Operational,United States of America,North America,4,4,4,0,0,4,0,Unknown
1945-04-21 00:00:00,United States Army Air Forces - USAAF,Flight,Operational,Myanmar,Asia,4,4,4,0,0,4,0,Unknown
1945-05-05 00:00:00,United States Army Air Forces - USAAF,Flight,Military / Government,India,Asia,4,4,4,0,0,4,0,Unknown
1945-05-15 00:00:00,United States Army Air Forces - USAAF,Flight,Military / Government,Myanmar,Asia,4,4,4,0,0,4,0,Unknown
1945-05-17 00:00:00,United States Navy - USN,Flight,Military / Government,Papua New Guinea,Oceania,4,4,4,0,0,4,0,Unknown
1945-05-23 00:00:00,United States Army Air Forces - USAAF,Takeoff (climb),Operational,United States of America,North America,4,4,4,0,0,4,0,Technical Failure
1945-05-25 00:00:00,United States Army Air Forces - USAAF,Flight,Military / Government,Myanmar,Asia,4,4,4,0,0,4,0,Unknown
1945-05-27 00:00:00,United States Army Air Forces - USAAF,Flight,Military / Government,Myanmar,Asia,4,4,4,0,0,4,0,Unknown
1945-06-05 00:00:00,Royal Air Force - RAF,Flight,Military / Government,Myanmar,Asia,4,4,4,0,0,4,0,Unknown
1945-06-07 00:00:00,United States Navy - USN,Flight,Military / Government,Papua New Guinea,Oceania,4,4,4,0,0,4,0,Unknown
1945-06-12 00:00:00,United States Army Air Forces - USAAF,Flight,Military / Government,Indonesia,Asia,4,4,4,0,0,4,0,Unknown
1945-06-18 00:00:00,United States Army Air Forces - USAAF,Flight,Military / Government,Algeria,Africa,4,4,4,0,0,4,0,Unknown
1945-06-20 00:00:00,Royal Air Force - RAF,Flight,Military / Government,Myanmar,Asia,4,4,4,0,0,4,0,Unknown
1945-06-23 00:00:00,Royal Air Force - RAF,Flight,Military / Government,Myanmar,Asia,4,4,4,0,0,4,0,Technical Failure
1945-06-26 00:00:00,Royal Air Force - RAF,Flight,Military / Government,Myanmar,Asia,4,4,4,0,0,4,0,Technical Failure
1945-07-01 00:00:00,Royal New Zealand Air Force - RNZAF,Takeoff (climb),Military / Government,Papua New Guinea,Oceania,4,4,4,0,0,4,0,Unknown
1945-07-01 00:00:00,Royal Australian Air Force - RAAF,Flight,Military / Government,Indonesia,Asia,11,11,4,0,0,4,7,Terrorism
1945-07-02 00:00:00,Royal Air Force - RAF,Flight,Military / Government,Myanmar,Asia,4,4,4,0,0,4,0,Weather
1945-07-03 00:00:00,United States Army Air Forces - USAAF,Landing (descent or approach),Military / Government,Portugal,Europe,4,4,4,0,0,4,0,Unknown
1945-07-06 00:00:00,United States Army Air Forces - USAAF,Takeoff (climb),Operational,China,Asia,4,4,4,0,0,4,0,Technical Failure
1945-07-08 00:00:00,United States Army Air Forces - USAAF,Takeoff (climb),Military / Government,India,Asia,4,4,4,0,0,4,0,Unknown
1945-07-17 00:00:00,United States Army Air Forces - USAAF,Flight,Operational,India,Asia,4,4,4,0,0,4,0,Unknown
1945-07-20 00:00:00,United States Army Air Forces - USAAF,Landing (descent or approach),Operational,United States of America,North America,4,4,4,0,0,4,0,Unknown
1945-07-28 00:00:00,United States Army Air Forces - USAAF,Takeoff (climb),Military / Government,Bangladesh,Asia,4,4,4,0,0,4,0,Unknown
1945-07-30 00:00:00,United States Army Air Forces - USAAF,Flight,Operational,India,Asia,4,4,4,0,0,4,0,Unknown
1945-08-01 00:00:00,Brazilian Air Force - Força Aérea Brasileira,Landing (descent or approach),Operational,Brazil,South America,4,4,4,0,0,4,0,Unknown
1945-08-03 00:00:00,Pan American World Airways - PAA,Landing (descent or approach),Commercial,Martinique,Central America,14,4,0,10,4,4,10,Human Factor
1945-08-06 00:00:00,United States Army Air Forces - USAAF,Flight,Military / Government,India,Asia,4,4,4,0,0,4,0,Unknown
1945-08-16 00:00:00,Royal Australian Air Force - RAAF,Takeoff (climb),Military / Government,Australia,Oceania,19,8,2,11,2,4,15,Technical Failure
1945-08-18 00:00:00,United States Army Air Forces - USAAF,Landing (descent or approach),Military / Government,Switzerland,Europe,6,6,4,0,0,4,2,Human Factor
1945-08-18 00:00:00,Japan Air Self-Defense Force - Kōkū Jieitai,Takeoff (climb),Military / Government,Taiwan,Asia,4,2,2,2,2,4,0,Technical Failure
1945-09-26 00:00:00,Royal Air Force - RAF,Flight,Military / Government,Myanmar,Asia,4,4,4,0,0,4,0,Unknown
1945-10-05 00:00:00,United States Army Air Forces - USAAF,Flight,Military / Government,United States of America,North America,4,4,4,0,0,4,0,Human Factor
1945-10-19 00:00:00,Royal Canadian Air Force - RCAF,Takeoff (climb),Military / Government,United Kingdom,Europe,7,7,4,0,0,4,3,Human Factor
1945-10-21 00:00:00,United States Army Air Forces - USAAF,Takeoff (climb),Military / Government,United States of America,North America,4,4,4,0,0,4,0,Technical Failure
1945-10-28 00:00:00,Royal Air Force - RAF,Landing (descent or approach),Military / Government,United Kingdom,Europe,4,4,4,0,0,4,0,Technical Failure
1945-11-01 00:00:00,United States Army Air Forces - USAAF,Flight,Military / Government,United States of America,North America,4,4,4,0,0,4,0,Weather
1945-11-15 00:00:00,United States Army Air Forces - USAAF,Flight,Military / Government,Germany,Europe,4,1,1,3,3,4,0,Weather
1945-12-11 00:00:00,United States Army Air Forces - USAAF,Flight,Military / Government,World,World,4,4,4,0,0,4,0,Unknown
1946-01-03 00:00:00,Royal Air Force - RAF,Landing (descent or approach),Military / Government,United Kingdom,Europe,5,3,2,2,2,4,1,Human Factor
1946-01-08 00:00:00,Royal Air Force - RAF,Landing (descent or approach),Operational,United Kingdom,Europe,7,7,4,0,0,4,3,Human Factor
1946-01-14 00:00:00,French Navy,Flight,Military / Government,Morocco,Africa,4,4,4,0,0,4,0,Unknown
1946-01-30 00:00:00,GLAM - Groupe de Liaisons Aériennes Ministérielles,Flight,Military / Government,France,Europe,4,1,1,3,3,4,0,Weather
1946-02-28 00:00:00,Royal New Zealand Air Force - RNZAF,Flight,Other,New Zealand,Oceania,4,4,4,0,0,4,0,Human Factor
1946-03-08 00:00:00,Royal Air Force - RAF,Takeoff (climb),Military / Government,United Kingdom,Europe,13,13,4,0,0,4,9,Technical Failure
1946-03-26 00:00:00,Royal Air Force - RAF,Landing (descent or approach),Specialised Services,China,Asia,4,3,3,1,1,4,0,Human Factor
1946-03-29 00:00:00,Royal Air Force - RAF,Landing (descent or approach),Military / Government,India,Asia,6,3,1,3,3,4,2,Technical Failure
1946-04-05 00:00:00,Royal Air Force - RAF,Flight,Operational,Malta,Europe,4,4,4,0,0,4,0,Technical Failure
1946-05-20 00:00:00,United States Army Air Forces - USAAF,Flight,Military / Government,United States of America,North America,4,4,4,0,0,4,0,Human Factor
1946-05-26 00:00:00,United States Navy - USN,Flight,Operational,United States of America,North America,4,4,4,0,0,4,0,Unknown
1946-06-28 00:00:00,Turkish Air Force - Türk Hava Kuvvetleri,Flight,Operational,Turkey,Asia,4,4,4,0,0,4,0,Unknown
1946-08-01 00:00:00,Royal Air Force - RAF,Flight,Operational,United Kingdom,Europe,4,4,4,0,0,4,0,Human Factor
1946-08-09 00:00:00,Atlantic Central Airlines,Landing (descent or approach),Commercial,United States of America,North America,6,2,2,4,2,4,2,Technical Failure
1946-08-14 00:00:00,Turkish Air Force - Türk Hava Kuvvetleri,Flight,Operational,Turkey,Asia,4,4,4,0,0,4,0,Unknown
1946-09-07 00:00:00,Mount McKinley Airfreight,Landing (descent or approach),Commercial,United States of America,North America,4,2,2,2,2,4,0,Human Factor
1946-10-22 00:00:00,Royal Air Force - RAF,Flight,Operational,World,World,4,4,4,0,0,4,0,Unknown
1946-12-31 00:00:00,Aeroflot - Russian International Airlines,Flight,Operational,Kazakhstan,Asia,4,4,4,0,0,4,0,Weather
1947-01-25 00:00:00,Philippine Airlines - PAL,Landing (descent or approach),Operational,China,Asia,4,4,4,0,0,4,0,Human Factor
1947-02-04 00:00:00,Organização Mineira de Transportes Aéreos,Flight,Commercial,Brazil,South America,9,1,1,8,3,4,5,Technical Failure
1947-02-11 00:00:00,United States Coast Guard - USCG,Flight,Operational,United States of America,North America,6,4,4,2,0,4,2,Human Factor
1947-02-20 00:00:00,French Air Force - Armée de l'Air,Landing (descent or approach),Military / Government,Germany,Europe,4,4,4,0,0,4,0,Technical Failure
1947-02-22 00:00:00,Spanish Air Force - Ejército del Aire,Flight,Military / Government,Spain,Europe,4,4,4,0,0,4,0,Unknown
1947-03-13 00:00:00,Loftleidir Icelandic Airlines,Takeoff (climb),Commercial,Iceland,Europe,4,2,2,2,2,4,0,Unknown
1947-04-05 00:00:00,United States Army Air Forces - USAAF,Flight,Military / Government,United States of America,North America,4,2,2,2,2,4,0,Unknown
1947-05-11 00:00:00,Trans World Airlines - TWA,Flight,Operational,United States of America,North America,4,4,4,0,0,4,0,Human Factor
1947-05-15 00:00:00,Secrétariat Général de l'Aviation Civile - SGAC,Flight,Specialised Services,France,Europe,4,2,2,2,2,4,0,Human Factor
1947-06-19 00:00:00,Lineas Aéreas de Transporte Nacional - LATN,Flight,Military / Government,Paraguay,South America,4,2,2,2,2,4,0,Weather
1947-07-01 00:00:00,Aeroflot - Russian International Airlines,Takeoff (climb),Operational,Russia,Asia,6,5,4,1,0,4,2,Technical Failure
1947-08-06 00:00:00,Aeroflot - Russian International Airlines,Landing (descent or approach),Operational,Azerbaijan,Asia,6,6,4,0,0,4,2,Human Factor
1947-08-15 00:00:00,Transporte Aéreo de Carga Internacional,Landing (descent or approach),Operational,Uruguay,South America,7,5,4,2,0,4,3,Unknown
1947-08-23 00:00:00,Minister of Supply %26 Aircraft Production,Takeoff (climb),Specialised Services,United Kingdom,Europe,6,6,4,0,0,4,2,Other
1947-09-06 00:00:00,Gidrometeosluzhba,Takeoff (climb),Operational,Russia,Asia,6,4,3,2,1,4,2,Technical Failure
1947-10-21 00:00:00,Royal Air Force - RAF,Flight,Operational,United Kingdom,Europe,10,7,1,3,3,4,6,Technical Failure
1947-12-05 00:00:00,Lancashire Aircraft Corporation - LAC,Landing (descent or approach),Operational,United Kingdom,Europe,4,4,4,0,0,4,0,Human Factor
1947-12-19 00:00:00,Turkish Air Force - Türk Hava Kuvvetleri,Flight,Operational,Turkey,Asia,4,4,4,0,0,4,0,Unknown
1948-01-10 00:00:00,Corrieri Aerei Militari - CAM,Flight,Military / Government,Italy,Europe,4,4,4,0,0,4,0,Unknown
1948-01-24 00:00:00,United States Coast Guard - USCG,Flight,Operational,United States of America,North America,4,4,4,0,0,4,0,Weather
1948-02-07 00:00:00,United States Air Force - USAF,Flight,Military / Government,United States of America,North America,10,2,0,8,4,4,6,Unknown
1948-03-02 00:00:00,Société de Transports Aériens - STA,Flight,Operational,World,World,4,3,3,1,1,4,0,Unknown
1948-03-07 00:00:00,Loftleidir Icelandic Airlines,Flight,Commercial,Iceland,Europe,4,2,2,2,2,4,0,Unknown
1948-03-17 00:00:00,Royal Air Force - RAF,Takeoff (climb),Operational,United Kingdom,Europe,4,4,4,0,0,4,0,Human Factor
1948-03-17 00:00:00,Royal Air Force - RAF,Landing (descent or approach),Operational,United Kingdom,Europe,4,4,4,0,0,4,0,Human Factor
1948-03-20 00:00:00,Brazilian Air Force - Força Aérea Brasileira,Flight,Military / Government,Brazil,South America,4,4,4,0,0,4,0,Unknown
1948-04-09 00:00:00,SCOLTA - Sociedad Colombiana de Transportes Aéreos,Flight,Operational,Venezuela,South America,4,3,3,1,1,4,0,Unknown
1948-05-10 00:00:00,Israeli Air Force - Heyl Ha'avir,Flight,Military / Government,Jordan,Asia,4,2,2,2,2,4,0,Unknown
1948-05-13 00:00:00,Skyways of London,Flight,Commercial,France,Europe,4,2,2,2,2,4,0,Weather
1948-05-25 00:00:00,Colombian Air Force - Fuerza Aérea Colombiana,Landing (descent or approach),Operational,Colombia,South America,4,4,4,0,0,4,0,Human Factor
1948-05-25 00:00:00,Alpha Airways,Takeoff (climb),Operational,Spain,Europe,4,4,4,0,0,4,0,Human Factor
1948-06-29 00:00:00,United States Air Force - USAF,Flight,Military / Government,Germany,Europe,4,2,2,2,2,4,0,Unknown
1948-07-02 00:00:00,Royal Air Force - RAF,Flight,Specialised Services,United Kingdom,Europe,4,4,4,0,0,4,0,Human Factor
1948-08-01 00:00:00,OnzeAir,Landing (descent or approach),Operational,Pakistan,Asia,4,4,4,0,0,4,0,Other
1948-09-09 00:00:00,Aeroflot - Russian International Airlines,Takeoff (climb),Operational,Russia,Asia,4,4,4,0,0,4,0,Human Factor
1948-09-28 00:00:00,World Air Freight,Flight,Operational,United Kingdom,Europe,4,4,4,0,0,4,0,Human Factor
1948-10-12 00:00:00,Aeroflot - Russian International Airlines,Flight,Operational,Russia,Asia,4,4,4,0,0,4,0,Human Factor
1948-10-17 00:00:00,United States Air Force - USAF,Flight,Military / Government,United States of America,North America,34,4,0,30,4,4,30,Technical Failure
1948-11-17 00:00:00,Royal Air Force - RAF,Landing (descent or approach),Operational,Germany,Europe,4,4,4,0,0,4,0,Human Factor
1948-11-18 00:00:00,Aeroflot - Russian International Airlines,Landing (descent or approach),Operational,Tajikistan,Asia,5,5,4,0,0,4,1,Weather
1948-12-05 00:00:00,United States Air Force - USAF,Flight,Military / Government,World,World,37,7,0,30,4,4,33,Technical Failure
1948-12-16 00:00:00,United States Air Force - USAF,Flight,Operational,United States of America,North America,7,7,4,0,0,4,3,Unknown
1948-12-23 00:00:00,Aeroflot - Russian International Airlines,Flight,Operational,Russia,Asia,4,4,4,0,0,4,0,Human Factor
1949-02-19 00:00:00,Royal Air Force - RAF,Flight,Operational,United Kingdom,Europe,4,4,4,0,0,4,0,Human Factor
1949-04-29 00:00:00,World Air Freight,Landing (descent or approach),Operational,Germany,Europe,4,4,4,0,0,4,0,Unknown
1949-06-17 00:00:00,Royal Air Force - RAF,Flight,Operational,Zimbabwe,Africa,4,4,4,0,0,4,0,Unknown
1949-06-19 00:00:00,La Legión Caribe,Takeoff (climb),Military / Government,Dominican Republic,Central America,4,4,4,0,0,4,0,Terrorism
1949-06-24 00:00:00,Turkish Air Force - Türk Hava Kuvvetleri,Flight,Military / Government,Turkey,Asia,4,4,4,0,0,4,0,Unknown
1949-07-07 00:00:00,Venezuelan Air Force - Fuerza Aérea Venezolana,Flight,Military / Government,Venezuela,South America,4,2,2,2,2,4,0,Unknown
1949-07-23 00:00:00,Turkish Air Force - Türk Hava Kuvvetleri,,Military / Government,Turkey,Asia,4,4,4,0,0,4,0,Unknown
1949-08-29 00:00:00,Mexican Air Force - Fuerza Aérea Mexicana,Takeoff (climb),Military / Government,Mexico,Central America,4,2,2,2,2,4,0,Unknown
1949-10-15 00:00:00,Short Brothers,Flight,Operational,Norway,Europe,4,2,2,2,2,4,0,Unknown
1949-11-03 00:00:00,French Navy,Takeoff (climb),Specialised Services,France,Europe,15,15,4,0,0,4,11,Weather
1950-01-24 00:00:00,Philippine Airlines - PAL,Takeoff (climb),Operational,Philippines,Asia,4,3,3,1,1,4,0,Unknown
1950-02-06 00:00:00,Colombian Air Force - Fuerza Aérea Colombiana,Flight,Military / Government,Colombia,South America,4,4,4,0,0,4,0,Human Factor
1950-03-07 00:00:00,Royal Australian Air Force - RAAF,Takeoff (climb),Operational,Australia,Oceania,4,4,4,0,0,4,0,Unknown
1950-03-10 00:00:00,Société Indochinoise de Transports Aériens - SITA,Landing (descent or approach),Operational,Vietnam,Asia,4,3,3,1,1,4,0,Unknown
1950-03-21 00:00:00,Bristol Aeroplane Company,Flight,Specialised Services,United Kingdom,Europe,4,1,1,3,3,4,0,Technical Failure
1950-03-28 00:00:00,United States Air Force - USAF,Takeoff (climb),Military / Government,Canada,North America,5,3,2,2,2,4,1,Technical Failure
1950-03-29 00:00:00,Royal Air Force - RAF,Takeoff (climb),Operational,United Kingdom,Europe,4,4,4,0,0,4,0,Technical Failure
1950-04-05 00:00:00,Royal Air Force - RAF,Flight,Operational,United Kingdom,Europe,4,4,4,0,0,4,0,Technical Failure
1950-05-08 00:00:00,Morton Air Services,Landing (descent or approach),Commercial,United Kingdom,Europe,4,1,1,3,3,4,0,Unknown
1950-05-11 00:00:00,United States Navy - USN,Flight,Specialised Services,United States of America,North America,4,4,4,0,0,4,0,Technical Failure
1950-06-23 00:00:00,Transportes Aéreos de Jalisco,Takeoff (climb),Commercial,Mexico,Central America,0,0,1,0,3,4,-4,Unknown
1950-06-24 00:00:00,Directorate of Geodesy and Cartography,Flight,Specialised Services,Russia,Asia,4,4,4,0,0,4,0,Unknown
1950-06-28 00:00:00,United States Air Force - USAF,Flight,Operational,United States of America,North America,30,4,4,26,0,4,26,Technical Failure
1950-07-13 00:00:00,United States Air Force - USAF,Flight,Operational,United States of America,North America,10,10,4,0,0,4,6,Technical Failure
1950-07-19 00:00:00,Aeroflot - Russian International Airlines,Landing (descent or approach),Operational,Georgia,Asia,10,4,3,6,1,4,6,Human Factor
1950-08-11 00:00:00,Aeroflot - Russian International Airlines,Landing (descent or approach),Commercial,Russia,Asia,27,5,2,22,2,4,23,Human Factor
1950-08-14 00:00:00,United States Air Force - USAF,Landing (descent or approach),Military / Government,United States of America,North America,12,12,4,0,0,4,8,Unknown
1950-10-13 00:00:00,Air Atlas,Landing (descent or approach),Commercial,Morocco,Africa,7,3,3,4,1,4,3,Technical Failure
1950-10-13 00:00:00,United States Air Force - USAF,Flight,Military / Government,United States of America,North America,4,4,4,0,0,4,0,Technical Failure
1950-10-15 00:00:00,United States Air Force - USAF,Flight,Military / Government,World,World,4,4,4,0,0,4,0,Technical Failure
1950-10-26 00:00:00,United States Air Force - USAF,Flight,Military / Government,United States of America,North America,4,3,3,1,1,4,0,Unknown
1950-11-10 00:00:00,United States Air Force - USAF,Flight,Military / Government,North Korea,Asia,12,12,4,0,0,4,8,Terrorism
1950-11-11 00:00:00,United States Air Force - USAF,Landing (descent or approach),Military / Government,United States of America,North America,4,4,4,0,0,4,0,Unknown
1950-11-11 00:00:00,Turkish Air Force - Türk Hava Kuvvetleri,Flight,Military / Government,Turkey,Asia,4,4,4,0,0,4,0,Unknown
1950-11-18 00:00:00,United States Navy - USN,Landing (descent or approach),Military / Government,United States of America,North America,4,4,4,0,0,4,0,Human Factor
1950-12-20 00:00:00,United States Air Force - USAF,Flight,Military / Government,Japan,Asia,4,4,4,0,0,4,0,Unknown
1951-01-05 00:00:00,United States Air Force - USAF,Takeoff (climb),Military / Government,South Korea,Asia,4,4,4,0,0,4,0,Unknown
1951-01-16 00:00:00,United States Air Force - USAF,Takeoff (climb),Military / Government,South Korea,Asia,4,4,4,0,0,4,0,Unknown
1951-02-06 00:00:00,Spanish Air Force - Ejército del Aire,Flight,Military / Government,Spain,Europe,4,4,4,0,0,4,0,Unknown
1951-02-11 00:00:00,United States Air Force - USAF,Flight,Military / Government,North Korea,Asia,4,4,4,0,0,4,0,Unknown
1951-02-12 00:00:00,United States Air Force - USAF,Flight,Military / Government,North Korea,Asia,4,4,4,0,0,4,0,Unknown
1951-02-21 00:00:00,United States Air Force - USAF,Flight,Military / Government,North Korea,Asia,4,4,4,0,0,4,0,Unknown
1951-03-08 00:00:00,Lancashire Aircraft Corporation - LAC,Landing (descent or approach),Operational,United Kingdom,Europe,4,4,4,0,0,4,0,Weather
1951-04-01 00:00:00,Royal Air Force - RAF,Landing (descent or approach),Operational,United Kingdom,Europe,4,4,4,0,0,4,0,Human Factor
1951-04-10 00:00:00,United States Air Force - USAF,Landing (descent or approach),Military / Government,South Korea,Asia,12,12,4,0,0,4,8,Terrorism
1951-04-21 00:00:00,Aeroflot - Russian International Airlines,Flight,Operational,Russia,Asia,4,4,4,0,0,4,0,Weather
1951-04-25 00:00:00,United States Navy - USN,Flight,Operational,United States of America,North America,4,4,4,0,0,4,0,Human Factor
1951-04-27 00:00:00,United States Air Force - USAF,,Operational,North Korea,Asia,4,4,4,0,0,4,0,Terrorism
1951-05-02 00:00:00,Argentinian Navy - Armada Argentina,Flight,Operational,Argentina,South America,5,5,4,0,0,4,1,Unknown
1951-05-09 00:00:00,Spanish Air Force - Ejército del Aire,Flight,Military / Government,Spain,Europe,4,4,4,0,0,4,0,Weather
1951-05-14 00:00:00,Royal Canadian Air Force - RCAF,Flight,Operational,Canada,North America,4,4,4,0,0,4,0,Unknown
1951-05-16 00:00:00,French Air Force - Armée de l'Air,Flight,Specialised Services,France,Europe,4,4,4,0,0,4,0,Unknown
1951-06-03 00:00:00,United States Air Force - USAF,Flight,Military / Government,South Korea,Asia,4,4,4,0,0,4,0,Terrorism
1951-06-04 00:00:00,United States Air Force - USAF,Flight,Military / Government,United States of America,North America,7,7,4,0,0,4,3,Weather
1951-07-14 00:00:00,Airtaco,Takeoff (climb),Operational,Sweden,Europe,6,2,1,4,3,4,2,Human Factor
1951-08-07 00:00:00,Brazilian Air Force - Força Aérea Brasileira,Landing (descent or approach),Military / Government,Brazil,South America,4,4,4,0,0,4,0,Technical Failure
1951-08-26 00:00:00,United States Air Force - USAF,Flight,Military / Government,North Korea,Asia,4,4,4,0,0,4,0,Unknown
1951-09-03 00:00:00,United States Air Force - USAF,Takeoff (climb),Military / Government,South Korea,Asia,4,4,4,0,0,4,0,Unknown
1951-09-07 00:00:00,United States Air Force - USAF,Flight,Military / Government,North Korea,Asia,4,4,4,0,0,4,0,Unknown
1951-09-17 00:00:00,Royal Air Force - RAF,Flight,Military / Government,South Sudan,Africa,4,4,4,0,0,4,0,Weather
1951-09-18 00:00:00,Argentinian Air Force - Fuerza Aérea Argentina,Takeoff (climb),Operational,Argentina,South America,4,4,4,0,0,4,0,Unknown
1951-09-29 00:00:00,United States Air Force - USAF,Flight,Military / Government,North Korea,Asia,4,4,4,0,0,4,0,Terrorism
1951-10-01 00:00:00,United States Air Force - USAF,Flight,Military / Government,South Korea,Asia,4,4,4,0,0,4,0,Unknown
1951-10-11 00:00:00,Brazilian Air Force - Força Aérea Brasileira,Landing (descent or approach),Military / Government,Brazil,South America,7,7,4,0,0,4,3,Unknown
1951-10-22 00:00:00,United States Air Force - USAF,Takeoff (climb),Operational,United States of America,North America,6,6,4,0,0,4,2,Unknown
1951-11-08 00:00:00,United States Air Force - USAF,Landing (descent or approach),Operational,United States of America,North America,15,15,4,0,0,4,11,Technical Failure
1951-11-18 00:00:00,Turkish Air Force - Türk Hava Kuvvetleri,Flight,Military / Government,Turkey,Asia,4,4,4,0,0,4,0,Unknown
1951-11-25 00:00:00,United States Air Force - USAF,Flight,Military / Government,North Korea,Asia,4,4,4,0,0,4,0,Weather
1951-11-25 00:00:00,United States Navy - USN,Landing (descent or approach),Military / Government,Japan,Asia,14,14,4,0,0,4,10,Weather
1951-12-08 00:00:00,United States Air Force - USAF,Landing (descent or approach),Military / Government,Japan,Asia,5,5,4,0,0,4,1,Unknown
1951-12-17 00:00:00,United States Air Force - USAF,Landing (descent or approach),Operational,United States of America,North America,13,13,4,0,0,4,9,Unknown
1951-12-27 00:00:00,United States Air Force - USAF,Takeoff (climb),Military / Government,Japan,Asia,23,3,0,20,4,4,19,Unknown
1951-12-30 00:00:00,Transocean Air Lines - TOA,Landing (descent or approach),Operational,United States of America,North America,4,2,2,2,2,4,0,Human Factor
1951-12-31 00:00:00,United States Navy - USN,Takeoff (climb),Military / Government,China,Asia,11,11,4,0,0,4,7,Unknown
1952-01-04 00:00:00,British Government,Flight,Specialised Services,United Kingdom,Europe,4,2,2,2,2,4,0,Unknown
1952-02-10 00:00:00,United States Air Force - USAF,Takeoff (climb),Operational,United States of America,North America,36,4,4,32,0,4,32,Unknown
1952-02-19 00:00:00,Swiss Air Force,Flight,Military / Government,Switzerland,Europe,4,4,4,0,0,4,0,Unknown
1952-02-22 00:00:00,United States Air Force - USAF,Flight,Other,North Korea,Asia,4,4,4,0,0,4,0,Unknown
1952-03-06 00:00:00,United States Air Force - USAF,Flight,Military / Government,North Korea,Asia,4,4,4,0,0,4,0,Unknown
1952-03-22 00:00:00,Maritime Central Airways,Flight,Operational,Canada,North America,4,1,1,3,3,4,0,Unknown
1952-04-06 00:00:00,United States Navy - USN,Flight,Military / Government,United States of America,North America,4,4,4,0,0,4,0,Human Factor
1952-04-10 00:00:00,Kalinga Airlines,Landing (descent or approach),Operational,India,Asia,4,4,4,0,0,4,0,Technical Failure
1952-04-25 00:00:00,Royal Canadian Air Force - RCAF,Takeoff (climb),Specialised Services,Canada,North America,12,12,4,0,0,4,8,Human Factor
1952-04-29 00:00:00,United States Air Force - USAF,Landing (descent or approach),Military / Government,Japan,Asia,4,4,4,0,0,4,0,Human Factor
1952-05-03 00:00:00,Aeroflot - Russian International Airlines,Flight,Operational,Russia,Asia,4,4,4,0,0,4,0,Human Factor
1952-05-22 00:00:00,Royal Air Force - RAF,Landing (descent or approach),Operational,United Kingdom,Europe,11,11,4,0,0,4,7,Technical Failure
1952-05-27 00:00:00,United States Navy - USN,Takeoff (climb),Military / Government,United States of America,North America,4,4,4,0,0,4,0,Unknown
1952-07-19 00:00:00,Aeroflot - Russian International Airlines,Takeoff (climb),Operational,Latvia,Europe,4,4,4,0,0,4,0,Human Factor
1952-07-23 00:00:00,United States Air Force - USAF,Flight,Military / Government,South Korea,Asia,4,4,4,0,0,4,0,Unknown
1952-08-04 00:00:00,Private American,Landing (descent or approach),Operational,United States of America,North America,4,2,2,2,2,4,0,Human Factor
1952-08-04 00:00:00,French Air Force - Armée de l'Air,Flight,Military / Government,Vietnam,Asia,20,2,0,18,4,4,16,Unknown
1952-08-07 00:00:00,United States Air Force - USAF,Flight,Military / Government,North Korea,Asia,4,4,4,0,0,4,0,Terrorism
1952-08-08 00:00:00,United States Air Force - USAF,Flight,Operational,United States of America,North America,4,4,4,0,0,4,0,Technical Failure
1952-08-25 00:00:00,United States Air Force - USAF,Flight,Operational,United States of America,North America,8,8,4,0,0,4,4,Terrorism
1952-09-04 00:00:00,Aerotechnica de Espana,Flight,Specialised Services,Spain,Europe,4,3,3,1,1,4,0,Human Factor
1952-09-28 00:00:00,Spanish Air Force - Ejército del Aire,Flight,Military / Government,Spain,Europe,4,4,4,0,0,4,0,Technical Failure
1952-10-15 00:00:00,Royal Air Force - RAF,Takeoff (climb),Operational,United Kingdom,Europe,4,4,4,0,0,4,0,Weather
1952-11-14 00:00:00,Turkish Air Force - Türk Hava Kuvvetleri,Takeoff (climb),Military / Government,Turkey,Asia,4,4,4,0,0,4,0,Unknown
1952-11-24 00:00:00,United States Air Force - USAF,Flight,Specialised Services,United States of America,North America,4,4,4,0,0,4,0,Technical Failure
1952-12-02 00:00:00,Royal Air Force - RAF,Landing (descent or approach),Operational,United Kingdom,Europe,4,4,4,0,0,4,0,Human Factor
1952-12-14 00:00:00,Royal Air Force - RAF,Takeoff (climb),Operational,United Kingdom,Europe,8,8,4,0,0,4,4,Technical Failure
1952-12-26 00:00:00,United States Air Force - USAF,Flight,Military / Government,North Korea,Asia,4,4,4,0,0,4,0,Unknown
1953-01-13 00:00:00,Aeronorte,Flight,Commercial,Brazil,South America,4,3,3,1,1,4,0,Unknown
1953-01-30 00:00:00,United States Air Force - USAF,Takeoff (climb),Operational,United States of America,North America,7,7,4,0,0,4,3,Unknown
1953-03-10 00:00:00,Argentinian Government,Flight,Military / Government,Argentina,South America,5,2,2,3,2,4,1,Human Factor
1953-03-25 00:00:00,Royal Air Force - RAF,Landing (descent or approach),Military / Government,Japan,Asia,11,11,4,0,0,4,7,Human Factor
1953-04-01 00:00:00,United States Air Force - USAF,Flight,Military / Government,North Korea,Asia,4,4,4,0,0,4,0,Terrorism
1953-04-10 00:00:00,Air France,Takeoff (climb),Commercial,Madagascar,Africa,15,3,3,12,1,4,11,Technical Failure
1953-04-30 00:00:00,Italian Air Force - Aeronautica Militare Italiana,Takeoff (climb),Military / Government,Italy,Europe,4,4,4,0,0,4,0,Technical Failure
1953-07-06 00:00:00,Belgian Congo Geographic Institute,Flight,Specialised Services,Democratic Republic of Congo,Africa,4,2,2,2,2,4,0,Unknown
1953-07-06 00:00:00,United States Coast Guard - USCG,Takeoff (climb),Military / Government,United States of America,North America,4,2,2,2,2,4,0,Technical Failure
1953-07-14 00:00:00,United States Air Force - USAF,Flight,Military / Government,North Korea,Asia,4,4,4,0,0,4,0,Terrorism
1953-08-03 00:00:00,Air France,Flight,Commercial,Turkey,Asia,42,8,0,34,4,4,38,Technical Failure
1953-08-05 00:00:00,Belgian Air Force - Force Aérienne Belge - Belgische Luchtmacht,Flight,Military / Government,Germany,Europe,4,2,2,2,2,4,0,Unknown
1953-08-07 00:00:00,Czech Air Force - Ceské Vojenské Letectvo,Landing (descent or approach),Operational,Slovakia,Europe,4,4,4,0,0,4,0,Human Factor
1953-08-12 00:00:00,United States Navy - USN,Takeoff (climb),Operational,United States of America,North America,4,4,4,0,0,4,0,Unknown
1953-09-02 00:00:00,Brazilian Air Force - Força Aérea Brasileira,Flight,Operational,Brazil,South America,4,4,4,0,0,4,0,Unknown
1953-09-05 00:00:00,Royal Air Force - RAF,Landing (descent or approach),Military / Government,United Kingdom,Europe,4,4,4,0,0,4,0,Human Factor
1953-09-26 00:00:00,Texaco Colombia,Flight,Business,Colombia,South America,4,3,3,1,1,4,0,Human Factor
1953-09-26 00:00:00,United States Air Force - USAF,Flight,Military / Government,France,Europe,4,4,4,0,0,4,0,Unknown
1953-10-14 00:00:00,Aeroflot - Russian International Airlines,Takeoff (climb),Commercial,Russia,Asia,28,6,4,22,0,4,24,Human Factor
1953-10-15 00:00:00,Royal New Zealand Air Force - RNZAF,Flight,Operational,New Zealand,Oceania,4,4,4,0,0,4,0,Human Factor
1953-10-31 00:00:00,Brazilian Air Force - Força Aérea Brasileira,Takeoff (climb),Military / Government,Brazil,South America,5,5,4,0,0,4,1,Unknown
1954-01-05 00:00:00,Devlet Hava Yollari - DHY,Flight,Commercial,Turkey,Asia,10,5,2,5,2,4,6,Human Factor
1954-01-20 00:00:00,Royal Air Force - RAF,Landing (descent or approach),Operational,United Kingdom,Europe,4,4,4,0,0,4,0,Human Factor
1954-02-05 00:00:00,United States Navy - USN,Landing (descent or approach),Operational,Japan,Asia,4,4,4,0,0,4,0,Human Factor
1954-02-22 00:00:00,Royal Air Force - RAF,Flight,Military / Government,United Kingdom,Europe,4,4,4,0,0,4,0,Technical Failure
1954-02-23 00:00:00,Royal Air Force - RAF,Flight,Military / Government,Malaysia,Asia,4,4,4,0,0,4,0,Human Factor
1954-02-26 00:00:00,United States Air Force - USAF,Flight,Operational,United States of America,North America,4,4,4,0,0,4,0,Human Factor
1954-03-13 00:00:00,Royal Air Force - RAF,Landing (descent or approach),Operational,United Kingdom,Europe,4,4,4,0,0,4,0,Human Factor
1954-04-04 00:00:00,Compagnie Autrex-Lopez-Loreta-Le Breton,Landing (descent or approach),Operational,Vietnam,Asia,4,4,4,0,0,4,0,Human Factor
1954-05-21 00:00:00,United States Navy - USN,Flight,Military / Government,World,World,10,10,4,0,0,4,6,Technical Failure
1954-06-08 00:00:00,Société de Transports Aériens en Extrême-Orient - STAEO,Flight,Commercial,Vietnam,Asia,4,2,2,2,2,4,0,Unknown
1954-06-23 00:00:00,MAP - Ministerstvo Aviatsionnoi Promyshlennosti - Minaviaprom,Takeoff (climb),Operational,Russia,Asia,7,5,3,2,1,4,3,Technical Failure
1954-08-24 00:00:00,Private Japanese,Flight,Specialised Services,Japan,Asia,4,2,2,2,2,4,0,Unknown
1954-08-29 00:00:00,Spanish Air Force - Ejército del Aire,Flight,Military / Government,Spain,Europe,4,4,4,0,0,4,0,Technical Failure
1954-10-02 00:00:00,Whitehorse Flying Services,Flight,Commercial,Canada,North America,4,1,1,3,3,4,0,Human Factor
1954-10-11 00:00:00,Royal Thai Air Force - Kong Thap Akat Thai,Takeoff (climb),Military / Government,Thailand,Asia,18,2,0,16,4,4,14,Technical Failure
1954-10-23 00:00:00,Royal Air Force - RAF,Landing (descent or approach),Military / Government,Denmark,Europe,7,7,4,0,0,4,3,Weather
1954-11-04 00:00:00,United States Air Force - USAF,Landing (descent or approach),Military / Government,United States of America,North America,15,3,0,12,4,4,11,Technical Failure
1954-11-06 00:00:00,Italian Air Force - Aeronautica Militare Italiana,Flight,Operational,Italy,Europe,4,4,4,0,0,4,0,Human Factor
1954-12-11 00:00:00,United States Coast Guard - USCG,Takeoff (climb),Humanitarian,United States of America,North America,4,3,3,1,1,4,0,Unknown
1954-12-12 00:00:00,CSA Czech Airlines - Československé Státní Aerolinie,Landing (descent or approach),Operational,Slovakia,Europe,4,4,4,0,0,4,0,Human Factor
1954-12-17 00:00:00,Miller Brewing Company,Takeoff (climb),Business,United States of America,North America,4,2,2,2,2,4,0,Technical Failure
1954-12-29 00:00:00,Chilean Air Force - Fuerza Aérea de Chile,,Military / Government,Chile,South America,4,4,4,0,0,4,0,Unknown
1955-03-26 00:00:00,Pan American World Airways - PAA,Flight,Commercial,World,World,23,8,2,15,2,4,19,Technical Failure
1955-03-29 00:00:00,Royal Air Force - RAF,Landing (descent or approach),Specialised Services,United Kingdom,Europe,4,4,4,0,0,4,0,Unknown
1955-04-09 00:00:00,United States Navy - USN,Takeoff (climb),Operational,United States of America,North America,8,8,4,0,0,4,4,Human Factor
1955-05-08 00:00:00,Aeroflot - Russian International Airlines,Landing (descent or approach),Operational,Ukraine,Europe,4,4,4,0,0,4,0,Weather
1955-05-21 00:00:00,Linea Aeropostal Venezolana - LAV,Landing (descent or approach),Commercial,Venezuela,South America,13,3,0,10,4,4,9,Technical Failure
1955-06-04 00:00:00,Royal Air Force - RAF,Landing (descent or approach),Operational,United Kingdom,Europe,14,14,4,0,0,4,10,Human Factor
1955-07-20 00:00:00,United States Air Force - USAF,Flight,Operational,Germany,Europe,4,1,1,3,3,4,0,Unknown
1955-07-24 00:00:00,Aeroflot - Russian International Airlines,Flight,Operational,Russia,Asia,4,2,2,2,2,4,0,Human Factor
1955-09-14 00:00:00,AVENSA - Aerovias Venezolanas,Flight,Operational,Venezuela,South America,4,4,4,0,0,4,0,Unknown
1955-10-03 00:00:00,Great Lakes Carbon Corp.,Flight,Business,United States of America,North America,4,2,2,2,2,4,0,Technical Failure
1955-11-04 00:00:00,United States Air Force - USAF,Landing (descent or approach),Military / Government,United States of America,North America,8,8,4,0,0,4,4,Weather
1955-11-05 00:00:00,Mexican Government,Takeoff (climb),Military / Government,Mexico,Central America,17,3,1,14,3,4,13,Technical Failure
1955-11-07 00:00:00,United States Air Force - USAF,Flight,Military / Government,South Korea,Asia,4,1,1,3,3,4,0,Weather
1955-11-21 00:00:00,United States Air Force - USAF,Flight,Military / Government,Iceland,Europe,4,4,4,0,0,4,0,Unknown
1955-12-20 00:00:00,Argentinian Air Force - Fuerza Aérea Argentina,Takeoff (climb),Military / Government,Argentina,South America,6,6,4,0,0,4,2,Unknown
1955-12-20 00:00:00,Spanish Air Force - Ejército del Aire,Flight,Military / Government,Spain,Europe,5,5,4,0,0,4,1,Unknown
1956-01-17 00:00:00,Québecair,Landing (descent or approach),Commercial,Canada,North America,18,3,3,15,1,4,14,Technical Failure
1956-02-14 00:00:00,United States Air Force - USAF,Flight,Operational,Canada,North America,4,4,4,0,0,4,0,Weather
1956-02-16 00:00:00,United States Air Force - USAF,Flight,Operational,United States of America,North America,8,8,4,0,0,4,4,Technical Failure
1956-04-06 00:00:00,French Air Force - Armée de l'Air,Flight,Military / Government,Switzerland,Europe,4,4,4,0,0,4,0,Unknown
1956-05-31 00:00:00,Italian Air Force - Aeronautica Militare Italiana,Flight,Military / Government,Italy,Europe,4,1,1,3,3,4,0,Weather
1956-07-09 00:00:00,Brazilian Air Force - Força Aérea Brasileira,Takeoff (climb),Military / Government,Brazil,South America,26,6,4,20,0,4,22,Unknown
1956-07-15 00:00:00,Swissair,Landing (descent or approach),Operational,Ireland,Europe,4,4,4,0,0,4,0,Human Factor
1956-07-20 00:00:00,Aeroflot - Russian International Airlines,Flight,Commercial,Russia,Asia,6,3,3,3,1,4,2,Human Factor
1956-09-11 00:00:00,Polyarnaya Aviatsiya,Flight,Operational,Russia,Asia,4,4,4,0,0,4,0,Unknown
1956-10-18 00:00:00,United States Navy - USN,Landing (descent or approach),Military / Government,Antarctica,Antarctica,8,8,4,0,0,4,4,Unknown
1956-10-26 00:00:00,United States Air Force - USAF,Flight,Military / Government,United States of America,North America,4,4,4,0,0,4,0,Human Factor
1956-12-07 00:00:00,Royal Air Force - RAF,Flight,Specialised Services,United Kingdom,Europe,4,4,4,0,0,4,0,Human Factor
1956-12-30 00:00:00,Prospec,Flight,Business,Brazil,South America,4,2,2,2,2,4,0,Unknown
1957-01-31 00:00:00,Douglas Aircraft Company,Flight,Specialised Services,United States of America,North America,4,4,4,0,0,4,0,Human Factor
1957-02-02 00:00:00,United States Air Force - USAF,Flight,Operational,France,Europe,9,9,4,0,0,4,5,Human Factor
1957-03-12 00:00:00,United States Air Force - USAF,Flight,Military / Government,Japan,Asia,4,4,4,0,0,4,0,Unknown
1957-03-19 00:00:00,Royal Australian Air Force - RAAF,Takeoff (climb),Operational,Australia,Oceania,4,4,4,0,0,4,0,Technical Failure
1957-03-29 00:00:00,Aeroflot - Russian International Airlines,Flight,Specialised Services,Russia,Asia,4,4,4,0,0,4,0,Technical Failure
1957-04-22 00:00:00,United States Air Force - USAF,Landing (descent or approach),Military / Government,Japan,Asia,4,4,4,0,0,4,0,Human Factor
1957-05-21 00:00:00,United States Air Force - USAF,Flight,Military / Government,Germany,Europe,4,1,1,3,3,4,0,Technical Failure
1957-07-03 00:00:00,Kenting Aviation,Flight,Commercial,Canada,North America,4,2,2,2,2,4,0,Unknown
1957-08-17 00:00:00,Aeroflot - Russian International Airlines,Flight,Operational,Ukraine,Europe,4,4,4,0,0,4,0,Human Factor
1957-08-17 00:00:00,French Air Force - Armée de l'Air,Flight,Military / Government,Algeria,Africa,4,1,1,3,3,4,0,Unknown
1957-08-22 00:00:00,United States Coast Guard - USCG,Takeoff (climb),Operational,United States of America,North America,6,6,4,0,0,4,2,Human Factor
1957-09-01 00:00:00,Indian Airlines,Takeoff (climb),Operational,India,Asia,4,4,4,0,0,4,0,Human Factor
1957-09-28 00:00:00,Italian Air Force - Aeronautica Militare Italiana,Takeoff (climb),Military / Government,Italy,Europe,5,5,4,0,0,4,1,Technical Failure
1957-10-01 00:00:00,Pacific Western Airlines - PWA,Takeoff (climb),Commercial,Canada,North America,4,4,4,0,0,4,0,Unknown
1957-10-02 00:00:00,United States Air Force - USAF,Flight,Military / Government,United States of America,North America,4,1,1,3,3,4,0,Unknown
1957-11-04 00:00:00,Romanian Government,Landing (descent or approach),Military / Government,Russia,Asia,16,6,3,10,1,4,12,Human Factor
1957-11-15 00:00:00,Aviaco - Aviacion y Comercio,Landing (descent or approach),Commercial,Spain,Europe,4,2,2,2,2,4,0,Human Factor
1957-11-21 00:00:00,Straits Air Freight Express,Flight,Operational,New Zealand,Oceania,4,2,2,2,2,4,0,Technical Failure
1957-11-23 00:00:00,Air National Guard,Landing (descent or approach),Military / Government,United States of America,North America,11,4,4,7,0,4,7,Human Factor
1957-12-23 00:00:00,Scottish Airlines,Landing (descent or approach),Operational,United Kingdom,Europe,4,4,4,0,0,4,0,Human Factor
1958-01-29 00:00:00,AeroNorte,Flight,Commercial,Argentina,South America,6,1,1,5,3,4,2,Technical Failure
1958-03-22 00:00:00,Private American,Flight,Business,United States of America,North America,4,2,2,2,2,4,0,Technical Failure
1958-04-13 00:00:00,United States Air Force - USAF,Flight,Operational,United States of America,North America,4,4,4,0,0,4,0,Weather
1958-05-30 00:00:00,French Air Force - Armée de l'Air,Flight,Military / Government,Madagascar,Africa,4,4,4,0,0,4,0,Unknown
1958-05-31 00:00:00,Paraense Transportes Aéreos,Takeoff (climb),Operational,Brazil,South America,4,4,4,0,0,4,0,Other
1958-06-23 00:00:00,United States Forest Service - USFS,Flight,Military / Government,United States of America,North America,4,2,2,2,2,4,0,Weather
1958-07-02 00:00:00,Aeroflot - Russian International Airlines,Flight,Commercial,Russia,Asia,4,4,4,0,0,4,0,Human Factor
1958-07-07 00:00:00,French Navy,Landing (descent or approach),Operational,Senegal,Africa,11,11,4,0,0,4,7,Unknown
1958-08-29 00:00:00,Pacific Western Airlines - PWA,Takeoff (climb),Commercial,Canada,North America,4,1,1,3,3,4,0,Human Factor
1958-08-31 00:00:00,Aéroclub de Saint Étienne de Saint Geoirs,Flight,Business,France,Europe,4,1,1,3,3,4,0,Unknown
1958-09-19 00:00:00,United States Air Force - USAF,Takeoff (climb),Military / Government,United States of America,North America,4,1,1,3,3,4,0,Unknown
1958-10-10 00:00:00,Aeroflot - Russian International Airlines,Landing (descent or approach),Operational,Russia,Asia,5,5,4,0,0,4,1,Human Factor
1958-10-21 00:00:00,Royal Danish Air Force - Flyvevåbnet,Flight,Operational,Denmark,Europe,4,4,4,0,0,4,0,Unknown
1958-11-02 00:00:00,Aeroflot - Russian International Airlines,Flight,Operational,Russia,Asia,4,4,4,0,0,4,0,Other
1958-12-15 00:00:00,Aeroflot - Russian International Airlines,Landing (descent or approach),Operational,Russia,Asia,7,7,4,0,0,4,3,Human Factor
1959-01-21 00:00:00,Linea Expressa Bolivar Compania Aérea - LEBCA,Flight,Commercial,Venezuela,South America,4,2,2,2,2,4,0,Human Factor
1959-01-27 00:00:00,United States Navy - USN,Landing (descent or approach),Operational,United States of America,North America,10,10,4,0,0,4,6,Technical Failure
1959-03-05 00:00:00,Baade Flugzeuge,Flight,Specialised Services,Germany,Europe,4,4,4,0,0,4,0,Technical Failure
1959-03-31 00:00:00,United States Air Force - USAF,Flight,Operational,United States of America,North America,4,4,4,0,0,4,0,Weather
1959-03-31 00:00:00,United States Air Force - USAF,Takeoff (climb),Military / Government,Turkey,Asia,9,9,4,0,0,4,5,Unknown
1959-04-01 00:00:00,United States Air Force - USAF,Flight,Military / Government,United States of America,North America,4,4,4,0,0,4,0,Unknown
1959-05-06 00:00:00,Lec Refrigeration,Flight,Operational,United Kingdom,Europe,4,2,2,2,2,4,0,Human Factor
1959-06-01 00:00:00,Portuguese Air Force - Força Aerea Portuguesa,Flight,Operational,Portugal,Europe,4,4,4,0,0,4,0,Unknown
1959-08-04 00:00:00,Johnson Flying Service,Landing (descent or approach),Military / Government,United States of America,North America,5,2,1,3,3,4,1,Other
1959-09-16 00:00:00,German Air Force - Deutsche Luftwaffe,Flight,Specialised Services,Germany,Europe,4,4,4,0,0,4,0,Unknown
1959-10-02 00:00:00,Aeroflot - Russian International Airlines,Flight,Operational,Russia,Asia,4,4,4,0,0,4,0,Weather
1959-10-13 00:00:00,United States Air Force - USAF,Flight,Military / Government,United States of America,North America,4,1,1,3,3,4,0,Weather
1959-10-15 00:00:00,United States Air Force - USAF,Flight,Operational,United States of America,North America,8,8,4,0,0,4,4,Human Factor
1959-10-15 00:00:00,United States Air Force - USAF,Flight,Operational,United States of America,North America,4,4,4,0,0,4,0,Human Factor
1959-10-19 00:00:00,Boeing Airplane Company,Flight,Specialised Services,United States of America,North America,8,8,4,0,0,4,4,Human Factor
1959-11-29 00:00:00,Aeroflot - Russian International Airlines,Landing (descent or approach),Operational,Russia,Asia,4,4,4,0,0,4,0,Human Factor
1959-12-02 00:00:00,United States Air Force - USAF,Flight,Military / Government,Norway,Europe,4,4,4,0,0,4,0,Weather
1960-01-09 00:00:00,United States Navy - USN,Flight,Operational,United States of America,North America,9,9,4,0,0,4,5,Technical Failure
1960-03-16 00:00:00,United States Air Force - USAF,Flight,Military / Government,Italy,Europe,4,4,4,0,0,4,0,Unknown
1960-03-20 00:00:00,Faucett,Flight,Operational,Peru,South America,4,4,4,0,0,4,0,Unknown
1960-05-23 00:00:00,Delta Airlines,Takeoff (climb),Operational,United States of America,North America,4,4,4,0,0,4,0,Unknown
1960-05-23 00:00:00,Indonesian Air Force - TNI-AU Tentara Nasional Indonesia - Angkatan Udara,Flight,Operational,Indonesia,Asia,4,4,4,0,0,4,0,Unknown
1960-08-25 00:00:00,Italian Air Force - Aeronautica Militare Italiana,Landing (descent or approach),Military / Government,Italy,Europe,4,4,4,0,0,4,0,Unknown
1960-11-05 00:00:00,Royal Nepal Airlines,Takeoff (climb),Operational,Nepal,Asia,4,4,4,0,0,4,0,Unknown
1960-12-17 00:00:00,Chilean Air Force - Fuerza Aérea de Chile,Flight,Military / Government,Chile,South America,4,4,4,0,0,4,0,Weather
1960-12-30 00:00:00,Rijksluchtvaartschool - RLS,Landing (descent or approach),Operational,Netherlands,Europe,4,4,4,0,0,4,0,Unknown
1961-01-15 00:00:00,Spanish Air Force - Ejército del Aire,Takeoff (climb),Military / Government,Spain,Europe,4,4,4,0,0,4,0,Unknown
1961-01-19 00:00:00,Aeronaves de Mexico,Takeoff (climb),Commercial,United States of America,North America,106,9,4,97,0,4,102,Human Factor
1961-01-23 00:00:00,German Air Force - Deutsche Luftwaffe,Landing (descent or approach),Specialised Services,Germany,Europe,4,4,4,0,0,4,0,Weather
1961-01-27 00:00:00,Irish Air Corps - Aer Chór na hÉireann,Landing (descent or approach),Operational,Ireland,Europe,5,5,4,0,0,4,1,Weather
1961-02-15 00:00:00,Republic of China Air Force,Flight,Military / Government,Thailand,Asia,6,6,4,0,0,4,2,Terrorism
1961-04-17 00:00:00,Cuban Air Force - Fuerza Aérea del Ejército de Cuba,Flight,Military / Government,Cuba,Central America,4,4,4,0,0,4,0,Terrorism
1961-04-21 00:00:00,Federal Aviation Administration - FAA,Flight,Operational,United States of America,North America,4,4,4,0,0,4,0,Human Factor
1961-05-07 00:00:00,Indian Air Force - Bharatiya Vayu Sena,Flight,Military / Government,India,Asia,4,4,4,0,0,4,0,Unknown
1961-06-23 00:00:00,Forest Industries Flying Tankers,Flight,Humanitarian,Canada,North America,4,4,4,0,0,4,0,Unknown
1961-07-31 00:00:00,Royal Australian Air Force - RAAF,Takeoff (climb),Military / Government,Australia,Oceania,7,4,4,3,0,4,3,Unknown
1961-09-06 00:00:00,Real Aerovias,Landing (descent or approach),Operational,Brazil,South America,4,4,4,0,0,4,0,Human Factor
1961-10-17 00:00:00,BKS Air Transport,Landing (descent or approach),Operational,United Kingdom,Europe,4,4,4,0,0,4,0,Human Factor
1961-11-17 00:00:00,Italian Air Force - Aeronautica Militare Italiana,Landing (descent or approach),Humanitarian,Democratic Republic of Congo,Africa,10,7,4,3,0,4,6,Other
1961-11-28 00:00:00,French Air Force - Armée de l'Air,Flight,Military / Government,Algeria,Africa,4,4,4,0,0,4,0,Human Factor
1961-11-28 00:00:00,French Air Force - Armée de l'Air,Flight,Military / Government,Algeria,Africa,4,4,4,0,0,4,0,Human Factor
1961-12-03 00:00:00,United States Air Force - USAF,Flight,Military / Government,Italy,Europe,4,4,4,0,0,4,0,Unknown
1962-02-17 00:00:00,Colombian Air Force - Fuerza Aérea Colombiana,Flight,Military / Government,Colombia,South America,4,2,2,2,2,4,0,Unknown
1962-02-22 00:00:00,Royal Lao Air Force,Flight,Military / Government,Thailand,Asia,8,8,4,0,0,4,4,Terrorism
1962-04-06 00:00:00,Air America,Takeoff (climb),Military / Government,Laos,Asia,4,2,2,2,2,4,0,Other
1962-05-07 00:00:00,Indian Air Force - Bharatiya Vayu Sena,Flight,Military / Government,India,Asia,4,4,4,0,0,4,0,Unknown
1962-05-24 00:00:00,Darbhanga Aviation,Landing (descent or approach),Operational,Bangladesh,Asia,4,4,4,0,0,4,0,Technical Failure
1962-06-08 00:00:00,Winn-Dixie Stores,Flight,Business,United States of America,North America,4,2,2,2,2,4,0,Human Factor
1962-08-13 00:00:00,United States Army,Flight,Military / Government,Germany,Europe,4,1,1,3,3,4,0,Technical Failure
1962-08-21 00:00:00,Lloyd Aéreo Boliviano - LAB Airlines,Takeoff (climb),Specialised Services,Bolivia,South America,12,3,0,9,4,4,8,Unknown
1962-09-10 00:00:00,Aerolineas Abaroa - ALAS,Flight,Commercial,Bolivia,South America,4,2,2,2,2,4,0,Technical Failure
1962-10-10 00:00:00,Iranian Government,Landing (descent or approach),Specialised Services,Iran,Asia,4,4,4,0,0,4,0,Weather
1962-11-19 00:00:00,All Nippon Airways,Flight,Operational,Japan,Asia,4,4,4,0,0,4,0,Human Factor
1962-12-18 00:00:00,Aeroflot - Russian International Airlines,Landing (descent or approach),Operational,Russia,Asia,4,4,4,0,0,4,0,Human Factor
1963-01-27 00:00:00,Aeroflot - Russian International Airlines,Flight,Operational,Russia,Asia,4,4,4,0,0,4,0,Human Factor
1963-02-01 00:00:00,Aeroflot - Russian International Airlines,Landing (descent or approach),Operational,Ukraine,Europe,11,5,4,6,0,4,7,Human Factor
1963-02-03 00:00:00,Slick Airways,Landing (descent or approach),Operational,United States of America,North America,8,3,2,5,2,4,4,Human Factor
1963-03-04 00:00:00,French Air Force - Armée de l'Air,Flight,Operational,France,Europe,4,4,4,0,0,4,0,Unknown
1963-03-15 00:00:00,Middle East Airlines - MEA,Takeoff (climb),Operational,Iran,Asia,4,4,4,0,0,4,0,Technical Failure
1963-03-18 00:00:00,Prospec,Takeoff (climb),Specialised Services,Brazil,South America,4,2,2,2,2,4,0,Unknown
1963-06-23 00:00:00,Aeroflot - Russian International Airlines,Flight,Military / Government,Russia,Asia,4,2,2,2,2,4,0,Human Factor
1963-10-24 00:00:00,French Air Force - Armée de l'Air,Flight,Operational,France,Europe,4,4,4,0,0,4,0,Unknown
1963-11-15 00:00:00,Mexican Air Force - Fuerza Aérea Mexicana,Landing (descent or approach),Military / Government,Mexico,Central America,5,5,4,0,0,4,1,Unknown
1963-12-18 00:00:00,United States Army,Flight,Military / Government,Vietnam,Asia,4,1,1,3,3,4,0,Terrorism
1964-02-15 00:00:00,Private American,Flight,Business,United States of America,North America,4,1,1,3,3,4,0,Unknown
1964-03-17 00:00:00,Spanish Air Force - Ejército del Aire,Landing (descent or approach),Military / Government,Spain,Europe,21,5,4,16,0,4,17,Unknown
1964-03-31 00:00:00,United States Navy - USN,Flight,Military / Government,United States of America,North America,4,2,2,2,2,4,0,Weather
1964-04-20 00:00:00,SATENA - Servicio de Aeronavegacion a Territorios Nacionales,Takeoff (climb),Operational,Colombia,South America,4,3,3,1,1,4,0,Unknown
1964-04-27 00:00:00,Hood Corporation,Landing (descent or approach),Business,United States of America,North America,4,2,2,2,2,4,0,Human Factor
1964-05-06 00:00:00,United States Air Force - USAF,Landing (descent or approach),Operational,United States of America,North America,8,8,4,0,0,4,4,Unknown
1964-07-08 00:00:00,United States Air Force - USAF,Flight,Operational,United States of America,North America,4,4,4,0,0,4,0,Human Factor
1964-07-08 00:00:00,TAM Paraguay - Transporte Aéreo Militar,,Military / Government,Paraguay,South America,4,4,4,0,0,4,0,Unknown
1964-07-16 00:00:00,Private American,Flight,Business,United States of America,North America,4,1,1,3,3,4,0,Weather
1964-08-22 00:00:00,Servicios Aéreos Cochabamba,Landing (descent or approach),Commercial,Bolivia,South America,4,2,2,2,2,4,0,Human Factor
1964-11-09 00:00:00,Aeroflot - Russian International Airlines,Flight,Operational,Moldova,Europe,4,2,2,2,2,4,0,Human Factor
1964-11-12 00:00:00,Private American,Takeoff (climb),Business,Bahamas,Central America,4,1,1,3,3,4,0,Unknown
1964-11-15 00:00:00,Jersey State Airline,Landing (descent or approach),Operational,United States of America,North America,5,2,1,3,3,4,1,Human Factor
1964-11-24 00:00:00,German Air Force - Deutsche Luftwaffe,Landing (descent or approach),Operational,Germany,Europe,5,4,4,1,0,4,1,Unknown
1964-12-04 00:00:00,Mexican Air Force - Fuerza Aérea Mexicana,Takeoff (climb),Military / Government,Mexico,Central America,4,2,2,2,2,4,0,Unknown
1964-12-18 00:00:00,United States Air Force - USAF,Landing (descent or approach),Operational,United States of America,North America,11,11,4,0,0,4,7,Unknown
1964-12-28 00:00:00,United States Air Force - USAF,Landing (descent or approach),Military / Government,United States of America,North America,4,4,4,0,0,4,0,Unknown
1964-12-30 00:00:00,Zantop Air Transport,Landing (descent or approach),Operational,United States of America,North America,4,2,2,2,2,4,0,Human Factor
1965-01-03 00:00:00,Dow-McDonald Company,Flight,Business,United States of America,North America,4,1,1,3,3,4,0,Human Factor
1965-01-04 00:00:00,United States Air Force - USAF,Takeoff (climb),Operational,United States of America,North America,4,4,4,0,0,4,0,Technical Failure
1965-02-03 00:00:00,Air Cameroon,Takeoff (climb),Operational,Cameroon,Africa,4,3,3,1,1,4,0,Unknown
1965-02-26 00:00:00,United States Air Force - USAF,Flight,Operational,World,World,4,4,4,0,0,4,0,Unknown
1965-03-10 00:00:00,Hope Natural Gas Company,Takeoff (climb),Business,United States of America,North America,4,2,2,2,2,4,0,Weather
1965-04-05 00:00:00,Indian Air Force - Bharatiya Vayu Sena,Flight,Military / Government,India,Asia,4,2,2,2,2,4,0,Unknown
1965-04-29 00:00:00,United States Navy - USN,Flight,Specialised Services,United States of America,North America,4,4,4,0,0,4,0,Unknown
1965-07-27 00:00:00,United States Navy - USN,Landing (descent or approach),Operational,Bermuda,North America,13,4,0,9,4,4,9,Human Factor
1965-08-20 00:00:00,LOT Polish Airlines - Polskie Linie Lotnicze,Flight,Operational,Belgium,Europe,4,4,4,0,0,4,0,Weather
1965-09-04 00:00:00,Cordova Airlines,Flight,Commercial,United States of America,North America,5,1,1,4,3,4,1,Human Factor
1965-09-18 00:00:00,United States Air Force - USAF,Landing (descent or approach),Military / Government,Vietnam,Asia,7,5,2,2,2,4,3,Human Factor
1965-10-04 00:00:00,SEA Colombia - Servicios Especiales Aéreos Colombia,Flight,Operational,Colombia,South America,4,3,3,1,1,4,0,Human Factor
1965-10-08 00:00:00,Pakistan International Airlines - PIA,Flight,Operational,Pakistan,Asia,4,4,4,0,0,4,0,Unknown
1965-10-10 00:00:00,Alfred Defosche,Landing (descent or approach),Business,United States of America,North America,4,1,1,3,3,4,0,Technical Failure
1965-11-23 00:00:00,Vicair,Flight,Operational,Colombia,South America,4,2,2,2,2,4,0,Human Factor
1965-12-04 00:00:00,Eastern Airlines,Flight,Commercial,United States of America,North America,54,5,1,49,3,4,50,Human Factor
1966-01-17 00:00:00,United States Air Force - USAF,Flight,Operational,Spain,Europe,7,7,4,0,0,4,3,Human Factor
1966-01-17 00:00:00,United States Air Force - USAF,Flight,Operational,Spain,Europe,4,4,4,0,0,4,0,Human Factor
1966-01-21 00:00:00,United States Navy - USN,Flight,Military / Government,Vietnam,Asia,4,4,4,0,0,4,0,Unknown
1966-01-25 00:00:00,French Air Force - Armée de l'Air,Flight,Operational,France,Europe,4,4,4,0,0,4,0,Unknown
1966-02-02 00:00:00,United Arab Airlines,Flight,Specialised Services,Egypt,Africa,4,4,4,0,0,4,0,Unknown
1966-02-03 00:00:00,United States Air Force - USAF,Flight,Military / Government,Vietnam,Asia,4,4,4,0,0,4,0,Terrorism
1966-02-18 00:00:00,Belgian International Air Services - BIAS,Landing (descent or approach),Operational,Italy,Europe,4,3,3,1,1,4,0,Human Factor
1966-03-10 00:00:00,Brazilian Air Force - Força Aérea Brasileira,Takeoff (climb),Military / Government,Brazil,South America,6,2,2,4,2,4,2,Unknown
1966-06-03 00:00:00,Hawker Siddeley Aircraft,Flight,Specialised Services,United Kingdom,Europe,4,4,4,0,0,4,0,Human Factor
1966-07-04 00:00:00,United States Navy - USN,Flight,Military / Government,United States of America,North America,4,4,4,0,0,4,0,Unknown
1966-08-15 00:00:00,Shaw Flight Service,Flight,Commercial,United States of America,North America,4,1,1,3,3,4,0,Technical Failure
1966-09-04 00:00:00,Indian Airlines,Landing (descent or approach),Operational,India,Asia,4,4,4,0,0,4,0,Human Factor
1966-09-30 00:00:00,United States Air Force - USAF,Flight,Operational,United States of America,North America,4,4,4,0,0,4,0,Human Factor
1966-10-19 00:00:00,Cruzeiro do Sul,Flight,Operational,Brazil,South America,4,4,4,0,0,4,0,Unknown
1966-11-10 00:00:00,United States Navy - USN,Flight,Military / Government,World,World,4,4,4,0,0,4,0,Terrorism
1966-12-07 00:00:00,French Air Force - Armée de l'Air,Flight,Operational,France,Europe,4,4,4,0,0,4,0,Weather
1966-12-24 00:00:00,Flying Tiger Line,Landing (descent or approach),Operational,Vietnam,Asia,4,4,4,0,0,4,0,Human Factor
1967-01-11 00:00:00,Bush Aviation,Flight,Business,Bahamas,Central America,4,4,4,0,0,4,0,Unknown
1967-02-10 00:00:00,Swissair,Takeoff (climb),Operational,Switzerland,Europe,4,4,4,0,0,4,0,Human Factor
1967-02-16 00:00:00,Travelair - Germany,Takeoff (climb),Specialised Services,Germany,Europe,4,2,2,2,2,4,0,Unknown
1967-02-20 00:00:00,SAHSA - Servicios Aéreos de Honduras SA,Landing (descent or approach),Commercial,Honduras,Central America,55,5,0,50,4,4,51,Technical Failure
1967-03-10 00:00:00,West Coast Airlines,Takeoff (climb),Commercial,United States of America,North America,4,3,3,1,1,4,0,Human Factor
1967-03-11 00:00:00,Aeralpi,Flight,Commercial,Italy,Europe,5,2,2,3,2,4,1,Human Factor
1967-04-07 00:00:00,Colombian Air Force - Fuerza Aérea Colombiana,Flight,Military / Government,Colombia,South America,4,4,4,0,0,4,0,Human Factor
1967-05-15 00:00:00,Nordair,Landing (descent or approach),Commercial,Canada,North America,4,2,2,2,2,4,0,Human Factor
1967-07-05 00:00:00,United States Air Force - USAF,Takeoff (climb),Military / Government,Puerto Rico,Central America,7,7,4,0,0,4,3,Technical Failure
1967-08-09 00:00:00,Federal Industry,Flight,Business,United States of America,North America,4,1,1,3,3,4,0,Human Factor
1967-08-17 00:00:00,United States Army,Landing (descent or approach),Military / Government,Vietnam,Asia,4,2,2,2,2,4,0,Weather
1967-08-21 00:00:00,Air America,Takeoff (climb),Military / Government,Vietnam,Asia,8,1,0,7,4,4,4,Technical Failure
1967-08-27 00:00:00,Private German,Takeoff (climb),Business,Germany,Europe,4,1,1,3,3,4,0,Unknown
1967-10-20 00:00:00,Royal Malaysian Air Force - Tentera Udara Diraja Malaysia,Flight,Military / Government,Malaysia,Asia,4,2,2,2,2,4,0,Unknown
1967-11-19 00:00:00,Aeroflot - Russian International Airlines,Landing (descent or approach),Operational,Russia,Asia,4,4,4,0,0,4,0,Human Factor
1967-12-27 00:00:00,Thai Airways International,Landing (descent or approach),Commercial,Thailand,Asia,31,3,0,28,4,4,27,Human Factor
1968-01-15 00:00:00,United Arab Airlines,Flight,Operational,Egypt,Africa,4,4,4,0,0,4,0,Weather
1968-01-25 00:00:00,United States Air Force - USAF,Landing (descent or approach),Operational,United States of America,North America,4,4,4,0,0,4,0,Human Factor
1968-02-08 00:00:00,Brazilian Air Force - Força Aérea Brasileira,Flight,Military / Government,Brazil,South America,23,4,0,19,4,4,19,Technical Failure
1968-03-16 00:00:00,Sadia Transportes Aéreos,Flight,Operational,Peru,South America,4,4,4,0,0,4,0,Human Factor
1968-03-17 00:00:00,United States Navy - USN,Flight,Military / Government,Vietnam,Asia,4,4,4,0,0,4,0,Technical Failure
1968-04-16 00:00:00,United States Air Force - USAF,Flight,Operational,United States of America,North America,4,4,4,0,0,4,0,Human Factor
1968-04-27 00:00:00,Private American,Takeoff (climb),Business,United States of America,North America,4,1,1,3,3,4,0,Unknown
1968-07-01 00:00:00,North American Aircraft Trading,Landing (descent or approach),Humanitarian,Nigeria,Africa,4,3,3,1,1,4,0,Unknown
1968-07-22 00:00:00,Avery Aviation,Flight,Humanitarian,United States of America,North America,4,2,2,2,2,4,0,Human Factor
1968-08-20 00:00:00,Linea Aeropostal Venezolana - LAV,Takeoff (climb),Commercial,Venezuela,South America,7,3,2,4,2,4,3,Technical Failure
1968-08-23 00:00:00,Transportes Aéreos Benianos - TABSA,Takeoff (climb),Operational,Bolivia,South America,4,3,3,1,1,4,0,Unknown
1968-09-02 00:00:00,Watson Lake Flying Services,Flight,Commercial,Canada,North America,4,1,1,3,3,4,0,Unknown
1968-10-01 00:00:00,United States Air Force - USAF,Takeoff (climb),Operational,Thailand,Asia,4,4,4,0,0,4,0,Technical Failure
1968-10-04 00:00:00,United States Air Force - USAF,Landing (descent or approach),Operational,United States of America,North America,6,6,4,0,0,4,2,Human Factor
1968-10-08 00:00:00,Catalina-Vegas Airlines,Takeoff (climb),Commercial,United States of America,North America,4,2,2,2,2,4,0,Technical Failure
1968-10-17 00:00:00,Cruzeiro do Sul,Landing (descent or approach),Commercial,Brazil,South America,14,5,0,9,4,4,10,Unknown
1968-12-07 00:00:00,North American Aircraft Trading,Landing (descent or approach),Operational,Nigeria,Africa,4,4,4,0,0,4,0,Unknown
1969-01-28 00:00:00,Brazilian Air Force - Força Aérea Brasileira,Flight,Operational,Brazil,South America,4,4,4,0,0,4,0,Unknown
1969-01-29 00:00:00,United States Air Force - USAF,Landing (descent or approach),Military / Government,United States of America,North America,11,11,4,0,0,4,7,Human Factor
1969-02-12 00:00:00,German Air Force - Deutsche Luftwaffe,Landing (descent or approach),Specialised Services,Germany,Europe,4,4,4,0,0,4,0,Unknown
1969-03-16 00:00:00,Royal Thai Navy - Kong Thap Ruea Thai,Flight,Operational,Thailand,Asia,4,4,4,0,0,4,0,Unknown
1969-03-19 00:00:00,Yemen Airlines,Takeoff (climb),Specialised Services,Yemen,Asia,4,4,4,0,0,4,0,Human Factor
1969-03-24 00:00:00,Aeroflot - Russian International Airlines,Takeoff (climb),Commercial,Kazakhstan,Asia,31,5,1,26,3,4,27,Technical Failure
1969-03-30 00:00:00,Aeroflot - Russian International Airlines,Landing (descent or approach),Operational,Ukraine,Europe,4,2,2,2,2,4,0,Human Factor
1969-04-13 00:00:00,Société Guyane Air Transport,Takeoff (climb),Commercial,Guyana,South America,4,1,1,3,3,4,0,Unknown
1969-04-25 00:00:00,Texaco Colombia,Flight,Business,Colombia,South America,4,2,2,2,2,4,0,Unknown
1969-05-03 00:00:00,C. L. Hall,Takeoff (climb),Business,United States of America,North America,4,2,2,2,2,4,0,Human Factor
1969-05-07 00:00:00,Balair - Switzerland,Landing (descent or approach),Humanitarian,Nigeria,Africa,4,4,4,0,0,4,0,Human Factor
1969-05-10 00:00:00,Rockwell Aircraft,Takeoff (climb),Specialised Services,United States of America,North America,4,4,4,0,0,4,0,Technical Failure
1969-06-05 00:00:00,Transair Sweden,Flight,Humanitarian,Nigeria,Africa,4,4,4,0,0,4,0,Terrorism
1969-06-23 00:00:00,Dominicana de Aviación,Takeoff (climb),Operational,United States of America,North America,4,3,3,1,1,4,0,Technical Failure
1969-07-05 00:00:00,Aeroflot - Russian International Airlines,Flight,Commercial,Russia,Asia,4,4,4,0,0,4,0,Human Factor
1969-07-15 00:00:00,French Air Force - Armée de l'Air,Flight,Operational,France,Europe,4,4,4,0,0,4,0,Unknown
1969-08-03 00:00:00,Canairelief,Landing (descent or approach),Humanitarian,Nigeria,Africa,4,4,4,0,0,4,0,Unknown
1969-08-09 00:00:00,Catair,Flight,Operational,Cameroon,Africa,4,4,4,0,0,4,0,Unknown
1969-08-12 00:00:00,Aeroflot - Russian International Airlines,Landing (descent or approach),Operational,Russia,Asia,6,6,4,0,0,4,2,Technical Failure
1969-08-13 00:00:00,French Air Force - Armée de l'Air,Flight,Operational,France,Europe,4,4,4,0,0,4,0,Unknown
1969-08-13 00:00:00,French Air Force - Armée de l'Air,Flight,Operational,France,Europe,4,4,4,0,0,4,0,Unknown
1969-09-06 00:00:00,United States Air Force - USAF,Landing (descent or approach),Military / Government,Thailand,Asia,16,16,4,0,0,4,12,Weather
1969-09-11 00:00:00,United States Air Force - USAF,Flight,Military / Government,Vietnam,Asia,4,4,4,0,0,4,0,Terrorism
1969-09-17 00:00:00,Pacific Western Airlines - PWA,Landing (descent or approach),Commercial,Canada,North America,15,4,2,11,2,4,11,Human Factor
1969-09-18 00:00:00,United States Air Force - USAF,Takeoff (climb),Military / Government,United States of America,North America,13,3,3,10,1,4,9,Unknown
1969-10-13 00:00:00,United States Air Force - USAF,Flight,Military / Government,United States of America,North America,4,4,4,0,0,4,0,Unknown
1969-10-17 00:00:00,Massey Ferguson,Flight,Business,United States of America,North America,4,1,1,3,3,4,0,Human Factor
1969-11-09 00:00:00,Austin Airways,Landing (descent or approach),Commercial,Canada,North America,8,2,2,6,2,4,4,Human Factor
1969-12-19 00:00:00,United States Air Force - USAF,Takeoff (climb),Operational,Taiwan,Asia,4,4,4,0,0,4,0,Weather
1969-12-28 00:00:00,United States Navy - USN,Flight,Operational,Vietnam,Asia,4,4,4,0,0,4,0,Unknown
1970-01-02 00:00:00,Xieng Khouang Air Transport,Landing (descent or approach),Operational,Laos,Asia,4,4,4,0,0,4,0,Unknown
1970-01-31 00:00:00,Transportes Aéreos Littoral - TAL,Flight,Operational,Peru,South America,4,4,4,0,0,4,0,Human Factor
1970-03-15 00:00:00,Transportes Aéreos Benianos - TABSA,Takeoff (climb),Operational,Bolivia,South America,4,4,4,0,0,4,0,Unknown
1970-03-18 00:00:00,Suburban Airlines,Landing (descent or approach),Commercial,United States of America,North America,4,1,1,3,3,4,0,Human Factor
1970-03-28 00:00:00,DETA Mozambique Airlines - Direcção de Exploração dos Transportes Aéreos,Takeoff (climb),Operational,Mozambique,Africa,4,3,3,1,1,4,0,Unknown
1970-03-28 00:00:00,Alert Bay Air Services,Flight,Military / Government,Canada,North America,4,1,1,3,3,4,0,Human Factor
1970-04-10 00:00:00,Aerocosta Colombia,Flight,Operational,World,World,4,4,4,0,0,4,0,Unknown
1970-04-16 00:00:00,United States Air Force - USAF,Flight,Military / Government,United States of America,North America,4,4,4,0,0,4,0,Unknown
1970-05-12 00:00:00,Aero Spacelines,Takeoff (climb),Specialised Services,United States of America,North America,4,4,4,0,0,4,0,Unknown
1970-06-04 00:00:00,Mid-Continent Airlines,Landing (descent or approach),Business,United States of America,North America,5,1,1,4,3,4,1,Human Factor
1970-06-27 00:00:00,United States Army,Landing (descent or approach),Military / Government,Vietnam,Asia,5,1,0,4,4,4,1,Unknown
1970-07-27 00:00:00,Flying Tiger Line,Landing (descent or approach),Operational,Japan,Asia,4,4,4,0,0,4,0,Human Factor
1970-09-30 00:00:00,Air Vietnam,Landing (descent or approach),Commercial,Vietnam,Asia,38,4,3,34,1,4,34,Unknown
1970-10-01 00:00:00,Soviet Navy - Voyenno-morskoy flot CCCP,Takeoff (climb),Operational,Ukraine,Europe,4,4,4,0,0,4,0,Other
1970-10-28 00:00:00,Amazônia Transportes Aéreos,Flight,Operational,Brazil,South America,4,4,4,0,0,4,0,Unknown
1970-12-02 00:00:00,Cargolux,Landing (descent or approach),Humanitarian,Bangladesh,Asia,4,4,4,0,0,4,0,Technical Failure
1970-12-24 00:00:00,Mount Cook Airlines,Flight,Specialised Services,New Zealand,Oceania,4,1,1,3,3,4,0,Human Factor
1970-12-29 00:00:00,Private American,Landing (descent or approach),Business,United States of America,North America,4,1,1,3,3,4,0,Other
1971-04-17 00:00:00,F %26 S Contracting,Landing (descent or approach),Business,United States of America,North America,4,2,2,2,2,4,0,Human Factor
1971-04-19 00:00:00,Royal Canadian Air Force - RCAF,Flight,Military / Government,Canada,North America,4,4,4,0,0,4,0,Unknown
1971-04-29 00:00:00,Air America,Flight,Commercial,Laos,Asia,4,1,1,3,3,4,0,Unknown
1971-05-02 00:00:00,Brookside-Pratt Mining Company,Takeoff (climb),Business,United States of America,North America,4,1,1,3,3,4,0,Human Factor
1971-05-25 00:00:00,Aerolineas Flecha Austral - AFA,Takeoff (climb),Operational,Chile,South America,4,3,3,1,1,4,0,Technical Failure
1971-05-26 00:00:00,South African Air Force,Flight,Operational,South Africa,Africa,4,4,4,0,0,4,0,Human Factor
1971-05-26 00:00:00,South African Air Force,Flight,Operational,South Africa,Africa,4,4,4,0,0,4,0,Human Factor
1971-07-25 00:00:00,Pan American World Airways - PAA,Landing (descent or approach),Operational,Philippines,Asia,4,4,4,0,0,4,0,Human Factor
1971-08-29 00:00:00,Harry Noe,Landing (descent or approach),Business,United States of America,North America,6,1,0,5,4,4,2,Technical Failure
1971-10-20 00:00:00,Balair - USA,Flight,Operational,Bahamas,Central America,4,4,4,0,0,4,0,Other
1971-10-24 00:00:00,Monmouth Airlines,Landing (descent or approach),Commercial,United States of America,North America,8,2,2,6,2,4,4,Human Factor
1971-11-01 00:00:00,Linea Aeropostal Venezolana - LAV,Takeoff (climb),Operational,Venezuela,South America,4,4,4,0,0,4,0,Technical Failure
1971-11-17 00:00:00,Savannah Aero Service,Takeoff (climb),Business,United States of America,North America,4,2,2,2,2,4,0,Human Factor
1971-12-12 00:00:00,Pakistan International Airlines - PIA,Landing (descent or approach),Operational,Pakistan,Asia,4,4,4,0,0,4,0,Human Factor
1971-12-12 00:00:00,United States Navy - USN,Flight,Military / Government,World,World,4,4,4,0,0,4,0,Unknown
1971-12-22 00:00:00,PacificAir - Pacific Airways,Flight,Commercial,Philippines,Asia,4,2,2,2,2,4,0,Other
1971-12-27 00:00:00,Air America,Flight,Operational,Laos,Asia,4,4,4,0,0,4,0,Terrorism
1972-03-24 00:00:00,United States Air Force - USAF,Landing (descent or approach),Operational,United States of America,North America,4,4,4,0,0,4,0,Unknown
1972-03-28 00:00:00,Copeland Refrigeration Company,Landing (descent or approach),Business,United States of America,North America,4,2,2,2,2,4,0,Human Factor
1972-04-08 00:00:00,Royal Air Force - RAF,Takeoff (climb),Military / Government,Italy,Europe,21,3,2,18,2,4,17,Technical Failure
1972-04-24 00:00:00,Air America,Flight,Commercial,Laos,Asia,10,1,1,9,3,4,6,Human Factor
1972-04-24 00:00:00,Aeroflot - Russian International Airlines,Flight,Commercial,Moldova,Europe,4,3,3,1,1,4,0,Human Factor
1972-05-17 00:00:00,United States Air Force - USAF,Takeoff (climb),Military / Government,Vietnam,Asia,5,5,4,0,0,4,1,Terrorism
1972-05-30 00:00:00,Delta Airlines,Landing (descent or approach),Operational,United States of America,North America,4,4,4,0,0,4,0,Other
1972-06-13 00:00:00,Mexican Air Force - Fuerza Aérea Mexicana,Flight,Military / Government,Mexico,Central America,4,4,4,0,0,4,0,Unknown
1972-06-28 00:00:00,Aeroflot - Russian International Airlines,Flight,Military / Government,Russia,Asia,4,2,2,2,2,4,0,Technical Failure
1972-09-01 00:00:00,Ansett Airlines of Papua New Guinea,Flight,Commercial,Papua New Guinea,Oceania,4,1,1,3,3,4,0,Unknown
1972-09-14 00:00:00,Aerotaxi Servicios Aéreos,Takeoff (climb),Commercial,Colombia,South America,4,1,1,3,3,4,0,Human Factor
1972-09-17 00:00:00,Robert H. Ford,Takeoff (climb),Business,United States of America,North America,4,2,2,2,2,4,0,Technical Failure
1972-10-07 00:00:00,Air Pyrénées,Takeoff (climb),Commercial,France,Europe,4,1,1,3,3,4,0,Unknown
1972-11-23 00:00:00,Air America,Flight,Military / Government,Laos,Asia,4,4,4,0,0,4,0,Terrorism
1972-12-15 00:00:00,Private American,Landing (descent or approach),Business,United States of America,North America,4,1,1,3,3,4,0,Human Factor
1972-12-20 00:00:00,United States Air Force - USAF,Flight,Military / Government,Vietnam,Asia,7,7,4,0,0,4,3,Terrorism
1972-12-20 00:00:00,United States Air Force - USAF,Flight,Military / Government,Thailand,Asia,6,6,4,0,0,4,2,Terrorism
1972-12-26 00:00:00,United States Air Force - USAF,Landing (descent or approach),Military / Government,Thailand,Asia,6,6,4,0,0,4,2,Terrorism
1972-12-29 00:00:00,Polaris Leasing Corp.,Landing (descent or approach),Business,United States of America,North America,4,1,1,3,3,4,0,Human Factor
1973-01-19 00:00:00,British European Airways - BEA,Flight,Specialised Services,United Kingdom,Europe,4,2,2,2,2,4,0,Human Factor
1973-02-07 00:00:00,Aviation Leasing,Landing (descent or approach),Business,United States of America,North America,4,2,2,2,2,4,0,Human Factor
1973-02-19 00:00:00,The Falk Corp.,Takeoff (climb),Business,United States of America,North America,4,1,1,3,3,4,0,Technical Failure
1973-03-07 00:00:00,Air America,Flight,Operational,Laos,Asia,4,4,4,0,0,4,0,Unknown
1973-04-18 00:00:00,Bakhtar Afghan Airlines,Takeoff (climb),Commercial,Afghanistan,Asia,19,3,2,16,2,4,15,Unknown
1973-04-23 00:00:00,Seventh-Day Adventist Church,Takeoff (climb),Business,Papua New Guinea,Oceania,4,1,1,3,3,4,0,Unknown
1973-05-10 00:00:00,Beech Aircraft Corporation,Flight,Operational,United States of America,North America,4,4,4,0,0,4,0,Human Factor
1973-05-29 00:00:00,Air Gaspé,Landing (descent or approach),Commercial,Canada,North America,4,3,3,1,1,4,0,Human Factor
1973-06-06 00:00:00,Aerovias Regionales,Landing (descent or approach),Commercial,Colombia,South America,4,1,1,3,3,4,0,Unknown
1973-06-18 00:00:00,Philipp Holzmann,Landing (descent or approach),Business,Germany,Europe,4,2,2,2,2,4,0,Human Factor
1973-08-20 00:00:00,Mexican Air Force - Fuerza Aérea Mexicana,Takeoff (climb),Military / Government,Mexico,Central America,4,2,2,2,2,4,0,Unknown
1973-09-21 00:00:00,Gary R. Smith,Flight,Business,United States of America,North America,4,1,1,3,3,4,0,Human Factor
1973-10-29 00:00:00,Compagnie Antillaise de Transport Aérien - CATA,Flight,Commercial,Saint Lucia,Central America,4,1,1,3,3,4,0,Human Factor
1973-11-16 00:00:00,Princeton American Airlines,Flight,Business,United States of America,North America,4,1,1,3,3,4,0,Technical Failure
1973-11-23 00:00:00,Italian Air Force - Aeronautica Militare Italiana,Flight,Military / Government,Italy,Europe,4,4,4,0,0,4,0,Unknown
1974-01-06 00:00:00,Servicios Aéreos Bolivianos - SAB,Flight,Operational,Bolivia,South America,4,3,3,1,1,4,0,Human Factor
1974-01-25 00:00:00,Aeroflot - Russian International Airlines,Takeoff (climb),Operational,Russia,Asia,4,4,4,0,0,4,0,Technical Failure
1974-01-25 00:00:00,Kinzig Tool Company,Landing (descent or approach),Business,United States of America,North America,4,1,1,3,3,4,0,Human Factor
1974-02-24 00:00:00,C %26 L Timber Company,Landing (descent or approach),Business,United States of America,North America,4,1,1,3,3,4,0,Weather
1974-05-23 00:00:00,Saturn Airways,Flight,Operational,United States of America,North America,4,3,3,1,1,4,0,Technical Failure
1974-05-31 00:00:00,Crédit Bail Haussmann,Flight,Business,France,Europe,4,1,1,3,3,4,0,Human Factor
1974-07-18 00:00:00,Tesoro Alaskan Petroleum Company,Landing (descent or approach),Business,United States of America,North America,4,1,1,3,3,4,0,Human Factor
1974-08-13 00:00:00,Merric Aviation,Flight,Commercial,United States of America,North America,4,1,1,3,3,4,0,Human Factor
1974-08-31 00:00:00,Alpine Aircraft Charters,Flight,Operational,United States of America,North America,4,4,4,0,0,4,0,Human Factor
1974-09-06 00:00:00,French Air Force - Armée de l'Air,Flight,Military / Government,France,Europe,4,4,4,0,0,4,0,Unknown
1974-09-07 00:00:00,Transportes Aéreos de Integración -TAISA,Takeoff (climb),Operational,Haiti,Central America,4,3,3,1,1,4,0,Technical Failure
1974-09-27 00:00:00,Prospec,Flight,Specialised Services,Brazil,South America,4,2,2,2,2,4,0,Technical Failure
1974-09-30 00:00:00,U.S. Department of the Interior,Flight,Military / Government,World,World,4,1,1,3,3,4,0,Unknown
1974-10-27 00:00:00,Alaska International Air,Flight,Operational,United States of America,North America,4,4,4,0,0,4,0,Technical Failure
1974-11-15 00:00:00,Southeast Skyways,Flight,Commercial,United States of America,North America,4,1,1,3,3,4,0,Human Factor
1974-11-22 00:00:00,Alpa Servicios Aéreos,Takeoff (climb),Commercial,Spain,Europe,4,2,2,2,2,4,0,Unknown
1974-11-29 00:00:00,Honduran Air Force - Fuerza Aérea Hondureña,Flight,Military / Government,Costa Rica,Central America,4,4,4,0,0,4,0,Human Factor
1974-12-06 00:00:00,Ragsdale Aviation,Landing (descent or approach),Operational,United States of America,North America,4,2,2,2,2,4,0,Human Factor
1974-12-12 00:00:00,United States Air Force - USAF,Landing (descent or approach),Operational,Guam Island,Asia,6,6,4,0,0,4,2,Technical Failure
1974-12-26 00:00:00,Harbor Airlines,Takeoff (climb),Commercial,United States of America,North America,6,1,1,5,3,4,2,Technical Failure
1975-02-15 00:00:00,Ronald H. Galowich Associates,Landing (descent or approach),Business,United States of America,North America,4,1,1,3,3,4,0,Human Factor
1975-03-15 00:00:00,Royal Air Lao,Takeoff (climb),Operational,Cambodia,Asia,4,4,4,0,0,4,0,Unknown
1975-04-17 00:00:00,Royal Cambodian Air Force - Kangtorp Cheung Akas,Flight,Military / Government,Thailand,Asia,4,1,1,3,3,4,0,Unknown
1975-04-24 00:00:00,SAVCO - Servicios Aéreos Virgen de Copacabana,Landing (descent or approach),Operational,Bolivia,South America,4,4,4,0,0,4,0,Human Factor
1975-05-03 00:00:00,SATENA - Servicio de Aeronavegacion a Territorios Nacionales,Flight,Commercial,Colombia,South America,7,4,4,3,0,4,3,Unknown
1975-08-07 00:00:00,Laurentian Air Services,Flight,Humanitarian,Canada,North America,4,1,1,3,3,4,0,Unknown
1975-08-30 00:00:00,Aeroflot - Russian International Airlines,Flight,Operational,Russia,Asia,4,2,2,2,2,4,0,Human Factor
1975-09-12 00:00:00,Campbell Ewald Company,Landing (descent or approach),Business,United States of America,North America,4,2,2,2,2,4,0,Human Factor
1975-09-26 00:00:00,United States Navy - USN,Takeoff (climb),Operational,United States of America,North America,6,6,4,0,0,4,2,Unknown
1975-09-30 00:00:00,Avianca,Landing (descent or approach),Operational,Colombia,South America,4,4,4,0,0,4,0,Technical Failure
1975-12-07 00:00:00,United States Air Force - USAF,Takeoff (climb),Operational,United States of America,North America,4,4,4,0,0,4,0,Technical Failure
1975-12-28 00:00:00,Philip Bruce Davis,Takeoff (climb),Business,United States of America,North America,4,1,1,3,3,4,0,Technical Failure
1976-02-04 00:00:00,LAC Colombia - Lineas Aéreas del Caribe,Takeoff (climb),Operational,Colombia,South America,4,3,3,1,1,4,0,Technical Failure
1976-03-07 00:00:00,Western Alaska Airlines,Takeoff (climb),Commercial,United States of America,North America,4,1,1,3,3,4,0,Human Factor
1976-03-23 00:00:00,Italian Air Force - Aeronautica Militare Italiana,Landing (descent or approach),Military / Government,Italy,Europe,4,4,4,0,0,4,0,Human Factor
1976-03-25 00:00:00,International Air Service,Takeoff (climb),Business,United States of America,North America,4,2,2,2,2,4,0,Human Factor
1976-04-11 00:00:00,Aeroflot - Russian International Airlines,Flight,Operational,Russia,Asia,4,2,2,2,2,4,0,Human Factor
1976-05-05 00:00:00,Philippine Aerotransport,Flight,Commercial,Philippines,Asia,10,2,0,8,4,4,6,Unknown
1976-05-25 00:00:00,Republic of Korea Navy,Flight,Operational,South Korea,Asia,4,4,4,0,0,4,0,Unknown
1976-06-06 00:00:00,MAP - Ministerstvo Aviatsionnoi Promyshlennosti - Minaviaprom,Flight,Military / Government,Russia,Asia,4,4,4,0,0,4,0,Human Factor
1976-06-29 00:00:00,Grupo Protexa,Landing (descent or approach),Business,Mexico,Central America,4,2,2,2,2,4,0,Human Factor
1976-07-25 00:00:00,Stryker Corporation,Landing (descent or approach),Business,United States of America,North America,4,1,1,3,3,4,0,Human Factor
1976-07-28 00:00:00,Aeroflot - Russian International Airlines,Flight,Operational,Russia,Asia,4,3,3,1,1,4,0,Human Factor
1976-09-13 00:00:00,Ruel Insurance,Flight,Business,United States of America,North America,4,1,1,3,3,4,0,Human Factor
1976-10-04 00:00:00,Emirates Air Transport,Flight,Operational,Kenya,Africa,4,4,4,0,0,4,0,Human Factor
1976-10-20 00:00:00,Skyline Aviation,Landing (descent or approach),Commercial,United States of America,North America,4,2,2,2,2,4,0,Technical Failure
1976-12-12 00:00:00,Atlantic City Airlines,Landing (descent or approach),Commercial,United States of America,North America,10,2,1,8,3,4,6,Human Factor
1977-01-06 00:00:00,Jet Avia,Takeoff (climb),Business,United States of America,North America,4,2,2,2,2,4,0,Human Factor
1977-01-07 00:00:00,Commonwealth Electric Company,Takeoff (climb),Business,United States of America,North America,4,1,1,3,3,4,0,Technical Failure
1977-02-11 00:00:00,CSA Czech Airlines - Československé Státní Aerolinie,Landing (descent or approach),Operational,Slovakia,Europe,5,3,2,2,2,4,1,Human Factor
1977-02-28 00:00:00,Survair,Landing (descent or approach),Commercial,Canada,North America,10,3,2,7,2,4,6,Human Factor
1977-03-05 00:00:00,Fred Bell Enterprises,Flight,Business,Bahamas,Central America,4,1,1,3,3,4,0,Unknown
1977-04-03 00:00:00,Mountain Bell,Takeoff (climb),Business,United States of America,North America,5,2,2,3,2,4,1,Technical Failure
1977-04-23 00:00:00,J. D. Barter Construction Company,Takeoff (climb),Business,United States of America,North America,4,1,1,3,3,4,0,Other
1977-04-28 00:00:00,Southern Services,Takeoff (climb),Business,United States of America,North America,4,2,2,2,2,4,0,Technical Failure
1977-05-07 00:00:00,Aeroflot - Russian International Airlines,Flight,Operational,Russia,Asia,4,3,3,1,1,4,0,Technical Failure
1977-06-29 00:00:00,Transportes Aéreos de Moçambique - TAM,Takeoff (climb),Commercial,Mozambique,Africa,7,2,1,5,3,4,3,Unknown
1977-06-30 00:00:00,Cooperativa de Montecillos,Flight,Operational,World,World,4,3,3,1,1,4,0,Unknown
1977-07-07 00:00:00,Let,Flight,Specialised Services,Czech Republic,Europe,4,4,4,0,0,4,0,Human Factor
1977-09-02 00:00:00,Transmeridian Air Cargo,Takeoff (climb),Operational,China,Asia,4,4,4,0,0,4,0,Technical Failure
1977-09-12 00:00:00,Safe Air Cargo,Takeoff (climb),Operational,United States of America,North America,4,4,4,0,0,4,0,Human Factor
1977-09-23 00:00:00,Arab Wings,Takeoff (climb),Commercial,Jordan,Asia,4,2,2,2,2,4,0,Human Factor
1977-09-24 00:00:00,Sabang Merauke Raya Air Charter - SMAC,Takeoff (climb),Commercial,Indonesia,Asia,10,1,0,9,4,4,6,Unknown
1977-11-04 00:00:00,Citrex,Flight,Business,Argentina,South America,4,1,1,3,3,4,0,Unknown
1977-12-11 00:00:00,Warbirds of Great Britain,Flight,Business,Spain,Europe,4,1,1,3,3,4,0,Human Factor
1978-01-03 00:00:00,Märkische Luftfahrtgesellschaft,Landing (descent or approach),Business,Germany,Europe,5,1,1,4,3,4,1,Human Factor
1978-02-02 00:00:00,Argentinian Air Force - Fuerza Aérea Argentina,Flight,Military / Government,Argentina,South America,4,2,2,2,2,4,0,Unknown
1978-02-13 00:00:00,Aero Center,Landing (descent or approach),Commercial,Sweden,Europe,5,2,2,3,2,4,1,Human Factor
1978-02-13 00:00:00,Private American,Landing (descent or approach),Business,United States of America,North America,6,1,1,5,3,4,2,Human Factor
1978-02-15 00:00:00,Private Mexican,Flight,Business,Mexico,Central America,4,1,1,3,3,4,0,Unknown
1978-02-19 00:00:00,Peruvian Air Force - Fuerza Aérea del Perú,Takeoff (climb),Operational,Peru,South America,4,4,4,0,0,4,0,Technical Failure
1978-02-27 00:00:00,Private Canadian,Takeoff (climb),Business,Canada,North America,4,2,2,2,2,4,0,Unknown
1978-03-03 00:00:00,Michael C. Mirk Jr.,Flight,Business,United States of America,North America,4,1,1,3,3,4,0,Human Factor
1978-03-23 00:00:00,Balkan Bulgarian Airlines,Landing (descent or approach),Operational,Syria,Asia,4,4,4,0,0,4,0,Unknown
1978-04-28 00:00:00,National Agricultural Organisation,,Military / Government,South Sudan,Africa,7,1,1,6,3,4,3,Unknown
1978-05-05 00:00:00,Air Toulouse,Landing (descent or approach),Commercial,Italy,Europe,4,1,1,3,3,4,0,Technical Failure
1978-05-16 00:00:00,Bar Harbor Airlines,Landing (descent or approach),Commercial,United States of America,North America,4,2,2,2,2,4,0,Technical Failure
1978-05-18 00:00:00,Flight Safety International,Landing (descent or approach),Operational,United States of America,North America,4,4,4,0,0,4,0,Human Factor
1978-05-19 00:00:00,Aeroflot - Russian International Airlines,Flight,Commercial,Russia,Asia,134,8,0,126,4,4,130,Technical Failure
1978-06-05 00:00:00,Benjamin G. Cobb,Takeoff (climb),Business,United States of America,North America,4,1,1,3,3,4,0,Human Factor
1978-07-01 00:00:00,Bolivian Air Force - Fuerza Aérea Boliviana,Flight,Military / Government,Bolivia,South America,4,2,2,2,2,4,0,Unknown
1978-07-22 00:00:00,Government of Bulgaria,Flight,Humanitarian,Bulgaria,Europe,4,2,2,2,2,4,0,Unknown
1978-08-27 00:00:00,New World Air Charter,Takeoff (climb),Operational,Oman,Asia,4,4,4,0,0,4,0,Human Factor
1978-09-02 00:00:00,Antilles Air Boats,Flight,Commercial,United States of America,Central America,11,1,1,10,3,4,7,Human Factor
1978-09-05 00:00:00,Canyon Airways,Flight,Commercial,Canada,North America,4,1,1,3,3,4,0,Human Factor
1978-09-21 00:00:00,Argosy Air Lines,Flight,Operational,World,World,4,4,4,0,0,4,0,Unknown
1978-10-24 00:00:00,Don Zimmermann Aviation,Flight,Commercial,United States of America,North America,4,1,1,3,3,4,0,Human Factor
1978-11-03 00:00:00,Hohenloher Flugdienst,Landing (descent or approach),Business,Germany,Europe,4,2,2,2,2,4,0,Unknown
1978-11-13 00:00:00,Air Inter Gabon,Flight,Commercial,Ghana,Africa,4,1,1,3,3,4,0,Unknown
1979-01-19 00:00:00,Simmons Airlines,Landing (descent or approach),Commercial,United States of America,North America,6,1,1,5,3,4,2,Human Factor
1979-01-21 00:00:00,Royal Thai Air Force - Kong Thap Akat Thai,Takeoff (climb),Military / Government,Thailand,Asia,4,1,1,3,3,4,0,Unknown
1979-03-06 00:00:00,Garuda Indonesian Airways,Flight,Operational,Indonesia,Asia,4,4,4,0,0,4,0,Human Factor
1979-03-10 00:00:00,Nichols Aviation,Landing (descent or approach),Business,United States of America,North America,4,1,1,3,3,4,0,Human Factor
1979-03-18 00:00:00,May Petroleum,Takeoff (climb),Business,United States of America,North America,4,1,1,3,3,4,0,Human Factor
1979-03-22 00:00:00,Aeroflot - Russian International Airlines,Landing (descent or approach),Operational,Latvia,Europe,5,5,4,0,0,4,1,Human Factor
1979-03-25 00:00:00,Aeroflot - Russian International Airlines,Landing (descent or approach),Operational,Russia,Asia,12,6,1,6,3,4,8,Human Factor
1979-03-25 00:00:00,Aeroflot - Russian International Airlines,Takeoff (climb),Operational,Russia,Asia,4,2,2,2,2,4,0,Technical Failure
1979-03-31 00:00:00,Patzig Fleischwaren,Flight,Business,Switzerland,Europe,4,2,2,2,2,4,0,Human Factor
1979-05-27 00:00:00,John D. Johnston,Flight,Business,United States of America,North America,4,1,1,3,3,4,0,Human Factor
1979-06-14 00:00:00,Votec Taxi Aéreo,Flight,Commercial,Brazil,South America,6,1,1,5,3,4,2,Unknown
1979-07-03 00:00:00,Metro Inns inc.,Flight,Business,United States of America,North America,4,1,1,3,3,4,0,Human Factor
1979-07-08 00:00:00,Private American,Flight,Business,United States of America,North America,4,1,1,3,3,4,0,Technical Failure
1979-09-15 00:00:00,Northern Air Service - USA,Landing (descent or approach),Operational,United States of America,North America,4,1,1,3,3,4,0,Technical Failure
1979-09-18 00:00:00,Pacific Coastal Airlines - PCA,Flight,Commercial,Canada,North America,9,1,0,8,4,4,5,Human Factor
1979-09-20 00:00:00,Marr Short Stops of Texas,Takeoff (climb),Business,United States of America,North America,4,1,1,3,3,4,0,Human Factor
1979-09-28 00:00:00,Transporte Aéreo Boliviano - TAB,Takeoff (climb),Operational,Panama,Central America,4,4,4,0,0,4,0,Unknown
1979-10-08 00:00:00,Spernak Airways,Takeoff (climb),Commercial,United States of America,North America,4,1,1,3,3,4,0,Human Factor
1979-12-03 00:00:00,Evergreen International Airlines,Flight,Commercial,United States of America,North America,4,2,2,2,2,4,0,Human Factor
1979-12-19 00:00:00,Anson Drilling Company,Flight,Business,Colombia,South America,4,2,2,2,2,4,0,Human Factor
1979-12-21 00:00:00,Sterling Stores Company,Landing (descent or approach),Business,United States of America,North America,4,1,1,3,3,4,0,Human Factor
1979-12-22 00:00:00,Intercontinental Association,Takeoff (climb),Business,United States of America,North America,4,1,1,3,3,4,0,Human Factor
1980-01-24 00:00:00,Aerotal Colombia - Aerolineas Territoriales de Colombia,Flight,Specialised Services,Colombia,South America,4,4,4,0,0,4,0,Technical Failure
1980-02-14 00:00:00,Holt Manufacturing Company,Landing (descent or approach),Business,United States of America,North America,5,1,1,4,3,4,1,Human Factor
1980-03-02 00:00:00,University of Nevada,Flight,Business,United States of America,North America,4,2,2,2,2,4,0,Human Factor
1980-05-09 00:00:00,Private American,Flight,Business,United States of America,North America,4,1,1,3,3,4,0,Technical Failure
1980-06-29 00:00:00,Private American,Landing (descent or approach),Business,United States of America,North America,4,1,1,3,3,4,0,Technical Failure
1980-07-10 00:00:00,Israeli Air Force - Heyl Ha'avir,Flight,Military / Government,Egypt,Africa,4,4,4,0,0,4,0,Unknown
1980-08-13 00:00:00,Spantax,Landing (descent or approach),Business,Spain,Europe,4,2,2,2,2,4,0,Human Factor
1980-08-15 00:00:00,United States Navy - USN,Landing (descent or approach),Military / Government,United States of America,North America,4,4,4,0,0,4,0,Unknown
1980-08-20 00:00:00,Staal Leasing,Landing (descent or approach),Business,United States of America,North America,4,1,1,3,3,4,0,Technical Failure
1980-09-23 00:00:00,Iraqi Airways,Landing (descent or approach),Operational,Iraq,Asia,4,4,4,0,0,4,0,Terrorism
1980-10-01 00:00:00,Aero Contractors,Flight,Commercial,Nigeria,Africa,4,2,2,2,2,4,0,Unknown
1980-10-02 00:00:00,United States Air Force - USAF,Flight,Operational,United States of America,North America,4,4,4,0,0,4,0,Technical Failure
1980-10-17 00:00:00,James B. Urban,Takeoff (climb),Business,United States of America,North America,4,1,1,3,3,4,0,Human Factor
1980-11-03 00:00:00,Latin Carga - Latinamericana Aérea de Carga,Takeoff (climb),Operational,Venezuela,South America,4,4,4,0,0,4,0,Technical Failure
1980-11-10 00:00:00,Private American,Landing (descent or approach),Business,United States of America,North America,4,1,1,3,3,4,0,Technical Failure
1980-11-17 00:00:00,Provincial Air Services,Takeoff (climb),Commercial,Papua New Guinea,Oceania,16,1,0,15,4,4,12,Human Factor
1980-11-28 00:00:00,Miami Air Lease,Takeoff (climb),Humanitarian,Bahamas,Central America,4,2,2,2,2,4,0,Technical Failure
1980-11-28 00:00:00,Jarlin Aviation,Flight,Business,South Africa,Africa,4,1,1,3,3,4,0,Unknown
1980-12-07 00:00:00,Queen Airmotive,Landing (descent or approach),Commercial,United States of America,North America,4,1,1,3,3,4,0,Human Factor
1980-12-16 00:00:00,Milestone Construction,Landing (descent or approach),Business,South Africa,Africa,6,1,0,5,4,4,2,Unknown
1980-12-19 00:00:00,Royal Canadian Air Force - RCAF,Flight,Military / Government,United States of America,North America,4,4,4,0,0,4,0,Unknown
1981-01-18 00:00:00,Guyana Civil Aviation Department,Flight,Military / Government,Guyana,South America,4,2,2,2,2,4,0,Unknown
1981-02-17 00:00:00,J. P. Dos Santos,Takeoff (climb),Business,Paraguay,South America,4,1,1,3,3,4,0,Unknown
1981-03-02 00:00:00,Spanish Air Force - Ejército del Aire,Flight,Operational,Spain,Europe,4,4,4,0,0,4,0,Unknown
1981-03-06 00:00:00,Aeroflot - Russian International Airlines,Flight,Commercial,Russia,Asia,4,2,2,2,2,4,0,Unknown
1981-03-27 00:00:00,Galena Air Service,Landing (descent or approach),Commercial,United States of America,North America,4,1,1,3,3,4,0,Technical Failure
1981-04-21 00:00:00,Hemet Exploration,Flight,Operational,World,World,4,2,2,2,2,4,0,Unknown
1981-04-30 00:00:00,Royal Flying Doctor Service - RFDS,Landing (descent or approach),Humanitarian,Australia,Oceania,5,1,1,4,3,4,1,Weather
1981-05-02 00:00:00,Servicios Aéreos Regiomontanos - SARSA,Landing (descent or approach),Commercial,Mexico,Central America,6,2,2,4,2,4,2,Human Factor
1981-05-16 00:00:00,TAAG Angola Airlines - Transportes Aéreos de Angola,Landing (descent or approach),Operational,Angola,Africa,4,4,4,0,0,4,0,Terrorism
1981-05-31 00:00:00,Aeroflot - Russian International Airlines,Flight,Business,Russia,Asia,4,3,3,1,1,4,0,Human Factor
1981-06-06 00:00:00,Lakeland Airways,Flight,Commercial,Canada,North America,4,1,1,3,3,4,0,Human Factor
1981-07-18 00:00:00,Transporte Aereo Rioplatense,Flight,Operational,Armenia,Asia,4,3,3,1,1,4,0,Human Factor
1981-07-25 00:00:00,Transamazonica,Landing (descent or approach),Commercial,Colombia,South America,9,3,3,6,1,4,5,Technical Failure
1981-08-16 00:00:00,P. R. Gerrits,Landing (descent or approach),Business,United States of America,Central America,4,1,1,3,3,4,0,Technical Failure
1981-09-04 00:00:00,Morgan Maxfield,Takeoff (climb),Business,United States of America,North America,4,1,1,3,3,4,0,Technical Failure
1981-09-05 00:00:00,Joseph R. Gifford,Landing (descent or approach),Business,United States of America,North America,4,1,1,3,3,4,0,Human Factor
1981-11-16 00:00:00,Benin Government,Landing (descent or approach),Military / Government,Nigeria,Africa,4,2,2,2,2,4,0,Unknown
1981-11-21 00:00:00,Guatemalan Air Force - Fuerza Aérea Guatemalteca,Landing (descent or approach),Military / Government,Guatemala,Central America,11,3,0,8,4,4,7,Unknown
1981-12-10 00:00:00,Spernak Airways,Takeoff (climb),Commercial,United States of America,North America,4,1,1,3,3,4,0,Unknown
1981-12-31 00:00:00,Sun West Airlines - SWA,Landing (descent or approach),Commercial,United States of America,North America,6,1,1,5,3,4,2,Human Factor
1982-02-19 00:00:00,LAC Colombia - Lineas Aéreas del Caribe,Landing (descent or approach),Operational,Colombia,South America,4,4,4,0,0,4,0,Unknown
1982-02-26 00:00:00,Aeroflot - Russian International Airlines,Takeoff (climb),Commercial,Russia,Asia,5,2,2,3,2,4,1,Human Factor
1982-03-13 00:00:00,United States Air Force - USAF,Landing (descent or approach),Operational,United States of America,North America,4,4,4,0,0,4,0,Human Factor
1982-05-06 00:00:00,Ibex Corporation,Flight,Business,United States of America,North America,4,2,2,2,2,4,0,Unknown
1982-05-09 00:00:00,Taylor Airways,Landing (descent or approach),Commercial,Canada,North America,4,1,1,3,3,4,0,Technical Failure
1982-07-10 00:00:00,Italian Air Force - Aeronautica Militare Italiana,Flight,Humanitarian,Italy,Europe,4,4,4,0,0,4,0,Unknown
1982-07-11 00:00:00,Philippine Airlines - PAL,Takeoff (climb),Commercial,Philippines,Asia,30,5,1,25,3,4,26,Human Factor
1982-07-30 00:00:00,Partenavia,Flight,Specialised Services,Italy,Europe,4,4,4,0,0,4,0,Unknown
1982-08-12 00:00:00,Republic of Korea Navy,Flight,Operational,World,World,4,4,4,0,0,4,0,Unknown
1982-08-14 00:00:00,MAP - Ministerstvo Aviatsionnoi Promyshlennosti - Minaviaprom,Flight,Operational,Russia,Asia,4,4,4,0,0,4,0,Unknown
1982-12-11 00:00:00,Carey Hilliard's Restaurant,Landing (descent or approach),Business,United States of America,North America,4,1,1,3,3,4,0,Human Factor
1982-12-12 00:00:00,Transportes Aéreos Latinoamericanos - TALA Colombia,Takeoff (climb),Operational,Colombia,South America,4,4,4,0,0,4,0,Human Factor
1983-01-22 00:00:00,Aeroflot - Russian International Airlines,Landing (descent or approach),Operational,Russia,Asia,4,4,4,0,0,4,0,Technical Failure
1983-01-31 00:00:00,Mexican Air Force - Fuerza Aérea Mexicana,Takeoff (climb),Military / Government,Mexico,Central America,4,2,2,2,2,4,0,Unknown
1983-02-15 00:00:00,Robert M. McCormick,Takeoff (climb),Business,United States of America,North America,4,2,2,2,2,4,0,Human Factor
1983-02-21 00:00:00,Colombian Air Force - Fuerza Aérea Colombiana,Flight,Military / Government,Colombia,South America,4,4,4,0,0,4,0,Unknown
1983-03-07 00:00:00,Aeroflot - Russian International Airlines,Flight,Commercial,Russia,Asia,6,2,2,4,2,4,2,Unknown
1983-03-24 00:00:00,McCauley Aviation,Flight,Commercial,United States of America,North America,4,1,1,3,3,4,0,Weather
1983-03-30 00:00:00,Aeroflot - Russian International Airlines,Flight,Operational,Russia,Asia,4,3,3,1,1,4,0,Human Factor
1983-04-01 00:00:00,Winn Exploration Company,Landing (descent or approach),Business,United States of America,North America,4,2,2,2,2,4,0,Human Factor
1983-04-14 00:00:00,Servicio de Transporte de la Guardia Nacional,Flight,Military / Government,Venezuela,South America,4,2,2,2,2,4,0,Unknown
1983-05-09 00:00:00,Aeroflot - Russian International Airlines,Takeoff (climb),Military / Government,Ukraine,Europe,4,2,2,2,2,4,0,Human Factor
1983-07-20 00:00:00,Tenson,Flight,Operational,United States of America,North America,4,2,2,2,2,4,0,Other
1983-08-23 00:00:00,United States Navy - USN,Landing (descent or approach),Operational,United States of America,North America,4,4,4,0,0,4,0,Unknown
1983-09-02 00:00:00,SAT Aerotaxi,Takeoff (climb),Commercial,Italy,Europe,6,1,0,5,4,4,2,Unknown
1983-11-05 00:00:00,Air Unlimited,Flight,Commercial,United States of America,North America,4,1,1,3,3,4,0,Human Factor
1983-11-23 00:00:00,Austin Airways,Landing (descent or approach),Commercial,Canada,North America,7,2,0,5,4,4,3,Human Factor
1983-11-24 00:00:00,United States Navy - USN,Flight,Military / Government,World,World,4,4,4,0,0,4,0,Human Factor
1983-12-09 00:00:00,Island Airlines,Takeoff (climb),Commercial,United States of America,North America,4,1,1,3,3,4,0,Human Factor
1984-01-17 00:00:00,Integrated Products,Landing (descent or approach),Business,United States of America,North America,4,2,2,2,2,4,0,Human Factor
1984-01-28 00:00:00,Aeroflot - Russian International Airlines,Landing (descent or approach),Commercial,Russia,Asia,53,4,1,49,3,4,49,Human Factor
1984-02-11 00:00:00,Aeroflot - Russian International Airlines,Flight,Operational,Angola,Africa,4,4,4,0,0,4,0,Terrorism
1984-03-13 00:00:00,Private Colombian,Landing (descent or approach),Humanitarian,Colombia,South America,6,4,3,2,1,4,2,Technical Failure
1984-03-26 00:00:00,Fort Myers 21,Landing (descent or approach),Business,United States of America,North America,4,1,1,3,3,4,0,Human Factor
1984-03-28 00:00:00,Líder Taxi Aéreo,Landing (descent or approach),Commercial,Brazil,South America,4,2,2,2,2,4,0,Unknown
1984-04-19 00:00:00,SANSA - Servicios Aéreos Nacionales,Flight,Operational,Costa Rica,Central America,4,4,4,0,0,4,0,Human Factor
1984-05-24 00:00:00,Soviet Air Force - Voyenno-vozdushnye sily CCCP,Flight,Military / Government,Ukraine,Europe,4,3,3,1,1,4,0,Human Factor
1984-05-30 00:00:00,Zantop International Airlines,Flight,Operational,United States of America,North America,4,3,3,1,1,4,0,Technical Failure
1984-06-14 00:00:00,Aeroflot - Russian International Airlines,Flight,Military / Government,Russia,Asia,4,2,2,2,2,4,0,Human Factor
1984-06-20 00:00:00,Mobile Home Estates,Takeoff (climb),Business,United States of America,North America,4,1,1,3,3,4,0,Human Factor
1984-07-05 00:00:00,Captivator Ventures,Flight,Business,United States of America,North America,4,1,1,3,3,4,0,Human Factor
1984-07-21 00:00:00,Harold W. Dierich,Takeoff (climb),Business,United States of America,North America,4,1,1,3,3,4,0,Human Factor
1984-07-24 00:00:00,Aeroflot - Russian International Airlines,Flight,Military / Government,Kazakhstan,Asia,4,2,2,2,2,4,0,Technical Failure
1984-08-08 00:00:00,Nichols Industries,Takeoff (climb),Business,United States of America,North America,4,1,1,3,3,4,0,Human Factor
1984-08-10 00:00:00,Sabang Merauke Raya Air Charter - SMAC,Flight,Commercial,Indonesia,Asia,4,1,1,3,3,4,0,Unknown
1984-08-25 00:00:00,James P. Demetry,Takeoff (climb),Business,United States of America,North America,4,1,1,3,3,4,0,Weather
1984-09-18 00:00:00,Aeroservicios Ecuatorianos,Takeoff (climb),Operational,Ecuador,South America,4,4,4,0,0,4,0,Human Factor
1984-10-11 00:00:00,Labrador Airways,Landing (descent or approach),Humanitarian,Canada,North America,4,2,2,2,2,4,0,Human Factor
1984-10-31 00:00:00,Village Airways,Flight,Operational,Philippines,Asia,4,4,4,0,0,4,0,Unknown
1984-12-12 00:00:00,United States Army,Landing (descent or approach),Military / Government,United States of America,North America,4,2,2,2,2,4,0,Human Factor
1985-01-31 00:00:00,Santa Fe Associates,Landing (descent or approach),Business,United States of America,North America,4,2,2,2,2,4,0,Human Factor
1985-02-01 00:00:00,Air Trends,Landing (descent or approach),Commercial,United States of America,North America,5,2,2,3,2,4,1,Human Factor
1985-02-09 00:00:00,Mercy Flights,Landing (descent or approach),Commercial,United States of America,North America,4,1,1,3,3,4,0,Human Factor
1985-03-14 00:00:00,Sudanese Air Force - Al Quwwat al-Jawwiya As-Sudaniya,Takeoff (climb),Military / Government,South Sudan,Africa,4,4,4,0,0,4,0,Unknown
1985-03-29 00:00:00,Royal Canadian Air Force - RCAF,Flight,Operational,Canada,North America,4,4,4,0,0,4,0,Human Factor
1985-04-20 00:00:00,Carga Aéreo Transportadora,Takeoff (climb),Operational,Bolivia,South America,4,3,3,1,1,4,0,Technical Failure
1985-05-29 00:00:00,Aeroflot - Russian International Airlines,Takeoff (climb),Operational,Russia,Asia,5,2,2,3,2,4,1,Technical Failure
1985-06-27 00:00:00,Brazilian Air Force - Força Aérea Brasileira,Flight,Operational,Brazil,South America,4,4,4,0,0,4,0,Human Factor
1985-07-01 00:00:00,Tanzania Peoples Defence Forces,Takeoff (climb),Military / Government,Tanzania,Africa,4,4,4,0,0,4,0,Unknown
1985-08-18 00:00:00,Alaska Air Guides,Landing (descent or approach),Commercial,United States of America,North America,4,1,1,3,3,4,0,Human Factor
1985-08-29 00:00:00,Italian Air Force - Aeronautica Militare Italiana,Flight,Humanitarian,Italy,Europe,4,4,4,0,0,4,0,Unknown
1985-09-26 00:00:00,Douglas Airways,Flight,Commercial,Papua New Guinea,Oceania,4,1,1,3,3,4,0,Unknown
1985-10-01 00:00:00,Rosewood Enterprises,Landing (descent or approach),Business,United States of America,North America,4,1,1,3,3,4,0,Human Factor
1985-10-12 00:00:00,Burma Airways,Landing (descent or approach),Operational,Myanmar,Asia,4,2,2,2,2,4,0,Unknown
1985-10-22 00:00:00,ERA Aviation,Landing (descent or approach),Humanitarian,United States of America,North America,4,2,2,2,2,4,0,Human Factor
1985-11-15 00:00:00,United States Navy - USN,Takeoff (climb),Specialised Services,United States of America,North America,4,4,4,0,0,4,0,Technical Failure
1985-11-16 00:00:00,Aeroflot - Russian International Airlines,Flight,Humanitarian,Russia,Asia,4,2,2,2,2,4,0,Unknown
1985-11-21 00:00:00,Private German,Landing (descent or approach),Business,Germany,Europe,4,1,1,3,3,4,0,Unknown
1986-01-08 00:00:00,RCMP - GRC Air Services,Takeoff (climb),Military / Government,Canada,North America,4,2,2,2,2,4,0,Weather
1986-01-26 00:00:00,Private Colombian,Flight,Business,Colombia,South America,4,1,1,3,3,4,0,Human Factor
1986-03-24 00:00:00,Goose Bay Air Services,Flight,Commercial,Canada,North America,5,1,1,4,3,4,1,Technical Failure
1986-06-17 00:00:00,United States Air Force - USAF,Landing (descent or approach),Operational,Panama,Central America,4,4,4,0,0,4,0,Unknown
1986-07-19 00:00:00,David D. Weaver,Takeoff (climb),Business,United States of America,North America,4,1,1,3,3,4,0,Human Factor
1986-07-19 00:00:00,Sécurité civile française,Flight,Humanitarian,Spain,Europe,4,4,4,0,0,4,0,Human Factor
1986-07-23 00:00:00,The Yomiuri Shimbun,Landing (descent or approach),Operational,Japan,Asia,4,4,4,0,0,4,0,Human Factor
1986-07-31 00:00:00,Atlas Consolidated Mining,Flight,Business,Philippines,Asia,4,1,1,3,3,4,0,Human Factor
1986-10-02 00:00:00,Rembrandt Tobacco,Landing (descent or approach),Business,South Africa,Africa,4,2,2,2,2,4,0,Human Factor
1986-11-03 00:00:00,Royal Air Maroc - RAM,Flight,Operational,Morocco,Africa,4,4,4,0,0,4,0,Unknown
1986-11-25 00:00:00,William K. Tyus,Flight,Business,United States of America,North America,4,1,1,3,3,4,0,Human Factor
1986-12-06 00:00:00,Hungarian Air Force - Magyar Honvédség Repülö Csapatai MHRC,Landing (descent or approach),Military / Government,Hungary,Europe,5,5,4,0,0,4,1,Weather
1986-12-13 00:00:00,Peruvian Air Force - Fuerza Aérea del Perú,Flight,Military / Government,Peru,South America,4,2,2,2,2,4,0,Unknown
1987-02-24 00:00:00,Dirgantara Air Service,Landing (descent or approach),Commercial,Indonesia,Asia,9,2,0,7,4,4,5,Unknown
1987-04-13 00:00:00,Buffalo Airways,Landing (descent or approach),Operational,United States of America,North America,4,3,3,1,1,4,0,Human Factor
1987-05-15 00:00:00,Honda,Flight,Operational,Japan,Asia,4,4,4,0,0,4,0,Human Factor
1987-06-21 00:00:00,Private Australian,Takeoff (climb),Humanitarian,Australia,Oceania,5,1,1,4,3,4,1,Human Factor
1987-06-28 00:00:00,Hugo Schoellkopf,Flight,Business,United States of America,North America,4,1,1,3,3,4,0,Human Factor
1987-07-01 00:00:00,United States Air Force - USAF,Landing (descent or approach),Operational,United States of America,North America,6,6,4,0,0,4,2,Human Factor
1987-07-17 00:00:00,Skywater Lodge,Landing (descent or approach),Business,United States of America,North America,4,1,1,3,3,4,0,Human Factor
1987-07-22 00:00:00,Jess Lee Terry,Flight,Business,United States of America,North America,4,1,1,3,3,4,0,Human Factor
1987-07-30 00:00:00,Royal Thai Navy - Kong Thap Ruea Thai,Landing (descent or approach),Operational,Thailand,Asia,6,6,4,0,0,4,2,Unknown
1987-08-18 00:00:00,Oxaero - Oxford Aerocharter,Flight,Commercial,France,Europe,7,1,1,6,3,4,3,Human Factor
1987-09-23 00:00:00,Air Trans Ivoire,Takeoff (climb),Commercial,Ivory Coast,Africa,4,2,2,2,2,4,0,Unknown
1987-12-04 00:00:00,Wilderness Airlines,Flight,Commercial,Canada,North America,4,1,1,3,3,4,0,Unknown
1987-12-06 00:00:00,W. H. Hoffmann,Landing (descent or approach),Business,Germany,Europe,4,1,1,3,3,4,0,Human Factor
1988-03-31 00:00:00,Arax Airlines,Takeoff (climb),Operational,Egypt,Africa,4,4,4,0,0,4,0,Technical Failure
1988-05-24 00:00:00,United Executive Jet,Takeoff (climb),Operational,United States of America,North America,4,2,2,2,2,4,0,Human Factor
1988-05-28 00:00:00,Brooks Products,Flight,Business,United States of America,North America,4,1,1,3,3,4,0,Human Factor
1988-06-16 00:00:00,Burma Airways,Landing (descent or approach),Operational,Myanmar,Asia,4,3,3,1,1,4,0,Unknown
1988-08-26 00:00:00,Aeroflot - Russian International Airlines,Landing (descent or approach),Commercial,Russia,Asia,4,2,2,2,2,4,0,Human Factor
1988-09-09 00:00:00,Spanish Air Force - Ejército del Aire,Takeoff (climb),Humanitarian,Spain,Europe,4,4,4,0,0,4,0,Technical Failure
1988-11-18 00:00:00,Air Littoral,Takeoff (climb),Commercial,France,Europe,4,2,2,2,2,4,0,Technical Failure
1988-11-29 00:00:00,Voyageur Airways,Landing (descent or approach),Humanitarian,Canada,North America,4,2,2,2,2,4,0,Human Factor
1989-01-02 00:00:00,Baronco Aire,Landing (descent or approach),Business,United States of America,North America,4,1,1,3,3,4,0,Human Factor
1989-02-19 00:00:00,Flying Tigers,Landing (descent or approach),Operational,Malaysia,Asia,4,4,4,0,0,4,0,Human Factor
1989-05-11 00:00:00,Aeroflot - Russian International Airlines,Flight,Military / Government,Belarus,Europe,4,2,2,2,2,4,0,Human Factor
1989-05-26 00:00:00,Aviatia Utilitara,Flight,Operational,Romania,Europe,4,4,4,0,0,4,0,Unknown
1989-05-30 00:00:00,Mexican Air Force - Fuerza Aérea Mexicana,Flight,Military / Government,Mexico,Central America,4,4,4,0,0,4,0,Unknown
1989-06-20 00:00:00,Maurice J. Walsh III,Flight,Business,United States of America,North America,4,1,1,3,3,4,0,Weather
1989-06-26 00:00:00,Conifair Aviation,Flight,Military / Government,Canada,North America,4,4,4,0,0,4,0,Human Factor
1989-08-05 00:00:00,Locadora Belauto,Landing (descent or approach),Business,Brazil,South America,4,2,2,2,2,4,0,Weather
1989-10-04 00:00:00,United States Air Force - USAF,Flight,Operational,Canada,North America,4,4,4,0,0,4,0,Technical Failure
1989-10-12 00:00:00,Soviet Air Force - Voyenno-vozdushnye sily CCCP,Parking,Military / Government,Azerbaijan,Asia,7,7,4,0,0,4,3,Human Factor
1989-11-05 00:00:00,Belair Táxi Aéreo,Landing (descent or approach),Commercial,Brazil,South America,4,2,2,2,2,4,0,Human Factor
1989-11-15 00:00:00,Air Express - Norway,Landing (descent or approach),Humanitarian,Norway,Europe,4,3,3,1,1,4,0,Human Factor
1989-11-27 00:00:00,Republic of Korea Navy,Takeoff (climb),Operational,South Korea,Asia,4,4,4,0,0,4,0,Technical Failure
1989-12-07 00:00:00,Royal Thai Navy - Kong Thap Ruea Thai,Flight,Military / Government,Thailand,Asia,4,4,4,0,0,4,0,Unknown
1989-12-21 00:00:00,Aviation Sans Frontières - ASF,Takeoff (climb),Humanitarian,South Sudan,Africa,4,1,1,3,3,4,0,Terrorism
1990-02-01 00:00:00,Aeroflot - Russian International Airlines,Flight,Commercial,Russia,Asia,4,3,3,1,1,4,0,Human Factor
1990-02-08 00:00:00,Sudanese Air Force - Al Quwwat al-Jawwiya As-Sudaniya,Flight,Military / Government,Sudan,Africa,4,4,4,0,0,4,0,Terrorism
1990-03-23 00:00:00,Cubana de Aviación,Takeoff (climb),Commercial,Cuba,Central America,46,5,0,41,4,4,42,Unknown
1990-04-25 00:00:00,N18PP Inc.,Flight,Business,United States of America,North America,4,1,1,3,3,4,0,Human Factor
1990-05-15 00:00:00,Geokart,Landing (descent or approach),Specialised Services,United Arab Emirates,Asia,4,1,1,3,3,4,0,Technical Failure
1990-06-01 00:00:00,Aero Sur,Flight,Commercial,Peru,South America,4,1,1,3,3,4,0,Unknown
1990-06-02 00:00:00,ITD Inc.,Flight,Specialised Services,Belgium,Europe,4,2,2,2,2,4,0,Human Factor
1990-06-05 00:00:00,Inter-Thon,Landing (descent or approach),Military / Government,Portugal,Europe,4,1,1,3,3,4,0,Human Factor
1990-09-14 00:00:00,Aeroflot - Russian International Airlines,Landing (descent or approach),Commercial,Russia,Asia,129,5,1,124,3,4,125,Human Factor
1990-09-24 00:00:00,HiTech Helicopters,Landing (descent or approach),Business,United States of America,North America,4,2,2,2,2,4,0,Human Factor
1990-10-22 00:00:00,Trans-Provincial Airlines - TPA,Flight,Commercial,Canada,North America,4,1,1,3,3,4,0,Human Factor
1991-02-07 00:00:00,Macon Horizons,Landing (descent or approach),Commercial,United States of America,North America,4,1,1,3,3,4,0,Human Factor
1991-03-17 00:00:00,Donald M. Schreiber,Flight,Business,United States of America,North America,4,1,1,3,3,4,0,Weather
1991-05-24 00:00:00,Metro Cargo Airlines,Landing (descent or approach),Humanitarian,Iran,Asia,10,10,4,0,0,4,6,Technical Failure
1991-06-16 00:00:00,Superior North Air,Takeoff (climb),Commercial,Canada,North America,4,1,1,3,3,4,0,Unknown
1991-06-17 00:00:00,Castor Trading Company,Landing (descent or approach),Operational,Venezuela,South America,4,2,2,2,2,4,0,Human Factor
1991-06-26 00:00:00,Okada Air,Landing (descent or approach),Commercial,Nigeria,Africa,53,5,0,48,4,4,49,Technical Failure
1991-06-28 00:00:00,Jones Air Corporation,Landing (descent or approach),Business,United States of America,North America,4,1,1,3,3,4,0,Human Factor
1991-08-20 00:00:00,Temsco Helicopters,Flight,Commercial,United States of America,North America,4,1,1,3,3,4,0,Human Factor
1991-08-22 00:00:00,Italian Air Force - Aeronautica Militare Italiana,Flight,Operational,Italy,Europe,4,4,4,0,0,4,0,Technical Failure
1991-09-09 00:00:00,Royal Australian Army,Takeoff (climb),Operational,Australia,Oceania,4,4,4,0,0,4,0,Technical Failure
1991-09-17 00:00:00,Ethiopian Airlines,Landing (descent or approach),Humanitarian,Djibouti,Africa,4,4,4,0,0,4,0,Human Factor
1991-10-11 00:00:00,Aero Condor - Servicio de Transporte Aéreo Turistico - STAT,Flight,Commercial,Peru,South America,4,1,1,3,3,4,0,Human Factor
1991-12-02 00:00:00,French Air Force - Armée de l'Air,Landing (descent or approach),Operational,France,Europe,4,4,4,0,0,4,0,Technical Failure
1991-12-02 00:00:00,Croatian Air Force - Hrvatske Zračne Snage,Flight,Military / Government,Croatia,Europe,4,2,2,2,2,4,0,Terrorism
1992-01-04 00:00:00,Frank Gearhart,Flight,Business,United States of America,North America,6,1,0,5,4,4,2,Human Factor
1992-02-15 00:00:00,Air Transport International,Landing (descent or approach),Operational,United States of America,North America,4,3,3,1,1,4,0,Human Factor
1992-04-01 00:00:00,Indian Air Force - Bharatiya Vayu Sena,Flight,Operational,India,Asia,4,4,4,0,0,4,0,Human Factor
1992-04-01 00:00:00,Indian Air Force - Bharatiya Vayu Sena,Flight,Operational,India,Asia,4,4,4,0,0,4,0,Human Factor
1992-06-16 00:00:00,Omega Air Inc.,Landing (descent or approach),Business,United States of America,North America,4,2,2,2,2,4,0,Technical Failure
1992-07-23 00:00:00,McLaughlin Construction Company,Flight,Business,United States of America,North America,4,2,2,2,2,4,0,Weather
1992-07-27 00:00:00,Aero Eslava,Landing (descent or approach),Operational,Mexico,Central America,4,2,2,2,2,4,0,Human Factor
1992-08-18 00:00:00,Maeda Taxi Aéreo,Landing (descent or approach),Commercial,Brazil,South America,4,2,2,2,2,4,0,Human Factor
1992-09-03 00:00:00,Italian Air Force - Aeronautica Militare Italiana,Landing (descent or approach),Humanitarian,Bosnia and Herzegovina,Europe,4,4,4,0,0,4,0,Terrorism
1992-10-04 00:00:00,El Al Cargo,Flight,Operational,Netherlands,Europe,4,3,3,1,1,4,0,Technical Failure
1992-12-10 00:00:00,Ek-Pack Folien,Landing (descent or approach),Business,Germany,Europe,4,1,1,3,3,4,0,Unknown
1993-01-02 00:00:00,Indian Coast Guard,Flight,Military / Government,India,Asia,6,2,2,4,2,4,2,Unknown
1993-01-06 00:00:00,Lufthansa Cityline,Landing (descent or approach),Commercial,France,Europe,23,4,0,19,4,4,19,Human Factor
1993-02-10 00:00:00,Gary L. Means,Takeoff (climb),Business,United States of America,North America,4,1,1,3,3,4,0,Human Factor
1993-03-18 00:00:00,Aero Taxi Iquitos,Flight,Commercial,Peru,South America,4,1,1,3,3,4,0,Weather
1993-04-01 00:00:00,Eastern Foods,Landing (descent or approach),Business,United States of America,North America,4,1,1,3,3,4,0,Human Factor
1993-04-06 00:00:00,Casper Air Service,Landing (descent or approach),Humanitarian,United States of America,North America,4,1,1,3,3,4,0,Human Factor
1993-05-25 00:00:00,Peacock's Flying Service,Landing (descent or approach),Operational,United States of America,North America,4,3,3,1,1,4,0,Human Factor
1993-06-07 00:00:00,Aero-Dienst - Executive Jet Service,Takeoff (climb),Operational,Germany,Europe,4,2,2,2,2,4,0,Human Factor
1993-06-25 00:00:00,Mexican Air Force - Fuerza Aérea Mexicana,Flight,Military / Government,Mexico,Central America,4,4,4,0,0,4,0,Unknown
1993-07-15 00:00:00,National Remote Sensing Agency,Landing (descent or approach),Business,India,Asia,4,1,1,3,3,4,0,Human Factor
1993-07-15 00:00:00,Turkish Navy - Türk Deniz Kuvvetleri,Takeoff (climb),Military / Government,Turkey,Asia,4,4,4,0,0,4,0,Technical Failure
1993-07-30 00:00:00,Motel Developers Inc.,Landing (descent or approach),Business,United States of America,North America,4,1,1,3,3,4,0,Human Factor
1993-08-03 00:00:00,Aeroservicios Ecuatorianos,Flight,Commercial,Ecuador,South America,7,2,2,5,2,4,3,Unknown
1993-08-07 00:00:00,Critical Care Medflight,Landing (descent or approach),Humanitarian,United States of America,North America,4,1,1,3,3,4,0,Human Factor
1993-10-13 00:00:00,Heli Niugini,Takeoff (climb),Commercial,Papua New Guinea,Oceania,4,2,2,2,2,4,0,Human Factor
1993-11-22 00:00:00,Argentinian Air Force - Fuerza Aérea Argentina,Landing (descent or approach),Military / Government,Argentina,South America,4,1,1,3,3,4,0,Unknown
1994-02-24 00:00:00,U.S. Department of Health and Human Services,Landing (descent or approach),Military / Government,United States of America,North America,4,1,1,3,3,4,0,Human Factor
1994-03-08 00:00:00,Air Sahara,Takeoff (climb),Operational,India,Asia,4,4,4,0,0,4,0,Human Factor
1994-03-23 00:00:00,Orion Aero Taxi,Flight,Commercial,Colombia,South America,4,2,2,2,2,4,0,Human Factor
1994-05-10 00:00:00,Oscar A. Romaguera,Flight,Business,Dominican Republic,Central America,4,1,1,3,3,4,0,Technical Failure
1994-05-19 00:00:00,Michelle M. Mellor,Flight,Business,United States of America,North America,4,1,1,3,3,4,0,Human Factor
1994-05-23 00:00:00,Arall Colombia - Aerolineas Llaneras,Flight,Commercial,Colombia,South America,11,2,1,9,3,4,7,Technical Failure
1994-06-24 00:00:00,United States Air Force - USAF,Flight,Operational,United States of America,North America,4,4,4,0,0,4,0,Human Factor
1994-08-04 00:00:00,TASISA,Flight,Commercial,Spain,Europe,4,1,1,3,3,4,0,Human Factor
1994-08-14 00:00:00,David Pierpoint,Flight,Business,United States of America,North America,4,1,1,3,3,4,0,Human Factor
1994-09-17 00:00:00,Golden Eagle Aviation - Taiwan,Flight,Military / Government,Taiwan,Asia,4,4,4,0,0,4,0,Terrorism
1994-10-19 00:00:00,Japan Air Self-Defense Force - Kōkū Jieitai,Flight,Specialised Services,Japan,Asia,4,4,4,0,0,4,0,Technical Failure
1994-11-04 00:00:00,Trigana Air Service,Flight,Commercial,Indonesia,Asia,4,2,2,2,2,4,0,Human Factor
1994-11-24 00:00:00,Südzucker,Landing (descent or approach),Business,Germany,Europe,4,2,2,2,2,4,0,Human Factor
1994-11-24 00:00:00,Kenn Borek Air,Takeoff (climb),Commercial,Antarctica,Antarctica,4,2,2,2,2,4,0,Unknown
1995-01-12 00:00:00,Charles B. Merrill Jr.,Takeoff (climb),Business,United States of America,North America,4,1,1,3,3,4,0,Human Factor
1995-01-30 00:00:00,TransAsia Airways,Landing (descent or approach),Operational,Taiwan,Asia,4,4,4,0,0,4,0,Human Factor
1995-03-05 00:00:00,Brown's Aircraft Sales,Flight,Business,United States of America,North America,4,1,1,3,3,4,0,Weather
1995-06-09 00:00:00,Ansett New Zealand - ANZ,Landing (descent or approach),Commercial,New Zealand,Oceania,21,3,1,18,3,4,17,Human Factor
1995-06-20 00:00:00,Alaska Wilderness Lodge,Flight,Commercial,United States of America,North America,4,1,1,3,3,4,0,Human Factor
1995-06-25 00:00:00,Thiel Construction Company,Landing (descent or approach),Business,United States of America,North America,4,1,1,3,3,4,0,Human Factor
1995-07-29 00:00:00,Business Flying Enterprises,Flight,Business,United States of America,North America,4,1,1,3,3,4,0,Technical Failure
1995-10-06 00:00:00,National Argentinian Police,Landing (descent or approach),Military / Government,Argentina,South America,4,2,2,2,2,4,0,Weather
1995-10-11 00:00:00,French Air Force - Armée de l'Air,Flight,Operational,France,Europe,4,2,2,2,2,4,0,Technical Failure
1996-02-04 00:00:00,LAC Colombia - Lineas Aéreas del Caribe,Takeoff (climb),Operational,Paraguay,South America,4,3,3,1,1,4,0,Human Factor
1996-02-05 00:00:00,Business Air Connection,Takeoff (climb),Operational,United States of America,North America,4,2,2,2,2,4,0,Human Factor
1996-05-10 00:00:00,Aerodat,Flight,Commercial,Peru,South America,4,1,1,3,3,4,0,Unknown
1996-05-12 00:00:00,Airlink Austria,Flight,Commercial,Austria,Europe,4,2,2,2,2,4,0,Human Factor
1996-05-19 00:00:00,Brazilian Air Force - Força Aérea Brasileira,Takeoff (climb),Military / Government,Brazil,South America,4,2,2,2,2,4,0,Unknown
1996-05-25 00:00:00,Republic of China Air Force,Flight,Military / Government,Taiwan,Asia,4,2,2,2,2,4,0,Unknown
1996-05-30 00:00:00,Les Transports Aéro 2000,Flight,Commercial,Canada,North America,4,1,1,3,3,4,0,Human Factor
1996-06-02 00:00:00,Home Oil Stations,Flight,Business,United States of America,North America,4,1,1,3,3,4,0,Weather
1996-06-09 00:00:00,Iran Air,Landing (descent or approach),Operational,Iran,Asia,7,7,4,0,0,4,3,Human Factor
1996-06-24 00:00:00,Air Nacoia - Exploraçao de Aeronaves,Landing (descent or approach),Operational,Angola,Africa,8,8,4,0,0,4,4,Human Factor
1996-07-20 00:00:00,Northern Air Cargo,Landing (descent or approach),Operational,United States of America,North America,4,3,3,1,1,4,0,Technical Failure
1996-08-08 00:00:00,Burda Holding,Landing (descent or approach),Business,Germany,Europe,4,2,2,2,2,4,0,Human Factor
1996-10-22 00:00:00,Millon Air,Takeoff (climb),Operational,Ecuador,South America,4,4,4,0,0,4,0,Technical Failure
1996-10-30 00:00:00,Alberto Culver,Takeoff (climb),Business,United States of America,North America,4,3,3,1,1,4,0,Human Factor
1996-12-21 00:00:00,Selva Colombia - Servicios Aéreos del Vaupés,Landing (descent or approach),Operational,Colombia,South America,4,3,3,1,1,4,0,Technical Failure
1997-01-02 00:00:00,CG Aviation,Takeoff (climb),Business,United States of America,North America,4,1,1,3,3,4,0,Human Factor
1997-01-20 00:00:00,Sri Lanka Air Force,Flight,Military / Government,Sri Lanka,Asia,4,4,4,0,0,4,0,Unknown
1997-02-07 00:00:00,Estornel Air Services,Flight,Operational,Argentina,South America,4,2,2,2,2,4,0,Human Factor
1997-02-21 00:00:00,Sri Lanka Air Force,Takeoff (climb),Military / Government,Sri Lanka,Asia,63,4,0,59,4,4,59,Human Factor
1997-03-03 00:00:00,Islamic Republic of Iran Air Force,Landing (descent or approach),Humanitarian,Iran,Asia,4,4,4,0,0,4,0,Weather
1997-03-20 00:00:00,Sudanese Air Force - Al Quwwat al-Jawwiya As-Sudaniya,Landing (descent or approach),Military / Government,South Sudan,Africa,4,4,4,0,0,4,0,Terrorism
1997-05-20 00:00:00,Corey Douglas Garber,Flight,Business,Mexico,Central America,4,2,2,2,2,4,0,Weather
1997-06-05 00:00:00,Bahia Táxi Aéreo - BATA,Takeoff (climb),Commercial,Brazil,South America,4,2,2,2,2,4,0,Human Factor
1997-06-17 00:00:00,Tula Air Enterprise - Tulskoe Aviapredpriatie,Takeoff (climb),Commercial,Russia,Asia,7,2,1,5,3,4,3,Technical Failure
1997-07-05 00:00:00,Alaska Bush Carrier,Flight,Commercial,United States of America,North America,5,1,1,4,3,4,1,Technical Failure
1997-07-20 00:00:00,Corporate Aircraft Management,Flight,Business,United States of America,North America,4,2,2,2,2,4,0,Human Factor
1997-07-23 00:00:00,Brazilian Air Force - Força Aérea Brasileira,Flight,Operational,Brazil,South America,4,4,4,0,0,4,0,Human Factor
1997-08-07 00:00:00,Fine Air,Takeoff (climb),Operational,United States of America,North America,4,3,3,1,1,4,0,Human Factor
1997-08-12 00:00:00,South Texas Aircraft,Takeoff (climb),Operational,United States of America,North America,4,2,2,2,2,4,0,Human Factor
1997-11-14 00:00:00,Pilot und Flugzeug,Landing (descent or approach),Business,Germany,Europe,4,1,1,3,3,4,0,Unknown
1997-12-09 00:00:00,Sowind Air,Landing (descent or approach),Commercial,Canada,North America,17,2,1,15,3,4,13,Human Factor
1998-04-04 00:00:00,Alpha Wolf Enterprises,Flight,Business,United States of America,North America,4,1,1,3,3,4,0,Human Factor
1998-04-10 00:00:00,Private German,Landing (descent or approach),Business,Monaco,Europe,8,1,0,7,4,4,4,Technical Failure
1998-05-08 00:00:00,Brazilian Air Force - Força Aérea Brasileira,Flight,Humanitarian,Brazil,South America,13,3,3,10,1,4,9,Technical Failure
1998-07-23 00:00:00,Mexican Air Force - Fuerza Aérea Mexicana,Flight,Military / Government,Mexico,Central America,4,2,2,2,2,4,0,Human Factor
1998-08-04 00:00:00,Eagle Flight Center,Landing (descent or approach),Business,United States of America,North America,4,1,1,3,3,4,0,Human Factor
1998-09-20 00:00:00,Henry K. Sagel,Landing (descent or approach),Business,United States of America,North America,4,1,1,3,3,4,0,Human Factor
1998-09-25 00:00:00,TanaMana Aviation,Flight,Commercial,Uganda,Africa,11,1,1,10,3,4,7,Terrorism
1998-12-27 00:00:00,ACA-Ancargo Air,Flight,Operational,Angola,Africa,4,4,4,0,0,4,0,Terrorism
1999-01-13 00:00:00,Air National Guard,Landing (descent or approach),Operational,Germany,Europe,4,4,4,0,0,4,0,Unknown
1999-02-13 00:00:00,Smolensk Aircraft Plant,Flight,Operational,Russia,Asia,4,1,1,3,3,4,0,Weather
1999-02-25 00:00:00,Alitalia - Linee Aeree Italiane,Landing (descent or approach),Commercial,Italy,Europe,31,4,1,27,3,4,27,Human Factor
1999-04-24 00:00:00,Sky Club,Takeoff (climb),Humanitarian,Israel,Asia,10,1,1,9,3,4,6,Technical Failure
1999-05-27 00:00:00,Robert E. Linville,Landing (descent or approach),Business,United States of America,North America,4,1,1,3,3,4,0,Technical Failure
1999-06-14 00:00:00,David Drye Company,Takeoff (climb),Business,United States of America,North America,4,1,1,3,3,4,0,Technical Failure
1999-07-04 00:00:00,LANC Colombia - Lineas Aéreas Norte de Colombia,Landing (descent or approach),Operational,Colombia,South America,15,3,0,12,4,4,11,Human Factor
1999-07-09 00:00:00,Aerojet Express,Landing (descent or approach),Operational,Mexico,Central America,4,2,2,2,2,4,0,Human Factor
1999-11-26 00:00:00,Aircraft Leasing Services - ALS,Takeoff (climb),Commercial,Kenya,Africa,4,1,1,3,3,4,0,Unknown
1999-11-27 00:00:00,William S. Warren,Takeoff (climb),Business,United States of America,North America,4,1,1,3,3,4,0,Human Factor
1999-12-22 00:00:00,Korean Air Cargo,Takeoff (climb),Operational,United Kingdom,Europe,4,4,4,0,0,4,0,Human Factor
2000-01-18 00:00:00,Hart Corporation Delaware Division,Landing (descent or approach),Business,United States of America,North America,4,1,1,3,3,4,0,Human Factor
2000-01-24 00:00:00,Top Air,Flight,Business,Turkey,Asia,4,1,1,3,3,4,0,Unknown
2000-02-23 00:00:00,Ingenio y Refinería San Martín del Tabacal,Landing (descent or approach),Business,Argentina,South America,4,2,2,2,2,4,0,Human Factor
2000-04-01 00:00:00,TAM Bolivia - Transporte Aéreo Militar Boliviano,Landing (descent or approach),Military / Government,Bolivia,South America,4,2,2,2,2,4,0,Technical Failure
2000-04-29 00:00:00,North Coast Aviation - PNG,Takeoff (climb),Commercial,Papua New Guinea,Oceania,4,1,1,3,3,4,0,Human Factor
2000-09-01 00:00:00,Jeffrey Thomas Needham,Takeoff (climb),Business,United States of America,North America,4,1,1,3,3,4,0,Unknown
2000-10-06 00:00:00,Keith Corporation,Landing (descent or approach),Business,United States of America,North America,4,1,1,3,3,4,0,Human Factor
2000-10-24 00:00:00,Flight Inspection International,Landing (descent or approach),Specialised Services,Germany,Europe,4,2,2,2,2,4,0,Human Factor
2000-12-31 00:00:00,Skyline Ranch Investment Company,Flight,Business,Canada,North America,4,1,1,3,3,4,0,Human Factor
2001-01-24 00:00:00,Amprite Aviation,Takeoff (climb),Business,United States of America,North America,4,1,1,3,3,4,0,Technical Failure
2001-04-10 00:00:00,Reefwatch Air Tours,Flight,Commercial,Australia,Oceania,4,1,1,3,3,4,0,Human Factor
2001-05-18 00:00:00,Turkish Coast Guard - Sahil Güvenlik,Takeoff (climb),Specialised Services,Turkey,Asia,4,4,4,0,0,4,0,Human Factor
2001-08-23 00:00:00,Gran Propeller - Victoria Air,Flight,Commercial,Democratic Republic of Congo,Africa,11,2,2,9,2,4,7,Technical Failure
2001-08-29 00:00:00,Binter Mediterraneo,Landing (descent or approach),Commercial,Spain,Europe,47,3,1,44,3,4,43,Human Factor
2001-10-08 00:00:00,Air Evex,Taxiing,Commercial,Italy,Europe,4,2,2,2,2,4,0,Human Factor
2001-11-12 00:00:00,Cage Acquisitions,Landing (descent or approach),Business,United States of America,North America,4,1,1,3,3,4,0,Human Factor
2001-11-24 00:00:00,Aero Photo Europe Investigation,Flight,Operational,France,Europe,4,2,2,2,2,4,0,Human Factor
2001-11-27 00:00:00,Eastland Air - Moore's Air Charter,Takeoff (climb),Commercial,Australia,Oceania,4,1,1,3,3,4,0,Technical Failure
2002-01-15 00:00:00,Procuraduría General de la República,Landing (descent or approach),Military / Government,Mexico,Central America,18,3,0,15,4,4,14,Human Factor
2002-03-17 00:00:00,Djibouti Airlines,Landing (descent or approach),Operational,Djibouti,Africa,4,4,4,0,0,4,0,Human Factor
2002-03-24 00:00:00,Lear 171,Landing (descent or approach),Business,United States of America,North America,4,1,1,3,3,4,0,Human Factor
2002-05-08 00:00:00,United States Navy - USN,Flight,Operational,United States of America,North America,4,4,4,0,0,4,0,Human Factor
2002-07-12 00:00:00,Bigfoot Air,Flight,Commercial,United States of America,North America,4,1,1,3,3,4,0,Human Factor
2002-07-17 00:00:00,Skyline Airways,Landing (descent or approach),Commercial,Nepal,Asia,4,2,2,2,2,4,0,Human Factor
2002-08-11 00:00:00,Thomas F. Reid,Landing (descent or approach),Business,United States of America,North America,4,1,1,3,3,4,0,Human Factor
2002-08-16 00:00:00,Fematic Engineering,Flight,Business,Italy,Europe,4,1,1,3,3,4,0,Human Factor
2002-11-08 00:00:00,Brown County Financial Services,Flight,Business,United States of America,North America,4,2,2,2,2,4,0,Human Factor
2003-03-27 00:00:00,Air Regional,Takeoff (climb),Commercial,Indonesia,Asia,16,2,2,14,2,4,12,Unknown
2003-05-16 00:00:00,Angola Air Force - Força Aérea Nacional Angolana,Takeoff (climb),Military / Government,Angola,Africa,4,4,4,0,0,4,0,Technical Failure
2003-05-21 00:00:00,Japan Maritime Self-Defense Force - Kaijō Jieitai,Landing (descent or approach),Operational,Japan,Asia,4,4,4,0,0,4,0,Human Factor
2003-05-25 00:00:00,Navajo Inc.,Takeoff (climb),Business,United States of America,North America,4,1,1,3,3,4,0,Human Factor
2003-06-11 00:00:00,Astro Taxi Aéreo,Landing (descent or approach),Commercial,Brazil,South America,4,2,2,2,2,4,0,Human Factor
2003-06-26 00:00:00,Comav Aviation,Flight,Humanitarian,Namibia,Africa,4,1,1,3,3,4,0,Human Factor
2003-06-30 00:00:00,Algerian Air Force - Al Quwwat Aljawwija Aljaza'Eriiya,Takeoff (climb),Operational,Algeria,Africa,4,4,4,0,0,4,0,Technical Failure
2003-07-01 00:00:00,Heringer Taxi Aéreo,Landing (descent or approach),Commercial,Brazil,South America,4,2,2,2,2,4,0,Weather
2003-07-13 00:00:00,Gary Ostler,Flight,Business,United States of America,North America,6,1,1,5,3,4,2,Human Factor
2003-07-13 00:00:00,Ruiban %26 Duran Compania Aérea,Landing (descent or approach),Commercial,Venezuela,South America,10,2,0,8,4,4,6,Human Factor
2003-12-11 00:00:00,Young Forever,Landing (descent or approach),Business,United States of America,North America,5,1,1,4,3,4,1,Human Factor
2004-03-10 00:00:00,United States Marine Corps,Landing (descent or approach),Operational,United States of America,North America,4,2,2,2,2,4,0,Unknown
2004-05-18 00:00:00,Pickerel Arm Camps,Landing (descent or approach),Commercial,Canada,North America,4,1,1,3,3,4,0,Human Factor
2004-06-26 00:00:00,Oleg Lyakishev,Takeoff (climb),Business,Russia,Asia,5,3,3,2,1,4,1,Technical Failure
2004-10-05 00:00:00,Sarit Airlines,Flight,Operational,Sudan,Africa,4,4,4,0,0,4,0,Technical Failure
2004-10-09 00:00:00,Huktra International,Landing (descent or approach),Business,France,Europe,4,1,1,3,3,4,0,Human Factor
2004-10-27 00:00:00,Jorge Campillo,Takeoff (climb),Business,United States of America,North America,4,1,1,3,3,4,0,Technical Failure
2005-04-14 00:00:00,Japan Air Self-Defense Force - Kōkū Jieitai,Flight,Operational,Japan,Asia,4,4,4,0,0,4,0,Unknown
2005-05-08 00:00:00,Chemtrad Aviation,Takeoff (climb),Humanitarian,Philippines,Asia,6,1,1,5,3,4,2,Technical Failure
2005-05-24 00:00:00,Max Aviation - USA,Takeoff (climb),Commercial,United States of America,North America,4,1,1,3,3,4,0,Human Factor
2005-08-13 00:00:00,Sgavit Aviation,Landing (descent or approach),Business,United States of America,North America,4,1,1,3,3,4,0,Human Factor
2005-09-16 00:00:00,Wayumi Aero-Taxi - Linea Aéreo Taxi Wayumi,Flight,Commercial,Venezuela,South America,4,1,1,3,3,4,0,Human Factor
2005-12-02 00:00:00,Peter Menegazzo,Flight,Business,Australia,Oceania,4,2,2,2,2,4,0,Unknown
2006-01-10 00:00:00,United States Navy - USN,Flight,Operational,United States of America,North America,4,4,4,0,0,4,0,Human Factor
2006-01-24 00:00:00,Goship Air,Landing (descent or approach),Business,United States of America,North America,4,2,2,2,2,4,0,Human Factor
2006-01-30 00:00:00,H K Golden Eagle Inc.,Landing (descent or approach),Business,United States of America,North America,4,1,1,3,3,4,0,Human Factor
2006-03-29 00:00:00,KASET - Bureau of Royal Rainmaking and Agricultural Aviation,Takeoff (climb),Other,Thailand,Asia,5,1,1,4,3,4,1,Technical Failure
2006-04-23 00:00:00,ROSTO,Flight,Business,Russia,Asia,5,1,1,4,3,4,1,Human Factor
2006-05-23 00:00:00,Air São Tome e Principe,Landing (descent or approach),Operational,São Tomé and Principe,Africa,4,4,4,0,0,4,0,Unknown
2006-10-10 00:00:00,Atlantic Airways,Landing (descent or approach),Commercial,Norway,Europe,16,4,1,12,3,4,12,Technical Failure
2006-10-15 00:00:00,Jon Peter Olsen,Flight,Business,United States of America,North America,4,2,2,2,2,4,0,Human Factor
2006-10-19 00:00:00,Flowair Aviation,Takeoff (climb),Humanitarian,France,Europe,4,2,2,2,2,4,0,Human Factor
2006-10-26 00:00:00,Swedish Coast Guard,Landing (descent or approach),Military / Government,Sweden,Europe,4,4,4,0,0,4,0,Human Factor
2006-12-16 00:00:00,Mexican Air Force - Fuerza Aérea Mexicana,Takeoff (climb),Military / Government,Mexico,Central America,4,4,4,0,0,4,0,Unknown
2006-12-21 00:00:00,John Frank Mauricio Trustee,Landing (descent or approach),Business,United States of America,North America,4,1,1,3,3,4,0,Human Factor
2006-12-22 00:00:00,Ray Baxter Armistead,Landing (descent or approach),Business,United States of America,North America,4,1,1,3,3,4,0,Human Factor
2007-01-13 00:00:00,Transportes 246,Flight,Commercial,Colombia,South America,4,1,1,3,3,4,0,Unknown
2007-02-16 00:00:00,Color Ink,Landing (descent or approach),Business,United States of America,North America,4,1,1,3,3,4,0,Human Factor
2007-03-14 00:00:00,Bahia Táxi Aéreo - BATA,Flight,Commercial,Brazil,South America,4,2,2,2,2,4,0,Technical Failure
2007-06-29 00:00:00,Ivorian Government,Taxiing,Military / Government,Ivory Coast,Africa,34,4,0,30,4,4,30,Terrorism
2007-08-06 00:00:00,Hendrickson Aviation,Landing (descent or approach),Business,United States of America,North America,4,1,1,3,3,4,0,Human Factor
2007-09-08 00:00:00,Joy Alukkas Group,Takeoff (climb),Business,India,Asia,4,1,1,3,3,4,0,Human Factor
2007-10-14 00:00:00,Gold Diggers,Takeoff (climb),Business,United States of America,North America,4,1,1,3,3,4,0,Technical Failure
2008-01-12 00:00:00,Private American,Landing (descent or approach),Business,United States of America,North America,4,1,1,3,3,4,0,Human Factor
2008-02-02 00:00:00,Michael John Bybyk,Flight,Business,United States of America,North America,4,1,1,3,3,4,0,Human Factor
2008-06-30 00:00:00,Ababeel Aviation,Takeoff (climb),Operational,Sudan,Africa,4,4,4,0,0,4,0,Human Factor
2008-08-17 00:00:00,Reconnaissance Ventures,Landing (descent or approach),Specialised Services,United Kingdom,Europe,4,4,4,0,0,4,0,Human Factor
2008-09-14 00:00:00,Volare Air Charter Company,Flight,Military / Government,Mexico,Central America,4,1,1,3,3,4,0,Human Factor
2008-09-19 00:00:00,Global Exec Aviation,Takeoff (climb),Commercial,United States of America,North America,6,2,2,4,2,4,2,Technical Failure
2008-09-21 00:00:00,Unnamed operator,Flight,Humanitarian,Dominican Republic,Central America,4,2,2,2,2,4,0,Human Factor
2008-11-07 00:00:00,Timothy O’Brien,Takeoff (climb),Business,Australia,Oceania,4,1,1,3,3,4,0,Human Factor
2009-01-15 00:00:00,Russian Air Force - Voyenno-vozdushnye sily Rossii,Taxiing,Military / Government,Russia,Asia,7,7,4,0,0,4,3,Human Factor
2009-02-05 00:00:00,Aero Klub Ban,Flight,Operational,Croatia,Europe,4,4,4,0,0,4,0,Weather
2009-03-31 00:00:00,Polish Navy - Lotnictwa Marynarki Wojenna,Landing (descent or approach),Operational,Poland,Europe,4,4,4,0,0,4,0,Human Factor
2009-07-05 00:00:00,Nicholas Elliott %26 Jordan,Flight,Business,United States of America,North America,4,1,1,3,3,4,0,Technical Failure
2009-10-17 00:00:00,Victoria Air - Philippines,Landing (descent or approach),Operational,Philippines,Asia,4,3,3,1,1,4,0,Human Factor
2009-10-26 00:00:00,Mazak Properties,Flight,Business,United States of America,North America,4,1,1,3,3,4,0,Weather
2009-11-02 00:00:00,Indonesian National Police - Kepolisian Negara Republik Indonesia,Landing (descent or approach),Military / Government,Indonesia,Asia,4,4,4,0,0,4,0,Human Factor
2010-01-18 00:00:00,Mitts Corporation,Landing (descent or approach),Business,United States of America,North America,4,2,2,2,2,4,0,Human Factor
2010-04-12 00:00:00,United States Navy - USN,Flight,Operational,United States of America,North America,4,4,4,0,0,4,0,Unknown
2010-07-16 00:00:00,Air Saguenay,Flight,Commercial,Canada,North America,6,1,1,5,3,4,2,Human Factor
2010-07-28 00:00:00,United States Air Force - USAF,Takeoff (climb),Operational,United States of America,North America,4,4,4,0,0,4,0,Human Factor
2010-08-21 00:00:00,Branch River Air Service,Flight,Commercial,United States of America,North America,4,1,1,3,3,4,0,Unknown
2010-08-31 00:00:00,Trans Air - Papua New Guinea,Landing (descent or approach),Commercial,Papua New Guinea,Oceania,5,2,1,3,3,4,1,Human Factor
2011-02-27 00:00:00,Triple S Aviation,Takeoff (climb),Business,United Arab Emirates,Asia,4,1,1,3,3,4,0,Human Factor
2011-04-02 00:00:00,Gulfstream Aerospace Corporation,Takeoff (climb),Specialised Services,United States of America,North America,4,2,2,2,2,4,0,Other
2011-10-25 00:00:00,Yemeni Air Force,Landing (descent or approach),Military / Government,Yemen,Asia,15,4,0,11,4,4,11,Unknown
2011-10-28 00:00:00,Johannes Ruttinger Systemtechnik,Landing (descent or approach),Business,France,Europe,4,1,1,3,3,4,0,Technical Failure
2011-12-09 00:00:00,Quest Aviation,Takeoff (climb),Commercial,United States of America,North America,4,1,1,3,3,4,0,Human Factor
2012-01-10 00:00:00,Keystone Air Service,Landing (descent or approach),Commercial,Canada,North America,5,1,1,4,3,4,1,Human Factor
2012-02-12 00:00:00,Stanford Aviation,Landing (descent or approach),Military / Government,Democratic Republic of Congo,Africa,9,2,2,7,2,4,5,Human Factor
2012-02-18 00:00:00,United States Air Force - USAF,Landing (descent or approach),Military / Government,Djibouti,Africa,4,4,4,0,0,4,0,Human Factor
2012-05-05 00:00:00,Transports Aériens Intercaraïbes,Takeoff (climb),Humanitarian,France,Europe,4,1,1,3,3,4,0,Human Factor
2012-05-11 00:00:00,DRDJ Sales,Flight,Business,United States of America,North America,5,1,1,4,3,4,1,Technical Failure
2012-06-23 00:00:00,Colombian National Army - Ejército Nacional de Colombia,Flight,Military / Government,Colombia,South America,4,2,2,2,2,4,0,Unknown
2012-07-01 00:00:00,United States Air Force - USAF,Flight,Humanitarian,United States of America,North America,6,6,4,0,0,4,2,Weather
2012-08-22 00:00:00,Mombasa Air Safari,Takeoff (climb),Commercial,Kenya,Africa,13,2,2,11,2,4,9,Technical Failure
2012-08-24 00:00:00,Air Sarina,Flight,Business,France,Europe,4,1,1,3,3,4,0,Human Factor
2012-08-24 00:00:00,Intan Angkasa Air Service,Flight,Military / Government,Indonesia,Asia,4,1,1,3,3,4,0,Human Factor
2012-11-06 00:00:00,Taxi Aéreo Hércules,Landing (descent or approach),Commercial,Brazil,South America,4,2,2,2,2,4,0,Human Factor
2012-12-02 00:00:00,Donald P. Horan,Landing (descent or approach),Business,United States of America,North America,4,1,1,3,3,4,0,Human Factor
2012-12-17 00:00:00,Amazon Sky,Flight,Operational,Peru,South America,4,4,4,0,0,4,0,Weather
2013-04-26 00:00:00,Private German,Landing (descent or approach),Business,Germany,Europe,4,2,2,2,2,4,0,Human Factor
2013-04-27 00:00:00,United States Air Force - USAF,Flight,Military / Government,Afghanistan,Asia,4,4,4,0,0,4,0,Human Factor
2013-08-09 00:00:00,Ethiopian Air Force - Ye Ityopya Ayer Hayl,Landing (descent or approach),Military / Government,Somalia,Africa,6,6,4,0,0,4,2,Technical Failure
2013-09-24 00:00:00,Sacha Aviation,Takeoff (climb),Business,France,Europe,4,1,1,3,3,4,0,Human Factor
2013-09-29 00:00:00,CREX-MML,Landing (descent or approach),Business,United States of America,North America,4,1,1,3,3,4,0,Human Factor
2013-10-04 00:00:00,James M. Parrish,Flight,Business,United States of America,North America,4,1,1,3,3,4,0,Human Factor
2013-10-05 00:00:00,Airborne Services Global,Flight,Military / Government,Colombia,South America,6,2,0,4,4,4,2,Unknown
2013-10-10 00:00:00,Stephen George,Landing (descent or approach),Business,United States of America,North America,4,1,1,3,3,4,0,Human Factor
2013-11-19 00:00:00,AeroJL,Takeoff (climb),Operational,United States of America,North America,4,2,2,2,2,4,0,Technical Failure
2013-11-29 00:00:00,ERA Alaska,Landing (descent or approach),Commercial,United States of America,North America,10,1,1,9,3,4,6,Human Factor
2014-01-12 00:00:00,Theo Steil,Landing (descent or approach),Business,Germany,Europe,4,2,2,2,2,4,0,Human Factor
2014-01-19 00:00:00,Intan Angkasa Air Service,Landing (descent or approach),Operational,Indonesia,Asia,4,1,1,3,3,4,0,Technical Failure
2014-02-03 00:00:00,Mid Kansas Agri Company,Landing (descent or approach),Business,United States of America,North America,4,1,1,3,3,4,0,Human Factor
2014-03-03 00:00:00,Iran Aseman Airlines,Landing (descent or approach),Specialised Services,Iran,Asia,4,2,2,2,2,4,0,Human Factor
2014-07-02 00:00:00,Skyward International Aviation,Takeoff (climb),Operational,Kenya,Africa,4,2,2,2,2,4,0,Human Factor
2014-08-18 00:00:00,Aqua Sun Investments,Landing (descent or approach),Business,Bahamas,Central America,4,1,1,3,3,4,0,Human Factor
2014-08-23 00:00:00,Doren Air Congo,Flight,Operational,Democratic Republic of Congo,Africa,4,2,2,2,2,4,0,Technical Failure
2014-08-27 00:00:00,Amigos Aviation,Takeoff (climb),Humanitarian,United States of America,North America,4,1,1,3,3,4,0,Human Factor
2014-09-20 00:00:00,Hevilift,Landing (descent or approach),Commercial,Papua New Guinea,Oceania,9,2,2,7,2,4,5,Human Factor
2014-10-20 00:00:00,Unijet,Takeoff (climb),Commercial,Russia,Asia,4,3,3,1,1,4,0,Human Factor
2015-02-11 00:00:00,Aeropanamericano,Takeoff (climb),Operational,United States of America,North America,4,2,2,2,2,4,0,Technical Failure
2015-04-12 00:00:00,Aircraft Guaranty Corporation Trustee,Landing (descent or approach),Business,United States of America,North America,4,1,1,3,3,4,0,Technical Failure
2015-05-09 00:00:00,Airbus Industrie,Takeoff (climb),Specialised Services,Spain,Europe,6,6,4,0,0,4,2,Technical Failure
2015-05-20 00:00:00,Private American,Flight,Humanitarian,Colombia,South America,4,2,2,2,2,4,0,Terrorism
2015-07-31 00:00:00,Salem Aviation,Landing (descent or approach),Business,United Kingdom,Europe,4,1,1,3,3,4,0,Human Factor
2015-08-07 00:00:00,Majestic Air,Takeoff (climb),Business,United States of America,North America,4,1,1,3,3,4,0,Human Factor
2015-08-16 00:00:00,BAe Systems,Landing (descent or approach),Military / Government,United States of America,North America,4,2,2,2,2,4,0,Human Factor
2015-08-20 00:00:00,Dubnica Air,Flight,Humanitarian,Slovakia,Europe,19,2,2,17,2,4,15,Human Factor
2015-10-18 00:00:00,Sky Hub Aviation,Takeoff (climb),Commercial,Colombia,South America,4,1,1,3,3,4,0,Technical Failure
2015-10-22 00:00:00,Grupo Constructor Plata,Flight,Business,Mexico,Central America,4,2,2,2,2,4,0,Unknown
2015-11-10 00:00:00,Banco Bradesco,Flight,Business,Brazil,South America,4,2,2,2,2,4,0,Technical Failure
2015-11-14 00:00:00,WWSL Inc. Trustee,Landing (descent or approach),Business,United Kingdom,Europe,4,1,1,3,3,4,0,Human Factor
2016-07-29 00:00:00,Cal-Ore Life Flight,Flight,Humanitarian,United States of America,North America,4,1,1,3,3,4,0,Technical Failure
2016-09-30 00:00:00,Llanera de Aviación,Takeoff (climb),Commercial,Colombia,South America,11,2,1,9,3,4,7,Human Factor
2016-10-13 00:00:00,Norjet,Takeoff (climb),Business,Canada,North America,4,1,1,3,3,4,0,Unknown
2016-10-31 00:00:00,Perkumpulan Penerbangan Alfa Indonesia,Flight,Operational,Indonesia,Asia,4,4,4,0,0,4,0,Human Factor
2016-11-18 00:00:00,American Medflight Air Ambulance,Takeoff (climb),Humanitarian,United States of America,North America,4,1,1,3,3,4,0,Technical Failure
2016-12-04 00:00:00,PA Scale Company of Florida,Flight,Business,Spain,Europe,4,1,1,3,3,4,0,Weather
2017-01-16 00:00:00,ACT Airlines,Landing (descent or approach),Operational,Kyrgyzstan,Asia,4,4,4,0,0,4,0,Human Factor
2017-04-07 00:00:00,Park City Aviation,Landing (descent or approach),Business,United States of America,North America,4,1,1,3,3,4,0,Weather
2017-04-17 00:00:00,Symbios Orthopédie,Takeoff (climb),Business,Portugal,Europe,4,1,1,3,3,4,0,Technical Failure
2017-05-15 00:00:00,Ithaca Consulting,Flight,Business,Bahamas,Central America,4,1,1,3,3,4,0,Human Factor
2017-05-15 00:00:00,Japan Air Self-Defense Force - Kōkū Jieitai,Flight,Humanitarian,Japan,Asia,4,2,2,2,2,4,0,Unknown
2017-10-14 00:00:00,Valan International Cargo Charter - Valan ICC,Landing (descent or approach),Operational,Ivory Coast,Africa,10,3,3,7,1,4,6,Human Factor
2017-12-19 00:00:00,Naryan-Mar Air Enterprise - Naryan-Marskoe Aviapredpriatie,Takeoff (climb),Commercial,Russia,Asia,13,2,0,11,4,4,9,Human Factor
2018-05-02 00:00:00,Policía Nacional de Colombia,Landing (descent or approach),Operational,Colombia,South America,4,4,4,0,0,4,0,Unknown
2018-06-02 00:00:00,Bernard J. Krupinski,Landing (descent or approach),Business,United States of America,North America,4,1,1,3,3,4,0,Weather
2018-06-24 00:00:00,Eagle Air - Guinea,Flight,Commercial,Guinea,Africa,4,2,2,2,2,4,0,Human Factor
2018-06-28 00:00:00,U.Y. Aviation Private Ltd,Landing (descent or approach),Specialised Services,India,Asia,4,2,2,2,2,4,0,Unknown
2018-08-30 00:00:00,Henry Leasing Company,Landing (descent or approach),Business,United States of America,North America,4,1,1,3,3,4,0,Human Factor
2018-11-26 00:00:00,ARG Ltd,Landing (descent or approach),Business,Brazil,South America,4,2,2,2,2,4,0,Unknown
2018-12-20 00:00:00,Chen Aircrafts,Takeoff (climb),Business,United States of America,North America,4,1,1,3,3,4,0,Human Factor
2019-06-07 00:00:00,Gregory G. Boll,Flight,Business,United States of America,North America,4,1,1,3,3,4,0,Weather
2019-07-26 00:00:00,Seair Seaplanes - Seair Services,Flight,Commercial,Canada,North America,9,1,1,8,3,4,5,Human Factor
2019-09-18 00:00:00,Rimbun Air,Flight,Operational,Indonesia,Asia,4,3,3,1,1,4,0,Unknown
2020-01-03 00:00:00,Sri Lanka Air Force,Flight,Military / Government,Sri Lanka,Asia,4,4,4,0,0,4,0,Unknown
2020-02-08 00:00:00,Remonia Air,Flight,Business,United States of America,North America,4,1,1,3,3,4,0,Unknown
2020-02-12 00:00:00,Aero Taxi Guaymaral,Takeoff (climb),Commercial,Colombia,South America,4,2,2,2,2,4,0,Technical Failure
2020-08-13 00:00:00,Doren Air Congo,Landing (descent or approach),Operational,Democratic Republic of Congo,Africa,4,2,2,2,2,4,0,Unknown
2020-09-20 00:00:00,KMAC Bravo,Landing (descent or approach),Business,United States of America,North America,4,1,1,3,3,4,0,Unknown
2020-09-23 00:00:00,Private Mexican,Landing (descent or approach),Humanitarian,Guatemala,Central America,4,2,2,2,2,4,0,Human Factor
2021-01-12 00:00:00,Kenya Air Force,Landing (descent or approach),Military / Government,Kenya,Africa,4,4,4,0,0,4,0,Unknown
2021-03-13 00:00:00,Kazakhstan Border Guards,Landing (descent or approach),Military / Government,Kazakhstan,Asia,6,6,4,0,0,4,2,Unknown
2021-06-19 00:00:00,DOSAAF,Takeoff (climb),Humanitarian,Russia,Asia,19,2,2,17,2,4,15,Technical Failure
2021-09-02 00:00:00,Brook Haven Properties,Takeoff (climb),Business,United States of America,North America,4,2,2,2,2,4,0,Unknown
2021-09-12 00:00:00,SiLA-Avia,Landing (descent or approach),Commercial,Russia,Asia,16,2,1,14,3,4,12,Unknown
2021-11-13 00:00:00,Island Airways - Michigan,Landing (descent or approach),Commercial,United States of America,North America,5,1,1,4,3,4,1,Unknown
2021-12-27 00:00:00,Aeromedevac Air Ambulance,Landing (descent or approach),Operational,United States of America,North America,4,2,2,2,2,4,0,Unknown
1919-07-18 00:00:00,Royal Air Force - RAF,Takeoff (climb),Operational,United Kingdom,Europe,3,3,3,0,0,3,0,Human Factor
1920-02-09 00:00:00,U.S. Air Mail Service,Flight,Operational,United States of America,North America,3,1,1,2,2,3,0,Unknown
1920-06-24 00:00:00,S. Summerfield Company,Landing (descent or approach),Business,United Kingdom,Europe,3,1,1,2,2,3,0,Technical Failure
1920-11-11 00:00:00,Walsh Brother's Flying School,Landing (descent or approach),Commercial,New Zealand,Oceania,3,1,1,2,2,3,0,Unknown
1921-02-09 00:00:00,U.S. Air Mail Service,Flight,Operational,United States of America,North America,3,3,3,0,0,3,0,Technical Failure
1922-06-03 00:00:00,Compagnie des Messageries Aériennes - CMA,Flight,Commercial,United Kingdom,Europe,3,1,1,2,2,3,0,Unknown
1922-07-08 00:00:00,Nederlands-Indische Luchtvaart Onderneming,Takeoff (climb),Commercial,Indonesia,Asia,4,1,1,3,2,3,1,Unknown
1922-07-26 00:00:00,Compagnie Générale d'Entreprises Aéronautiques - CGEA,Flight,Commercial,Spain,Europe,3,1,1,2,2,3,0,Technical Failure
1922-09-07 00:00:00,E. C. Twombley,Flight,Business,United States of America,North America,3,1,1,2,2,3,0,Unknown
1922-10-03 00:00:00,Evan Williams,Flight,Business,United Kingdom,Europe,3,1,1,2,2,3,0,Unknown
1922-11-15 00:00:00,Caudron Industries,Takeoff (climb),Operational,France,Europe,3,3,3,0,0,3,0,Technical Failure
1923-05-26 00:00:00,French Air Force - Armée de l'Air,Takeoff (climb),Military / Government,France,Europe,3,3,3,0,0,3,0,Unknown
1923-08-01 00:00:00,Flygkompaniet,Landing (descent or approach),Operational,Netherlands,Europe,3,3,3,0,0,3,0,Other
1923-11-18 00:00:00,Soviet Air Force - Voyenno-vozdushnye sily CCCP,Flight,Operational,Russia,Asia,5,2,2,3,1,3,2,Unknown
1924-04-24 00:00:00,KLM Royal Dutch Airlines - Koninklijke Luchtvaart Maatschappij,Flight,Commercial,World,World,3,1,1,2,2,3,0,Technical Failure
1924-06-06 00:00:00,Compagnie Franco-Roumaine de Navigation Aérienne,Flight,Commercial,Czech Republic,Europe,3,1,1,2,2,3,0,Technical Failure
1925-03-27 00:00:00,Portuguese Air Force - Aeronáutica Militar,Flight,Operational,Portugal,Europe,3,3,3,0,0,3,0,Unknown
1926-06-30 00:00:00,Deutsche Lufthansa,Landing (descent or approach),Commercial,Germany,Europe,4,1,1,3,2,3,1,Unknown
1926-08-18 00:00:00,Air Union France,Flight,Commercial,United Kingdom,Europe,15,2,1,13,2,3,12,Human Factor
1926-09-02 00:00:00,Stallard Airways,Flight,Commercial,United Kingdom,Europe,3,1,1,2,2,3,0,Human Factor
1926-11-11 00:00:00,Compagnie Générale d'Entreprises Aéronautiques - CGEA,Flight,Operational,Western Sahara,Africa,3,3,3,0,0,3,0,Technical Failure
1927-03-24 00:00:00,Qantas Airways - Queensland and Northern Territory Aerial Services,Landing (descent or approach),Commercial,Australia,Oceania,3,1,1,2,2,3,0,Technical Failure
1927-07-11 00:00:00,Royal Canadian Air Force - RCAF,Flight,Specialised Services,Canada,North America,3,3,3,0,0,3,0,Weather
1927-08-01 00:00:00,Compagnie Générale d'Entreprises Aéronautiques - CGEA,Landing (descent or approach),Operational,France,Europe,3,3,3,0,0,3,0,Human Factor
1927-08-16 00:00:00,William F. Malloska,Flight,Business,World,World,3,2,2,1,1,3,0,Unknown
1927-08-31 00:00:00,Princess Anne of Löwenstein-Wertheim-Freudenberg,Flight,Business,World,World,3,2,2,1,1,3,0,Unknown
1927-09-07 00:00:00,William Randolph Hearst,Flight,Business,World,World,3,2,2,1,1,3,0,Unknown
1927-10-17 00:00:00,Brazilian Air Force - Aviação Militar,Takeoff (climb),Operational,Brazil,South America,3,3,3,0,0,3,0,Unknown
1928-01-08 00:00:00,Colonial Western Airways,Flight,Commercial,United States of America,North America,3,1,1,2,2,3,0,Human Factor
1928-03-02 00:00:00,Royal Air Force - RAF,Flight,Operational,United Kingdom,Europe,3,3,3,0,0,3,0,Unknown
1928-05-04 00:00:00,Private American,Flight,Business,United States of America,North America,3,1,1,2,2,3,0,Technical Failure
1928-05-23 00:00:00,Société Générale des Transports Aériens - SGTA,Takeoff (climb),Commercial,Germany,Europe,3,2,2,1,1,3,0,Unknown
1928-05-26 00:00:00,Ölag - Österreichische Luftverkehrs AG,Flight,Commercial,Germany,Europe,5,1,1,4,2,3,2,Other
1928-06-23 00:00:00,United States Marine Corps,Flight,Military / Government,United States of America,North America,4,4,3,0,0,3,1,Unknown
1928-07-05 00:00:00,Imperial Japanese Navy - Nihon Kaigun,Flight,Military / Government,Japan,Asia,7,7,3,0,0,3,4,Unknown
1928-07-08 00:00:00,H. O. Comp,Flight,Business,United States of America,North America,3,1,1,2,2,3,0,Unknown
1928-09-06 00:00:00,Bodensee Aerolloyd,Flight,Commercial,Germany,Europe,3,1,1,2,2,3,0,Unknown
1928-09-06 00:00:00,Packard Electric Company,Takeoff (climb),Business,United States of America,North America,6,1,1,5,2,3,3,Technical Failure
1928-09-29 00:00:00,Regia Aeronautica,Flight,Operational,France,Europe,5,5,3,0,0,3,2,Human Factor
1928-10-04 00:00:00,L'Aéropostale,Flight,Commercial,Spain,Europe,3,1,1,2,2,3,0,Weather
1928-11-24 00:00:00,Universal Airlines,Flight,Commercial,United States of America,North America,3,1,1,2,2,3,0,Weather
1928-12-11 00:00:00,Deutsche Lufthansa,Flight,Commercial,Germany,Europe,4,3,3,1,0,3,1,Technical Failure
1928-12-31 00:00:00,Spanish Air Force - Aeronáutica Militar,Flight,Military / Government,Algeria,Africa,3,3,3,0,0,3,0,Unknown
1929-01-30 00:00:00,Royal Air Force - RAF,Landing (descent or approach),Operational,United Kingdom,Europe,3,3,3,0,0,3,0,Unknown
1929-05-09 00:00:00,Ceskoslovenska Letecka Spolecnost - CLS,Landing (descent or approach),Commercial,Germany,Europe,3,2,2,1,1,3,0,Weather
1929-06-20 00:00:00,Canadian Vickers,Takeoff (climb),Humanitarian,Canada,North America,3,2,2,1,1,3,0,Unknown
1929-07-04 00:00:00,John Sale,Landing (descent or approach),Business,United Kingdom,Europe,3,1,1,2,2,3,0,Human Factor
1929-08-13 00:00:00,L'Aéropostale,Landing (descent or approach),Commercial,France,Europe,3,1,1,2,2,3,0,Human Factor
1929-08-24 00:00:00,Ukrvozduchput,Takeoff (climb),Commercial,Russia,Asia,6,1,0,5,3,3,3,Human Factor
1929-09-06 00:00:00,Imperial Airways,Landing (descent or approach),Commercial,Iran,Asia,5,2,2,3,1,3,2,Human Factor
1929-11-16 00:00:00,Air Union France,Flight,Operational,France,Europe,3,3,3,0,0,3,0,Weather
1929-11-30 00:00:00,L'Aéropostale,Takeoff (climb),Operational,Spain,Europe,3,3,3,0,0,3,0,Unknown
1929-12-14 00:00:00,L'Aéropostale,Flight,Operational,Libya,Africa,3,3,3,0,0,3,0,Unknown
1930-01-13 00:00:00,Société Générale Aéronautique,Flight,Operational,Democratic Republic of Congo,Africa,3,3,3,0,0,3,0,Unknown
1930-01-18 00:00:00,Dobrolet,Landing (descent or approach),Commercial,Azerbaijan,Asia,4,2,1,2,2,3,1,Human Factor
1930-01-19 00:00:00,Florida Airways,Flight,Commercial,United States of America,North America,5,2,1,3,2,3,2,Unknown
1930-02-07 00:00:00,Chilean Air Force - Fuerza Aérea de Chile,Landing (descent or approach),Military / Government,Chile,South America,6,2,2,4,1,3,3,Technical Failure
1930-02-09 00:00:00,L'Aéropostale,Flight,Operational,France,Europe,3,3,3,0,0,3,0,Technical Failure
1930-02-23 00:00:00,Western Air Express,Flight,Operational,United States of America,North America,3,3,3,0,0,3,0,Human Factor
1930-03-24 00:00:00,Wallace Beery,Landing (descent or approach),Business,United States of America,North America,3,1,1,2,2,3,0,Technical Failure
1930-04-23 00:00:00,Verville Aircraft Company,Flight,Operational,United States of America,North America,3,1,1,2,2,3,0,Weather
1930-04-27 00:00:00,Texas Worth Tool Company,Flight,Business,United States of America,North America,4,1,1,3,2,3,1,Technical Failure
1930-07-05 00:00:00,Selfridges %26 Company,Takeoff (climb),Business,France,Europe,3,1,1,2,2,3,0,Unknown
1930-08-02 00:00:00,Air Union France,Takeoff (climb),Commercial,Switzerland,Europe,5,2,0,3,3,3,2,Unknown
1930-08-23 00:00:00,Sheboygan Airways,Flight,Business,United States of America,North America,3,1,1,2,2,3,0,Human Factor
1930-09-25 00:00:00,Western Canada Airways,Landing (descent or approach),Commercial,Canada,North America,3,1,1,2,2,3,0,Unknown
1930-10-12 00:00:00,Market Missionary,Landing (descent or approach),Specialised Services,United States of America,North America,3,1,1,2,2,3,0,Unknown
1930-10-13 00:00:00,Wings Ltd,Flight,Commercial,Australia,Oceania,3,1,1,2,2,3,0,Technical Failure
1930-10-28 00:00:00,Alaska Washington Airways,Flight,Military / Government,Canada,North America,3,1,1,2,2,3,0,Unknown
1930-10-30 00:00:00,Imperial Airways,Flight,Commercial,France,Europe,6,3,1,3,2,3,3,Technical Failure
1930-10-30 00:00:00,Balair - Switzerland,Landing (descent or approach),Commercial,Germany,Europe,6,3,3,3,0,3,3,Human Factor
1930-11-17 00:00:00,Pacific Air Transport,Flight,Commercial,United States of America,North America,3,2,2,1,1,3,0,Weather
1930-11-23 00:00:00,Bolivian Air Force - Fuerza Aérea Boliviana,Flight,Operational,Argentina,South America,3,3,3,0,0,3,0,Unknown
1931-01-07 00:00:00,Wedell-Williams Air Services,Flight,Commercial,United States of America,North America,3,2,2,1,1,3,0,Weather
1931-01-09 00:00:00,Private American,Flight,Operational,United States of America,North America,4,1,1,3,2,3,1,Technical Failure
1931-01-12 00:00:00,Royal Air Force - RAF,Flight,Operational,United Kingdom,Europe,4,4,3,0,0,3,1,Human Factor
1931-01-19 00:00:00,Royal Air Force - RAF,Landing (descent or approach),Operational,United Kingdom,Europe,4,4,3,0,0,3,1,Unknown
1931-01-25 00:00:00,Home Counties Aircraft Service,Flight,Operational,United Kingdom,Europe,3,1,1,2,2,3,0,Human Factor
1931-02-08 00:00:00,Dominion Airways - New Zealand,Flight,Commercial,New Zealand,Oceania,3,1,1,2,2,3,0,Human Factor
1931-07-15 00:00:00,Société de Transports Aériens Rapides - STAR,Flight,Commercial,France,Europe,5,1,1,4,2,3,2,Human Factor
1931-09-03 00:00:00,Brazilian Navy - Aviação Naval Brasileira,Flight,Military / Government,Brazil,South America,8,8,3,0,0,3,5,Human Factor
1931-09-12 00:00:00,Syndicato Condor,Takeoff (climb),Commercial,Brazil,South America,4,2,1,2,2,3,1,Other
1931-10-28 00:00:00,Corporación Aeronautica de Transportes,Flight,Operational,Mexico,Central America,3,3,3,0,0,3,0,Unknown
1931-11-13 00:00:00,Union Airways,Flight,Commercial,South Africa,Africa,3,1,1,2,2,3,0,Weather
1931-11-16 00:00:00,Spanish Navy - Aeronáutica Naval,Flight,Operational,Spain,Europe,4,4,3,0,0,3,1,Unknown
1931-11-19 00:00:00,China National Aviation Corporation - CNAC,Flight,Operational,China,Asia,3,2,2,1,1,3,0,Weather
1932-02-27 00:00:00,L'Aéropostale,Flight,Operational,Brazil,South America,3,3,3,0,0,3,0,Weather
1932-03-08 00:00:00,Century Air Lines,Landing (descent or approach),Operational,United States of America,North America,5,5,3,0,0,3,2,Human Factor
1932-03-29 00:00:00,Air Orient,Flight,Commercial,Iraq,Asia,3,2,2,1,1,3,0,Weather
1932-04-26 00:00:00,Brazilian Navy - Aviação Naval Brasileira,Landing (descent or approach),Military / Government,Brazil,South America,12,4,1,8,2,3,9,Unknown
1932-05-16 00:00:00,Pacific Air Transport,Landing (descent or approach),Commercial,United States of America,North America,3,1,1,2,2,3,0,Unknown
1932-06-19 00:00:00,Harry N. Hill,Takeoff (climb),Business,United States of America,North America,3,1,1,2,2,3,0,Unknown
1932-06-29 00:00:00,Canadian Airways,Flight,Commercial,Canada,North America,3,1,1,2,2,3,0,Unknown
1932-07-27 00:00:00,Brian Lewis %26 Company,Flight,Business,United Kingdom,Europe,3,1,1,2,2,3,0,Weather
1932-09-08 00:00:00,American Airways,Flight,Operational,United States of America,North America,3,3,3,0,0,3,0,Weather
1932-09-14 00:00:00,American Medical Researches,Flight,Business,World,World,3,3,3,0,0,3,0,Unknown
1932-09-18 00:00:00,New England Airways,Flight,Commercial,Australia,Oceania,3,1,1,2,2,3,0,Technical Failure
1932-09-24 00:00:00,Hochi Shimbun,Flight,Business,World,World,3,3,3,0,0,3,0,Unknown
1932-10-02 00:00:00,Petro Sol Corporation,Flight,Business,United States of America,North America,4,1,1,3,2,3,1,Unknown
1932-11-06 00:00:00,Frederick Lothrop Ames Jr.,Flight,Business,United States of America,North America,3,1,1,2,2,3,0,Human Factor
1932-12-06 00:00:00,Leroy C. Dunn,Flight,Business,United States of America,North America,3,1,1,2,2,3,0,Weather
1932-12-22 00:00:00,Royal Air Force - RAF,Flight,Military / Government,Sudan,Africa,3,3,3,0,0,3,0,Unknown
1933-02-08 00:00:00,Stinson Aircraft Company,Flight,Specialised Services,United States of America,North America,3,3,3,0,0,3,0,Unknown
1933-03-19 00:00:00,United States Army Air Corps - USAAC,Flight,Military / Government,United States of America,North America,3,3,3,0,0,3,0,Weather
1933-03-25 00:00:00,Varney Speed Lines - VSL,Landing (descent or approach),Commercial,United States of America,North America,3,1,1,2,2,3,0,Weather
1933-04-10 00:00:00,Henri Gelley,Flight,Business,France,Europe,4,1,0,3,3,3,1,Technical Failure
1933-06-01 00:00:00,United States Army Air Corps - USAAC,Flight,Military / Government,United States of America,North America,7,7,3,0,0,3,4,Human Factor
1933-06-18 00:00:00,Harry Sweet,Flight,Business,United States of America,North America,3,1,1,2,2,3,0,Technical Failure
1933-07-12 00:00:00,Polyarnaya Aviatsiya,Flight,Commercial,Russia,Asia,5,4,2,1,1,3,2,Weather
1933-08-15 00:00:00,Wells Air Transport,Flight,Commercial,Canada,North America,6,1,0,5,3,3,3,Human Factor
1933-10-01 00:00:00,Aerofilms,Takeoff (climb),Operational,Ireland,Europe,3,1,1,2,2,3,0,Technical Failure
1933-10-18 00:00:00,F. Free,Takeoff (climb),Business,Nicaragua,Central America,3,2,2,1,1,3,0,Unknown
1933-10-30 00:00:00,Charles de Verneilh Puyraseau,Flight,Business,France,Europe,3,3,3,0,0,3,0,Weather
1933-11-12 00:00:00,Safair - USA,Flight,Business,United States of America,North America,4,1,0,3,3,3,1,Unknown
1933-11-17 00:00:00,Aeroflot - Russian International Airlines,Takeoff (climb),Operational,Russia,Asia,3,3,3,0,0,3,0,Technical Failure
1933-11-24 00:00:00,National Air Transport - USA,Flight,Operational,United States of America,North America,3,3,3,0,0,3,0,Unknown
1934-03-22 00:00:00,Panagra - Pan American-Grace Airways,Takeoff (climb),Commercial,Peru,South America,15,3,2,12,1,3,12,Technical Failure
1934-06-26 00:00:00,CSA Czech Airlines - Československé Státní Aerolinie,Landing (descent or approach),Commercial,Czech Republic,Europe,6,2,2,4,1,3,3,Technical Failure
1934-06-28 00:00:00,Ray C. Van Arsdale,Landing (descent or approach),Business,United States of America,North America,3,1,1,2,2,3,0,Human Factor
1934-07-09 00:00:00,United Air Services - USA,Flight,Commercial,United States of America,North America,4,1,1,3,2,3,1,Unknown
1934-10-03 00:00:00,Qantas Airways - Queensland and Northern Territory Aerial Services,Flight,Commercial,Australia,Oceania,3,1,1,2,2,3,0,Unknown
1934-12-03 00:00:00,Charles T. P. Ulm,Flight,Business,World,World,3,3,3,0,0,3,0,Technical Failure
1934-12-07 00:00:00,Deutsche Lufthansa,Flight,Commercial,Germany,Europe,3,1,1,2,2,3,0,Unknown
1935-03-15 00:00:00,Misrair,Landing (descent or approach),Commercial,Egypt,Africa,6,1,1,5,2,3,3,Technical Failure
1935-05-18 00:00:00,Knowles Flying Services,Takeoff (climb),Commercial,United States of America,North America,12,2,1,10,2,3,9,Technical Failure
1935-07-23 00:00:00,Jersey Airways,Takeoff (climb),Commercial,United Kingdom,Europe,8,1,0,7,3,3,5,Unknown
1935-08-15 00:00:00,Aero Mayflower Transit Company,Flight,Commercial,United States of America,North America,3,1,1,2,2,3,0,Human Factor
1935-08-25 00:00:00,Private Indian,Flight,Business,India,Asia,3,1,1,2,2,3,0,Unknown
1935-09-01 00:00:00,Western Air Express,Takeoff (climb),Operational,United States of America,North America,3,3,3,0,0,3,0,Human Factor
1935-09-07 00:00:00,National Aviation Displays,Flight,Commercial,United Kingdom,Europe,3,1,1,2,2,3,0,Unknown
1935-09-07 00:00:00,Trafalgar Advertising Company,Flight,Business,United Kingdom,Europe,3,1,1,2,2,3,0,Unknown
1935-09-09 00:00:00,Compania Nacional de Aviacion de Guatemala,Landing (descent or approach),Operational,Guatemala,Central America,3,2,2,1,1,3,0,Human Factor
1935-09-16 00:00:00,French Air Force - Armée de l'Air,Takeoff (climb),Operational,France,Europe,4,4,3,0,0,3,1,Technical Failure
1935-10-06 00:00:00,Standard Oil of California,Takeoff (climb),Operational,United States of America,North America,3,3,3,0,0,3,0,Unknown
1935-11-11 00:00:00,Air France,Flight,Commercial,France,Europe,3,3,3,0,0,3,0,Weather
1935-12-20 00:00:00,Pan American World Airways - PAA,Landing (descent or approach),Commercial,Trinidad and Tobago,Central America,25,5,0,20,3,3,22,Unknown
1935-12-24 00:00:00,Deutsche Lufthansa,Flight,Commercial,Poland,Europe,3,1,1,2,2,3,0,Human Factor
1936-04-11 00:00:00,Pan American World Airways - PAA,Takeoff (climb),Commercial,Trinidad and Tobago,Central America,25,7,1,18,2,3,22,Human Factor
1936-04-17 00:00:00,Deutsche Lufthansa,Flight,Military / Government,Switzerland,Europe,5,5,3,0,0,3,2,Human Factor
1936-08-02 00:00:00,Air France,Flight,Operational,France,Europe,3,3,3,0,0,3,0,Unknown
1936-09-15 00:00:00,British Airways,Takeoff (climb),Operational,United Kingdom,Europe,3,3,3,0,0,3,0,Technical Failure
1936-09-28 00:00:00,Varney Air Transport - VAT,Flight,Commercial,United States of America,North America,3,1,1,2,2,3,0,Technical Failure
1936-10-11 00:00:00,Panagra - Pan American-Grace Airways,Landing (descent or approach),Operational,Guatemala,Central America,3,3,3,0,0,3,0,Human Factor
1936-12-28 00:00:00,LOT Polish Airlines - Polskie Linie Lotnicze,Flight,Commercial,Poland,Europe,12,2,1,10,2,3,9,Weather
1937-02-22 00:00:00,Royal Air Force - RAF,Flight,Operational,United Kingdom,Europe,4,4,3,0,0,3,1,Weather
1937-03-15 00:00:00,Imperial Airways,Landing (descent or approach),Commercial,Germany,Europe,3,2,2,1,1,3,0,Unknown
1937-04-06 00:00:00,Royal Air Force - RAF,Takeoff (climb),Operational,United Kingdom,Europe,5,5,3,0,0,3,2,Weather
1937-04-29 00:00:00,Royal Air Force - RAF,Flight,Operational,United Kingdom,Europe,3,3,3,0,0,3,0,Human Factor
1937-06-21 00:00:00,Leavens Brothers Air Services,Flight,Operational,Canada,North America,3,1,1,2,2,3,0,Technical Failure
1937-08-08 00:00:00,China National Aviation Corporation - CNAC,Flight,Commercial,China,Asia,11,4,3,7,0,3,8,Weather
1937-08-23 00:00:00,Panagra - Pan American-Grace Airways,Flight,Operational,Argentina,South America,3,3,3,0,0,3,0,Weather
1937-09-07 00:00:00,Royal Air Force - RAF,Flight,Military / Government,United Kingdom,Europe,3,3,3,0,0,3,0,Human Factor
1937-09-10 00:00:00,Alpar,Landing (descent or approach),Commercial,Switzerland,Europe,4,2,1,2,2,3,1,Weather
1937-11-26 00:00:00,Deutsche Lufthansa,Takeoff (climb),Operational,United Kingdom,Europe,3,3,3,0,0,3,0,Unknown
1937-12-15 00:00:00,Lloyd Aéreo Boliviano - LAB Airlines,Flight,Operational,Bolivia,South America,3,3,3,0,0,3,0,Unknown
1937-12-24 00:00:00,Air France,Flight,Commercial,Czech Republic,Europe,3,2,2,1,1,3,0,Human Factor
1937-12-29 00:00:00,Cuban Air Force - Cuerpo de Aviación del Ejército de Cuba,Flight,Military / Government,Colombia,South America,3,1,1,2,2,3,0,Weather
1938-02-09 00:00:00,Aerovias Centrales,Takeoff (climb),Specialised Services,Mexico,Central America,3,3,3,0,0,3,0,Technical Failure
1938-02-22 00:00:00,Deutsche Lufthansa,Landing (descent or approach),Operational,France,Europe,3,3,3,0,0,3,0,Weather
1938-04-06 00:00:00,Royal Air Force - RAF,Flight,Operational,World,World,3,3,3,0,0,3,0,Unknown
1938-05-14 00:00:00,Private British,Flight,Business,United Kingdom,Europe,3,1,1,2,2,3,0,Human Factor
1938-05-18 00:00:00,Swedish Air Force - Flygvapnet,Flight,Operational,Sweden,Europe,3,3,3,0,0,3,0,Unknown
1938-05-27 00:00:00,Deutsche Lufthansa,Flight,Commercial,Germany,Europe,3,3,3,0,0,3,0,Unknown
1938-06-08 00:00:00,Wilson Airways,Flight,Commercial,Tanzania,Africa,3,2,2,1,1,3,0,Unknown
1938-08-22 00:00:00,French Air Force - Armée de l'Air,Flight,Operational,France,Europe,3,3,3,0,0,3,0,Human Factor
1938-08-22 00:00:00,French Air Force - Armée de l'Air,Flight,Operational,France,Europe,3,3,3,0,0,3,0,Human Factor
1939-01-13 00:00:00,German Air Force - Deutsche Luftwaffe,Flight,Operational,Germany,Europe,3,3,3,0,0,3,0,Unknown
1939-01-21 00:00:00,Imperial Airways,Flight,Commercial,World,World,13,5,1,8,2,3,10,Weather
1939-03-14 00:00:00,SABENA - Société Anonyme Belge d'Exploitation de la Navigation Aérienne,Landing (descent or approach),Operational,Belgium,Europe,3,3,3,0,0,3,0,Unknown
1939-05-02 00:00:00,Royal Australian Air Force - RAAF,Landing (descent or approach),Operational,Australia,Oceania,3,2,2,1,1,3,0,Human Factor
1939-05-09 00:00:00,Royal Air Force - RAF,Flight,Operational,United Kingdom,Europe,3,3,3,0,0,3,0,Human Factor
1939-06-10 00:00:00,KLM Royal Dutch Airlines - Koninklijke Luchtvaart Maatschappij,Flight,Operational,Netherlands,Europe,3,2,2,1,1,3,0,Unknown
1939-06-20 00:00:00,British American Air Services - BAAS,Flight,Commercial,United Kingdom,Europe,3,2,2,1,1,3,0,Human Factor
1939-07-15 00:00:00,United States Coast Guard - USCG,Flight,Military / Government,World,World,8,8,3,0,0,3,5,Unknown
1939-07-21 00:00:00,Royal Air Force - RAF,Takeoff (climb),Operational,United Kingdom,Europe,3,3,3,0,0,3,0,Human Factor
1939-08-09 00:00:00,Royal Air Force - RAF,Flight,Military / Government,World,World,3,3,3,0,0,3,0,Unknown
1939-08-23 00:00:00,Royal Air Force - RAF,Takeoff (climb),Operational,United Kingdom,Europe,3,3,3,0,0,3,0,Human Factor
1939-09-01 00:00:00,Swedish Air Force - Flygvapnet,Flight,Military / Government,Sweden,Europe,3,3,3,0,0,3,0,Unknown
1939-09-05 00:00:00,Royal Air Force - RAF,Flight,Military / Government,Germany,Europe,4,4,3,0,0,3,1,Terrorism
1939-11-08 00:00:00,Royal Air Force - RAF,Landing (descent or approach),Operational,United Kingdom,Europe,3,3,3,0,0,3,0,Human Factor
1939-11-17 00:00:00,German Air Force - Deutsche Luftwaffe,Flight,Military / Government,Austria,Europe,4,4,3,0,0,3,1,Unknown
1939-11-22 00:00:00,German Air Force - Deutsche Luftwaffe,Flight,Military / Government,Belgium,Europe,4,4,3,0,0,3,1,Terrorism
1939-12-14 00:00:00,Royal Air Force - RAF,Landing (descent or approach),Military / Government,United Kingdom,Europe,6,6,3,0,0,3,3,Terrorism
1939-12-18 00:00:00,Royal Air Force - RAF,Flight,Operational,United Kingdom,Europe,3,3,3,0,0,3,0,Unknown
1940-01-06 00:00:00,Royal Air Force - RAF,Flight,Military / Government,United Kingdom,Europe,4,4,3,0,0,3,1,Human Factor
1940-01-21 00:00:00,Mandated Airlines,Landing (descent or approach),Commercial,Papua New Guinea,Oceania,6,1,1,5,2,3,3,Human Factor
1940-02-05 00:00:00,Royal Air Force - RAF,Flight,Military / Government,United Kingdom,Europe,4,4,3,0,0,3,1,Unknown
1940-02-11 00:00:00,Royal Air Force - RAF,Flight,Operational,United Kingdom,Europe,4,4,3,0,0,3,1,Human Factor
1940-03-03 00:00:00,Royal Air Force - RAF,Flight,Specialised Services,United Kingdom,Europe,4,4,3,0,0,3,1,Terrorism
1940-03-03 00:00:00,Air France,Flight,Operational,France,Europe,3,3,3,0,0,3,0,Human Factor
1940-03-12 00:00:00,Royal Air Force - RAF,Takeoff (climb),Operational,United Kingdom,Europe,3,3,3,0,0,3,0,Unknown
1940-04-10 00:00:00,Hellenic Air Force - Elleniki Polemiki Aeroporia,Flight,Operational,Greece,Europe,3,3,3,0,0,3,0,Unknown
1940-04-14 00:00:00,German Air Force - Deutsche Luftwaffe,Flight,Military / Government,Sweden,Europe,3,3,3,0,0,3,0,Terrorism
1940-05-10 00:00:00,German Air Force - Deutsche Luftwaffe,Flight,Military / Government,Belgium,Europe,3,3,3,0,0,3,0,Terrorism
1940-05-16 00:00:00,Royal Canadian Air Force - RCAF,Flight,Military / Government,Canada,North America,3,1,1,2,2,3,0,Unknown
1940-05-16 00:00:00,Royal Canadian Air Force - RCAF,Flight,Military / Government,Canada,North America,3,1,1,2,2,3,0,Unknown
1940-05-30 00:00:00,Royal Air Force - RAF,Flight,Military / Government,Norway,Europe,4,4,3,0,0,3,1,Terrorism
1940-06-01 00:00:00,Royal Air Force - RAF,Flight,Military / Government,France,Europe,5,5,3,0,0,3,2,Unknown
1940-07-11 00:00:00,Royal Air Force - RAF,Flight,Military / Government,Netherlands,Europe,4,4,3,0,0,3,1,Terrorism
1940-07-14 00:00:00,Royal Air Force - RAF,Flight,Military / Government,United Kingdom,Europe,3,3,3,0,0,3,0,Human Factor
1940-07-15 00:00:00,Royal Air Force - RAF,Flight,Military / Government,Germany,Europe,5,5,3,0,0,3,2,Unknown
1940-07-15 00:00:00,Royal Air Force - RAF,Flight,Military / Government,Egypt,Africa,5,5,3,0,0,3,2,Unknown
1940-08-02 00:00:00,Royal Air Force - RAF,Flight,Military / Government,United Kingdom,Europe,4,4,3,0,0,3,1,Human Factor
1940-08-05 00:00:00,Royal Air Force - RAF,Landing (descent or approach),Operational,United Kingdom,Europe,3,3,3,0,0,3,0,Unknown
1940-08-30 00:00:00,German Air Force - Deutsche Luftwaffe,Flight,Military / Government,United Kingdom,Europe,6,6,3,0,0,3,3,Terrorism
1940-09-07 00:00:00,Paraguay Air Force - Fuerza Aérea Paraguaya,Landing (descent or approach),Military / Government,Paraguay,South America,3,1,1,2,2,3,0,Human Factor
1940-09-24 00:00:00,Royal Air Force - RAF,Takeoff (climb),Military / Government,United Kingdom,Europe,5,5,3,0,0,3,2,Technical Failure
1940-09-28 00:00:00,Royal Air Force - RAF,Flight,Military / Government,World,World,6,6,3,0,0,3,3,Unknown
1940-09-30 00:00:00,Royal New Zealand Air Force - RNZAF,Flight,Operational,New Zealand,Oceania,3,3,3,0,0,3,0,Unknown
1940-10-11 00:00:00,Air France,Flight,Operational,Benin,Africa,3,3,3,0,0,3,0,Weather
1940-10-24 00:00:00,Royal Air Force - RAF,Takeoff (climb),Military / Government,United Kingdom,Europe,5,5,3,0,0,3,2,Terrorism
1940-11-03 00:00:00,Royal Air Force - RAF,Flight,Operational,United Kingdom,Europe,3,3,3,0,0,3,0,Unknown
1940-12-17 00:00:00,Royal Air Force - RAF,Landing (descent or approach),Military / Government,United Kingdom,Europe,6,6,3,0,0,3,3,Technical Failure
1940-12-28 00:00:00,Royal Air Force - RAF,Flight,Military / Government,United Kingdom,Europe,6,6,3,0,0,3,3,Unknown
1941-02-12 00:00:00,China National Aviation Corporation - CNAC,Flight,Operational,China,Asia,3,3,3,0,0,3,0,Weather
1941-02-20 00:00:00,Royal Air Force - RAF,Landing (descent or approach),Operational,Canada,North America,4,3,2,1,1,3,1,Technical Failure
1941-03-13 00:00:00,Royal Air Force - RAF,Takeoff (climb),Operational,United Kingdom,Europe,3,3,3,0,0,3,0,Technical Failure
1941-03-21 00:00:00,Royal Air Force - RAF,Takeoff (climb),Operational,United Kingdom,Europe,5,5,3,0,0,3,2,Human Factor
1941-08-02 00:00:00,United States Government,Landing (descent or approach),Operational,Gambia,Africa,3,3,3,0,0,3,0,Unknown
1941-08-05 00:00:00,United States Coast Guard - USCG,Flight,Military / Government,United States of America,North America,3,3,3,0,0,3,0,Weather
1941-08-07 00:00:00,Regia Aeronautica,Landing (descent or approach),Operational,Italy,Europe,8,8,3,0,0,3,5,Technical Failure
1941-08-16 00:00:00,Royal Air Force - RAF,Landing (descent or approach),Military / Government,United Kingdom,Europe,7,7,3,0,0,3,4,Terrorism
1941-08-27 00:00:00,Royal Air Force - RAF,Flight,Specialised Services,United Kingdom,Europe,3,2,2,1,1,3,0,Human Factor
1941-08-27 00:00:00,Airlines of Australia,Flight,Commercial,Australia,Oceania,3,1,1,2,2,3,0,Technical Failure
1941-08-28 00:00:00,Royal Air Force - RAF,Takeoff (climb),Military / Government,United Kingdom,Europe,3,3,3,0,0,3,0,Unknown
1941-08-30 00:00:00,Royal Netherlands Navy - Marineluchtvaartdienst,Flight,Military / Government,Norway,Europe,5,5,3,0,0,3,2,Terrorism
1941-09-21 00:00:00,Royal Air Force - RAF,Flight,Operational,Canada,North America,3,3,3,0,0,3,0,Unknown
1941-11-05 00:00:00,Royal Canadian Air Force - RCAF,Landing (descent or approach),Operational,Canada,North America,5,5,3,0,0,3,2,Unknown
1941-11-17 00:00:00,Royal Air Force - RAF,Flight,Military / Government,Libya,Africa,8,8,3,0,0,3,5,Terrorism
1941-11-19 00:00:00,Royal Air Force - RAF,Flight,Military / Government,United Kingdom,Europe,3,3,3,0,0,3,0,Unknown
1941-11-22 00:00:00,German Air Force - Deutsche Luftwaffe,Landing (descent or approach),Military / Government,Poland,Europe,5,5,3,0,0,3,2,Technical Failure
1941-12-08 00:00:00,Royal Australian Air Force - RAAF,Flight,Military / Government,Malaysia,Asia,4,4,3,0,0,3,1,Terrorism
1941-12-11 00:00:00,Pan American World Airways - PAA,Flight,Operational,United States of America,North America,3,3,3,0,0,3,0,Unknown
1941-12-21 00:00:00,Royal New Zealand Air Force - RNZAF,Flight,Military / Government,New Zealand,Oceania,3,3,3,0,0,3,0,Technical Failure
1942-01-01 00:00:00,Royal Australian Air Force - RAAF,Takeoff (climb),Military / Government,Indonesia,Asia,4,4,3,0,0,3,1,Technical Failure
1942-01-12 00:00:00,Royal Australian Air Force - RAAF,Flight,Military / Government,Indonesia,Asia,4,4,3,0,0,3,1,Terrorism
1942-01-21 00:00:00,Royal Australian Air Force - RAAF,Flight,Operational,Papua New Guinea,Oceania,8,8,3,0,0,3,5,Terrorism
1942-01-22 00:00:00,Royal Netherlands Navy - Marineluchtvaartdienst,Landing (descent or approach),Military / Government,Indonesia,Asia,3,3,3,0,0,3,0,Unknown
1942-01-24 00:00:00,Royal Netherlands Navy - Marineluchtvaartdienst,Landing (descent or approach),Military / Government,Indonesia,Asia,6,6,3,0,0,3,3,Human Factor
1942-03-08 00:00:00,Royal Air Force - RAF,Takeoff (climb),Operational,United Kingdom,Europe,3,3,3,0,0,3,0,Unknown
1942-03-09 00:00:00,Royal Air Force - RAF,Flight,Military / Government,Netherlands,Europe,6,6,3,0,0,3,3,Terrorism
1942-03-26 00:00:00,Royal New Zealand Air Force - RNZAF,Flight,Operational,World,World,3,3,3,0,0,3,0,Unknown
1942-04-11 00:00:00,Royal Air Force - RAF,Takeoff (climb),Military / Government,United Kingdom,Europe,5,1,0,4,3,3,2,Unknown
1942-04-16 00:00:00,United States Coast Guard - USCG,Flight,Military / Government,United States of America,North America,3,3,3,0,0,3,0,Unknown
1942-05-03 00:00:00,Royal Air Force - RAF,Flight,Military / Government,Germany,Europe,7,7,3,0,0,3,4,Terrorism
1942-05-08 00:00:00,Royal Canadian Air Force - RCAF,Landing (descent or approach),Operational,Canada,North America,3,3,3,0,0,3,0,Human Factor
1942-05-12 00:00:00,Northwest Airlines,Landing (descent or approach),Commercial,United States of America,North America,14,3,2,11,1,3,11,Human Factor
1942-05-15 00:00:00,Colón Development Company,Takeoff (climb),Business,Venezuela,South America,3,1,1,2,2,3,0,Unknown
1942-05-24 00:00:00,Royal Air Force - RAF,Takeoff (climb),Operational,United Kingdom,Europe,3,3,3,0,0,3,0,Unknown
1942-05-28 00:00:00,Royal Air Force - RAF,Flight,Military / Government,Norway,Europe,7,7,3,0,0,3,4,Terrorism
1942-05-31 00:00:00,Royal Air Force - RAF,Flight,Military / Government,Netherlands,Europe,7,7,3,0,0,3,4,Terrorism
1942-06-01 00:00:00,Royal Australian Air Force - RAAF,Flight,Operational,Australia,Oceania,3,3,3,0,0,3,0,Unknown
1942-06-24 00:00:00,United States Army Air Forces - USAAF,Flight,Operational,United States of America,North America,3,3,3,0,0,3,0,Human Factor
1942-06-30 00:00:00,United States Army Air Forces - USAAF,Landing (descent or approach),Humanitarian,Australia,Oceania,5,5,3,0,0,3,2,Technical Failure
1942-07-13 00:00:00,United States Army Air Forces - USAAF,Takeoff (climb),Military / Government,Australia,Oceania,9,9,3,0,0,3,6,Unknown
1942-07-14 00:00:00,Royal Australian Air Force - RAAF,Flight,Military / Government,Australia,Oceania,3,3,3,0,0,3,0,Unknown
1942-08-09 00:00:00,Royal Air Force - RAF,Flight,Specialised Services,United Kingdom,Europe,4,4,3,0,0,3,1,Technical Failure
1942-08-16 00:00:00,Linee Aeree Transcontinentali Italiane - LATI,Takeoff (climb),Commercial,Greece,Europe,3,3,3,0,0,3,0,Unknown
1942-08-21 00:00:00,Private German,Flight,Business,Germany,Europe,3,2,2,1,1,3,0,Technical Failure
1942-08-25 00:00:00,Royal Air Force - RAF,Flight,Operational,United Kingdom,Europe,3,3,3,0,0,3,0,Unknown
1942-09-03 00:00:00,Royal New Zealand Air Force - RNZAF,Flight,Operational,New Zealand,Oceania,3,3,3,0,0,3,0,Unknown
1942-09-15 00:00:00,Royal Canadian Air Force - RCAF,Flight,Operational,Canada,North America,4,4,3,0,0,3,1,Unknown
1942-09-30 00:00:00,Royal Air Force - RAF,Flight,Military / Government,Egypt,Africa,12,12,3,0,0,3,9,Human Factor
1942-10-14 00:00:00,Lockheed Aircraft Corporation,Flight,Operational,United Kingdom,Europe,3,2,2,1,1,3,0,Unknown
1942-11-14 00:00:00,Regia Aeronautica,Flight,Military / Government,Italy,Europe,3,3,3,0,0,3,0,Unknown
1942-11-16 00:00:00,Royal Air Force - RAF,Landing (descent or approach),Military / Government,United Kingdom,Europe,3,3,3,0,0,3,0,Other
1942-11-17 00:00:00,China National Aviation Corporation - CNAC,Flight,Operational,China,Asia,3,3,3,0,0,3,0,Unknown
1942-11-18 00:00:00,United Airlines,Landing (descent or approach),Operational,United States of America,North America,3,3,3,0,0,3,0,Human Factor
1942-11-20 00:00:00,Royal Air Force - RAF,Flight,Operational,Canada,North America,3,3,3,0,0,3,0,Unknown
1942-12-15 00:00:00,Royal Australian Air Force - RAAF,Flight,Military / Government,Papua New Guinea,Oceania,4,4,3,0,0,3,1,Terrorism
1942-12-31 00:00:00,United States Navy - USN,Takeoff (climb),Operational,Puerto Rico,Central America,3,3,3,0,0,3,0,Unknown
1943-01-01 00:00:00,United States Navy - USN,Flight,Military / Government,World,World,5,5,3,0,0,3,2,Human Factor
1943-01-04 00:00:00,Royal Air Force - RAF,Flight,Operational,United Kingdom,Europe,3,3,3,0,0,3,0,Human Factor
1943-01-13 00:00:00,Air France,Flight,Operational,Mali,Africa,3,3,3,0,0,3,0,Technical Failure
1943-01-28 00:00:00,United States Navy - USN,Flight,Operational,United States of America,North America,16,16,3,0,0,3,13,Unknown
1943-01-30 00:00:00,Royal Air Force - RAF,Flight,Operational,United Kingdom,Europe,5,5,3,0,0,3,2,Human Factor
1943-02-02 00:00:00,Royal Air Force - RAF,Flight,Military / Government,Belgium,Europe,7,7,3,0,0,3,4,Terrorism
1943-02-14 00:00:00,United States Navy - USN,Landing (descent or approach),Operational,United States of America,North America,6,6,3,0,0,3,3,Unknown
1943-02-23 00:00:00,United States Army Air Forces - USAAF,Flight,Operational,United States of America,North America,3,3,3,0,0,3,0,Unknown
1943-02-27 00:00:00,Royal Australian Air Force - RAAF,Landing (descent or approach),Operational,Australia,Oceania,6,6,3,0,0,3,3,Unknown
1943-03-01 00:00:00,Deutsche Lufthansa,Landing (descent or approach),Commercial,Norway,Europe,9,3,0,6,3,3,6,Unknown
1943-03-05 00:00:00,Aeroflot - Russian International Airlines,Flight,Commercial,Russia,Asia,11,5,3,6,0,3,8,Weather
1943-03-11 00:00:00,China National Aviation Corporation - CNAC,Flight,Operational,China,Asia,3,3,3,0,0,3,0,Human Factor
1943-03-12 00:00:00,United States Army Air Forces - USAAF,Flight,Operational,United States of America,North America,3,3,3,0,0,3,0,Unknown
1943-03-13 00:00:00,China National Aviation Corporation - CNAC,Flight,Operational,Myanmar,Asia,3,3,3,0,0,3,0,Weather
1943-03-23 00:00:00,British Overseas Airways Corporation - BOAC,Landing (descent or approach),Operational,United Kingdom,Europe,6,6,3,0,0,3,3,Unknown
1943-04-10 00:00:00,Royal Air Force - RAF,Flight,Operational,United Kingdom,Europe,5,5,3,0,0,3,2,Technical Failure
1943-04-10 00:00:00,Linee Aeree Transcontinentali Italiane - LATI,Flight,Commercial,World,World,3,3,3,0,0,3,0,Terrorism
1943-04-13 00:00:00,Linee Aeree Transcontinentali Italiane - LATI,Flight,Commercial,World,World,3,3,3,0,0,3,0,Terrorism
1943-04-13 00:00:00,Linee Aeree Transcontinentali Italiane - LATI,Flight,Commercial,World,World,3,3,3,0,0,3,0,Terrorism
1943-04-16 00:00:00,United States Army Air Forces - USAAF,Takeoff (climb),Operational,United States of America,North America,3,3,3,0,0,3,0,Technical Failure
1943-04-19 00:00:00,Linee Aeree Transcontinentali Italiane - LATI,Flight,Commercial,World,World,3,3,3,0,0,3,0,Terrorism
1943-04-23 00:00:00,Royal Air Force - RAF,Flight,Operational,Canada,North America,3,3,3,0,0,3,0,Unknown
1943-04-26 00:00:00,Royal Australian Air Force - RAAF,Flight,Military / Government,Papua New Guinea,Oceania,9,9,3,0,0,3,6,Human Factor
1943-05-01 00:00:00,United States Army Air Forces - USAAF,Flight,Military / Government,Trinidad and Tobago,Central America,3,3,3,0,0,3,0,Unknown
1943-05-03 00:00:00,United States Army Air Forces - USAAF,Takeoff (climb),Operational,United States of America,North America,5,5,3,0,0,3,2,Unknown
1943-05-05 00:00:00,United States Navy - USN,Flight,Military / Government,World,World,4,4,3,0,0,3,1,Human Factor
1943-05-10 00:00:00,United States Army Air Forces - USAAF,Takeoff (climb),Specialised Services,United States of America,North America,3,3,3,0,0,3,0,Technical Failure
1943-05-12 00:00:00,Royal Australian Air Force - RAAF,Flight,Operational,Australia,Oceania,3,3,3,0,0,3,0,Unknown
1943-05-17 00:00:00,United States Army Air Forces - USAAF,Flight,Military / Government,Netherlands,Europe,6,6,3,0,0,3,3,Terrorism
1943-05-21 00:00:00,Royal Air Force - RAF,Flight,Specialised Services,United Kingdom,Europe,3,1,1,2,2,3,0,Human Factor
1943-05-29 00:00:00,Soviet Air Force - Voyenno-vozdushnye sily CCCP,Landing (descent or approach),Military / Government,Russia,Asia,3,3,3,0,0,3,0,Unknown
1943-06-04 00:00:00,Royal Canadian Air Force - RCAF,Landing (descent or approach),Operational,Canada,North America,3,3,3,0,0,3,0,Human Factor
1943-06-04 00:00:00,Soviet Air Force - Voyenno-vozdushnye sily CCCP,Takeoff (climb),Military / Government,Russia,Asia,10,3,3,7,0,3,7,Human Factor
1943-06-24 00:00:00,Royal Air Force - RAF,Flight,Military / Government,France,Europe,3,3,3,0,0,3,0,Unknown
1943-07-09 00:00:00,United States Army Air Forces - USAAF,Flight,Operational,United States of America,North America,5,5,3,0,0,3,2,Human Factor
1943-07-11 00:00:00,United States Army Air Forces - USAAF,Flight,Military / Government,Italy,Europe,3,3,3,0,0,3,0,Terrorism
1943-07-15 00:00:00,Royal New Zealand Air Force - RNZAF,Takeoff (climb),Operational,New Zealand,Oceania,3,3,3,0,0,3,0,Unknown
1943-07-26 00:00:00,United States Army Air Forces - USAAF,Flight,Military / Government,Netherlands,Europe,10,10,3,0,0,3,7,Terrorism
1943-07-27 00:00:00,United States Army Air Forces - USAAF,Landing (descent or approach),Operational,United States of America,North America,3,3,3,0,0,3,0,Unknown
1943-08-02 00:00:00,United States Army Air Forces - USAAF,Flight,Operational,China,Asia,3,3,3,0,0,3,0,Other
1943-08-05 00:00:00,United States Army Air Forces - USAAF,Flight,Operational,United States of America,North America,3,3,3,0,0,3,0,Unknown
1943-08-11 00:00:00,China National Aviation Corporation - CNAC,Flight,Operational,Myanmar,Asia,3,3,3,0,0,3,0,Terrorism
1943-08-25 00:00:00,United States Navy - USN,Landing (descent or approach),Operational,United States of America,North America,3,3,3,0,0,3,0,Unknown
1943-08-25 00:00:00,United States Army Air Forces - USAAF,Takeoff (climb),Operational,India,Asia,3,3,3,0,0,3,0,Unknown
1943-09-08 00:00:00,Royal Australian Air Force - RAAF,Flight,Military / Government,Indonesia,Asia,5,5,3,0,0,3,2,Terrorism
1943-09-09 00:00:00,Royal Air Force - RAF,Flight,Operational,United Kingdom,Europe,6,6,3,0,0,3,3,Human Factor
1943-09-09 00:00:00,Royal Australian Air Force - RAAF,Flight,Operational,Australia,Oceania,3,3,3,0,0,3,0,Human Factor
1943-09-15 00:00:00,United States Army Air Forces - USAAF,Flight,Operational,China,Asia,3,3,3,0,0,3,0,Unknown
1943-09-16 00:00:00,United States Army Air Forces - USAAF,Landing (descent or approach),Operational,China,Asia,3,3,3,0,0,3,0,Unknown
1943-09-29 00:00:00,United States Army Air Forces - USAAF,Flight,Military / Government,United States of America,North America,3,3,3,0,0,3,0,Weather
1943-09-29 00:00:00,Royal New Zealand Air Force - RNZAF,Flight,Operational,New Zealand,Oceania,3,3,3,0,0,3,0,Human Factor
1943-10-13 00:00:00,China National Aviation Corporation - CNAC,Flight,Operational,Myanmar,Asia,3,3,3,0,0,3,0,Terrorism
1943-10-14 00:00:00,Royal Australian Air Force - RAAF,Flight,Military / Government,Australia,Oceania,5,5,3,0,0,3,2,Unknown
1943-10-24 00:00:00,Aeroflot - Russian International Airlines,Flight,Operational,Russia,Asia,3,3,3,0,0,3,0,Unknown
1943-11-02 00:00:00,United States Army Air Forces - USAAF,Flight,Operational,India,Asia,3,3,3,0,0,3,0,Unknown
1943-11-19 00:00:00,China National Aviation Corporation - CNAC,Landing (descent or approach),Operational,China,Asia,3,3,3,0,0,3,0,Human Factor
1943-11-26 00:00:00,United States Navy - USN,Landing (descent or approach),Military / Government,United States of America,North America,11,11,3,0,0,3,8,Unknown
1943-12-06 00:00:00,Royal Air Force - RAF,Landing (descent or approach),Operational,United Kingdom,Europe,4,4,3,0,0,3,1,Technical Failure
1943-12-21 00:00:00,Aeroflot - Russian International Airlines,Landing (descent or approach),Operational,Russia,Asia,7,7,3,0,0,3,4,Other
1944-01-05 00:00:00,Royal Air Force - RAF,Flight,Military / Government,United Kingdom,Europe,3,3,3,0,0,3,0,Unknown
1944-01-25 00:00:00,United States Army Air Forces - USAAF,Flight,Military / Government,China,Asia,4,4,3,0,0,3,1,Unknown
1944-01-31 00:00:00,United States Army Air Forces - USAAF,Takeoff (climb),Military / Government,United States of America,North America,3,3,3,0,0,3,0,Technical Failure
1944-02-01 00:00:00,German Air Force - Deutsche Luftwaffe,Flight,Military / Government,Finland,Europe,3,3,3,0,0,3,0,Unknown
1944-02-14 00:00:00,United States Navy - USN,Takeoff (climb),Military / Government,United States of America,North America,3,3,3,0,0,3,0,Unknown
1944-02-22 00:00:00,Royal Air Force - RAF,Flight,Operational,United Kingdom,Europe,5,5,3,0,0,3,2,Weather
1944-02-27 00:00:00,Royal Netherlands East Indies Air Force - ML-KNIL,Flight,Military / Government,World,World,4,4,3,0,0,3,1,Unknown
1944-03-12 00:00:00,Royal Air Force - RAF,Flight,Operational,United Kingdom,Europe,3,3,3,0,0,3,0,Unknown
1944-03-16 00:00:00,United States Army Air Forces - USAAF,Takeoff (climb),Operational,United States of America,North America,3,3,3,0,0,3,0,Technical Failure
1944-03-20 00:00:00,Royal Air Force - RAF,Flight,Operational,United Kingdom,Europe,3,3,3,0,0,3,0,Human Factor
1944-03-22 00:00:00,Royal Air Force - RAF,Takeoff (climb),Operational,United Kingdom,Europe,3,3,3,0,0,3,0,Technical Failure
1944-03-22 00:00:00,Royal Air Force - RAF,Flight,Military / Government,United Kingdom,Europe,7,7,3,0,0,3,4,Technical Failure
1944-04-09 00:00:00,United States Army Air Forces - USAAF,Flight,Military / Government,Denmark,Europe,10,10,3,0,0,3,7,Terrorism
1944-04-10 00:00:00,United States Army Air Forces - USAAF,Flight,Operational,United States of America,North America,3,3,3,0,0,3,0,Unknown
1944-04-15 00:00:00,Royal Air Force - RAF,Flight,Military / Government,Brazil,South America,3,3,3,0,0,3,0,Unknown
1944-04-16 00:00:00,United States Army Air Forces - USAAF,Flight,Military / Government,Papua New Guinea,Oceania,3,3,3,0,0,3,0,Unknown
1944-04-17 00:00:00,Royal Australian Air Force - RAAF,Flight,Specialised Services,Australia,Oceania,3,3,3,0,0,3,0,Unknown
1944-04-17 00:00:00,Royal Air Force - RAF,Flight,Military / Government,United Kingdom,Europe,3,3,3,0,0,3,0,Unknown
1944-04-30 00:00:00,United States Navy - USN,Landing (descent or approach),Military / Government,World,World,8,8,3,0,0,3,5,Unknown
1944-05-12 00:00:00,United States Army Air Forces - USAAF,Flight,Operational,United States of America,North America,3,3,3,0,0,3,0,Human Factor
1944-05-12 00:00:00,United States Navy - USN,Landing (descent or approach),Military / Government,Vanuatu,Oceania,9,9,3,0,0,3,6,Unknown
1944-05-15 00:00:00,China National Aviation Corporation - CNAC,Flight,Operational,China,Asia,3,3,3,0,0,3,0,Human Factor
1944-05-18 00:00:00,Aeroflot - Russian International Airlines,Flight,Military / Government,Belarus,Europe,6,6,3,0,0,3,3,Human Factor
1944-05-18 00:00:00,German Air Force - Deutsche Luftwaffe,Flight,Military / Government,Czech Republic,Europe,3,3,3,0,0,3,0,Technical Failure
1944-05-22 00:00:00,Royal Air Force - RAF,Flight,Military / Government,Netherlands,Europe,7,7,3,0,0,3,4,Terrorism
1944-05-24 00:00:00,United States Army Air Forces - USAAF,Flight,Military / Government,Sweden,Europe,9,9,3,0,0,3,6,Terrorism
1944-05-25 00:00:00,Royal Air Force - RAF,Flight,Military / Government,Netherlands,Europe,7,7,3,0,0,3,4,Unknown
1944-05-25 00:00:00,United States Army Air Forces - USAAF,Flight,Operational,Bhutan,Asia,3,3,3,0,0,3,0,Unknown
1944-05-27 00:00:00,United States Army Air Forces - USAAF,Flight,Military / Government,India,Asia,4,4,3,0,0,3,1,Unknown
1944-05-28 00:00:00,United States Army Air Forces - USAAF,Flight,Military / Government,Netherlands,Europe,10,10,3,0,0,3,7,Unknown
1944-05-30 00:00:00,Soviet Air Force - Voyenno-vozdushnye sily CCCP,Flight,Military / Government,Russia,Asia,3,3,3,0,0,3,0,Unknown
1944-06-06 00:00:00,Royal Air Force - RAF,Flight,Military / Government,France,Europe,3,3,3,0,0,3,0,Terrorism
1944-06-15 00:00:00,United States Army Air Forces - USAAF,Flight,Operational,United States of America,North America,3,3,3,0,0,3,0,Technical Failure
1944-06-20 00:00:00,Royal Netherlands Navy - Marineluchtvaartdienst,Flight,Military / Government,France,Europe,4,4,3,0,0,3,1,Terrorism
1944-06-20 00:00:00,United States Army Air Forces - USAAF,Flight,Military / Government,Netherlands,Europe,10,10,3,0,0,3,7,Terrorism
1944-06-22 00:00:00,United States Army Air Forces - USAAF,Flight,Military / Government,United Kingdom,Europe,10,10,3,0,0,3,7,Unknown
1944-06-24 00:00:00,Royal Canadian Air Force - RCAF,Flight,Military / Government,World,World,3,3,3,0,0,3,0,Terrorism
1944-07-02 00:00:00,United States Army Air Forces - USAAF,Landing (descent or approach),Operational,United States of America,North America,3,3,3,0,0,3,0,Human Factor
1944-07-07 00:00:00,United States Army Air Forces - USAAF,Flight,Operational,United States of America,North America,3,3,3,0,0,3,0,Human Factor
1944-07-07 00:00:00,Royal Canadian Air Force - RCAF,Flight,Operational,Canada,North America,3,3,3,0,0,3,0,Unknown
1944-07-15 00:00:00,Royal Air Force - RAF,Flight,Operational,United Kingdom,Europe,3,3,3,0,0,3,0,Human Factor
1944-07-19 00:00:00,Royal Air Force - RAF,Takeoff (climb),Operational,United Kingdom,Europe,3,3,3,0,0,3,0,Unknown
1944-07-20 00:00:00,Royal Canadian Air Force - RCAF,Flight,Operational,Canada,North America,3,3,3,0,0,3,0,Unknown
1944-07-26 00:00:00,United States Army Air Forces - USAAF,Flight,Operational,United States of America,North America,6,6,3,0,0,3,3,Technical Failure
1944-08-01 00:00:00,China National Aviation Corporation - CNAC,Takeoff (climb),Operational,China,Asia,3,3,3,0,0,3,0,Human Factor
1944-08-12 00:00:00,Royal Air Force - RAF,Takeoff (climb),Military / Government,Ireland,Europe,12,12,3,0,0,3,9,Technical Failure
1944-08-18 00:00:00,United States Army Air Forces - USAAF,Flight,Military / Government,Chad,Africa,3,3,3,0,0,3,0,Unknown
1944-08-21 00:00:00,Royal Australian Air Force - RAAF,Flight,Military / Government,Papua New Guinea,Oceania,3,3,3,0,0,3,0,Unknown
1944-08-23 00:00:00,United States Army Air Forces - USAAF,Landing (descent or approach),Specialised Services,United Kingdom,Europe,3,3,3,0,0,3,0,Weather
1944-08-29 00:00:00,Royal Air Force - RAF,Takeoff (climb),Military / Government,Canada,North America,3,3,3,0,0,3,0,Unknown
1944-09-07 00:00:00,United States Army Air Forces - USAAF,Takeoff (climb),Operational,United States of America,North America,3,3,3,0,0,3,0,Human Factor
1944-09-17 00:00:00,United States Army Air Forces - USAAF,Flight,Military / Government,Netherlands,Europe,4,4,3,0,0,3,1,Terrorism
1944-09-19 00:00:00,United States Army Air Forces - USAAF,Flight,Operational,United States of America,North America,3,3,3,0,0,3,0,Unknown
1944-09-25 00:00:00,United States Navy - USN,Landing (descent or approach),Operational,United States of America,North America,9,9,3,0,0,3,6,Unknown
1944-10-01 00:00:00,United States Army Air Forces - USAAF,Takeoff (climb),Operational,China,Asia,4,4,3,0,0,3,1,Technical Failure
1944-10-01 00:00:00,United States Navy - USN,Flight,Military / Government,Canada,North America,3,3,3,0,0,3,0,Unknown
1944-10-06 00:00:00,United States Navy - USN,Flight,Military / Government,Palau,Asia,10,10,3,0,0,3,7,Technical Failure
1944-10-07 00:00:00,China National Aviation Corporation - CNAC,Flight,Operational,India,Asia,3,3,3,0,0,3,0,Weather
1944-10-07 00:00:00,United States Army Air Forces - USAAF,Takeoff (climb),Military / Government,China,Asia,3,3,3,0,0,3,0,Unknown
1944-10-08 00:00:00,United States Army Air Forces - USAAF,Flight,Military / Government,Myanmar,Asia,3,3,3,0,0,3,0,Unknown
1944-10-14 00:00:00,German Air Force - Deutsche Luftwaffe,Flight,Military / Government,Norway,Europe,3,3,3,0,0,3,0,Terrorism
1944-10-19 00:00:00,United States Army Air Forces - USAAF,Landing (descent or approach),Military / Government,India,Asia,3,3,3,0,0,3,0,Unknown
1944-10-20 00:00:00,United States Army Air Forces - USAAF,Flight,Military / Government,China,Asia,3,3,3,0,0,3,0,Unknown
1944-10-21 00:00:00,German Air Force - Deutsche Luftwaffe,Flight,Military / Government,Finland,Europe,3,3,3,0,0,3,0,Terrorism
1944-10-29 00:00:00,United States Army Air Forces - USAAF,Landing (descent or approach),Military / Government,United States of America,North America,3,3,3,0,0,3,0,Unknown
1944-11-16 00:00:00,United States Army Air Forces - USAAF,Flight,Specialised Services,Italy,Europe,3,3,3,0,0,3,0,Human Factor
1944-11-22 00:00:00,United States Navy - USN,Landing (descent or approach),Operational,United States of America,North America,8,8,3,0,0,3,5,Technical Failure
1944-11-24 00:00:00,Section Civile de Liaisons Aériennes Métropolitaines - SCLAM,Landing (descent or approach),Operational,France,Europe,3,3,3,0,0,3,0,Unknown
1944-11-26 00:00:00,United States Army Air Forces - USAAF,Flight,Military / Government,United Kingdom,Europe,5,5,3,0,0,3,2,Human Factor
1944-11-30 00:00:00,China National Aviation Corporation - CNAC,Takeoff (climb),Operational,India,Asia,3,3,3,0,0,3,0,Human Factor
1944-12-15 00:00:00,United States Army Air Forces - USAAF,Flight,Commercial,World,World,3,2,2,1,1,3,0,Unknown
1944-12-16 00:00:00,United States Army Air Forces - USAAF,Landing (descent or approach),Operational,United States of America,North America,3,3,3,0,0,3,0,Human Factor
1944-12-17 00:00:00,United States Army Air Forces - USAAF,Takeoff (climb),Military / Government,United States of America,North America,8,2,0,6,3,3,5,Technical Failure
1944-12-22 00:00:00,United States Army Air Forces - USAAF,Landing (descent or approach),Military / Government,United Kingdom,Europe,5,5,3,0,0,3,2,Human Factor
1944-12-27 00:00:00,United States Army Air Forces - USAAF,Flight,Military / Government,Belgium,Europe,5,5,3,0,0,3,2,Terrorism
1944-12-27 00:00:00,United States Army Air Forces - USAAF,Flight,Military / Government,Belgium,Europe,4,4,3,0,0,3,1,Terrorism
1945-01-06 00:00:00,China National Aviation Corporation - CNAC,Flight,Operational,Myanmar,Asia,3,3,3,0,0,3,0,Unknown
1945-01-06 00:00:00,United States Army Air Forces - USAAF,Flight,Operational,India,Asia,3,3,3,0,0,3,0,Unknown
1945-01-07 00:00:00,China National Aviation Corporation - CNAC,Flight,Operational,China,Asia,3,3,3,0,0,3,0,Technical Failure
1945-01-10 00:00:00,Royal Air Force - RAF,Flight,Military / Government,United Kingdom,Europe,3,3,3,0,0,3,0,Technical Failure
1945-01-13 00:00:00,Royal Air Force - RAF,Flight,Operational,United Kingdom,Europe,3,3,3,0,0,3,0,Unknown
1945-01-14 00:00:00,Aeroflot - Russian International Airlines,Flight,Operational,Tajikistan,Asia,3,3,3,0,0,3,0,Technical Failure
1945-01-16 00:00:00,China National Aviation Corporation - CNAC,Flight,Operational,China,Asia,3,3,3,0,0,3,0,Human Factor
1945-01-18 00:00:00,Section Civile de Liaisons Aériennes Métropolitaines - SCLAM,Flight,Commercial,France,Europe,3,3,3,0,0,3,0,Weather
1945-01-19 00:00:00,Royal Air Force - RAF,Flight,Operational,World,World,3,3,3,0,0,3,0,Unknown
1945-01-21 00:00:00,Royal Canadian Air Force - RCAF,Flight,Operational,Canada,North America,3,3,3,0,0,3,0,Human Factor
1945-01-23 00:00:00,German Air Force - Deutsche Luftwaffe,Flight,Military / Government,Germany,Europe,4,4,3,0,0,3,1,Terrorism
1945-01-26 00:00:00,United States Army Air Forces - USAAF,Flight,Operational,United States of America,North America,3,3,3,0,0,3,0,Technical Failure
1945-01-28 00:00:00,United States Navy - USN,Landing (descent or approach),Operational,United States of America,North America,5,5,3,0,0,3,2,Unknown
1945-02-01 00:00:00,Royal Air Force - RAF,Flight,Operational,United Kingdom,Europe,3,3,3,0,0,3,0,Weather
1945-02-01 00:00:00,Royal Air Force - RAF,Flight,Military / Government,United Kingdom,Europe,8,3,1,5,2,3,5,Weather
1945-02-13 00:00:00,United States Army Air Forces - USAAF,Flight,Operational,China,Asia,3,3,3,0,0,3,0,Technical Failure
1945-02-15 00:00:00,United States Army Air Forces - USAAF,Landing (descent or approach),Military / Government,France,Europe,3,3,3,0,0,3,0,Unknown
1945-02-28 00:00:00,United States Army Air Forces - USAAF,Flight,Military / Government,Myanmar,Asia,3,3,3,0,0,3,0,Unknown
1945-03-05 00:00:00,United States Army Air Forces - USAAF,Takeoff (climb),Specialised Services,United States of America,North America,3,3,3,0,0,3,0,Unknown
1945-03-06 00:00:00,Royal Air Force - RAF,Flight,Military / Government,United Kingdom,Europe,3,3,3,0,0,3,0,Human Factor
1945-03-14 00:00:00,United States Army Air Forces - USAAF,Flight,Operational,France,Europe,3,3,3,0,0,3,0,Technical Failure
1945-03-16 00:00:00,United States Army Air Forces - USAAF,Flight,Military / Government,United States of America,North America,3,3,3,0,0,3,0,Unknown
1945-03-18 00:00:00,United States Army Air Forces - USAAF,Flight,Military / Government,United States of America,North America,6,4,1,2,2,3,3,Unknown
1945-03-24 00:00:00,United States Army Air Forces - USAAF,Flight,Military / Government,Germany,Europe,5,5,3,0,0,3,2,Terrorism
1945-03-24 00:00:00,Royal Air Force - RAF,Flight,Military / Government,Germany,Europe,4,4,3,0,0,3,1,Terrorism
1945-03-24 00:00:00,United States Army Air Forces - USAAF,Flight,Military / Government,Germany,Europe,4,4,3,0,0,3,1,Terrorism
1945-03-24 00:00:00,United States Army Air Forces - USAAF,Flight,Military / Government,Germany,Europe,5,5,3,0,0,3,2,Terrorism
1945-04-04 00:00:00,Royal Air Force - RAF,Flight,Operational,United Kingdom,Europe,5,5,3,0,0,3,2,Human Factor
1945-04-05 00:00:00,United States Army Air Forces - USAAF,Flight,Military / Government,Myanmar,Asia,3,3,3,0,0,3,0,Unknown
1945-04-09 00:00:00,United States Army Air Forces - USAAF,Flight,Military / Government,China,Asia,3,3,3,0,0,3,0,Unknown
1945-04-09 00:00:00,China National Aviation Corporation - CNAC,Flight,Operational,China,Asia,3,3,3,0,0,3,0,Weather
1945-04-13 00:00:00,Royal New Zealand Air Force - RNZAF,Takeoff (climb),Military / Government,Tuvalu,Oceania,10,10,3,0,0,3,7,Human Factor
1945-04-14 00:00:00,United States Army Air Forces - USAAF,Flight,Military / Government,Germany,Europe,3,3,3,0,0,3,0,Unknown
1945-04-16 00:00:00,United States Army Air Forces - USAAF,Flight,Military / Government,Belgium,Europe,3,3,3,0,0,3,0,Unknown
1945-04-16 00:00:00,Cruzeiro do Sul,Flight,Operational,Brazil,South America,4,4,3,0,0,3,1,Technical Failure
1945-04-19 00:00:00,United States Army Air Forces - USAAF,Flight,Military / Government,India,Asia,3,3,3,0,0,3,0,Unknown
1945-04-22 00:00:00,United States Army Air Forces - USAAF,Flight,Military / Government,Myanmar,Asia,3,3,3,0,0,3,0,Unknown
1945-04-23 00:00:00,Royal New Zealand Air Force - RNZAF,Landing (descent or approach),Military / Government,Papua New Guinea,Oceania,5,5,3,0,0,3,2,Unknown
1945-04-27 00:00:00,United States Army Air Forces - USAAF,Flight,Military / Government,France,Europe,3,3,3,0,0,3,0,Unknown
1945-04-29 00:00:00,Royal Air Force - RAF,Flight,Operational,United Kingdom,Europe,3,3,3,0,0,3,0,Weather
1945-05-05 00:00:00,United States Army Air Forces - USAAF,Flight,Military / Government,China,Asia,3,3,3,0,0,3,0,Unknown
1945-05-06 00:00:00,United States Army Air Forces - USAAF,Flight,Military / Government,France,Europe,3,3,3,0,0,3,0,Unknown
1945-05-12 00:00:00,United States Army Air Forces - USAAF,Flight,Military / Government,United States of America,North America,3,3,3,0,0,3,0,Unknown
1945-06-15 00:00:00,China National Aviation Corporation - CNAC,Flight,Operational,China,Asia,3,3,3,0,0,3,0,Weather
1945-06-22 00:00:00,United States Army Air Forces - USAAF,Flight,Operational,United States of America,North America,3,3,3,0,0,3,0,Technical Failure
1945-06-24 00:00:00,Faucett,Flight,Commercial,Peru,South America,3,2,2,1,1,3,0,Unknown
1945-06-27 00:00:00,Royal Canadian Air Force - RCAF,Flight,Operational,World,World,3,3,3,0,0,3,0,Unknown
1945-06-30 00:00:00,United States Army Air Forces - USAAF,Flight,Military / Government,Myanmar,Asia,3,3,3,0,0,3,0,Unknown
1945-07-02 00:00:00,Royal Air Force - RAF,Flight,Operational,Papua New Guinea,Oceania,3,3,3,0,0,3,0,Unknown
1945-07-03 00:00:00,Royal Canadian Air Force - RCAF,Taxiing,Operational,Canada,North America,4,4,3,0,0,3,1,Human Factor
1945-07-14 00:00:00,United States Army Air Forces - USAAF,Flight,Military / Government,India,Asia,3,3,3,0,0,3,0,Unknown
1945-07-26 00:00:00,United States Army Air Forces - USAAF,Flight,Military / Government,France,Europe,3,3,3,0,0,3,0,Unknown
1945-07-27 00:00:00,United States Army Air Forces - USAAF,Flight,Military / Government,United Arab Emirates,Asia,3,3,3,0,0,3,0,Unknown
1945-07-28 00:00:00,United States Army Air Forces - USAAF,Flight,Military / Government,United States of America,North America,3,3,3,0,0,3,0,Human Factor
1945-08-24 00:00:00,United States Army Air Forces - USAAF,Landing (descent or approach),Military / Government,United States of America,North America,5,5,3,0,0,3,2,Unknown
1945-08-31 00:00:00,United States Army Air Forces - USAAF,Flight,Operational,India,Asia,3,3,3,0,0,3,0,Unknown
1945-10-15 00:00:00,Royal Air Force - RAF,Flight,Specialised Services,United Kingdom,Europe,3,3,3,0,0,3,0,Human Factor
1945-10-26 00:00:00,United States Army Air Forces - USAAF,Flight,Military / Government,United States of America,North America,12,12,3,0,0,3,9,Unknown
1945-11-27 00:00:00,United States Army Air Forces - USAAF,Flight,Military / Government,Malaysia,Asia,3,3,3,0,0,3,0,Human Factor
1945-11-29 00:00:00,United States Navy - USN,Flight,Military / Government,United States of America,North America,3,3,3,0,0,3,0,Technical Failure
1945-12-14 00:00:00,United States Army Air Forces - USAAF,Takeoff (climb),Military / Government,Greece,Europe,3,3,3,0,0,3,0,Unknown
1946-01-04 00:00:00,Royal Air Force - RAF,Flight,Military / Government,China,Asia,9,4,0,5,3,3,6,Technical Failure
1946-01-04 00:00:00,Royal Air Force - RAF,Flight,Military / Government,China,Asia,9,4,0,5,3,3,6,Technical Failure
1946-01-06 00:00:00,Pennsylvania Central Air Lines,Landing (descent or approach),Commercial,United States of America,North America,11,4,3,7,0,3,8,Human Factor
1946-01-13 00:00:00,Air France,Landing (descent or approach),Operational,France,Europe,3,3,3,0,0,3,0,Human Factor
1946-01-21 00:00:00,Royal Air Force - RAF,Landing (descent or approach),Operational,Egypt,Africa,3,3,3,0,0,3,0,Human Factor
1946-01-31 00:00:00,Aeroflot - Russian International Airlines,Landing (descent or approach),Operational,Russia,Asia,5,5,3,0,0,3,2,Technical Failure
1946-02-14 00:00:00,Royal Australian Air Force - RAAF,Landing (descent or approach),Military / Government,Australia,Oceania,3,3,3,0,0,3,0,Weather
1946-02-27 00:00:00,North American Aviation,Flight,Specialised Services,United States of America,North America,3,2,2,1,1,3,0,Technical Failure
1946-03-16 00:00:00,United States Army Air Forces - USAAF,Flight,Military / Government,Hungary,Europe,4,4,3,0,0,3,1,Unknown
1946-04-24 00:00:00,Western Airlines,Landing (descent or approach),Specialised Services,United States of America,North America,3,3,3,0,0,3,0,Human Factor
1946-05-16 00:00:00,United States Army Air Forces - USAAF,Landing (descent or approach),Military / Government,United States of America,North America,9,9,3,0,0,3,6,Human Factor
1946-07-08 00:00:00,Royal Norwegian Air Force - Kongelige Norske Luftforsvaret,Landing (descent or approach),Military / Government,Norway,Europe,0,0,0,0,3,3,-3,Unknown
1946-07-26 00:00:00,Royal Air Force - RAF,Flight,Operational,United Kingdom,Europe,3,1,1,2,2,3,0,Human Factor
1946-08-07 00:00:00,British European Airways - BEA,Landing (descent or approach),Commercial,Norway,Europe,15,5,3,10,0,3,12,Human Factor
1946-08-23 00:00:00,Royal Air Force - RAF,Flight,Operational,United Kingdom,Europe,3,3,3,0,0,3,0,Human Factor
1946-09-13 00:00:00,Royal Air Force - RAF,Flight,Operational,France,Europe,6,6,3,0,0,3,3,Human Factor
1946-09-25 00:00:00,A. Desbillet,Flight,Commercial,France,Europe,3,1,1,2,2,3,0,Weather
1946-09-27 00:00:00,United States Army Air Forces - USAAF,Takeoff (climb),Operational,United States of America,North America,7,7,3,0,0,3,4,Human Factor
1946-10-11 00:00:00,Royal Air Force - RAF,Landing (descent or approach),Operational,United Kingdom,Europe,4,4,3,0,0,3,1,Unknown
1946-10-20 00:00:00,Royal Air Force - RAF,Takeoff (climb),Military / Government,India,Asia,18,8,2,10,1,3,15,Human Factor
1946-12-15 00:00:00,Anglo-Iranian Oil Company,Landing (descent or approach),Business,Iran,Asia,3,1,1,2,2,3,0,Unknown
1946-12-30 00:00:00,United States Navy - USN,Flight,Military / Government,Antarctica,Antarctica,9,9,3,0,0,3,6,Unknown
1947-02-13 00:00:00,CSA Czech Airlines - Československé Státní Aerolinie,Takeoff (climb),Operational,Czech Republic,Europe,3,3,3,0,0,3,0,Human Factor
1947-02-18 00:00:00,United States Army Air Forces - USAAF,Flight,Military / Government,Japan,Asia,3,3,3,0,0,3,0,Unknown
1947-03-13 00:00:00,British Overseas Airways Corporation - BOAC,Landing (descent or approach),Specialised Services,United Kingdom,Europe,3,2,2,1,1,3,0,Human Factor
1947-03-24 00:00:00,United States Army Air Forces - USAAF,Flight,Operational,United States of America,North America,3,3,3,0,0,3,0,Unknown
1947-03-27 00:00:00,Royal Air Force - RAF,Flight,Operational,United Kingdom,Europe,3,3,3,0,0,3,0,Human Factor
1947-05-29 00:00:00,United States Army Air Forces - USAAF,Takeoff (climb),Military / Government,United States of America,North America,12,12,3,0,0,3,9,Unknown
1947-05-30 00:00:00,Services Français de Télécommunications et de Signalisation,Takeoff (climb),Military / Government,Algeria,Africa,3,3,3,0,0,3,0,Unknown
1947-06-04 00:00:00,Air France,Flight,Operational,France,Europe,3,3,3,0,0,3,0,Human Factor
1947-06-05 00:00:00,Royal Air Force - RAF,Flight,Operational,United Kingdom,Europe,3,3,3,0,0,3,0,Unknown
1947-06-16 00:00:00,Aeroflot - Russian International Airlines,Takeoff (climb),Operational,Tajikistan,Asia,7,4,2,3,1,3,4,Other
1947-08-04 00:00:00,LAN Chile - Linea Aérea Nacional de Chile,Flight,Commercial,Chile,South America,3,2,2,1,1,3,0,Human Factor
1947-08-08 00:00:00,American Airlines,Landing (descent or approach),Operational,United States of America,North America,5,5,3,0,0,3,2,Technical Failure
1947-08-13 00:00:00,TARS - Transporturile Aeriene Româno-Sovietice,Landing (descent or approach),Commercial,Romania,Europe,8,3,0,5,3,3,5,Unknown
1947-08-16 00:00:00,United States Army Air Forces - USAAF,Flight,Military / Government,World,World,13,4,0,9,3,3,10,Technical Failure
1947-08-21 00:00:00,Slick Airways,Flight,Operational,United States of America,North America,3,2,2,1,1,3,0,Human Factor
1947-09-03 00:00:00,Hellenic Airlines,Landing (descent or approach),Operational,Greece,Europe,8,8,3,0,0,3,5,Weather
1947-10-16 00:00:00,Strato Freight,Flight,Operational,United States of America,North America,3,2,2,1,1,3,0,Human Factor
1947-10-17 00:00:00,Central Air Transport - China,Takeoff (climb),Operational,China,Asia,3,3,3,0,0,3,0,Unknown
1948-01-13 00:00:00,Royal Air Force - RAF,Takeoff (climb),Operational,United Kingdom,Europe,4,4,3,0,0,3,1,Technical Failure
1948-01-21 00:00:00,Federal Aviation Administration - FAA,Flight,Specialised Services,United States of America,North America,3,2,2,1,1,3,0,Weather
1948-01-21 00:00:00,Royal Air Force - RAF,Landing (descent or approach),Operational,United Kingdom,Europe,3,3,3,0,0,3,0,Human Factor
1948-01-27 00:00:00,Air Portugal - Transportes Aéreos Portugueses,Flight,Operational,Portugal,Europe,3,3,3,0,0,3,0,Unknown
1948-04-05 00:00:00,Royal Air Force - RAF,Flight,Operational,World,World,3,3,3,0,0,3,0,Unknown
1948-04-09 00:00:00,United States Air Force - USAF,Flight,Operational,United States of America,North America,3,3,3,0,0,3,0,Unknown
1948-04-11 00:00:00,Compagnie Air Transport - CAT,Takeoff (climb),Operational,Spain,Europe,3,3,3,0,0,3,0,Human Factor
1948-04-21 00:00:00,Aeroflot - Russian International Airlines,Flight,Military / Government,Russia,Asia,6,5,3,1,0,3,3,Human Factor
1948-05-20 00:00:00,Air Transport Charter,Landing (descent or approach),Operational,United Kingdom,Europe,4,4,3,0,0,3,1,Human Factor
1948-05-31 00:00:00,Royal Navy,Flight,Military / Government,United Kingdom,Europe,3,3,3,0,0,3,0,Human Factor
1948-06-27 00:00:00,United States Air Force - USAF,Flight,Operational,United States of America,North America,4,4,3,0,0,3,1,Unknown
1948-07-03 00:00:00,Central BC Airways,Landing (descent or approach),Commercial,Canada,North America,3,1,1,2,2,3,0,Unknown
1948-07-08 00:00:00,United States Air Force - USAF,Takeoff (climb),Operational,Germany,Europe,3,3,3,0,0,3,0,Unknown
1948-07-17 00:00:00,Extractors Hull,Flight,Business,Spain,Europe,3,2,2,1,1,3,0,Unknown
1948-07-31 00:00:00,Aeroflot - Russian International Airlines,Landing (descent or approach),Commercial,Russia,Asia,19,4,0,15,3,3,16,Human Factor
1948-08-20 00:00:00,AVENSA - Aerovias Venezolanas,Flight,Operational,World,World,3,3,3,0,0,3,0,Unknown
1948-09-09 00:00:00,Uruguayan Air Force - Fuerza Aérea Uruguaya,Flight,Operational,Brazil,South America,3,3,3,0,0,3,0,Technical Failure
1948-10-18 00:00:00,United States Air Force - USAF,Landing (descent or approach),Operational,Germany,Europe,3,3,3,0,0,3,0,Unknown
1948-10-24 00:00:00,United States Air Force - USAF,Landing (descent or approach),Military / Government,United States of America,North America,22,3,3,19,0,3,19,Weather
1948-11-08 00:00:00,Australian National Airways - ANA,Flight,Commercial,Australia,Oceania,23,4,3,19,0,3,20,Human Factor
1948-11-08 00:00:00,Egyptian Air Force and Air Defence Command,Landing (descent or approach),Military / Government,Egypt,Africa,9,9,3,0,0,3,6,Unknown
1948-11-10 00:00:00,Avianca,Landing (descent or approach),Commercial,Colombia,South America,4,4,3,0,0,3,1,Unknown
1948-11-30 00:00:00,Royal New Zealand Air Force - RNZAF,Flight,Specialised Services,New Zealand,Oceania,3,3,3,0,0,3,0,Technical Failure
1948-12-01 00:00:00,Aéro Cargo,Takeoff (climb),Operational,France,Europe,8,3,0,5,3,3,5,Weather
1948-12-05 00:00:00,United States Air Force - USAF,Takeoff (climb),Operational,Germany,Europe,3,3,3,0,0,3,0,Unknown
1948-12-07 00:00:00,Israeli Air Force - Heyl Ha'avir,Landing (descent or approach),Operational,Israel,Asia,3,2,2,1,1,3,0,Unknown
1948-12-16 00:00:00,Brazilian Air Force - Força Aérea Brasileira,Landing (descent or approach),Operational,Brazil,South America,7,7,3,0,0,3,4,Unknown
1948-12-30 00:00:00,Aeroflot - Russian International Airlines,Takeoff (climb),Operational,Belarus,Europe,4,4,3,0,0,3,1,Human Factor
1949-01-05 00:00:00,British South American Airways - BSAA,Flight,Commercial,Brazil,South America,15,6,0,9,3,3,12,Technical Failure
1949-01-07 00:00:00,United States Air Force - USAF,Landing (descent or approach),Military / Government,United States of America,North America,3,3,3,0,0,3,0,Human Factor
1949-01-09 00:00:00,Aeroflot - Russian International Airlines,Takeoff (climb),Operational,Russia,Asia,4,4,3,0,0,3,1,Weather
1949-01-12 00:00:00,United States Air Force - USAF,Landing (descent or approach),Operational,Germany,Europe,3,3,3,0,0,3,0,Human Factor
1949-01-14 00:00:00,United States Air Force - USAF,Flight,Operational,United States of America,North America,3,3,3,0,0,3,0,Unknown
1949-01-21 00:00:00,United States Air Force - USAF,Takeoff (climb),Military / Government,United States of America,North America,12,12,3,0,0,3,9,Unknown
1949-01-22 00:00:00,Yellowknife Airways,Takeoff (climb),Commercial,Canada,North America,3,1,1,2,2,3,0,Unknown
1949-01-29 00:00:00,Aeroflot - Russian International Airlines,Takeoff (climb),Operational,Russia,Asia,4,4,3,0,0,3,1,Other
1949-03-15 00:00:00,Skyways of London,Landing (descent or approach),Operational,Germany,Europe,3,3,3,0,0,3,0,Unknown
1949-03-21 00:00:00,Lancashire Aircraft Corporation - LAC,Landing (descent or approach),Operational,Germany,Europe,4,4,3,0,0,3,1,Human Factor
1949-03-22 00:00:00,Royal Air Force - RAF,Landing (descent or approach),Operational,Germany,Europe,3,3,3,0,0,3,0,Human Factor
1949-04-26 00:00:00,Myanmar Air Force - Tatmadaw Lei,Landing (descent or approach),Operational,Myanmar,Asia,3,3,3,0,0,3,0,Terrorism
1949-06-02 00:00:00,Central Air Transport - China,Flight,Operational,China,Asia,3,3,3,0,0,3,0,Unknown
1949-07-09 00:00:00,Fairbanks-Morse %26 Company,Flight,Business,United States of America,North America,4,2,2,2,1,3,1,Technical Failure
1949-07-12 00:00:00,United States Air Force - USAF,Flight,Military / Government,Germany,Europe,3,3,3,0,0,3,0,Technical Failure
1949-07-24 00:00:00,United States Navy - USN,Flight,Military / Government,United States of America,North America,7,7,3,0,0,3,4,Technical Failure
1949-08-21 00:00:00,Compagnie Aérienne de Transports Indochinois - CATI,Landing (descent or approach),Commercial,Vietnam,Asia,3,2,2,1,1,3,0,Unknown
1949-09-07 00:00:00,Royal Air Force - RAF,Flight,Military / Government,Malaysia,Asia,3,3,3,0,0,3,0,Human Factor
1949-09-20 00:00:00,Aeroflot - Russian International Airlines,Flight,Operational,Russia,Asia,4,4,3,0,0,3,1,Technical Failure
1949-09-26 00:00:00,Royal Air Force - RAF,Flight,Operational,United Kingdom,Europe,3,3,3,0,0,3,0,Technical Failure
1949-09-30 00:00:00,Transportes Aéreos Bandeirantes,Landing (descent or approach),Commercial,Brazil,South America,25,5,1,20,2,3,22,Other
1949-09-30 00:00:00,United States Air Force - USAF,Flight,Operational,United States of America,North America,3,3,3,0,0,3,0,Technical Failure
1949-10-09 00:00:00,Slick Airways,Landing (descent or approach),Operational,United States of America,North America,3,2,2,1,1,3,0,Weather
1949-10-18 00:00:00,Czech Air Force - Ceské Vojenské Letectvo,Flight,Operational,Slovakia,Europe,3,3,3,0,0,3,0,Unknown
1949-11-04 00:00:00,Harrington's,Landing (descent or approach),Operational,United States of America,North America,3,3,3,0,0,3,0,Human Factor
1949-12-30 00:00:00,Aeroflot - Russian International Airlines,Takeoff (climb),Operational,Russia,Asia,6,5,2,1,1,3,3,Human Factor
1949-12-30 00:00:00,Royal Air Force - RAF,Landing (descent or approach),Operational,United Kingdom,Europe,3,3,3,0,0,3,0,Human Factor
1950-01-30 00:00:00,Royal Norwegian Air Force - Kongelige Norske Luftforsvaret,Takeoff (climb),Specialised Services,Norway,Europe,3,1,1,2,2,3,0,Unknown
1950-02-04 00:00:00,United States Air Force - USAF,Takeoff (climb),Operational,Puerto Rico,Central America,3,3,3,0,0,3,0,Unknown
1950-02-09 00:00:00,United States Air Force - USAF,Flight,Military / Government,United States of America,North America,3,3,3,0,0,3,0,Unknown
1950-02-11 00:00:00,Private American,Landing (descent or approach),Military / Government,United States of America,North America,3,1,1,2,2,3,0,Human Factor
1950-03-28 00:00:00,United States Air Force - USAF,Landing (descent or approach),Operational,Japan,Asia,4,4,3,0,0,3,1,Unknown
1950-04-05 00:00:00,Deccan Airways,Takeoff (climb),Operational,India,Asia,3,3,3,0,0,3,0,Technical Failure
1950-04-28 00:00:00,Italian Air Force - Aeronautica Militare Italiana,Flight,Military / Government,Italy,Europe,3,3,3,0,0,3,0,Unknown
1950-05-06 00:00:00,Turkish Air Force - Türk Hava Kuvvetleri,Flight,Operational,Turkey,Asia,3,3,3,0,0,3,0,Unknown
1950-06-23 00:00:00,Northwest Airlines,Flight,Commercial,United States of America,North America,58,3,3,55,0,3,55,Weather
1950-06-23 00:00:00,United States Air Force - USAF,Flight,Military / Government,World,World,11,11,3,0,0,3,8,Unknown
1950-07-22 00:00:00,Lufttransport,Flight,Commercial,Norway,Europe,3,1,1,2,2,3,0,Unknown
1950-07-28 00:00:00,United States Air Force - USAF,Flight,Operational,United States of America,North America,3,3,3,0,0,3,0,Human Factor
1950-07-28 00:00:00,United States Air Force - USAF,Flight,Military / Government,North Korea,Asia,3,3,3,0,0,3,0,Terrorism
1950-07-28 00:00:00,United States Air Force - USAF,Flight,Operational,United States of America,North America,3,3,3,0,0,3,0,Human Factor
1950-08-26 00:00:00,Servicios Aéreos Nacionales - SAN,Flight,Operational,Mexico,Central America,3,2,2,1,1,3,0,Unknown
1950-09-02 00:00:00,United States Air Force - USAF,Flight,Military / Government,South Korea,Asia,3,3,3,0,0,3,0,Human Factor
1950-09-10 00:00:00,Turkish Air Force - Türk Hava Kuvvetleri,Takeoff (climb),Military / Government,Turkey,Asia,3,3,3,0,0,3,0,Technical Failure
1950-09-11 00:00:00,Private American,Flight,Business,United States of America,North America,3,2,2,1,1,3,0,Human Factor
1950-09-23 00:00:00,Brazilian Air Force - Força Aérea Brasileira,Flight,Operational,Brazil,South America,3,2,2,1,1,3,0,Unknown
1950-09-30 00:00:00,United States Air Force - USAF,Flight,Military / Government,North Korea,Asia,3,3,3,0,0,3,0,Terrorism
1950-10-03 00:00:00,United States Air Force - USAF,Flight,Military / Government,North Korea,Asia,3,3,3,0,0,3,0,Terrorism
1950-10-03 00:00:00,United States Air Force - USAF,Flight,Military / Government,South Korea,Asia,3,3,3,0,0,3,0,Unknown
1950-10-12 00:00:00,United States Air Force - USAF,Landing (descent or approach),Military / Government,Japan,Asia,8,4,3,4,0,3,5,Unknown
1950-10-15 00:00:00,Royal Air Force - RAF,Landing (descent or approach),Operational,United Kingdom,Europe,5,5,3,0,0,3,2,Human Factor
1950-11-09 00:00:00,United States Air Force - USAF,Flight,Operational,North Korea,Asia,3,3,3,0,0,3,0,Unknown
1950-11-21 00:00:00,United States Air Force - USAF,Flight,Military / Government,North Korea,Asia,3,3,3,0,0,3,0,Unknown
1950-11-25 00:00:00,Indamer Airways,Flight,Operational,Bhutan,Asia,3,3,3,0,0,3,0,Human Factor
1950-11-30 00:00:00,United States Air Force - USAF,Flight,Military / Government,South Korea,Asia,3,3,3,0,0,3,0,Unknown
1950-12-02 00:00:00,United States Air Force - USAF,Flight,Military / Government,North Korea,Asia,3,3,3,0,0,3,0,Terrorism
1950-12-09 00:00:00,Civil Air Transport,Flight,Commercial,Japan,Asia,3,3,3,0,0,3,0,Human Factor
1950-12-28 00:00:00,Royal Netherlands Navy - Marineluchtvaartdienst,Takeoff (climb),Military / Government,Indonesia,Asia,7,7,3,0,0,3,4,Unknown
1950-12-29 00:00:00,United States Air Force - USAF,Flight,Military / Government,North Korea,Asia,3,3,3,0,0,3,0,Terrorism
1951-01-03 00:00:00,United States Air Force - USAF,Landing (descent or approach),Military / Government,South Korea,Asia,3,3,3,0,0,3,0,Technical Failure
1951-01-08 00:00:00,United States Air Force - USAF,Flight,Military / Government,North Korea,Asia,3,3,3,0,0,3,0,Unknown
1951-01-26 00:00:00,United States Air Force - USAF,Flight,Military / Government,Japan,Asia,3,3,3,0,0,3,0,Unknown
1951-01-31 00:00:00,United States Air Force - USAF,Takeoff (climb),Military / Government,Japan,Asia,11,11,3,0,0,3,8,Technical Failure
1951-02-08 00:00:00,United States Air Force - USAF,Landing (descent or approach),Military / Government,South Korea,Asia,3,3,3,0,0,3,0,Technical Failure
1951-02-10 00:00:00,United States Air Force - USAF,Flight,Military / Government,United States of America,North America,6,6,3,0,0,3,3,Unknown
1951-02-15 00:00:00,Gamez Calcan y Compania,Flight,Operational,Venezuela,South America,3,2,2,1,1,3,0,Unknown
1951-02-17 00:00:00,United States Air Force - USAF,Flight,Military / Government,South Korea,Asia,3,3,3,0,0,3,0,Terrorism
1951-02-21 00:00:00,United States Air Force - USAF,Flight,Military / Government,North Korea,Asia,3,3,3,0,0,3,0,Other
1951-02-25 00:00:00,United States Air Force - USAF,Flight,Military / Government,North Korea,Asia,3,3,3,0,0,3,0,Terrorism
1951-02-25 00:00:00,United States Air Force - USAF,Landing (descent or approach),Military / Government,Japan,Asia,3,3,3,0,0,3,0,Human Factor
1951-02-26 00:00:00,United States Air Force - USAF,Flight,Military / Government,North Korea,Asia,3,3,3,0,0,3,0,Terrorism
1951-02-26 00:00:00,Royal Air Force - RAF,Landing (descent or approach),Operational,United Kingdom,Europe,3,3,3,0,0,3,0,Human Factor
1951-03-03 00:00:00,United States Air Force - USAF,Landing (descent or approach),Military / Government,Japan,Asia,3,3,3,0,0,3,0,Technical Failure
1951-03-19 00:00:00,Royal Air Force - RAF,Takeoff (climb),Operational,United Kingdom,Europe,8,8,3,0,0,3,5,Human Factor
1951-03-22 00:00:00,Cruzeiro do Sul,Landing (descent or approach),Commercial,Brazil,South America,14,4,0,10,3,3,11,Technical Failure
1951-03-25 00:00:00,United States Air Force - USAF,Flight,Military / Government,North Korea,Asia,3,3,3,0,0,3,0,Unknown
1951-03-29 00:00:00,Aeroflot - Russian International Airlines,Landing (descent or approach),Specialised Services,Russia,Asia,8,8,3,0,0,3,5,Human Factor
1951-04-05 00:00:00,United States Air Force - USAF,Flight,Military / Government,North Korea,Asia,3,3,3,0,0,3,0,Terrorism
1951-04-12 00:00:00,Loftleidir Icelandic Airlines,Flight,Operational,United Kingdom,Europe,3,2,2,1,1,3,0,Human Factor
1951-04-21 00:00:00,Colombian Air Force - Fuerza Aérea Colombiana,Takeoff (climb),Military / Government,Colombia,South America,3,3,3,0,0,3,0,Unknown
1951-04-21 00:00:00,United States Air Force - USAF,Flight,Military / Government,North Korea,Asia,3,3,3,0,0,3,0,Terrorism
1951-04-26 00:00:00,Brazilian Air Force - Força Aérea Brasileira,Flight,Operational,Brazil,South America,3,3,3,0,0,3,0,Technical Failure
1951-05-03 00:00:00,Royal Air Force - RAF,Flight,Operational,United Kingdom,Europe,3,3,3,0,0,3,0,Human Factor
1951-05-05 00:00:00,United States Air Force - USAF,Flight,Military / Government,North Korea,Asia,4,4,3,0,0,3,1,Human Factor
1951-05-12 00:00:00,Air Fret Transimex,Flight,Operational,Algeria,Africa,3,3,3,0,0,3,0,Unknown
1951-06-07 00:00:00,United States Air Force - USAF,Flight,Military / Government,North Korea,Asia,3,3,3,0,0,3,0,Unknown
1951-06-09 00:00:00,Private British,Flight,Operational,United Kingdom,Europe,3,2,2,1,1,3,0,Technical Failure
1951-06-13 00:00:00,United States Air Force - USAF,Flight,Military / Government,North Korea,Asia,3,3,3,0,0,3,0,Unknown
1951-06-14 00:00:00,United States Navy - USN,Landing (descent or approach),Operational,Philippines,Asia,8,8,3,0,0,3,5,Human Factor
1951-06-28 00:00:00,Faucett,Flight,Operational,Peru,South America,3,2,2,1,1,3,0,Unknown
1951-06-29 00:00:00,United States Air Force - USAF,Flight,Military / Government,South Korea,Asia,3,3,3,0,0,3,0,Unknown
1951-06-29 00:00:00,Royal Air Force - RAF,Landing (descent or approach),Operational,United Kingdom,Europe,3,3,3,0,0,3,0,Human Factor
1951-07-01 00:00:00,United States Air Force - USAF,Flight,Military / Government,South Korea,Asia,3,3,3,0,0,3,0,Unknown
1951-07-03 00:00:00,United States Air Force - USAF,Flight,Military / Government,South Korea,Asia,3,3,3,0,0,3,0,Unknown
1951-07-12 00:00:00,Indamer Airways,Flight,Operational,India,Asia,3,3,3,0,0,3,0,Human Factor
1951-07-19 00:00:00,United States Air Force - USAF,Flight,Military / Government,North Korea,Asia,3,3,3,0,0,3,0,Unknown
1951-07-22 00:00:00,Czech Air Force - Ceské Vojenské Letectvo,Flight,Military / Government,Czech Republic,Europe,3,3,3,0,0,3,0,Technical Failure
1951-07-24 00:00:00,SABENA - Société Anonyme Belge d'Exploitation de la Navigation Aérienne,Takeoff (climb),Operational,Mali,Africa,3,3,3,0,0,3,0,Technical Failure
1951-07-28 00:00:00,Brazilian Air Force - Força Aérea Brasileira,Flight,Military / Government,Brazil,South America,3,3,3,0,0,3,0,Unknown
1951-07-29 00:00:00,United States Air Force - USAF,Landing (descent or approach),Military / Government,South Korea,Asia,3,3,3,0,0,3,0,Technical Failure
1951-07-31 00:00:00,United States Air Force - USAF,Landing (descent or approach),Operational,United States of America,North America,3,3,3,0,0,3,0,Unknown
1951-08-12 00:00:00,Aeronorte,Takeoff (climb),Commercial,Brazil,South America,4,3,2,1,1,3,1,Unknown
1951-08-30 00:00:00,United States Air Force - USAF,Flight,Military / Government,North Korea,Asia,3,3,3,0,0,3,0,Terrorism
1951-09-02 00:00:00,United States Air Force - USAF,Flight,Military / Government,North Korea,Asia,3,3,3,0,0,3,0,Terrorism
1951-09-12 00:00:00,United Airlines,Landing (descent or approach),Operational,United States of America,North America,3,3,3,0,0,3,0,Human Factor
1951-09-14 00:00:00,United States Air Force - USAF,Flight,Military / Government,North Korea,Asia,4,4,3,0,0,3,1,Terrorism
1951-09-17 00:00:00,United States Air Force - USAF,Flight,Military / Government,South Korea,Asia,5,5,3,0,0,3,2,Unknown
1951-10-06 00:00:00,United States Air Force - USAF,Takeoff (climb),Operational,United States of America,North America,3,3,3,0,0,3,0,Unknown
1951-10-07 00:00:00,National Homes Corp.,Landing (descent or approach),Business,United States of America,North America,7,1,1,6,2,3,4,Human Factor
1951-10-17 00:00:00,Italian Air Force - Aeronautica Militare Italiana,Flight,Military / Government,Italy,Europe,4,3,3,1,0,3,1,Weather
1951-10-20 00:00:00,Royal Danish Air Force - Flyvevåbnet,Landing (descent or approach),Military / Government,Denmark,Europe,4,4,3,0,0,3,1,Human Factor
1951-10-29 00:00:00,Brazilian Air Force - Força Aérea Brasileira,Landing (descent or approach),Operational,Brazil,South America,3,3,3,0,0,3,0,Unknown
1951-11-17 00:00:00,Overseas National Airways - ONA,Landing (descent or approach),Operational,United States of America,North America,3,3,3,0,0,3,0,Human Factor
1951-11-22 00:00:00,United States Air Force - USAF,Flight,Military / Government,North Korea,Asia,3,3,3,0,0,3,0,Terrorism
1951-12-03 00:00:00,United States Air Force - USAF,Flight,Military / Government,United States of America,North America,3,2,2,1,1,3,0,Unknown
1951-12-04 00:00:00,United Airlines,Flight,Operational,United States of America,North America,3,3,3,0,0,3,0,Human Factor
1951-12-11 00:00:00,Royal New Zealand Air Force - RNZAF,Flight,Operational,New Zealand,Oceania,3,3,3,0,0,3,0,Human Factor
1951-12-13 00:00:00,Qantas Airways - Queensland and Northern Territory Aerial Services,Flight,Specialised Services,Papua New Guinea,Oceania,3,1,1,2,2,3,0,Human Factor
1951-12-18 00:00:00,United States Air Force - USAF,Flight,Military / Government,North Korea,Asia,3,3,3,0,0,3,0,Unknown
1951-12-31 00:00:00,Kalinga Airlines,Takeoff (climb),Operational,India,Asia,3,3,3,0,0,3,0,Human Factor
1952-01-06 00:00:00,United States Air Force - USAF,Flight,Military / Government,North Korea,Asia,3,3,3,0,0,3,0,Unknown
1952-01-09 00:00:00,Aeroflot - Russian International Airlines,Landing (descent or approach),Operational,Russia,Asia,4,4,3,0,0,3,1,Human Factor
1952-01-16 00:00:00,United States Air Force - USAF,Flight,Military / Government,South Korea,Asia,5,5,3,0,0,3,2,Technical Failure
1952-01-19 00:00:00,United States Air Force - USAF,Flight,Military / Government,United States of America,North America,8,8,3,0,0,3,5,Human Factor
1952-02-04 00:00:00,Royal Canadian Air Force - RCAF,Flight,Operational,Canada,North America,3,3,3,0,0,3,0,Human Factor
1952-02-19 00:00:00,Deccan Airways,Landing (descent or approach),Commercial,India,Asia,17,3,2,14,1,3,14,Human Factor
1952-02-21 00:00:00,United States Air Force - USAF,Flight,Military / Government,North Korea,Asia,3,3,3,0,0,3,0,Unknown
1952-02-29 00:00:00,Spanish Air Force - Ejército del Aire,Flight,Operational,Spain,Europe,8,8,3,0,0,3,5,Unknown
1952-03-10 00:00:00,Philippine Airlines - PAL,Takeoff (climb),Operational,Philippines,Asia,3,3,3,0,0,3,0,Unknown
1952-03-11 00:00:00,Royal Air Force - RAF,Landing (descent or approach),Operational,United Kingdom,Europe,4,4,3,0,0,3,1,Technical Failure
1952-03-13 00:00:00,French Navy,Flight,Military / Government,Algeria,Africa,3,3,3,0,0,3,0,Unknown
1952-03-31 00:00:00,United States Air Force - USAF,Flight,Military / Government,North Korea,Asia,3,3,3,0,0,3,0,Unknown
1952-04-04 00:00:00,United States Air Force - USAF,Flight,Military / Government,North Korea,Asia,3,3,3,0,0,3,0,Unknown
1952-05-15 00:00:00,United States Air Force - USAF,Flight,Specialised Services,North Korea,Asia,3,3,3,0,0,3,0,Unknown
1952-05-18 00:00:00,Maritime Central Airways,Landing (descent or approach),Operational,Canada,North America,3,3,3,0,0,3,0,Human Factor
1952-05-31 00:00:00,United States Air Force - USAF,Flight,Military / Government,North Korea,Asia,3,3,3,0,0,3,0,Terrorism
1952-06-01 00:00:00,French Air Force - Armée de l'Air,Flight,Military / Government,Vietnam,Asia,4,4,3,0,0,3,1,Unknown
1952-06-05 00:00:00,United States Air Force - USAF,Flight,Military / Government,North Korea,Asia,3,3,3,0,0,3,0,Unknown
1952-06-11 00:00:00,Club d'Aviation de Neuchâtel,Landing (descent or approach),Business,Switzerland,Europe,3,1,1,2,2,3,0,Human Factor
1952-07-08 00:00:00,United States Air Force - USAF,Flight,Military / Government,North Korea,Asia,3,3,3,0,0,3,0,Unknown
1952-07-11 00:00:00,United States Navy - USN,Landing (descent or approach),Operational,United States of America,North America,3,3,3,0,0,3,0,Human Factor
1952-08-06 00:00:00,United States Air Force - USAF,Takeoff (climb),Military / Government,Japan,Asia,12,12,3,0,0,3,9,Technical Failure
1952-08-08 00:00:00,United States Air Force - USAF,Flight,Military / Government,North Korea,Asia,3,3,3,0,0,3,0,Terrorism
1952-08-11 00:00:00,Royal Air Force - RAF,Flight,Military / Government,United Kingdom,Europe,3,3,3,0,0,3,0,Human Factor
1952-08-19 00:00:00,Royal Air Force - RAF,Takeoff (climb),Operational,United Kingdom,Europe,3,3,3,0,0,3,0,Technical Failure
1952-08-22 00:00:00,Hungarian Air Force - Magyar Honvédség Repülö Csapatai MHRC,Landing (descent or approach),Operational,Hungary,Europe,3,3,3,0,0,3,0,Human Factor
1952-09-11 00:00:00,Brazilian Air Force - Força Aérea Brasileira,Flight,Operational,Brazil,South America,3,3,3,0,0,3,0,Technical Failure
1952-09-11 00:00:00,Indamer Airways,Flight,Operational,Sudan,Africa,3,3,3,0,0,3,0,Human Factor
1952-09-20 00:00:00,Czech Air Force - Ceské Vojenské Letectvo,Flight,Military / Government,Czech Republic,Europe,3,3,3,0,0,3,0,Unknown
1952-09-20 00:00:00,United States Air Force - USAF,Landing (descent or approach),Military / Government,France,Europe,4,4,3,0,0,3,1,Human Factor
1952-10-02 00:00:00,Maszovlet,Landing (descent or approach),Operational,Hungary,Europe,3,3,3,0,0,3,0,Unknown
1952-10-07 00:00:00,United States Air Force - USAF,Landing (descent or approach),Military / Government,United States of America,North America,6,3,3,3,0,3,3,Unknown
1952-10-21 00:00:00,United States Air Force - USAF,Landing (descent or approach),Military / Government,South Korea,Asia,3,3,3,0,0,3,0,Unknown
1952-10-27 00:00:00,United States Air Force - USAF,Landing (descent or approach),Military / Government,United States of America,North America,6,2,2,4,1,3,3,Technical Failure
1952-11-07 00:00:00,United States Air Force - USAF,Flight,Military / Government,Italy,Europe,3,3,3,0,0,3,0,Technical Failure
1952-11-11 00:00:00,United States Coast Guard - USCG,Takeoff (climb),Operational,Guam Island,Asia,5,5,3,0,0,3,2,Technical Failure
1952-11-14 00:00:00,United States Air Force - USAF,Flight,Military / Government,North Korea,Asia,4,4,3,0,0,3,1,Terrorism
1952-11-17 00:00:00,Royal Air Force - RAF,Takeoff (climb),Operational,United Kingdom,Europe,3,2,2,1,1,3,0,Technical Failure
1952-11-21 00:00:00,Royal Air Force - RAF,Takeoff (climb),Military / Government,United Kingdom,Europe,3,3,3,0,0,3,0,Technical Failure
1952-12-04 00:00:00,United States Air Force - USAF,Flight,Military / Government,North Korea,Asia,3,3,3,0,0,3,0,Terrorism
1952-12-04 00:00:00,Aeroflot - Russian International Airlines,Flight,Commercial,Russia,Asia,19,5,0,14,3,3,16,Technical Failure
1952-12-21 00:00:00,Ransa - Rutas Aéreas Nacionales,Flight,Operational,World,World,3,3,3,0,0,3,0,Unknown
1952-12-30 00:00:00,Royal Air Force - RAF,Takeoff (climb),Military / Government,Malta,Europe,4,4,3,0,0,3,1,Technical Failure
1953-01-13 00:00:00,United States Air Force - USAF,Flight,Military / Government,North Korea,Asia,3,3,3,0,0,3,0,Unknown
1953-01-13 00:00:00,United States Air Force - USAF,Flight,Military / Government,North Korea,Asia,14,14,3,0,0,3,11,Terrorism
1953-01-15 00:00:00,Czech Air Force - Ceské Vojenské Letectvo,Flight,Military / Government,Czech Republic,Europe,6,6,3,0,0,3,3,Unknown
1953-01-27 00:00:00,United States Air Force - USAF,Flight,Military / Government,North Korea,Asia,14,14,3,0,0,3,11,Terrorism
1953-02-04 00:00:00,United States Air Force - USAF,Flight,Military / Government,North Korea,Asia,3,3,3,0,0,3,0,Unknown
1953-02-07 00:00:00,Union Aéromaritime de Transport - UAT,Landing (descent or approach),Commercial,France,Europe,19,6,0,13,3,3,16,Human Factor
1953-02-23 00:00:00,United States Air Force - USAF,Flight,Military / Government,North Korea,Asia,3,3,3,0,0,3,0,Unknown
1953-02-28 00:00:00,United States Air Force - USAF,Landing (descent or approach),Military / Government,United States of America,North America,3,2,2,1,1,3,0,Unknown
1953-04-14 00:00:00,Airways India,Flight,Operational,India,Asia,3,3,3,0,0,3,0,Technical Failure
1953-04-25 00:00:00,United States Air Force - USAF,Flight,Military / Government,North Korea,Asia,3,3,3,0,0,3,0,Terrorism
1953-05-11 00:00:00,Tupolev Industries - GKAP Tupolev OKB,Flight,Specialised Services,Russia,Asia,12,12,3,0,0,3,9,Technical Failure
1953-07-01 00:00:00,United States Air Force - USAF,Flight,Military / Government,North Korea,Asia,3,3,3,0,0,3,0,Unknown
1953-07-07 00:00:00,United States Coast Guard - USCG,Landing (descent or approach),Humanitarian,United States of America,North America,6,6,3,0,0,3,3,Other
1953-08-20 00:00:00,Companhia Itaú de Transportes Aéreos,Landing (descent or approach),Operational,Brazil,South America,4,4,3,0,0,3,1,Unknown
1953-08-28 00:00:00,Orillia Air Service,Landing (descent or approach),Commercial,Canada,North America,3,1,1,2,2,3,0,Unknown
1953-09-08 00:00:00,TACA International Airlines - Transportes Aéreos Centro Americanos,Landing (descent or approach),Operational,Honduras,Central America,3,3,3,0,0,3,0,Technical Failure
1953-09-26 00:00:00,Aeroflot - Russian International Airlines,Takeoff (climb),Commercial,Russia,Asia,9,2,2,7,1,3,6,Human Factor
1953-10-15 00:00:00,Royal New Zealand Air Force - RNZAF,Flight,Operational,New Zealand,Oceania,3,3,3,0,0,3,0,Human Factor
1953-10-20 00:00:00,Argentinian Air Force - Fuerza Aérea Argentina,Flight,Specialised Services,Argentina,South America,5,5,3,0,0,3,2,Unknown
1953-11-25 00:00:00,Royal Australian Air Force - RAAF,Flight,Operational,Australia,Oceania,3,3,3,0,0,3,0,Technical Failure
1954-01-10 00:00:00,United States Air Force - USAF,Flight,Military / Government,United States of America,North America,3,3,3,0,0,3,0,Weather
1954-01-11 00:00:00,Spanish Air Force - Ejército del Aire,Landing (descent or approach),Military / Government,Spain,Europe,3,3,3,0,0,3,0,Unknown
1954-01-16 00:00:00,United States Air Force - USAF,Landing (descent or approach),Military / Government,United States of America,North America,3,3,3,0,0,3,0,Unknown
1954-01-20 00:00:00,Zantop Air Transport,Landing (descent or approach),Operational,United States of America,North America,3,3,3,0,0,3,0,Weather
1954-02-21 00:00:00,Royal Air Force - RAF,Landing (descent or approach),Military / Government,Singapore,Asia,12,4,2,8,1,3,9,Technical Failure
1954-02-25 00:00:00,Indian Airlines,Landing (descent or approach),Specialised Services,India,Asia,3,3,3,0,0,3,0,Unknown
1954-03-18 00:00:00,Czech Air Force - Ceské Vojenské Letectvo,Flight,Operational,Czech Republic,Europe,4,4,3,0,0,3,1,Technical Failure
1954-04-02 00:00:00,Royal Air Force - RAF,Flight,Military / Government,Saudi Arabia,Asia,3,3,3,0,0,3,0,Weather
1954-05-21 00:00:00,Compagnie Autrex-Lopez-Loreta-Le Breton,Landing (descent or approach),Operational,Vietnam,Asia,3,3,3,0,0,3,0,Unknown
1954-05-22 00:00:00,New Zealand National Airways,Landing (descent or approach),Commercial,New Zealand,Oceania,28,3,0,25,3,3,25,Technical Failure
1954-05-24 00:00:00,Brazilian Air Force - Força Aérea Brasileira,Takeoff (climb),Operational,Brazil,South America,3,3,3,0,0,3,0,Technical Failure
1954-06-04 00:00:00,VARIG - Viação Aérea Rio Grandense,Takeoff (climb),Operational,Brazil,South America,3,3,3,0,0,3,0,Human Factor
1954-06-19 00:00:00,Swissair,Flight,Commercial,United Kingdom,Europe,9,4,0,5,3,3,6,Technical Failure
1954-06-26 00:00:00,Skyways of London,Flight,Operational,Germany,Europe,3,3,3,0,0,3,0,Technical Failure
1954-08-12 00:00:00,Compagnie Autrex-Lopez-Loreta-Le Breton,Flight,Operational,Vietnam,Asia,3,3,3,0,0,3,0,Unknown
1954-09-14 00:00:00,John Fairfax %26 Sons,Flight,Operational,Australia,Oceania,3,2,2,1,1,3,0,Unknown
1954-09-15 00:00:00,Misrair,Landing (descent or approach),Specialised Services,Egypt,Africa,4,4,3,0,0,3,1,Human Factor
1954-10-15 00:00:00,United States Air Force - USAF,Flight,Military / Government,United States of America,North America,3,3,3,0,0,3,0,Unknown
1954-10-31 00:00:00,Trans Australia Airlines - TAA,Takeoff (climb),Operational,Australia,Oceania,8,8,3,0,0,3,5,Human Factor
1955-01-09 00:00:00,United States Navy - USN,Flight,Military / Government,United States of America,North America,3,2,2,1,1,3,0,Unknown
1955-01-18 00:00:00,United States Air Force - USAF,Flight,Military / Government,Colombia,South America,6,6,3,0,0,3,3,Unknown
1955-01-20 00:00:00,United States Air Force - USAF,Flight,Military / Government,United States of America,North America,3,3,3,0,0,3,0,Unknown
1955-01-21 00:00:00,Indian Airlines,Landing (descent or approach),Operational,India,Asia,3,3,3,0,0,3,0,Human Factor
1955-01-23 00:00:00,Aeroflot - Russian International Airlines,Flight,Operational,Ukraine,Europe,13,8,2,5,1,3,10,Human Factor
1955-03-01 00:00:00,United States Air Force - USAF,Takeoff (climb),Military / Government,Japan,Asia,7,7,3,0,0,3,4,Technical Failure
1955-03-11 00:00:00,Royal Air Force - RAF,Flight,Specialised Services,United Kingdom,Europe,3,3,3,0,0,3,0,Technical Failure
1955-04-03 00:00:00,Companhia Itaú de Transportes Aéreos,Landing (descent or approach),Operational,Brazil,South America,3,3,3,0,0,3,0,Human Factor
1955-04-04 00:00:00,United Airlines,Takeoff (climb),Operational,United States of America,North America,3,3,3,0,0,3,0,Human Factor
1955-04-26 00:00:00,Ransa - Rutas Aéreas Nacionales,Flight,Operational,Venezuela,South America,3,3,3,0,0,3,0,Unknown
1955-05-29 00:00:00,The Ellenbrook Club,Landing (descent or approach),Business,United Kingdom,Europe,3,1,1,2,2,3,0,Unknown
1955-06-03 00:00:00,Union Aéromaritime de Transport - UAT,Landing (descent or approach),Operational,Chad,Africa,3,3,3,0,0,3,0,Unknown
1955-06-16 00:00:00,Transportes Aéreos Peruanas - TAPSA,Takeoff (climb),Operational,Peru,South America,3,3,3,0,0,3,0,Other
1955-06-24 00:00:00,Colombian Air Force - Fuerza Aérea Colombiana,Flight,Military / Government,Colombia,South America,3,1,1,2,2,3,0,Weather
1955-07-13 00:00:00,Lineas Interamericana Aérea,Flight,Operational,Venezuela,South America,4,3,3,1,0,3,1,Unknown
1955-08-05 00:00:00,Spanish Air Force - Ejército del Aire,Flight,Operational,Spain,Europe,7,7,3,0,0,3,4,Unknown
1955-09-05 00:00:00,Lloyd Aéreo Boliviano - LAB Airlines,Takeoff (climb),Operational,Bolivia,South America,3,3,3,0,0,3,0,Human Factor
1955-09-06 00:00:00,United States Air Force - USAF,Takeoff (climb),Military / Government,United States of America,North America,6,6,3,0,0,3,3,Technical Failure
1955-09-08 00:00:00,Currey Air Transport,Landing (descent or approach),Commercial,United States of America,North America,33,3,2,30,1,3,30,Technical Failure
1955-09-23 00:00:00,Flying Tiger Line,Flight,Operational,World,World,5,5,3,0,0,3,2,Human Factor
1955-09-23 00:00:00,French Air Force - Armée de l'Air,Flight,Operational,France,Europe,3,3,3,0,0,3,0,Human Factor
1955-11-02 00:00:00,United States Air Force - USAF,Flight,Operational,United States of America,North America,3,3,3,0,0,3,0,Unknown
1955-11-24 00:00:00,Royal Canadian Air Force - RCAF,Landing (descent or approach),Military / Government,Canada,North America,19,5,3,14,0,3,16,Human Factor
1955-12-22 00:00:00,Manx Airways,Landing (descent or approach),Operational,Germany,Europe,3,3,3,0,0,3,0,Human Factor
1956-01-25 00:00:00,French Air Force - Armée de l'Air,Flight,Military / Government,Algeria,Africa,3,3,3,0,0,3,0,Unknown
1956-01-25 00:00:00,French Air Force - Armée de l'Air,Flight,Military / Government,Algeria,Africa,3,3,3,0,0,3,0,Unknown
1956-01-26 00:00:00,Swiftlite Aircraft Corporation,Flight,Operational,United States of America,North America,3,3,3,0,0,3,0,Human Factor
1956-01-28 00:00:00,Air France,Landing (descent or approach),Operational,France,Europe,3,3,3,0,0,3,0,Human Factor
1956-02-13 00:00:00,Maritime Central Airways,Takeoff (climb),Operational,Canada,North America,3,3,3,0,0,3,0,Other
1956-02-24 00:00:00,United States Air Force - USAF,Flight,Military / Government,Spain,Europe,6,6,3,0,0,3,3,Unknown
1956-02-25 00:00:00,Pakistan International Airlines - PIA,Flight,Operational,Pakistan,Asia,3,3,3,0,0,3,0,Human Factor
1956-03-31 00:00:00,National Air Operators,Flight,Operational,India,Asia,3,3,3,0,0,3,0,Weather
1956-04-07 00:00:00,United States Air Force - USAF,Takeoff (climb),Specialised Services,United States of America,North America,7,7,3,0,0,3,4,Human Factor
1956-04-10 00:00:00,Royal Canadian Air Force - RCAF,Takeoff (climb),Specialised Services,Canada,North America,3,2,2,1,1,3,0,Technical Failure
1956-04-18 00:00:00,Panair do Brasil,Landing (descent or approach),Commercial,Brazil,South America,12,5,2,7,1,3,9,Other
1956-04-26 00:00:00,Aeroflot - Russian International Airlines,Landing (descent or approach),Commercial,Germany,Europe,6,6,3,0,0,3,3,Unknown
1956-05-04 00:00:00,Argentinian Air Force - Fuerza Aérea Argentina,Takeoff (climb),Military / Government,Argentina,South America,9,4,3,5,0,3,6,Technical Failure
1956-06-15 00:00:00,Mexican Air Force - Fuerza Aérea Mexicana,Flight,Military / Government,Mexico,Central America,3,3,3,0,0,3,0,Unknown
1956-08-20 00:00:00,Aeroflot - Russian International Airlines,Flight,Specialised Services,Russia,Asia,4,4,3,0,0,3,1,Human Factor
1956-08-21 00:00:00,United States Air Force - USAF,Takeoff (climb),Operational,United States of America,North America,6,6,3,0,0,3,3,Technical Failure
1956-10-01 00:00:00,Airwork East Africa,Landing (descent or approach),Commercial,Kenya,Africa,3,1,1,2,2,3,0,Technical Failure
1956-10-03 00:00:00,United States Air Force - USAF,Landing (descent or approach),Military / Government,United States of America,North America,10,9,2,1,1,3,7,Human Factor
1956-10-19 00:00:00,Indian Airlines,Landing (descent or approach),Operational,India,Asia,3,3,3,0,0,3,0,Human Factor
1956-12-20 00:00:00,Columbia-Geneva Steel Company,Flight,Business,United States of America,North America,3,2,2,1,1,3,0,Unknown
1956-12-22 00:00:00,JAT Yugoslav Airlines - Jugoslovenski Aerotransport,Landing (descent or approach),Commercial,Germany,Europe,30,3,2,27,1,3,27,Unknown
1956-12-27 00:00:00,Youngstown Sheet %26 Tube Company,Flight,Operational,United States of America,North America,3,3,3,0,0,3,0,Unknown
1957-02-08 00:00:00,Indian Air Force - Bharatiya Vayu Sena,Flight,Military / Government,India,Asia,3,3,3,0,0,3,0,Unknown
1957-02-26 00:00:00,United States Air Force - USAF,Flight,Military / Government,Japan,Asia,3,3,3,0,0,3,0,Unknown
1957-03-13 00:00:00,Aéroclub de Suisse,Landing (descent or approach),Business,Switzerland,Europe,3,1,1,2,2,3,0,Unknown
1957-03-29 00:00:00,Boeing Airplane Company,Flight,Specialised Services,United States of America,North America,4,4,3,0,0,3,1,Technical Failure
1957-04-12 00:00:00,Linea Aeropostal Venezolana - LAV,Takeoff (climb),Operational,Venezuela,South America,3,3,3,0,0,3,0,Unknown
1957-04-15 00:00:00,Transportes Aéreos Mexicanos - TAMSA,Takeoff (climb),Operational,Mexico,Central America,3,3,3,0,0,3,0,Other
1957-04-29 00:00:00,Meridian Air Maps,Takeoff (climb),Specialised Services,United Kingdom,Europe,3,2,2,1,1,3,0,Unknown
1957-05-14 00:00:00,Turkish Air Force - Türk Hava Kuvvetleri,Flight,Military / Government,Turkey,Asia,3,3,3,0,0,3,0,Unknown
1957-06-22 00:00:00,Capital Airlines,Landing (descent or approach),Operational,United States of America,North America,3,3,3,0,0,3,0,Human Factor
1957-07-09 00:00:00,Soviet Navy - Voyenno-morskoy flot CCCP,Flight,Operational,Russia,Asia,3,3,3,0,0,3,0,Unknown
1957-08-22 00:00:00,Royal Air Force - RAF,Flight,Military / Government,Malaysia,Asia,7,7,3,0,0,3,4,Technical Failure
1957-08-24 00:00:00,Helmut Horten,Landing (descent or approach),Operational,Austria,Europe,3,3,3,0,0,3,0,Technical Failure
1957-08-27 00:00:00,Royal Air Force - RAF,Landing (descent or approach),Military / Government,United Kingdom,Europe,4,4,3,0,0,3,1,Technical Failure
1957-09-01 00:00:00,Indian Air Force - Bharatiya Vayu Sena,Flight,Military / Government,India,Asia,3,3,3,0,0,3,0,Unknown
1957-09-28 00:00:00,British European Airways - BEA,Landing (descent or approach),Humanitarian,United Kingdom,Europe,3,2,2,1,1,3,0,Human Factor
1957-10-18 00:00:00,VARIG - Viação Aérea Rio Grandense,Takeoff (climb),Operational,Brazil,South America,3,3,3,0,0,3,0,Human Factor
1957-10-28 00:00:00,Transportes Aéreos Mexicanos - TAMSA,Takeoff (climb),Specialised Services,Mexico,Central America,3,3,3,0,0,3,0,Unknown
1957-11-16 00:00:00,NNGLM - Nederlands Nieuw Guinea Luchtvaart Maatschappij de Kroonduif,Flight,Military / Government,Indonesia,Asia,4,1,1,3,2,3,1,Unknown
1957-11-28 00:00:00,United States Air Force - USAF,Landing (descent or approach),Military / Government,Turkey,Asia,8,8,3,0,0,3,5,Human Factor
1957-12-10 00:00:00,Northern Wings,Landing (descent or approach),Commercial,Canada,North America,10,3,2,7,1,3,7,Unknown
1957-12-20 00:00:00,Ontario Central Airlines,Flight,Commercial,Canada,North America,4,1,0,3,3,3,1,Human Factor
1958-01-16 00:00:00,Cruzeiro do Sul,Takeoff (climb),Operational,Brazil,South America,3,3,3,0,0,3,0,Technical Failure
1958-01-23 00:00:00,Royal Air Force - RAF,Landing (descent or approach),Military / Government,United Kingdom,Europe,5,5,3,0,0,3,2,Unknown
1958-02-19 00:00:00,Gulf Aviation - Oman,Flight,Operational,Italy,Europe,3,3,3,0,0,3,0,Human Factor
1958-03-27 00:00:00,United States Air Force - USAF,Flight,Military / Government,United States of America,North America,3,3,3,0,0,3,0,Human Factor
1958-04-01 00:00:00,Skyways of London,Flight,Specialised Services,United Kingdom,Europe,3,3,3,0,0,3,0,Technical Failure
1958-04-02 00:00:00,Transportes Aéreos Orientales - TAO,Takeoff (climb),Commercial,Ecuador,South America,14,2,0,12,3,3,11,Technical Failure
1958-04-04 00:00:00,Government of Sri Lanka,Landing (descent or approach),Operational,Italy,Europe,3,1,1,2,2,3,0,Unknown
1958-04-13 00:00:00,United States Air Force - USAF,Landing (descent or approach),Operational,United States of America,North America,3,3,3,0,0,3,0,Unknown
1958-04-29 00:00:00,Colombian Air Force - Fuerza Aérea Colombiana,Landing (descent or approach),Military / Government,Colombia,South America,3,3,3,0,0,3,0,Unknown
1958-05-02 00:00:00,Polyarnaya Aviatsiya,Flight,Military / Government,Russia,Asia,3,3,3,0,0,3,0,Unknown
1958-05-16 00:00:00,British European Airways - BEA,Flight,Operational,France,Europe,3,3,3,0,0,3,0,Technical Failure
1958-06-08 00:00:00,Adastra Airways - Adastra Aerial Surveys,Landing (descent or approach),Specialised Services,Papua New Guinea,Oceania,3,2,2,1,1,3,0,Technical Failure
1958-06-13 00:00:00,Brazilian Air Force - Força Aérea Brasileira,Flight,Operational,Brazil,South America,3,3,3,0,0,3,0,Unknown
1958-06-17 00:00:00,Lineas Aéreas del Caribe - LIDCA,Flight,Operational,Venezuela,South America,3,3,3,0,0,3,0,Unknown
1958-07-09 00:00:00,Indian Airlines,Landing (descent or approach),Operational,Bangladesh,Asia,3,3,3,0,0,3,0,Weather
1958-08-06 00:00:00,RCMP - GRC Air Services,Flight,Military / Government,Canada,North America,3,3,3,0,0,3,0,Unknown
1958-08-25 00:00:00,United States Fish %26 Wildlife Service,Flight,Military / Government,United States of America,North America,3,2,2,1,1,3,0,Unknown
1958-09-02 00:00:00,Independent Air Travel,Landing (descent or approach),Operational,United Kingdom,Europe,3,3,3,0,0,3,0,Technical Failure
1958-09-22 00:00:00,Navegação Aérea Brasileira - NAB,Flight,Specialised Services,Brazil,South America,3,3,3,0,0,3,0,Human Factor
1958-10-16 00:00:00,Argentinian Air Force - Fuerza Aérea Argentina,Landing (descent or approach),Military / Government,Bolivia,South America,12,7,1,5,2,3,9,Unknown
1958-10-17 00:00:00,United States Air Force - USAF,Flight,Military / Government,Canada,North America,3,3,3,0,0,3,0,Unknown
1958-11-08 00:00:00,TAM Bolivia - Transporte Aéreo Militar Boliviano,Flight,Operational,Bolivia,South America,3,3,3,0,0,3,0,Unknown
1958-12-07 00:00:00,Aerovias Madre de Dios,Takeoff (climb),Commercial,Peru,South America,6,2,1,4,2,3,3,Unknown
1958-12-26 00:00:00,Union Aéromaritime de Transport - UAT,Takeoff (climb),Commercial,Zimbabwe,Africa,70,7,0,63,3,3,67,Weather
1959-02-01 00:00:00,General Airways,Landing (descent or approach),Commercial,United States of America,North America,28,3,2,25,1,3,25,Human Factor
1959-02-25 00:00:00,Aéroclub de Suisse,Takeoff (climb),Business,Switzerland,Europe,3,1,1,2,2,3,0,Unknown
1959-03-27 00:00:00,Italian Air Force - Aeronautica Militare Italiana,Flight,Military / Government,Italy,Europe,5,2,2,3,1,3,2,Weather
1959-03-31 00:00:00,United States Navy - USN,Takeoff (climb),Military / Government,Italy,Europe,20,6,0,14,3,3,17,Technical Failure
1959-04-13 00:00:00,French Navy,Flight,Specialised Services,France,Europe,3,3,3,0,0,3,0,Unknown
1959-05-06 00:00:00,Paraense Transportes Aéreos,Takeoff (climb),Operational,Brazil,South America,3,3,3,0,0,3,0,Unknown
1959-05-20 00:00:00,Royal Air Force - RAF,Flight,Military / Government,United Kingdom,Europe,3,3,3,0,0,3,0,Human Factor
1959-09-12 00:00:00,Pan American World Airways - PAA,Flight,Operational,Honduras,Central America,3,3,3,0,0,3,0,Human Factor
1959-11-24 00:00:00,Trans World Airlines - TWA,Takeoff (climb),Operational,United States of America,North America,3,3,3,0,0,3,0,Human Factor
1959-12-01 00:00:00,Linea Aeropostal Venezolana - LAV,Takeoff (climb),Specialised Services,Venezuela,South America,3,3,3,0,0,3,0,Technical Failure
1959-12-16 00:00:00,California Aircraft Company,Flight,Operational,United States of America,North America,3,3,3,0,0,3,0,Technical Failure
1960-01-22 00:00:00,Air Survey of India,Flight,Military / Government,India,Asia,3,1,1,2,2,3,0,Technical Failure
1960-02-17 00:00:00,Champion Paper %26 Fiber Company,Flight,Operational,United States of America,North America,3,3,3,0,0,3,0,Unknown
1960-02-17 00:00:00,United States Navy - USN,Landing (descent or approach),Operational,Vietnam,Asia,3,3,3,0,0,3,0,Unknown
1960-02-25 00:00:00,Cuban Air Force - Fuerza Aérea del Ejército de Cuba,Takeoff (climb),Military / Government,Cuba,Central America,3,3,3,0,0,3,0,Unknown
1960-06-19 00:00:00,United States Air Force - USAF,Landing (descent or approach),Military / Government,Suriname,South America,7,7,3,0,0,3,4,Human Factor
1960-07-05 00:00:00,Aeroflot - Russian International Airlines,Flight,Specialised Services,Russia,Asia,4,4,3,0,0,3,1,Human Factor
1960-08-24 00:00:00,Paraense Transportes Aéreos,Flight,Operational,Brazil,South America,3,3,3,0,0,3,0,Unknown
1960-08-24 00:00:00,Don Everall Aviation,Takeoff (climb),Operational,Greece,Europe,3,3,3,0,0,3,0,Technical Failure
1960-09-22 00:00:00,Wheeler Airlines,Takeoff (climb),Commercial,Canada,North America,4,1,1,3,2,3,1,Technical Failure
1960-10-07 00:00:00,Mexican Air Force - Fuerza Aérea Mexicana,Flight,Military / Government,Mexico,Central America,3,2,2,1,1,3,0,Unknown
1960-10-21 00:00:00,Aeroflot - Russian International Airlines,Landing (descent or approach),Commercial,Russia,Asia,68,7,3,61,0,3,65,Human Factor
1960-12-12 00:00:00,Airlines of New South Wales,Flight,Operational,Australia,Oceania,3,3,3,0,0,3,0,Unknown
1960-12-21 00:00:00,Venezuelan Air Force - Fuerza Aérea Venezolana,Flight,Military / Government,Venezuela,South America,3,3,3,0,0,3,0,Unknown
1961-01-24 00:00:00,United States Air Force - USAF,Landing (descent or approach),Military / Government,United States of America,North America,8,8,3,0,0,3,5,Technical Failure
1961-01-31 00:00:00,Katanga Air Force,Flight,Military / Government,Democratic Republic of Congo,Africa,3,3,3,0,0,3,0,Other
1961-02-06 00:00:00,Union Aéromaritime de Transport - UAT,Flight,Specialised Services,France,Europe,3,1,1,2,2,3,0,Weather
1961-02-15 00:00:00,Italian Air Force - Aeronautica Militare Italiana,Takeoff (climb),Military / Government,Democratic Republic of Congo,Africa,9,9,3,0,0,3,6,Technical Failure
1961-03-15 00:00:00,Aeronorte,Landing (descent or approach),Operational,Brazil,South America,3,3,3,0,0,3,0,Human Factor
1961-04-07 00:00:00,United States Air Force - USAF,Flight,Operational,United States of America,North America,8,8,3,0,0,3,5,Technical Failure
1961-04-27 00:00:00,Italian Air Force - Aeronautica Militare Italiana,Flight,Operational,Italy,Europe,3,3,3,0,0,3,0,Technical Failure
1961-07-01 00:00:00,Indian Air Force - Bharatiya Vayu Sena,Flight,Operational,India,Asia,9,9,3,0,0,3,6,Technical Failure
1961-07-08 00:00:00,Nordair,Landing (descent or approach),Operational,Canada,North America,3,3,3,0,0,3,0,Human Factor
1961-07-20 00:00:00,Aerolineas Vega,Flight,Operational,Mexico,Central America,3,2,2,1,1,3,0,Unknown
1961-08-09 00:00:00,Cubana de Aviación,Takeoff (climb),Commercial,Cuba,Central America,53,3,1,50,2,3,50,Terrorism
1961-09-20 00:00:00,United States Air Force - USAF,Landing (descent or approach),Operational,United States of America,North America,6,6,3,0,0,3,3,Human Factor
1961-09-24 00:00:00,United States Air Force - USAF,Takeoff (climb),Operational,United States of America,North America,15,3,0,12,3,3,12,Unknown
1961-11-11 00:00:00,Air Haïti International,Flight,Operational,World,World,3,3,3,0,0,3,0,Unknown
1961-11-24 00:00:00,Beriev,Flight,Specialised Services,Ukraine,Europe,5,5,3,0,0,3,2,Human Factor
1961-12-04 00:00:00,Lufthansa,Takeoff (climb),Operational,Germany,Europe,3,3,3,0,0,3,0,Unknown
1961-12-05 00:00:00,French Navy,Flight,Military / Government,France,Europe,3,3,3,0,0,3,0,Unknown
1961-12-06 00:00:00,Brazilian Air Force - Força Aérea Brasileira,Takeoff (climb),Military / Government,Brazil,South America,3,3,3,0,0,3,0,Unknown
1962-01-27 00:00:00,United States Army,Flight,Military / Government,Iran,Asia,5,1,1,4,2,3,2,Unknown
1962-02-02 00:00:00,United States Air Force - USAF,Flight,Military / Government,Vietnam,Asia,3,3,3,0,0,3,0,Unknown
1962-02-06 00:00:00,Italian Air Force - Aeronautica Militare Italiana,Flight,Operational,Italy,Europe,4,4,3,0,0,3,1,Technical Failure
1962-02-21 00:00:00,Aeroflot - Russian International Airlines,Flight,Operational,Russia,Asia,3,2,2,1,1,3,0,Human Factor
1962-02-23 00:00:00,TOA Nippon Airways,Landing (descent or approach),Operational,Japan,Asia,3,3,3,0,0,3,0,Human Factor
1962-02-25 00:00:00,United States Air Force - USAF,Flight,Military / Government,United States of America,North America,3,3,3,0,0,3,0,Human Factor
1962-03-09 00:00:00,Aeroflot - Russian International Airlines,Flight,Military / Government,Kazakhstan,Asia,10,4,1,6,2,3,7,Human Factor
1962-03-15 00:00:00,Howard Aero,Flight,Specialised Services,United States of America,North America,3,3,3,0,0,3,0,Unknown
1962-04-18 00:00:00,Purdue University Airlines,Takeoff (climb),Specialised Services,United States of America,North America,3,3,3,0,0,3,0,Human Factor
1962-04-19 00:00:00,French Navy,Flight,Specialised Services,France,Europe,3,3,3,0,0,3,0,Unknown
1962-04-19 00:00:00,Aeroflot - Russian International Airlines,Flight,Commercial,Kazakhstan,Asia,8,2,0,6,3,3,5,Human Factor
1962-05-10 00:00:00,Chilean Air Force - Fuerza Aérea de Chile,Flight,Operational,Chile,South America,3,3,3,0,0,3,0,Unknown
1962-05-15 00:00:00,United Arab Airlines,Takeoff (climb),Operational,Egypt,Africa,3,3,3,0,0,3,0,Unknown
1962-06-28 00:00:00,Aeroflot - Russian International Airlines,Takeoff (climb),Military / Government,Kazakhstan,Asia,4,2,1,2,2,3,1,Human Factor
1962-07-06 00:00:00,Maryland Flying Services,Takeoff (climb),Operational,Liberia,Africa,3,3,3,0,0,3,0,Unknown
1962-08-08 00:00:00,United States Air Force - USAF,Landing (descent or approach),Military / Government,United States of America,North America,3,3,3,0,0,3,0,Human Factor
1962-08-28 00:00:00,Royal Air Force - RAF,Flight,Operational,United Kingdom,Europe,3,3,3,0,0,3,0,Human Factor
1962-10-12 00:00:00,Philippine Airlines - PAL,Takeoff (climb),Operational,Philippines,Asia,3,3,3,0,0,3,0,Human Factor
1962-10-26 00:00:00,French Air Force - Armée de l'Air,Flight,Military / Government,France,Europe,3,3,3,0,0,3,0,Unknown
1962-10-27 00:00:00,Società Nazionale Metanodotti - SNAM,Landing (descent or approach),Business,Italy,Europe,3,1,1,2,2,3,0,Weather
1962-10-30 00:00:00,Brazilian Air Force - Força Aérea Brasileira,Flight,Military / Government,Brazil,South America,3,2,2,1,1,3,0,Unknown
1962-11-27 00:00:00,Air America,Landing (descent or approach),Operational,Laos,Asia,3,3,3,0,0,3,0,Terrorism
1962-12-04 00:00:00,United States Air Force - USAF,Landing (descent or approach),Humanitarian,Guam Island,Asia,8,8,3,0,0,3,5,Unknown
1963-01-17 00:00:00,West Coast Airlines,Flight,Operational,United States of America,North America,3,3,3,0,0,3,0,Human Factor
1963-01-22 00:00:00,Portuguese Air Force - Força Aerea Portuguesa,Landing (descent or approach),Military / Government,Spain,Europe,14,3,0,11,3,3,11,Unknown
1963-02-01 00:00:00,Turkish Air Force - Türk Hava Kuvvetleri,Landing (descent or approach),Operational,Turkey,Asia,3,3,3,0,0,3,0,Human Factor
1963-03-04 00:00:00,French Air Force - Armée de l'Air,Flight,Operational,France,Europe,3,3,3,0,0,3,0,Unknown
1963-03-20 00:00:00,Colombian Air Force - Fuerza Aérea Colombiana,Takeoff (climb),Military / Government,Colombia,South America,3,3,3,0,0,3,0,Unknown
1963-04-12 00:00:00,United States Air Force - USAF,Takeoff (climb),Military / Government,Thailand,Asia,3,3,3,0,0,3,0,Human Factor
1963-05-01 00:00:00,Aerotaxi Servicios Aéreos,Flight,Commercial,Colombia,South America,9,1,0,8,3,3,6,Technical Failure
1963-05-16 00:00:00,Colombian Air Force - Fuerza Aérea Colombiana,Takeoff (climb),Military / Government,Colombia,South America,4,1,0,3,3,3,1,Unknown
1963-08-16 00:00:00,United States Air Force - USAF,Flight,Military / Government,Vietnam,Asia,3,3,3,0,0,3,0,Technical Failure
1963-12-07 00:00:00,Zantop Air Transport,Flight,Operational,United States of America,North America,3,2,2,1,1,3,0,Human Factor
1963-12-09 00:00:00,Hank Wharton,Flight,Operational,World,World,3,3,3,0,0,3,0,Unknown
1963-12-12 00:00:00,TMA of Lebanon - Trans Mediterranean Airways,Flight,Operational,Afghanistan,Asia,3,3,3,0,0,3,0,Human Factor
1963-12-19 00:00:00,Italian Air Force - Aeronautica Militare Italiana,Flight,Military / Government,Italy,Europe,3,3,3,0,0,3,0,Unknown
1964-01-13 00:00:00,United States Air Force - USAF,Flight,Military / Government,United States of America,North America,5,5,3,0,0,3,2,Weather
1964-01-25 00:00:00,Aeroflot - Russian International Airlines,Landing (descent or approach),Commercial,Kazakhstan,Asia,9,2,1,7,2,3,6,Human Factor
1964-01-28 00:00:00,United States Air Force - USAF,Flight,Operational,Germany,Europe,3,3,3,0,0,3,0,Terrorism
1964-02-03 00:00:00,Turkish Airlines - THY Türk Hava Yollari,Landing (descent or approach),Operational,Turkey,Asia,3,3,3,0,0,3,0,Human Factor
1964-02-09 00:00:00,Aeroflot - Russian International Airlines,Takeoff (climb),Operational,Russia,Asia,3,1,1,2,2,3,0,Human Factor
1964-03-10 00:00:00,Slick Airways,Landing (descent or approach),Operational,United States of America,North America,3,3,3,0,0,3,0,Weather
1964-03-14 00:00:00,Masa Treuunternehmen,Flight,Business,Germany,Europe,4,1,0,3,3,3,1,Weather
1964-03-26 00:00:00,VASP - Viação Aérea de São Paulo,Takeoff (climb),Operational,Brazil,South America,3,3,3,0,0,3,0,Technical Failure
1964-05-27 00:00:00,VASP - Viação Aérea de São Paulo,Takeoff (climb),Operational,Brazil,South America,3,3,3,0,0,3,0,Other
1964-07-15 00:00:00,Lufthansa,Flight,Operational,Germany,Europe,3,3,3,0,0,3,0,Human Factor
1964-07-21 00:00:00,Air Congo,Flight,Operational,Cameroon,Africa,3,1,1,2,2,3,0,Human Factor
1964-08-14 00:00:00,Aeroflot - Russian International Airlines,Landing (descent or approach),Operational,Russia,Asia,3,3,3,0,0,3,0,Human Factor
1964-09-18 00:00:00,Spanish Air Force - Ejército del Aire,Flight,Military / Government,Spain,Europe,3,3,3,0,0,3,0,Human Factor
1964-10-16 00:00:00,Indonesian Air Force - TNI-AU Tentara Nasional Indonesia - Angkatan Udara,Takeoff (climb),Military / Government,Indonesia,Asia,16,4,0,12,3,3,13,Unknown
1964-10-31 00:00:00,United States Army,Flight,Operational,United States of America,North America,3,3,3,0,0,3,0,Human Factor
1964-10-31 00:00:00,United States Army,Flight,Operational,United States of America,North America,3,3,3,0,0,3,0,Human Factor
1964-11-28 00:00:00,Private South African,Flight,Business,South Africa,Africa,3,1,1,2,2,3,0,Unknown
1964-12-24 00:00:00,Flying Tiger Line,Takeoff (climb),Operational,United States of America,North America,3,3,3,0,0,3,0,Unknown
1964-12-24 00:00:00,French Air Force - Armée de l'Air,Takeoff (climb),Operational,France,Europe,3,3,3,0,0,3,0,Unknown
1965-05-27 00:00:00,Mattagami Skyways,Landing (descent or approach),Commercial,Canada,North America,5,1,1,4,2,3,2,Weather
1965-06-08 00:00:00,Spanish Air Force - Ejército del Aire,Flight,Operational,Spain,Europe,11,2,2,9,1,3,8,Unknown
1965-06-18 00:00:00,United States Air Force - USAF,Flight,Military / Government,World,World,6,6,3,0,0,3,3,Human Factor
1965-06-19 00:00:00,Private American,Flight,Business,United States of America,North America,3,1,1,2,2,3,0,Human Factor
1965-06-29 00:00:00,Lineas Aéreas La Urraca,Flight,Operational,Colombia,South America,3,3,3,0,0,3,0,Unknown
1965-07-05 00:00:00,Air America,Takeoff (climb),Commercial,Vietnam,Asia,3,3,3,0,0,3,0,Terrorism
1965-09-15 00:00:00,West Indies Airways,Takeoff (climb),Business,United States of America,Central America,3,1,1,2,2,3,0,Unknown
1965-09-17 00:00:00,Banner Oil Company,Landing (descent or approach),Business,United States of America,North America,3,1,1,2,2,3,0,Weather
1965-09-27 00:00:00,Air America,Flight,Commercial,Vietnam,Asia,3,2,2,1,1,3,0,Unknown
1965-10-17 00:00:00,Avianca,Landing (descent or approach),Commercial,Colombia,South America,15,3,3,12,0,3,12,Unknown
1965-11-12 00:00:00,Private Mexican,Takeoff (climb),Business,Mexico,Central America,8,3,0,5,3,3,5,Unknown
1965-12-15 00:00:00,Flying Tiger Line,Flight,Operational,United States of America,North America,3,3,3,0,0,3,0,Human Factor
1966-01-20 00:00:00,Central African Air Force - Escadrille Centrafricaine,Landing (descent or approach),Military / Government,Cameroon,Africa,3,3,3,0,0,3,0,Unknown
1966-02-23 00:00:00,Trans Peruana,Landing (descent or approach),Operational,Peru,South America,3,3,3,0,0,3,0,Unknown
1966-02-26 00:00:00,Aeroflot - Russian International Airlines,Flight,Specialised Services,Russia,Asia,3,2,2,1,1,3,0,Human Factor
1966-03-09 00:00:00,United States Air Force - USAF,Flight,Military / Government,Vietnam,Asia,6,6,3,0,0,3,3,Terrorism
1966-03-29 00:00:00,United States Air Force - USAF,Landing (descent or approach),Military / Government,Vietnam,Asia,5,5,3,0,0,3,2,Human Factor
1966-04-23 00:00:00,Aeroflot - Russian International Airlines,Flight,Military / Government,Russia,Asia,3,2,2,1,1,3,0,Human Factor
1966-05-11 00:00:00,Polynesian Airline of Samoa - Polynesian Airlines,Landing (descent or approach),Operational,Samoa Islands (Western Samoa),Oceania,3,3,3,0,0,3,0,Technical Failure
1966-07-11 00:00:00,Alamo Airways,Flight,Commercial,United States of America,North America,3,2,2,1,1,3,0,Human Factor
1966-07-25 00:00:00,Thai Government,Flight,Operational,World,World,3,3,3,0,0,3,0,Technical Failure
1966-08-03 00:00:00,Lloyd Aéreo Boliviano - LAB Airlines,Flight,Operational,Bolivia,South America,3,3,3,0,0,3,0,Human Factor
1966-08-26 00:00:00,Royal Netherlands Navy - Marineluchtvaartdienst,Takeoff (climb),Operational,Netherlands,Central America,4,4,3,0,0,3,1,Unknown
1966-09-25 00:00:00,Q Airways,Takeoff (climb),Business,United States of America,North America,4,2,1,2,2,3,1,Human Factor
1966-11-15 00:00:00,Pan American World Airways - PAA,Landing (descent or approach),Operational,Germany,Europe,3,3,3,0,0,3,0,Human Factor
1966-11-20 00:00:00,Piedmont Airlines,Landing (descent or approach),Operational,United States of America,North America,3,3,3,0,0,3,0,Human Factor
1966-11-22 00:00:00,Aeroflot - Russian International Airlines,Takeoff (climb),Commercial,Kazakhstan,Asia,68,8,1,60,2,3,65,Technical Failure
1966-11-29 00:00:00,Argentinian Air Force - Fuerza Aérea Argentina,Landing (descent or approach),Military / Government,Argentina,South America,3,3,3,0,0,3,0,Unknown
1967-01-06 00:00:00,Channel Air Lift,Takeoff (climb),Operational,United States of America,North America,3,3,3,0,0,3,0,Human Factor
1967-01-25 00:00:00,Avcom Flight,Landing (descent or approach),Operational,United States of America,North America,3,2,2,1,1,3,0,Human Factor
1967-01-31 00:00:00,Saturn Airways,Landing (descent or approach),Operational,United States of America,North America,3,3,3,0,0,3,0,Human Factor
1967-02-10 00:00:00,Southwestern Public Service,Takeoff (climb),Business,United States of America,North America,3,1,1,2,2,3,0,Technical Failure
1967-02-13 00:00:00,Mexican Air Force - Fuerza Aérea Mexicana,Flight,Military / Government,Mexico,Central America,3,3,3,0,0,3,0,Unknown
1967-02-22 00:00:00,Ferro Corp.,Flight,Business,United States of America,North America,3,1,1,2,2,3,0,Technical Failure
1967-04-16 00:00:00,General Precision,Landing (descent or approach),Business,United States of America,North America,5,2,2,3,1,3,2,Human Factor
1967-04-16 00:00:00,United States Air Force - USAF,Landing (descent or approach),Military / Government,Vietnam,Asia,6,6,3,0,0,3,3,Technical Failure
1967-05-03 00:00:00,Flugsyn,Landing (descent or approach),Operational,Iceland,Europe,3,3,3,0,0,3,0,Weather
1967-05-19 00:00:00,Air Canada,Landing (descent or approach),Operational,Canada,North America,3,3,3,0,0,3,0,Human Factor
1967-05-28 00:00:00,Boun Oum Airways,Flight,Military / Government,Laos,Asia,3,3,3,0,0,3,0,Weather
1967-06-12 00:00:00,Aeronaves de Mexico,Takeoff (climb),Commercial,Mexico,Central America,28,4,3,24,0,3,25,Technical Failure
1967-06-15 00:00:00,United States Coast Guard - USCG,Flight,Military / Government,Canada,North America,6,6,3,0,0,3,3,Unknown
1967-06-22 00:00:00,Aer Lingus,Landing (descent or approach),Operational,Ireland,Europe,3,3,3,0,0,3,0,Human Factor
1967-07-04 00:00:00,Aeroflot - Russian International Airlines,Flight,Military / Government,Russia,Asia,3,2,2,1,1,3,0,Human Factor
1967-07-07 00:00:00,United States Air Force - USAF,Flight,Military / Government,Vietnam,Asia,7,7,3,0,0,3,4,Human Factor
1967-07-07 00:00:00,United States Air Force - USAF,Flight,Military / Government,Vietnam,Asia,6,6,3,0,0,3,3,Human Factor
1967-08-03 00:00:00,United States Air Force - USAF,Flight,Military / Government,Vietnam,Asia,3,3,3,0,0,3,0,Terrorism
1967-08-07 00:00:00,United States Coast Guard - USCG,Flight,Military / Government,United States of America,North America,8,8,3,0,0,3,5,Human Factor
1967-09-08 00:00:00,Private American,Takeoff (climb),Commercial,United States of America,North America,8,1,0,7,3,3,5,Human Factor
1967-10-24 00:00:00,GLAM - Groupe de Liaisons Aériennes Ministérielles,Takeoff (climb),Operational,France,Europe,3,3,3,0,0,3,0,Technical Failure
1967-11-25 00:00:00,Priority Air Services,Landing (descent or approach),Operational,United States of America,North America,3,2,2,1,1,3,0,Technical Failure
1967-11-29 00:00:00,Jet International,Landing (descent or approach),Business,United States of America,North America,3,2,2,1,1,3,0,Technical Failure
1967-12-28 00:00:00,Pangles Inc.,Flight,Business,United States of America,North America,3,2,2,1,1,3,0,Human Factor
1967-12-29 00:00:00,United States Air Force - USAF,Flight,Military / Government,Laos,Asia,3,3,3,0,0,3,0,Terrorism
1968-01-08 00:00:00,Imperial Commuter,Takeoff (climb),Commercial,United States of America,North America,4,1,1,3,2,3,1,Human Factor
1968-01-16 00:00:00,United States Navy - USN,Takeoff (climb),Military / Government,World,World,10,3,3,7,0,3,7,Unknown
1968-02-06 00:00:00,Ferrocarriles Nacionales de Colombia,Flight,Business,Colombia,South America,3,1,1,2,2,3,0,Unknown
1968-03-17 00:00:00,Brazilian Air Force - Força Aérea Brasileira,Flight,Military / Government,Brazil,South America,4,1,1,3,2,3,1,Technical Failure
1968-03-21 00:00:00,Portuguese Air Force - Força Aerea Portuguesa,Landing (descent or approach),Military / Government,Mozambique,Africa,3,3,3,0,0,3,0,Terrorism
1968-03-30 00:00:00,Rutas Aéreas Panameñas,Takeoff (climb),Operational,Panama,Central America,3,3,3,0,0,3,0,Technical Failure
1968-04-08 00:00:00,United States Army,Flight,Military / Government,United States of America,North America,3,3,3,0,0,3,0,Unknown
1968-05-05 00:00:00,United States Air Force - USAF,Flight,Military / Government,Vietnam,Asia,9,9,3,0,0,3,6,Terrorism
1968-05-23 00:00:00,United States Air Force - USAF,Flight,Military / Government,Vietnam,Asia,3,3,3,0,0,3,0,Terrorism
1968-06-01 00:00:00,Houston Beech Airlines,Takeoff (climb),Commercial,United States of America,North America,4,1,1,3,2,3,1,Technical Failure
1968-07-15 00:00:00,VARIG - Viação Aérea Rio Grandense,Flight,Operational,Brazil,South America,3,3,3,0,0,3,0,Unknown
1968-08-26 00:00:00,United States Air Force - USAF,Flight,Military / Government,Vietnam,Asia,3,3,3,0,0,3,0,Terrorism
1968-10-23 00:00:00,University of Wisconsin,Flight,Other,United States of America,North America,3,3,3,0,0,3,0,Unknown
1968-10-25 00:00:00,KLM Aerocarto,Flight,Military / Government,Suriname,South America,5,3,3,2,0,3,2,Technical Failure
1968-11-14 00:00:00,Aero Contractors,Landing (descent or approach),Commercial,Nigeria,Africa,3,1,1,2,2,3,0,Human Factor
1968-11-15 00:00:00,United States Navy - USN,Flight,Military / Government,Greece,Europe,3,3,3,0,0,3,0,Unknown
1968-12-06 00:00:00,Conquest Airways,Takeoff (climb),Commercial,United States of America,Central America,11,1,1,10,2,3,8,Human Factor
1968-12-08 00:00:00,Northwest Moon Services,Flight,Commercial,United States of America,North America,3,1,1,2,2,3,0,Weather
1968-12-17 00:00:00,United States Air Force - USAF,Flight,Military / Government,Vietnam,Asia,4,4,3,0,0,3,1,Technical Failure
1968-12-24 00:00:00,Kenya Police Air Wing,Takeoff (climb),Military / Government,Kenya,Africa,3,3,3,0,0,3,0,Other
1968-12-26 00:00:00,Pan American World Airways - PAA,Takeoff (climb),Operational,United States of America,North America,3,3,3,0,0,3,0,Human Factor
1969-02-05 00:00:00,Visador Company,Flight,Business,United States of America,North America,4,2,2,2,1,3,1,Human Factor
1969-02-12 00:00:00,Continental Air Services,Flight,Commercial,Laos,Asia,3,1,1,2,2,3,0,Unknown
1969-02-16 00:00:00,Royal Canadian Air Force - RCAF,Takeoff (climb),Military / Government,World,World,3,3,3,0,0,3,0,Unknown
1969-03-08 00:00:00,Continental Air Transport,Flight,Operational,World,World,3,3,3,0,0,3,0,Unknown
1969-03-20 00:00:00,British Midland Airways - BMA,Takeoff (climb),Operational,United Kingdom,Europe,4,4,3,0,0,3,1,Human Factor
1969-04-07 00:00:00,Aeroflot - Russian International Airlines,Flight,Military / Government,Russia,Asia,3,1,1,2,2,3,0,Human Factor
1969-04-10 00:00:00,Ethiopian Airlines,Flight,Operational,Egypt,Africa,3,3,3,0,0,3,0,Terrorism
1969-04-11 00:00:00,United States Army,Takeoff (climb),Military / Government,Venezuela,South America,5,2,1,3,2,3,2,Technical Failure
1969-04-28 00:00:00,United States Army,Takeoff (climb),Military / Government,Germany,Europe,5,2,2,3,1,3,2,Unknown
1969-05-05 00:00:00,Rockwell Aircraft,Flight,Specialised Services,United States of America,North America,3,2,2,1,1,3,0,Human Factor
1969-05-06 00:00:00,Peruvian Air Force - Fuerza Aérea del Perú,Flight,Operational,Peru,South America,3,3,3,0,0,3,0,Unknown
1969-05-27 00:00:00,Argentinian Air Force - Fuerza Aérea Argentina,Takeoff (climb),Military / Government,Argentina,South America,3,3,3,0,0,3,0,Unknown
1969-06-24 00:00:00,Japan Airlines,Takeoff (climb),Operational,United States of America,North America,5,5,3,0,0,3,2,Human Factor
1969-06-26 00:00:00,Aeroflot - Russian International Airlines,Takeoff (climb),Operational,Russia,Asia,5,5,3,0,0,3,2,Technical Failure
1969-07-15 00:00:00,New York Airways,Takeoff (climb),Commercial,United States of America,North America,14,3,2,11,1,3,11,Human Factor
1969-07-27 00:00:00,Air Car,Flight,Business,United States of America,North America,3,1,1,2,2,3,0,Human Factor
1969-08-16 00:00:00,Líder Taxi Aéreo,Flight,Operational,Brazil,South America,3,2,2,1,1,3,0,Unknown
1969-08-26 00:00:00,A. Murphy Construction Company,Landing (descent or approach),Business,United States of America,North America,4,1,1,3,2,3,1,Human Factor
1969-08-26 00:00:00,Zambia Air Force,Takeoff (climb),Military / Government,Zambia,Africa,4,2,1,2,2,3,1,Unknown
1969-10-31 00:00:00,The Pittston Company,Flight,Business,United States of America,North America,3,2,2,1,1,3,0,Human Factor
1969-11-26 00:00:00,Superior Oil Corporation,Landing (descent or approach),Operational,United States of America,North America,3,2,2,1,1,3,0,Human Factor
1969-12-09 00:00:00,Aeroflot - Russian International Airlines,Flight,Operational,Russia,Asia,3,2,2,1,1,3,0,Human Factor
1970-03-22 00:00:00,Commuter Airlines,Takeoff (climb),Commercial,United States of America,North America,11,2,1,9,2,3,8,Human Factor
1970-04-02 00:00:00,United States Air Force - USAF,Flight,Military / Government,Vietnam,Asia,3,3,3,0,0,3,0,Terrorism
1970-04-04 00:00:00,United States Air Force - USAF,Flight,Military / Government,Vietnam,Asia,3,3,3,0,0,3,0,Terrorism
1970-04-06 00:00:00,Royal New Zealand Air Force - RNZAF,Flight,Operational,New Zealand,Oceania,3,3,3,0,0,3,0,Human Factor
1970-04-06 00:00:00,United States Air Force - USAF,Flight,Military / Government,Vietnam,Asia,3,3,3,0,0,3,0,Terrorism
1970-07-04 00:00:00,Sécurité civile française,Flight,Humanitarian,France,Europe,3,2,2,1,1,3,0,Unknown
1970-07-17 00:00:00,Mobile Auto Crushing,Takeoff (climb),Business,United States of America,North America,3,1,1,2,2,3,0,Human Factor
1970-07-19 00:00:00,United Arab Airlines,Takeoff (climb),Operational,Egypt,Africa,3,3,3,0,0,3,0,Human Factor
1970-07-26 00:00:00,Aeroflot - Russian International Airlines,Flight,Military / Government,Lithuania,Europe,3,1,1,2,2,3,0,Human Factor
1970-08-10 00:00:00,United States Air Force - USAF,Landing (descent or approach),Military / Government,Vietnam,Asia,4,4,3,0,0,3,1,Technical Failure
1970-08-30 00:00:00,Dutch Continental Airlines,Flight,Commercial,Netherlands,Europe,10,1,1,9,2,3,7,Human Factor
1970-10-06 00:00:00,National Airways - South Africa,Takeoff (climb),Commercial,South Africa,Africa,11,2,1,9,2,3,8,Technical Failure
1970-10-10 00:00:00,Saturn Airways,Landing (descent or approach),Operational,United States of America,North America,3,3,3,0,0,3,0,Human Factor
1970-10-29 00:00:00,United States Army,Landing (descent or approach),Military / Government,United States of America,North America,4,2,2,2,1,3,1,Technical Failure
1970-11-19 00:00:00,Israel Aerospace Industries - IAI,Flight,Specialised Services,Palestine,Asia,4,4,3,0,0,3,1,Technical Failure
1970-11-24 00:00:00,United States Army,Takeoff (climb),Operational,Vietnam,Asia,3,3,3,0,0,3,0,Human Factor
1970-12-23 00:00:00,United States Army,Flight,Military / Government,Vietnam,Asia,3,3,3,0,0,3,0,Unknown
1971-03-21 00:00:00,Air America,Flight,Commercial,Laos,Asia,3,1,1,2,2,3,0,Unknown
1971-03-23 00:00:00,Aérospatiale Industries - SNIAS,Flight,Specialised Services,France,Europe,3,3,3,0,0,3,0,Unknown
1971-05-14 00:00:00,British Army Air Corps,Flight,Military / Government,Germany,Europe,3,1,1,2,2,3,0,Weather
1971-05-26 00:00:00,South African Air Force,Flight,Operational,South Africa,Africa,3,3,3,0,0,3,0,Human Factor
1971-05-31 00:00:00,Aeroflot - Russian International Airlines,Flight,Business,Russia,Asia,3,2,2,1,1,3,0,Human Factor
1971-06-05 00:00:00,French Air Force - Armée de l'Air,Flight,Military / Government,French Polynesia,Oceania,3,3,3,0,0,3,0,Unknown
1971-06-30 00:00:00,Spanish Air Force - Ejército del Aire,Takeoff (climb),Military / Government,Spain,Europe,5,5,3,0,0,3,2,Unknown
1971-08-19 00:00:00,Downeast Airlines,Landing (descent or approach),Commercial,United States of America,North America,8,1,1,7,2,3,5,Human Factor
1971-09-16 00:00:00,United States Air Force - USAF,Landing (descent or approach),Operational,United States of America,North America,3,3,3,0,0,3,0,Technical Failure
1971-09-17 00:00:00,Texas Department of Corrections,Flight,Military / Government,United States of America,North America,3,2,2,1,1,3,0,Weather
1971-09-21 00:00:00,Italian Air Force - Aeronautica Militare Italiana,Takeoff (climb),Military / Government,Italy,Europe,4,4,3,0,0,3,1,Technical Failure
1971-09-26 00:00:00,José Molina Portes,Takeoff (climb),Business,Dominican Republic,Central America,4,1,1,3,2,3,1,Unknown
1971-10-12 00:00:00,Río Táxi Aéreo,Landing (descent or approach),Operational,Brazil,South America,3,2,2,1,1,3,0,Unknown
1971-10-19 00:00:00,LADECO Airlines - Línea Aérea del Cobre,Flight,Operational,Argentina,South America,3,3,3,0,0,3,0,Technical Failure
1971-10-21 00:00:00,Labina,Flight,Business,United States of America,North America,3,1,1,2,2,3,0,Human Factor
1971-11-03 00:00:00,Compaña de Aviacion Aéreo Amazonas,Flight,Operational,Colombia,South America,3,3,3,0,0,3,0,Human Factor
1971-12-05 00:00:00,Air Lease,Landing (descent or approach),Business,United States of America,North America,3,1,1,2,2,3,0,Human Factor
1971-12-10 00:00:00,Coleman Aircraft,Landing (descent or approach),Operational,Canada,North America,3,3,3,0,0,3,0,Unknown
1972-02-12 00:00:00,United States Army,Landing (descent or approach),Military / Government,United States of America,North America,6,2,2,4,1,3,3,Unknown
1972-04-06 00:00:00,D. W. Winkelman,Takeoff (climb),Business,United States of America,North America,6,1,1,5,2,3,3,Weather
1972-04-16 00:00:00,Soble Air Leasing,Takeoff (climb),Business,United States of America,North America,3,2,2,1,1,3,0,Other
1972-05-02 00:00:00,United States Air Force - USAF,Flight,Military / Government,Vietnam,Asia,10,10,3,0,0,3,7,Terrorism
1972-05-13 00:00:00,Kenneth L. Compton,Takeoff (climb),Operational,United States of America,North America,3,1,1,2,2,3,0,Human Factor
1972-06-13 00:00:00,Aerolineas Flecha Austral - AFA,Landing (descent or approach),Operational,Chile,South America,3,3,3,0,0,3,0,Unknown
1972-06-21 00:00:00,Private German,Flight,Business,World,World,3,1,1,2,2,3,0,Unknown
1972-07-20 00:00:00,Soviet Navy - Voyenno-morskoy flot CCCP,Landing (descent or approach),Military / Government,Ukraine,Europe,4,4,3,0,0,3,1,Other
1972-07-25 00:00:00,Air America,Flight,Military / Government,Laos,Asia,4,2,2,2,1,3,1,Human Factor
1972-08-14 00:00:00,North American Research,Flight,Operational,United States of America,North America,3,2,2,1,1,3,0,Human Factor
1972-09-22 00:00:00,United Air,Takeoff (climb),Commercial,South Africa,Africa,3,2,2,1,1,3,0,Other
1972-09-26 00:00:00,Garuda Indonesian Airways,Takeoff (climb),Operational,Indonesia,Asia,3,3,3,0,0,3,0,Human Factor
1972-10-03 00:00:00,Instituto Geográfico Agustín Codazzi,Takeoff (climb),Business,Colombia,South America,3,1,1,2,2,3,0,Technical Failure
1972-11-08 00:00:00,Gateway Aviation,Flight,Humanitarian,Canada,North America,4,1,0,3,3,3,1,Unknown
1972-11-17 00:00:00,S %26 H Aviation,Flight,Commercial,World,World,3,2,2,1,1,3,0,Technical Failure
1972-11-17 00:00:00,Chilean Air Force - Fuerza Aérea de Chile,Flight,Military / Government,Chile,South America,3,3,3,0,0,3,0,Technical Failure
1972-11-28 00:00:00,M. J. Herman,Landing (descent or approach),Humanitarian,United States of America,North America,3,1,1,2,2,3,0,Human Factor
1972-12-16 00:00:00,Private American,Takeoff (climb),Business,United States of America,North America,3,1,1,2,2,3,0,Technical Failure
1972-12-18 00:00:00,United States Air Force - USAF,Flight,Military / Government,Vietnam,Asia,6,6,3,0,0,3,3,Terrorism
1972-12-21 00:00:00,United States Air Force - USAF,Flight,Military / Government,Vietnam,Asia,6,6,3,0,0,3,3,Terrorism
1972-12-27 00:00:00,Fluor Corp.,Landing (descent or approach),Business,United States of America,North America,3,3,3,0,0,3,0,Human Factor
1973-01-16 00:00:00,Prescott Valley Flying Service,Landing (descent or approach),Business,United States of America,North America,3,1,1,2,2,3,0,Human Factor
1973-01-27 00:00:00,TAN Airlines - Transportes Aéreos Nacionales de Honduras,Landing (descent or approach),Operational,Honduras,Central America,3,3,3,0,0,3,0,Unknown
1973-02-09 00:00:00,Air America,Flight,Operational,Laos,Asia,4,4,3,0,0,3,1,Terrorism
1973-02-17 00:00:00,Hassan Enterprises,Flight,Business,United States of America,North America,3,1,1,2,2,3,0,Human Factor
1973-02-23 00:00:00,Brazilian Air Force - Força Aérea Brasileira,Landing (descent or approach),Operational,Brazil,South America,3,3,3,0,0,3,0,Unknown
1973-03-05 00:00:00,Aviaco - Aviacion y Comercio,Landing (descent or approach),Operational,Portugal,Europe,3,3,3,0,0,3,0,Unknown
1973-03-09 00:00:00,Aeroflot - Russian International Airlines,Flight,Operational,Russia,Asia,3,2,2,1,1,3,0,Human Factor
1973-03-15 00:00:00,Indian Airlines,Landing (descent or approach),Operational,India,Asia,3,3,3,0,0,3,0,Human Factor
1973-03-18 00:00:00,Georg O. Mejlaender Jr.,Landing (descent or approach),Business,United States of America,North America,3,1,1,2,2,3,0,Human Factor
1973-03-22 00:00:00,Air Bolivia,Flight,Operational,Bolivia,South America,3,3,3,0,0,3,0,Unknown
1973-04-15 00:00:00,Pioneer Ventura Aviation,Landing (descent or approach),Business,Colombia,South America,3,2,2,1,1,3,0,Human Factor
1973-05-04 00:00:00,Líder Taxi Aéreo,Landing (descent or approach),Commercial,Brazil,South America,3,2,2,1,1,3,0,Human Factor
1973-05-04 00:00:00,Khmer Airlines,Takeoff (climb),Commercial,Cambodia,Asia,11,3,0,8,3,3,8,Terrorism
1973-05-14 00:00:00,Cubana de Aviación,Landing (descent or approach),Commercial,Cuba,Central America,21,4,0,17,3,3,18,Human Factor
1973-06-09 00:00:00,Aircraft Specialties Company,Takeoff (climb),Military / Government,Canada,North America,3,3,3,0,0,3,0,Human Factor
1973-06-21 00:00:00,Skyways International,Takeoff (climb),Operational,United States of America,North America,3,3,3,0,0,3,0,Weather
1973-06-22 00:00:00,Private German,Landing (descent or approach),Business,Germany,Europe,6,1,1,5,2,3,3,Human Factor
1973-07-05 00:00:00,Aeroflot - Russian International Airlines,Takeoff (climb),Specialised Services,Ukraine,Europe,3,2,2,1,1,3,0,Human Factor
1973-07-18 00:00:00,J. P. Tonkoff,Landing (descent or approach),Business,United States of America,North America,3,1,1,2,2,3,0,Human Factor
1973-09-04 00:00:00,Oliver B. Cannon %26 Sons,Takeoff (climb),Business,United States of America,North America,3,1,1,2,2,3,0,Human Factor
1973-09-08 00:00:00,Aeroflot - Russian International Airlines,Landing (descent or approach),Operational,Russia,Asia,3,3,3,0,0,3,0,Technical Failure
1973-09-25 00:00:00,Lisa Jet,Takeoff (climb),Business,United States of America,North America,3,2,2,1,1,3,0,Human Factor
1973-11-01 00:00:00,Chilean Navy,Flight,Military / Government,Chile,South America,6,6,3,0,0,3,3,Technical Failure
1973-11-03 00:00:00,Pan American World Airways - PAA,Landing (descent or approach),Operational,United States of America,North America,3,3,3,0,0,3,0,Technical Failure
1973-12-03 00:00:00,Guyana Airways,Landing (descent or approach),Commercial,Guyana,South America,4,2,2,2,1,3,1,Unknown
1973-12-15 00:00:00,Aircraft Pool Leasing Corporation,Takeoff (climb),Operational,United States of America,North America,3,3,3,0,0,3,0,Other
1973-12-17 00:00:00,Transportes Aéreos Suravia,Landing (descent or approach),Operational,Chile,South America,3,3,3,0,0,3,0,Technical Failure
1974-01-14 00:00:00,Air Caribbean,Landing (descent or approach),Humanitarian,United States of America,North America,3,2,2,1,1,3,0,Technical Failure
1974-02-05 00:00:00,Court Insurance Company,Flight,Business,United States of America,North America,3,1,1,2,2,3,0,Unknown
1974-02-20 00:00:00,Air Vietnam,Landing (descent or approach),Commercial,Vietnam,Asia,52,6,0,46,3,3,49,Terrorism
1974-03-05 00:00:00,North Coast Air Services,Takeoff (climb),Commercial,Canada,North America,10,1,1,9,2,3,7,Unknown
1974-03-22 00:00:00,Aeroflot - Russian International Airlines,Takeoff (climb),Commercial,Russia,Asia,9,3,3,6,0,3,6,Technical Failure
1974-04-11 00:00:00,North American Industries,Landing (descent or approach),Business,United States of America,North America,3,2,2,1,1,3,0,Human Factor
1974-05-06 00:00:00,Fragtflug,Landing (descent or approach),Operational,Germany,Europe,3,3,3,0,0,3,0,Human Factor
1974-06-15 00:00:00,Seiz Corp.,Takeoff (climb),Business,United States of America,North America,3,1,1,2,2,3,0,Unknown
1974-06-24 00:00:00,IBM - International Business Machines,Flight,Operational,United States of America,North America,3,3,3,0,0,3,0,Technical Failure
1974-07-24 00:00:00,Air France,Landing (descent or approach),Operational,France,Europe,3,3,3,0,0,3,0,Human Factor
1974-07-24 00:00:00,Aeronorte Colombia - Aerovias del Norte,Flight,Operational,Colombia,South America,3,3,3,0,0,3,0,Unknown
1974-07-27 00:00:00,Aeroflot - Russian International Airlines,Flight,Operational,Russia,Asia,3,3,3,0,0,3,0,Technical Failure
1974-08-02 00:00:00,Conair Aviation,Flight,Humanitarian,Canada,North America,3,3,3,0,0,3,0,Unknown
1974-11-07 00:00:00,Earl Hightower,Landing (descent or approach),Business,Mexico,Central America,5,1,1,4,2,3,2,Human Factor
1974-11-07 00:00:00,General Air Center - GAC,Landing (descent or approach),Humanitarian,Denmark,Europe,5,1,1,4,2,3,2,Unknown
1974-11-22 00:00:00,Marine Masters,Landing (descent or approach),Business,United States of America,North America,3,1,1,2,2,3,0,Human Factor
1974-11-30 00:00:00,Sabah Flying Club,Takeoff (climb),Operational,Malaysia,Asia,3,3,3,0,0,3,0,Unknown
1974-12-01 00:00:00,Northwest Airlines,Takeoff (climb),Operational,United States of America,North America,3,3,3,0,0,3,0,Human Factor
1974-12-07 00:00:00,Private Peruvian,Flight,Business,Peru,South America,10,1,0,9,3,3,7,Human Factor
1974-12-13 00:00:00,Les Liaisons Aériennes,Landing (descent or approach),Commercial,Austria,Europe,3,2,2,1,1,3,0,Human Factor
1974-12-26 00:00:00,Togolese Government,Landing (descent or approach),Military / Government,Togo,Africa,6,3,2,3,1,3,3,Unknown
1974-12-27 00:00:00,Anchor Hocking Company,Landing (descent or approach),Business,United States of America,North America,3,3,3,0,0,3,0,Human Factor
1974-12-30 00:00:00,Aeroflot - Russian International Airlines,Takeoff (climb),Commercial,Kazakhstan,Asia,3,2,2,1,1,3,0,Human Factor
1975-02-06 00:00:00,Private American,Flight,Business,United States of America,North America,3,3,3,0,0,3,0,Technical Failure
1975-02-16 00:00:00,Pacific Alaska Airlines - PAA,Takeoff (climb),Operational,United States of America,North America,3,3,3,0,0,3,0,Other
1975-03-10 00:00:00,Aerovias Las Minas,Landing (descent or approach),Operational,Bolivia,South America,3,3,3,0,0,3,0,Unknown
1975-03-16 00:00:00,Carlos Ribeiro,Flight,Business,Brazil,South America,3,1,1,2,2,3,0,Technical Failure
1975-03-20 00:00:00,Officine di Produzione,Flight,Business,Italy,Europe,3,1,1,2,2,3,0,Weather
1975-04-11 00:00:00,Sorya Airlines,Takeoff (climb),Operational,Cambodia,Asia,4,4,3,0,0,3,1,Terrorism
1975-05-09 00:00:00,Motor Parts Manufacturers - MPM,Takeoff (climb),Business,Nigeria,Africa,3,1,1,2,2,3,0,Unknown
1975-05-14 00:00:00,United States Air Force - USAF,Flight,Specialised Services,United States of America,North America,3,3,3,0,0,3,0,Human Factor
1975-06-17 00:00:00,Aeroflot - Russian International Airlines,Flight,Military / Government,Kazakhstan,Asia,3,1,1,2,2,3,0,Human Factor
1975-06-30 00:00:00,Taxi Aéreo El Venado,Landing (descent or approach),Operational,Colombia,South America,3,3,3,0,0,3,0,Human Factor
1975-07-23 00:00:00,Aeroflot - Russian International Airlines,Flight,Military / Government,Azerbaijan,Asia,3,2,2,1,1,3,0,Other
1975-07-26 00:00:00,German Air Force - Deutsche Luftwaffe,Takeoff (climb),Operational,Germany,Europe,3,3,3,0,0,3,0,Unknown
1975-08-03 00:00:00,Turkish Air Force - Türk Hava Kuvvetleri,Flight,Military / Government,Turkey,Asia,3,2,2,1,1,3,0,Unknown
1975-08-08 00:00:00,Bush Aviation,Flight,Business,World,World,3,1,1,2,2,3,0,Technical Failure
1975-08-18 00:00:00,Confederate Air Force,Takeoff (climb),Specialised Services,United States of America,North America,5,5,3,0,0,3,2,Technical Failure
1975-08-19 00:00:00,Schepps Grocery,Landing (descent or approach),Business,United States of America,North America,3,1,1,2,2,3,0,Human Factor
1975-09-03 00:00:00,United States Air Force - USAF,Flight,Operational,United States of America,North America,7,7,3,0,0,3,4,Technical Failure
1975-09-18 00:00:00,Aeroflot - Russian International Airlines,Flight,Operational,Russia,Asia,3,3,3,0,0,3,0,Human Factor
1975-09-18 00:00:00,North Coast Air Services,Flight,Commercial,Canada,North America,3,1,1,2,2,3,0,Unknown
1975-09-25 00:00:00,Ilford Riverton Airways,Landing (descent or approach),Operational,Canada,North America,3,2,2,1,1,3,0,Human Factor
1975-10-24 00:00:00,Escalante Coal,Flight,Business,United States of America,North America,3,1,1,2,2,3,0,Weather
1975-11-22 00:00:00,Balkan Bulgarian Airlines,Takeoff (climb),Commercial,Bulgaria,Europe,46,4,1,42,2,3,43,Human Factor
1976-01-13 00:00:00,Aerovias del Valle,Takeoff (climb),Operational,Costa Rica,Central America,3,2,2,1,1,3,0,Unknown
1976-02-08 00:00:00,Louisa D. A. Carpenter,Landing (descent or approach),Business,United States of America,North America,3,1,1,2,2,3,0,Technical Failure
1976-02-08 00:00:00,Mercer Airlines,Landing (descent or approach),Operational,United States of America,North America,6,5,3,1,0,3,3,Technical Failure
1976-05-14 00:00:00,Drug Enforcement Administration - DEA,Flight,Military / Government,Mexico,Central America,3,1,1,2,2,3,0,Human Factor
1976-05-16 00:00:00,Aeroflot - Russian International Airlines,Flight,Military / Government,Kazakhstan,Asia,4,1,1,3,2,3,1,Human Factor
1976-05-20 00:00:00,Snowy Mountains Hydro-Electric Authority,Landing (descent or approach),Business,Australia,Oceania,3,1,1,2,2,3,0,Human Factor
1976-06-11 00:00:00,Rico Taxi Aéreo - Rondonia Importaçao e Comercio,Flight,Commercial,Brazil,South America,17,3,0,14,3,3,14,Technical Failure
1976-06-30 00:00:00,Aeroflot - Russian International Airlines,Flight,Military / Government,Kazakhstan,Asia,3,2,2,1,1,3,0,Technical Failure
1976-07-23 00:00:00,Fafo Inc.,Landing (descent or approach),Business,Canada,North America,3,1,1,2,2,3,0,Unknown
1976-08-07 00:00:00,Hansa Jet Corporation,Flight,Commercial,Mexico,Central America,3,2,2,1,1,3,0,Human Factor
1976-09-08 00:00:00,Spanish Air Force - Ejército del Aire,Flight,Humanitarian,Spain,Europe,3,3,3,0,0,3,0,Unknown
1976-09-18 00:00:00,Owens Company,Flight,Business,United States of America,North America,3,2,2,1,1,3,0,Weather
1976-10-13 00:00:00,Lloyd Aéreo Boliviano - LAB Airlines,Takeoff (climb),Operational,Bolivia,South America,3,3,3,0,0,3,0,Human Factor
1976-11-17 00:00:00,Jack R. Sproch,Takeoff (climb),Business,United States of America,North America,3,1,1,2,2,3,0,Human Factor
1976-12-04 00:00:00,Baltimore Contractors,Flight,Business,United States of America,North America,3,1,1,2,2,3,0,Human Factor
1976-12-28 00:00:00,Mauritanian Air Force - Force Aérienne Islamique de Mauritanie,Flight,Military / Government,Mauritania,Africa,3,3,3,0,0,3,0,Terrorism
1977-01-07 00:00:00,Air Force of Zimbabwe,Takeoff (climb),Humanitarian,Zimbabwe,Africa,8,3,2,5,1,3,5,Unknown
1977-01-10 00:00:00,Mexican Navy - Armada de México,Takeoff (climb),Military / Government,Mexico,Central America,8,8,3,0,0,3,5,Unknown
1977-03-29 00:00:00,Avex Air Transport,Flight,Military / Government,South Africa,Africa,3,1,1,2,2,3,0,Unknown
1977-03-30 00:00:00,Avex Air Transport,Flight,Specialised Services,South Africa,Africa,3,1,1,2,2,3,0,Unknown
1977-03-31 00:00:00,Royal Canadian Air Force - RCAF,Landing (descent or approach),Operational,Canada,North America,12,12,3,0,0,3,9,Unknown
1977-04-09 00:00:00,Altair Airlines,Landing (descent or approach),Operational,United States of America,North America,3,3,3,0,0,3,0,Human Factor
1977-05-06 00:00:00,Cherokee Enterprise,Takeoff (climb),Business,United States of America,North America,3,1,1,2,2,3,0,Human Factor
1977-05-26 00:00:00,Hellenic Air Force - Elleniki Polemiki Aeroporia,Takeoff (climb),Operational,Greece,Europe,3,3,3,0,0,3,0,Unknown
1977-06-16 00:00:00,Finnwings,Takeoff (climb),Commercial,Finland,Europe,3,1,1,2,2,3,0,Technical Failure
1977-07-06 00:00:00,Fleming International Airways,Takeoff (climb),Operational,United States of America,North America,3,3,3,0,0,3,0,Human Factor
1977-07-25 00:00:00,Motor Parts Manufacturers - MPM,Landing (descent or approach),Business,Ivory Coast,Africa,3,2,2,1,1,3,0,Human Factor
1977-08-04 00:00:00,Robert Schiller,Landing (descent or approach),Business,United States of America,North America,3,1,1,2,2,3,0,Technical Failure
1977-08-11 00:00:00,Aeroflot - Russian International Airlines,Flight,Specialised Services,Russia,Asia,6,3,0,3,3,3,3,Human Factor
1977-08-13 00:00:00,Brower Airways,Takeoff (climb),Commercial,United States of America,North America,3,1,1,2,2,3,0,Unknown
1977-08-13 00:00:00,Ralph Scotts,Flight,Business,United States of America,North America,3,2,2,1,1,3,0,Technical Failure
1977-08-20 00:00:00,Monarch Aviation,Takeoff (climb),Operational,Costa Rica,Central America,3,3,3,0,0,3,0,Unknown
1977-08-25 00:00:00,Chart Aire,Flight,Specialised Services,United States of America,North America,3,2,2,1,1,3,0,Technical Failure
1977-10-06 00:00:00,Republic of Korea Navy,Landing (descent or approach),Operational,South Korea,Asia,3,3,3,0,0,3,0,Technical Failure
1977-10-08 00:00:00,Mark 50 Machinery Sales,Takeoff (climb),Business,United States of America,North America,3,1,1,2,2,3,0,Technical Failure
1977-10-23 00:00:00,Geoterrex,Flight,Specialised Services,Iran,Asia,3,3,3,0,0,3,0,Human Factor
1977-11-07 00:00:00,Mechanical Equipment Company,Takeoff (climb),Business,United States of America,North America,4,2,1,2,2,3,1,Human Factor
1977-11-26 00:00:00,African Lux,Flight,Operational,Mozambique,Africa,3,3,3,0,0,3,0,Terrorism
1977-12-18 00:00:00,United Airlines,Landing (descent or approach),Operational,United States of America,North America,3,3,3,0,0,3,0,Human Factor
1978-01-06 00:00:00,Air Zaïre,Takeoff (climb),Commercial,Democratic Republic of Congo,Africa,22,3,0,19,3,3,19,Unknown
1978-01-18 00:00:00,Frontier Airlines,Takeoff (climb),Operational,United States of America,North America,3,2,2,1,1,3,0,Human Factor
1978-02-22 00:00:00,Maniglia Costruzioni,Landing (descent or approach),Business,Italy,Europe,3,2,2,1,1,3,0,Unknown
1978-02-27 00:00:00,Yute Air Alaska,Flight,Commercial,United States of America,North America,3,1,1,2,2,3,0,Human Factor
1978-02-27 00:00:00,Taquari Agro Comercial,Takeoff (climb),Business,Brazil,South America,3,1,1,2,2,3,0,Unknown
1978-03-08 00:00:00,Spad Aviation,Landing (descent or approach),Business,United States of America,North America,3,2,2,1,1,3,0,Technical Failure
1978-03-25 00:00:00,Astro Airways,Landing (descent or approach),Business,United States of America,North America,6,2,0,4,3,3,3,Human Factor
1978-04-15 00:00:00,United States Air Force - USAF,Landing (descent or approach),Military / Government,United States of America,North America,6,6,3,0,0,3,3,Human Factor
1978-05-01 00:00:00,Wiley C. Puckett,Flight,Humanitarian,United States of America,North America,3,2,2,1,1,3,0,Human Factor
1978-05-07 00:00:00,Aeroflot - Russian International Airlines,Flight,Business,Russia,Asia,3,1,1,2,2,3,0,Human Factor
1978-05-08 00:00:00,National Airlines,Landing (descent or approach),Commercial,United States of America,North America,58,6,0,52,3,3,55,Human Factor
1978-05-10 00:00:00,Private American,Takeoff (climb),Military / Government,United States of America,North America,3,1,1,2,2,3,0,Weather
1978-05-13 00:00:00,Campbell Air Midwest,Landing (descent or approach),Business,United States of America,North America,3,1,1,2,2,3,0,Human Factor
1978-05-23 00:00:00,Transportes Aéreos Bolivar - TAB,Takeoff (climb),Operational,Bolivia,South America,5,5,3,0,0,3,2,Technical Failure
1978-06-08 00:00:00,Aviateca,Landing (descent or approach),Operational,Guatemala,Central America,3,3,3,0,0,3,0,Human Factor
1978-06-10 00:00:00,Hawkins %26 Powers Aviation,Takeoff (climb),Specialised Services,United States of America,North America,4,3,3,1,0,3,1,Unknown
1978-07-05 00:00:00,Portuguese Air Force - Força Aerea Portuguesa,Flight,Military / Government,Portugal,Europe,3,3,3,0,0,3,0,Unknown
1978-09-11 00:00:00,Mercury Aircraft,Landing (descent or approach),Business,United States of America,North America,5,1,1,4,2,3,2,Human Factor
1978-09-17 00:00:00,Viking Air Services,Flight,Commercial,United States of America,North America,3,1,1,2,2,3,0,Unknown
1978-09-23 00:00:00,Aeroflot - Russian International Airlines,Flight,Military / Government,Russia,Asia,3,2,2,1,1,3,0,Human Factor
1978-10-09 00:00:00,Lindberghs Hunt %26 Fish Air,Flight,Commercial,Canada,North America,3,1,1,2,2,3,0,Human Factor
1978-10-17 00:00:00,Private American,Flight,Humanitarian,Colombia,South America,3,3,3,0,0,3,0,Unknown
1978-10-20 00:00:00,Kelco Aircraft Company,Flight,Operational,United States of America,North America,3,3,3,0,0,3,0,Human Factor
1978-10-31 00:00:00,C. R. Morse,Flight,Business,United States of America,North America,3,1,1,2,2,3,0,Human Factor
1978-11-28 00:00:00,Corporate Air - USA,Takeoff (climb),Operational,United States of America,North America,3,1,1,2,2,3,0,Technical Failure
1978-12-05 00:00:00,Caribe Air,Takeoff (climb),Business,United States of America,North America,3,1,1,2,2,3,0,Other
1978-12-08 00:00:00,LAC Colombia - Lineas Aéreas del Caribe,Flight,Operational,Colombia,South America,3,3,3,0,0,3,0,Technical Failure
1978-12-25 00:00:00,Richard N. Smith,Flight,Business,United States of America,North America,3,2,2,1,1,3,0,Human Factor
1979-01-02 00:00:00,Aeroflot - Russian International Airlines,Takeoff (climb),Operational,Antarctica,Antarctica,14,5,3,9,0,3,11,Weather
1979-01-08 00:00:00,Jacksonville Flying Services,Takeoff (climb),Commercial,United States of America,North America,3,2,2,1,1,3,0,Human Factor
1979-01-11 00:00:00,Tamposi-Nash Real Estate Group,Flight,Commercial,United States of America,North America,3,1,1,2,2,3,0,Human Factor
1979-01-11 00:00:00,Ronald L. Quibell,Takeoff (climb),Business,United States of America,North America,3,1,1,2,2,3,0,Human Factor
1979-01-18 00:00:00,Aeroflot - Russian International Airlines,Landing (descent or approach),Operational,Russia,Asia,3,3,3,0,0,3,0,Unknown
1979-01-22 00:00:00,Business Air Travel,Landing (descent or approach),Commercial,United Kingdom,Europe,3,1,1,2,2,3,0,Human Factor
1979-01-28 00:00:00,Ethiopian Airlines,Flight,Operational,Eritrea,Africa,3,3,3,0,0,3,0,Unknown
1979-02-05 00:00:00,Aeropol,Flight,Operational,Bosnia and Herzegovina,Europe,3,3,3,0,0,3,0,Human Factor
1979-02-22 00:00:00,Phillip Moss %26 Company,Landing (descent or approach),Business,United States of America,North America,3,1,1,2,2,3,0,Human Factor
1979-02-23 00:00:00,Private American,Landing (descent or approach),Business,United States of America,North America,4,2,2,2,1,3,1,Human Factor
1979-02-26 00:00:00,Air Gabon,Landing (descent or approach),Operational,Gabon,Africa,3,3,3,0,0,3,0,Unknown
1979-03-10 00:00:00,Swift Aire Lines,Takeoff (climb),Commercial,United States of America,North America,7,3,2,4,1,3,4,Human Factor
1979-03-14 00:00:00,Commonwealth National Bank,Landing (descent or approach),Business,United States of America,North America,3,1,1,2,2,3,0,Human Factor
1979-03-17 00:00:00,Air Inuit,Flight,Operational,World,World,3,3,3,0,0,3,0,Technical Failure
1979-04-18 00:00:00,Aeroservicio Parragué - ASPAR,Flight,Humanitarian,Chile,South America,3,3,3,0,0,3,0,Human Factor
1979-05-11 00:00:00,Private German,Landing (descent or approach),Business,Germany,Europe,3,1,1,2,2,3,0,Technical Failure
1979-05-25 00:00:00,Sea Airmotive,Takeoff (climb),Operational,United States of America,North America,3,3,3,0,0,3,0,Other
1979-05-28 00:00:00,Aeroflot - Russian International Airlines,Takeoff (climb),Specialised Services,Russia,Asia,3,3,3,0,0,3,0,Other
1979-06-19 00:00:00,Lockwood Brothers,Landing (descent or approach),Business,United States of America,North America,5,1,1,4,2,3,2,Human Factor
1979-06-27 00:00:00,T. E. Carrillo Batalla,Flight,Business,Venezuela,South America,3,1,1,2,2,3,0,Unknown
1979-07-05 00:00:00,Aeroflot - Russian International Airlines,Flight,Military / Government,Russia,Asia,3,2,2,1,1,3,0,Human Factor
1979-07-23 00:00:00,Venezuelan National Guard - Guardia Nacional Bolivariana de Venezuela,Flight,Military / Government,Guyana,South America,9,2,0,7,3,3,6,Human Factor
1979-07-26 00:00:00,Lufthansa,Takeoff (climb),Operational,Brazil,South America,3,3,3,0,0,3,0,Human Factor
1979-08-23 00:00:00,IFG Leasing Company,Flight,Specialised Services,United States of America,North America,3,1,1,2,2,3,0,Weather
1979-09-23 00:00:00,Lowery Aircraft Parts,Takeoff (climb),Operational,United States of America,North America,3,2,2,1,1,3,0,Human Factor
1979-10-03 00:00:00,Southeast Skyways,Flight,Commercial,United States of America,North America,3,1,1,2,2,3,0,Human Factor
1979-10-27 00:00:00,Aeroflot - Russian International Airlines,Takeoff (climb),Commercial,Russia,Asia,12,2,1,10,2,3,9,Technical Failure
1979-11-01 00:00:00,Austin Airways,Landing (descent or approach),Commercial,Canada,North America,12,2,2,10,1,3,9,Human Factor
1979-11-05 00:00:00,Douglas Airways,Flight,Commercial,Papua New Guinea,Oceania,10,1,0,9,3,3,7,Human Factor
1979-11-16 00:00:00,Aeroflot - Russian International Airlines,Landing (descent or approach),Operational,Russia,Asia,5,5,3,0,0,3,2,Human Factor
1979-11-16 00:00:00,Jay B. Claster,Takeoff (climb),Business,United States of America,North America,3,1,1,2,2,3,0,Technical Failure
1979-11-18 00:00:00,Transamerica Airlines,Flight,Operational,United States of America,North America,3,3,3,0,0,3,0,Technical Failure
1979-11-26 00:00:00,Smithers Air Service,Takeoff (climb),Commercial,Canada,North America,4,1,0,3,3,3,1,Human Factor
1979-12-10 00:00:00,Ferruzzi,Landing (descent or approach),Business,Italy,Europe,3,2,2,1,1,3,0,Human Factor
1979-12-23 00:00:00,Transaéreos Frimo - Frigorifico Movima,Landing (descent or approach),Operational,Bolivia,South America,3,3,3,0,0,3,0,Unknown
1979-12-23 00:00:00,Transaéreos Frimo - Frigorifico Movima,Landing (descent or approach),Operational,Bolivia,South America,3,3,3,0,0,3,0,Unknown
1980-01-18 00:00:00,Aeroflot - Russian International Airlines,Flight,Military / Government,Lithuania,Europe,4,1,0,3,3,3,1,Human Factor
1980-02-01 00:00:00,Instituto Nacional de Tecnología Agropecuaria,Flight,Military / Government,Argentina,South America,3,1,1,2,2,3,0,Unknown
1980-02-08 00:00:00,Air Zaïre,Takeoff (climb),Operational,Democratic Republic of Congo,Africa,3,3,3,0,0,3,0,Unknown
1980-02-15 00:00:00,William J. Evans,Flight,Humanitarian,Haiti,Central America,3,3,3,0,0,3,0,Technical Failure
1980-02-18 00:00:00,Arctic Guide Air Taxi,Takeoff (climb),Commercial,United States of America,North America,3,1,1,2,2,3,0,Human Factor
1980-03-03 00:00:00,Merchant Bank,Landing (descent or approach),Business,Haiti,Central America,4,2,2,2,1,3,1,Human Factor
1980-03-25 00:00:00,South African Air Force,Flight,Military / Government,Namibia,Africa,3,3,3,0,0,3,0,Unknown
1980-04-10 00:00:00,Salvadorian Air Force - Fuerza Aérea Salvadoreña,Landing (descent or approach),Military / Government,Guatemala,Central America,3,2,2,1,1,3,0,Weather
1980-04-11 00:00:00,Clifford A. Hackney Sr.,Takeoff (climb),Specialised Services,United States of America,North America,6,3,3,3,0,3,3,Technical Failure
1980-05-13 00:00:00,Cubana de Aviación,Flight,Operational,Cuba,Central America,3,3,3,0,0,3,0,Unknown
1980-05-24 00:00:00,Charles Clay,Takeoff (climb),Operational,United States of America,North America,3,2,2,1,1,3,0,Human Factor
1980-05-30 00:00:00,Aeroflot - Russian International Airlines,Flight,Commercial,Russia,Asia,3,2,2,1,1,3,0,Human Factor
1980-06-02 00:00:00,Soviet Air Force - Voyenno-vozdushnye sily CCCP,Landing (descent or approach),Military / Government,Russia,Asia,6,6,3,0,0,3,3,Technical Failure
1980-06-22 00:00:00,Air Traders International,Takeoff (climb),Operational,United States of America,North America,8,3,2,5,1,3,5,Human Factor
1980-06-24 00:00:00,Air Affaires Afrique,Takeoff (climb),Business,Cameroon,Africa,3,2,2,1,1,3,0,Technical Failure
1980-07-12 00:00:00,Unnamed operator,Landing (descent or approach),Humanitarian,Haiti,Central America,3,1,1,2,2,3,0,Human Factor
1980-07-25 00:00:00,Air Pennsylvania,Landing (descent or approach),Commercial,United States of America,North America,3,2,2,1,1,3,0,Weather
1980-08-11 00:00:00,Prospec,Takeoff (climb),Specialised Services,Brazil,South America,3,1,1,2,2,3,0,Unknown
1980-08-31 00:00:00,Hansa Luftbild,Takeoff (climb),Operational,Germany,Europe,3,2,2,1,1,3,0,Unknown
1980-09-10 00:00:00,Aeronorte Colombia - Aerovias del Norte,Flight,Operational,Colombia,South America,3,3,3,0,0,3,0,Weather
1980-09-12 00:00:00,Aeronaves del Peru,Landing (descent or approach),Operational,Peru,South America,3,3,3,0,0,3,0,Human Factor
1980-09-15 00:00:00,JMG,Flight,Business,Haiti,Central America,4,3,2,1,1,3,1,Technical Failure
1980-09-16 00:00:00,French Air Force - Armée de l'Air,Flight,Military / Government,France,Europe,3,3,3,0,0,3,0,Unknown
1980-09-22 00:00:00,Flugfélag Austurlands,Landing (descent or approach),Commercial,Iceland,Europe,3,1,1,2,2,3,0,Human Factor
1980-10-17 00:00:00,Michael C. Joseph,Flight,Business,United States of America,North America,3,1,1,2,2,3,0,Human Factor
1980-10-24 00:00:00,Tampa Air Centre,Landing (descent or approach),Commercial,United States of America,North America,3,1,1,2,2,3,0,Technical Failure
1980-10-28 00:00:00,Aeroflot - Russian International Airlines,Flight,Operational,Russia,Asia,3,2,2,1,1,3,0,Human Factor
1980-12-02 00:00:00,Mountain Farm Bakery,Landing (descent or approach),Business,United States of America,North America,3,1,1,2,2,3,0,Human Factor
1980-12-19 00:00:00,Langham Petroleum Corporation,Landing (descent or approach),Business,United States of America,North America,4,2,2,2,1,3,1,Human Factor
1980-12-26 00:00:00,Servicios Aéreos Regiomontanos - SARSA,Takeoff (climb),Operational,Mexico,Central America,3,3,3,0,0,3,0,Unknown
1981-01-07 00:00:00,U.S. Department of Energy,Landing (descent or approach),Military / Government,United States of America,North America,3,2,2,1,1,3,0,Unknown
1981-01-15 00:00:00,Royal Netherlands Navy - Marineluchtvaartdienst,Flight,Military / Government,World,World,12,4,0,8,3,3,9,Technical Failure
1981-01-16 00:00:00,Private German,Takeoff (climb),Business,Germany,Europe,3,1,1,2,2,3,0,Technical Failure
1981-02-19 00:00:00,SS Airways,Landing (descent or approach),Business,United States of America,North America,3,1,1,2,2,3,0,Human Factor
1981-03-02 00:00:00,Solventes y Productos Químicos,Takeoff (climb),Business,Mexico,Central America,4,2,2,2,1,3,1,Technical Failure
1981-03-03 00:00:00,Calspan Corporation,Flight,Business,United States of America,North America,3,3,3,0,0,3,0,Technical Failure
1981-04-23 00:00:00,J %26 S Leasing,Landing (descent or approach),Business,United States of America,North America,3,1,1,2,2,3,0,Human Factor
1981-05-01 00:00:00,Houston Piper Aviation,Flight,Business,United States of America,North America,3,1,1,2,2,3,0,Human Factor
1981-05-31 00:00:00,Algerian Government,Landing (descent or approach),Military / Government,Mali,Africa,6,4,3,2,0,3,3,Weather
1981-06-23 00:00:00,Aeroflot - Russian International Airlines,Flight,Military / Government,Kazakhstan,Asia,3,2,2,1,1,3,0,Weather
1981-06-26 00:00:00,Dan-Air London,Landing (descent or approach),Operational,United Kingdom,Europe,3,3,3,0,0,3,0,Technical Failure
1981-07-01 00:00:00,United Aircraft Services,Takeoff (climb),Operational,United States of America,North America,3,3,3,0,0,3,0,Technical Failure
1981-07-02 00:00:00,Universal Airways - USA,Flight,Business,United States of America,North America,3,1,1,2,2,3,0,Human Factor
1981-07-09 00:00:00,Kelowna Flightcraft Air Charter,Takeoff (climb),Operational,Canada,North America,3,3,3,0,0,3,0,Human Factor
1981-07-14 00:00:00,Aero Union,Landing (descent or approach),Operational,United States of America,North America,3,3,3,0,0,3,0,Technical Failure
1981-07-29 00:00:00,Cowin %26 Company,Landing (descent or approach),Business,United States of America,North America,3,1,1,2,2,3,0,Human Factor
1981-08-29 00:00:00,Aeroflot - Russian International Airlines,Landing (descent or approach),Commercial,Russia,Asia,34,5,2,29,1,3,31,Human Factor
1981-09-01 00:00:00,Private Venezuelan,Flight,Business,Venezuela,South America,4,1,1,3,2,3,1,Unknown
1981-09-02 00:00:00,Royal Canadian Air Force - RCAF,Flight,Operational,Canada,North America,3,3,3,0,0,3,0,Human Factor
1981-10-01 00:00:00,Sky Train Air,Flight,Business,United States of America,North America,3,2,2,1,1,3,0,Weather
1981-10-26 00:00:00,Aerolineas Argo,Landing (descent or approach),Operational,United States of America,Central America,5,3,3,2,0,3,2,Human Factor
1981-11-21 00:00:00,Western Broadcasting Company,Flight,Business,United States of America,North America,3,1,1,2,2,3,0,Human Factor
1981-11-30 00:00:00,Guyana Airways,Takeoff (climb),Operational,Saint Lucia,Central America,3,3,3,0,0,3,0,Technical Failure
1982-02-09 00:00:00,Trans Air Service,Flight,Commercial,Philippines,Asia,32,3,2,29,1,3,29,Unknown
1982-03-16 00:00:00,Bacchus Aviation,Flight,Business,United States of America,North America,3,1,1,2,2,3,0,Weather
1982-03-26 00:00:00,Dornier Flugzeugwerke,Flight,Specialised Services,Germany,Europe,3,3,3,0,0,3,0,Human Factor
1982-04-18 00:00:00,San Jet,Takeoff (climb),Business,United States of America,North America,3,2,2,1,1,3,0,Human Factor
1982-05-05 00:00:00,Private Brazilian,Flight,Business,Venezuela,South America,3,1,1,2,2,3,0,Unknown
1982-09-18 00:00:00,Jetair,Landing (descent or approach),Commercial,Luxembourg,Europe,3,2,2,1,1,3,0,Unknown
1982-09-26 00:00:00,Donald Nelson,Flight,Business,United States of America,North America,3,1,1,2,2,3,0,Human Factor
1982-10-03 00:00:00,Panorama Air Tour,Flight,Operational,United States of America,North America,3,1,1,2,2,3,0,Unknown
1982-10-14 00:00:00,Aeroflot - Russian International Airlines,Flight,Humanitarian,Russia,Asia,3,2,2,1,1,3,0,Human Factor
1982-10-18 00:00:00,Vintage Sales Corporation,Landing (descent or approach),Humanitarian,United States of America,North America,3,3,3,0,0,3,0,Human Factor
1982-10-27 00:00:00,Standard Fittings,Landing (descent or approach),Business,United States of America,North America,3,1,1,2,2,3,0,Human Factor
1982-10-31 00:00:00,Moore Data Systems,Takeoff (climb),Business,United States of America,North America,3,1,1,2,2,3,0,Human Factor
1982-11-05 00:00:00,L. F. Vanstone Jr.,Flight,Business,Bahamas,Central America,3,2,2,1,1,3,0,Weather
1982-11-16 00:00:00,Brazilian Air Force - Força Aérea Brasileira,Takeoff (climb),Military / Government,Brazil,South America,3,2,2,1,1,3,0,Unknown
1982-11-18 00:00:00,Coin Acceptors,Takeoff (climb),Business,United States of America,North America,3,1,1,2,2,3,0,Human Factor
1982-12-05 00:00:00,Ministry of Agriculture and Hydraulic Resources,Flight,Military / Government,Mexico,Central America,3,2,2,1,1,3,0,Technical Failure
1982-12-08 00:00:00,Graham W. Wood,Takeoff (climb),Business,United States of America,North America,3,1,1,2,2,3,0,Technical Failure
1983-01-11 00:00:00,United Airlines,Takeoff (climb),Operational,United States of America,North America,3,3,3,0,0,3,0,Human Factor
1983-04-08 00:00:00,Aeroflot - Russian International Airlines,Flight,Military / Government,Kazakhstan,Asia,3,2,2,1,1,3,0,Human Factor
1983-04-13 00:00:00,Questor Surveys,Flight,Commercial,Philippines,Asia,3,1,1,2,2,3,0,Unknown
1983-04-26 00:00:00,Flight Brothers,Landing (descent or approach),Operational,United States of America,North America,3,3,3,0,0,3,0,Human Factor
1983-05-12 00:00:00,Roger Franklin Brumley,Flight,Business,United States of America,North America,3,1,1,2,2,3,0,Human Factor
1983-05-18 00:00:00,Air Traffic,Flight,Operational,World,World,3,2,2,1,1,3,0,Technical Failure
1983-05-30 00:00:00,La Tuque Air Service,Flight,Commercial,Canada,North America,5,1,0,4,3,3,2,Human Factor
1983-06-02 00:00:00,Garuda Indonesian Airways,Takeoff (climb),Commercial,Indonesia,Asia,61,4,2,57,1,3,58,Human Factor
1983-06-08 00:00:00,Indian Air Force - Bharatiya Vayu Sena,Flight,Military / Government,India,Asia,3,3,3,0,0,3,0,Unknown
1983-10-19 00:00:00,United States Army,Flight,Operational,United States of America,North America,3,3,3,0,0,3,0,Unknown
1983-10-20 00:00:00,Wil-Mc Oil Company,Landing (descent or approach),Business,United States of America,North America,3,1,1,2,2,3,0,Human Factor
1983-10-20 00:00:00,Aeroflot - Russian International Airlines,Flight,Operational,Afghanistan,Asia,3,3,3,0,0,3,0,Terrorism
1983-10-20 00:00:00,Aeroflot - Russian International Airlines,Landing (descent or approach),Operational,Afghanistan,Asia,3,3,3,0,0,3,0,Terrorism
1983-11-24 00:00:00,United States Navy - USN,Flight,Military / Government,World,World,3,3,3,0,0,3,0,Human Factor
1983-12-14 00:00:00,TAMPA Cargo,Takeoff (climb),Operational,Colombia,South America,3,3,3,0,0,3,0,Technical Failure
1984-01-30 00:00:00,Britt Airways,Takeoff (climb),Operational,United States of America,North America,3,2,2,1,1,3,0,Unknown
1984-03-05 00:00:00,Cumberland Airlines,Landing (descent or approach),Commercial,United States of America,North America,3,1,1,2,2,3,0,Human Factor
1984-03-08 00:00:00,United States Navy - USN,Landing (descent or approach),Military / Government,United States of America,North America,3,3,3,0,0,3,0,Unknown
1984-03-10 00:00:00,Hellenic Air Force - Elleniki Polemiki Aeroporia,Landing (descent or approach),Operational,Greece,Europe,3,3,3,0,0,3,0,Technical Failure
1984-05-16 00:00:00,Private Australian,Landing (descent or approach),Business,Australia,Oceania,3,1,1,2,2,3,0,Technical Failure
1984-06-04 00:00:00,Air Continental,Landing (descent or approach),Operational,United States of America,North America,3,2,2,1,1,3,0,Technical Failure
1984-07-05 00:00:00,Aeroflot - Russian International Airlines,Flight,Military / Government,Kazakhstan,Asia,3,2,2,1,1,3,0,Human Factor
1984-07-06 00:00:00,Govenment of Baluchistan,Flight,Military / Government,Pakistan,Asia,4,1,1,3,2,3,1,Unknown
1984-07-20 00:00:00,John Chura %26 Joseph Heinlein,Flight,Business,United States of America,North America,4,1,1,3,2,3,1,Technical Failure
1984-07-22 00:00:00,Thai Flying Service,Landing (descent or approach),Commercial,Thailand,Asia,8,2,0,6,3,3,5,Technical Failure
1984-08-01 00:00:00,Brister,Flight,Business,United States of America,North America,3,1,1,2,2,3,0,Weather
1984-08-11 00:00:00,Aviation Enterprises,Landing (descent or approach),Operational,United States of America,North America,3,2,2,1,1,3,0,Human Factor
1984-10-04 00:00:00,McCollum Aviation,Takeoff (climb),Operational,United States of America,North America,3,2,2,1,1,3,0,Human Factor
1984-10-08 00:00:00,Clay Lacy Aviation,Takeoff (climb),Operational,United States of America,North America,3,2,2,1,1,3,0,Unknown
1984-10-17 00:00:00,G. W. Martin Veneer Ltd,Landing (descent or approach),Business,Canada,North America,3,1,1,2,2,3,0,Human Factor
1984-12-20 00:00:00,Air Tanzania,Flight,Operational,Tanzania,Africa,3,3,3,0,0,3,0,Human Factor
1984-12-20 00:00:00,Jet East,Takeoff (climb),Operational,United States of America,North America,3,3,3,0,0,3,0,Human Factor
1984-12-22 00:00:00,Calm Air International,Flight,Humanitarian,Canada,North America,3,2,2,1,1,3,0,Unknown
1985-01-09 00:00:00,TPI International Airways,Landing (descent or approach),Operational,United States of America,North America,3,3,3,0,0,3,0,Human Factor
1985-01-23 00:00:00,Aeroflot - Russian International Airlines,Flight,Commercial,Russia,Asia,3,2,2,1,1,3,0,Human Factor
1985-02-24 00:00:00,Alfred Wegener Institute,Flight,Operational,Western Sahara,Africa,3,3,3,0,0,3,0,Terrorism
1985-02-25 00:00:00,WTS Inc.,Flight,Operational,United States of America,North America,3,2,2,1,1,3,0,Human Factor
1985-02-25 00:00:00,United States Air Force - USAF,Flight,Operational,United States of America,North America,3,3,3,0,0,3,0,Human Factor
1985-03-17 00:00:00,UKW Technik,Flight,Business,Germany,Europe,3,1,1,2,2,3,0,Unknown
1985-03-20 00:00:00,Argentinian Air Force - Fuerza Aérea Argentina,Flight,Operational,Argentina,South America,3,3,3,0,0,3,0,Human Factor
1985-03-28 00:00:00,Charles F. Dimino,Takeoff (climb),Business,Bahamas,Central America,3,1,1,2,2,3,0,Unknown
1985-06-01 00:00:00,Aeroflot - Russian International Airlines,Flight,Commercial,Kazakhstan,Asia,3,2,2,1,1,3,0,Human Factor
1985-07-05 00:00:00,Private Colombian,Flight,Humanitarian,Colombia,South America,3,2,2,1,1,3,0,Human Factor
1985-07-07 00:00:00,LACOL Colombia - Lineas Aéreas Colombianas,Takeoff (climb),Operational,Colombia,South America,6,2,0,4,3,3,3,Other
1985-07-21 00:00:00,Kenting Earth Sciences,Flight,Military / Government,Canada,North America,3,1,1,2,2,3,0,Unknown
1985-08-20 00:00:00,ERA Aviation,Landing (descent or approach),Commercial,United States of America,North America,3,2,2,1,1,3,0,Human Factor
1985-08-28 00:00:00,Sunbird Airlines,Flight,Operational,United States of America,North America,3,3,3,0,0,3,0,Human Factor
1985-08-30 00:00:00,Douglas Airways,Flight,Commercial,Papua New Guinea,Oceania,6,1,1,5,2,3,3,Human Factor
1985-09-26 00:00:00,Willow Air Service,Flight,Commercial,United States of America,North America,3,1,1,2,2,3,0,Human Factor
1985-10-08 00:00:00,Air Liberia,Takeoff (climb),Operational,Liberia,Africa,3,3,3,0,0,3,0,Unknown
1985-10-23 00:00:00,Japan Air Self-Defense Force - Kōkū Jieitai,Flight,Operational,Japan,Asia,3,3,3,0,0,3,0,Human Factor
1985-11-20 00:00:00,Oxaero - Oxford Aerocharter,Landing (descent or approach),Commercial,United Kingdom,Europe,3,1,1,2,2,3,0,Human Factor
1985-12-08 00:00:00,Corporate Air - USA,Landing (descent or approach),Operational,United States of America,North America,3,3,3,0,0,3,0,Human Factor
1985-12-16 00:00:00,Rieker Air Service,Takeoff (climb),Business,Switzerland,Europe,3,1,1,2,2,3,0,Human Factor
1986-01-27 00:00:00,Charles R. Maddox,Takeoff (climb),Business,United States of America,North America,3,1,1,2,2,3,0,Technical Failure
1986-02-11 00:00:00,Ryan Air,Takeoff (climb),Commercial,United States of America,North America,3,1,1,2,2,3,0,Weather
1986-03-13 00:00:00,Simmons Airlines,Landing (descent or approach),Commercial,United States of America,North America,9,2,1,7,2,3,6,Human Factor
1986-06-19 00:00:00,Aeronorte Colombia - Aerovias del Norte,Landing (descent or approach),Operational,Colombia,South America,3,3,3,0,0,3,0,Technical Failure
1986-06-27 00:00:00,Frontier Airways,Takeoff (climb),Military / Government,United States of America,North America,3,2,2,1,1,3,0,Human Factor
1986-07-16 00:00:00,Health Care %26 Retirement Corporation,Landing (descent or approach),Business,United States of America,North America,6,2,1,4,2,3,3,Human Factor
1986-08-07 00:00:00,Indian Navy - Bharatiya Nau Sena,Flight,Military / Government,India,Asia,3,3,3,0,0,3,0,Unknown
1986-09-05 00:00:00,TAROM - Transporturile Aeriene Române,Landing (descent or approach),Commercial,Romania,Europe,55,5,3,50,0,3,52,Human Factor
1986-09-09 00:00:00,United States Air Force - USAF,Landing (descent or approach),Military / Government,United States of America,North America,5,5,3,0,0,3,2,Technical Failure
1986-10-03 00:00:00,Private Colombian,Landing (descent or approach),Business,Colombia,South America,3,1,1,2,2,3,0,Human Factor
1986-10-04 00:00:00,Southern Air Transport,Takeoff (climb),Operational,United States of America,North America,3,3,3,0,0,3,0,Human Factor
1986-10-05 00:00:00,Corporate Air Services,Flight,Operational,Nicaragua,Central America,4,4,3,0,0,3,1,Terrorism
1986-10-09 00:00:00,T %26 G Aviation,Takeoff (climb),Military / Government,Senegal,Africa,4,3,3,1,0,3,1,Technical Failure
1986-10-15 00:00:00,Iran Air,Taxiing,Commercial,Iran,Asia,80,5,0,75,3,3,77,Terrorism
1987-01-11 00:00:00,Kitaro Takahashi Sanko Kensetsu,Flight,Business,Japan,Asia,3,1,1,2,2,3,0,Technical Failure
1987-01-20 00:00:00,United States Army,Flight,Military / Government,United States of America,North America,3,1,1,2,2,3,0,Human Factor
1987-01-20 00:00:00,Sachs Electric Company,Flight,Business,United States of America,North America,3,1,1,2,2,3,0,Human Factor
1987-02-11 00:00:00,Air Force of Zimbabwe,Landing (descent or approach),Military / Government,Mozambique,Africa,3,3,3,0,0,3,0,Unknown
1987-03-09 00:00:00,International Flight Center,Flight,Humanitarian,Dominican Republic,Central America,3,3,3,0,0,3,0,Human Factor
1987-03-10 00:00:00,Aero Express - USA,Flight,Humanitarian,Honduras,Central America,3,3,3,0,0,3,0,Terrorism
1987-03-25 00:00:00,Venezuelan Navy - Armada Venezolana,Flight,Military / Government,Venezuela,South America,3,3,3,0,0,3,0,Unknown
1987-03-26 00:00:00,Brazilian Air Force - Força Aérea Brasileira,Takeoff (climb),Military / Government,Brazil,South America,3,3,3,0,0,3,0,Human Factor
1987-03-27 00:00:00,Kalitta Charters - Kalitta Services,Landing (descent or approach),Humanitarian,United States of America,North America,3,2,2,1,1,3,0,Human Factor
1987-04-13 00:00:00,Barlow Rand,Takeoff (climb),Operational,South Africa,Africa,5,5,3,0,0,3,2,Technical Failure
1987-05-01 00:00:00,Midwest Packaging Materials Company,Landing (descent or approach),Business,United States of America,North America,3,1,1,2,2,3,0,Human Factor
1987-05-04 00:00:00,Indonesian Navy - TNI-AL Tentara Nasional Indonesia - Angkatan Laut,Flight,Military / Government,Indonesia,Asia,14,2,1,12,2,3,11,Technical Failure
1987-05-20 00:00:00,Burggraf Construction,Landing (descent or approach),Business,United States of America,North America,3,1,1,2,2,3,0,Human Factor
1987-05-30 00:00:00,Travel Air Flug,Landing (descent or approach),Commercial,Germany,Europe,4,2,2,2,1,3,1,Human Factor
1987-06-22 00:00:00,Afghan Republican Air Force - Afghan Hanai Qurah,Takeoff (climb),Military / Government,Afghanistan,Asia,3,3,3,0,0,3,0,Terrorism
1987-06-25 00:00:00,SATENA - Servicio de Aeronavegacion a Territorios Nacionales,Takeoff (climb),Military / Government,Colombia,South America,4,1,1,3,2,3,1,Unknown
1987-07-06 00:00:00,Octavia Air,Landing (descent or approach),Business,Denmark,Europe,3,2,2,1,1,3,0,Human Factor
1987-07-12 00:00:00,Soviet Air Force - Voyenno-vozdushnye sily CCCP,Landing (descent or approach),Military / Government,Afghanistan,Asia,6,6,3,0,0,3,3,Terrorism
1987-07-23 00:00:00,Guatemalan Air Force - Fuerza Aérea Guatemalteca,Flight,Humanitarian,Guatemala,Central America,3,3,3,0,0,3,0,Unknown
1987-08-11 00:00:00,Lechmetall Landsberg,Landing (descent or approach),Operational,Germany,Europe,3,2,2,1,1,3,0,Human Factor
1987-09-04 00:00:00,Aeroflot - Russian International Airlines,Flight,Military / Government,Russia,Asia,3,2,2,1,1,3,0,Human Factor
1987-09-16 00:00:00,Hawkins %26 Powers Aviation,Flight,Humanitarian,United States of America,North America,3,3,3,0,0,3,0,Technical Failure
1987-10-15 00:00:00,Falcon Jet Corporation,Takeoff (climb),Operational,United States of America,North America,3,2,2,1,1,3,0,Human Factor
1987-10-21 00:00:00,French Air Force - Armée de l'Air,Flight,Operational,France,Europe,3,3,3,0,0,3,0,Unknown
1988-01-10 00:00:00,American Way Service Corporation,Takeoff (climb),Operational,United States of America,North America,3,3,3,0,0,3,0,Technical Failure
1988-01-23 00:00:00,Ecuadorian Air Force - Fuerza Aérea Ecuatoriana,Takeoff (climb),Operational,Ecuador,South America,3,3,3,0,0,3,0,Unknown
1988-02-03 00:00:00,Minuteman Aviation,Landing (descent or approach),Commercial,United States of America,North America,3,2,2,1,1,3,0,Human Factor
1988-02-09 00:00:00,Jetstream International Airlines,Landing (descent or approach),Operational,United States of America,North America,3,3,3,0,0,3,0,Human Factor
1988-02-13 00:00:00,Musée Aéronautique Français,Flight,Specialised Services,France,Europe,3,3,3,0,0,3,0,Human Factor
1988-02-19 00:00:00,Atlantic City Air Taxi,Landing (descent or approach),Commercial,United States of America,North America,3,2,2,1,1,3,0,Weather
1988-02-19 00:00:00,Donald McCoy,Takeoff (climb),Business,United States of America,North America,3,1,1,2,2,3,0,Human Factor
1988-03-09 00:00:00,Private Colombian,Flight,Business,Colombia,South America,3,1,1,2,2,3,0,Unknown
1988-04-07 00:00:00,Oxley Airlines,Landing (descent or approach),Commercial,Australia,Oceania,7,1,1,6,2,3,4,Human Factor
1988-06-13 00:00:00,Private Colombian,Flight,Humanitarian,Mexico,Central America,3,2,2,1,1,3,0,Unknown
1988-06-26 00:00:00,Air France,Flight,Operational,France,Europe,136,6,0,130,3,3,133,Human Factor
1988-07-06 00:00:00,Líneas Aéreas Suramericanas,Landing (descent or approach),Operational,Colombia,South America,8,3,3,5,0,3,5,Technical Failure
1988-07-20 00:00:00,TACA International Airlines - Transportes Aéreos Centro Americanos,Landing (descent or approach),Operational,United States of America,North America,3,3,3,0,0,3,0,Technical Failure
1988-08-02 00:00:00,Geoterrex,Landing (descent or approach),Operational,Iceland,Europe,3,3,3,0,0,3,0,Human Factor
1988-08-16 00:00:00,Rickey L. Newsom,Landing (descent or approach),Business,United States of America,North America,3,1,1,2,2,3,0,Human Factor
1988-08-25 00:00:00,Lewis E. Phillips,Takeoff (climb),Business,United States of America,North America,3,2,2,1,1,3,0,Technical Failure
1988-09-05 00:00:00,Venezuelan National Guard - Guardia Nacional Bolivariana de Venezuela,Takeoff (climb),Military / Government,Venezuela,South America,3,3,3,0,0,3,0,Unknown
1988-10-16 00:00:00,Simpson Air,Landing (descent or approach),Commercial,Canada,North America,3,1,1,2,2,3,0,Unknown
1988-11-01 00:00:00,Delhi Australian Petroleum,Flight,Military / Government,Australia,Oceania,3,3,3,0,0,3,0,Technical Failure
1988-11-02 00:00:00,Federal Aviation Administration - FAA,Landing (descent or approach),Specialised Services,United States of America,North America,3,3,3,0,0,3,0,Human Factor
1988-12-05 00:00:00,Private Australian,Flight,Operational,Australia,Oceania,3,2,2,1,1,3,0,Unknown
1989-01-26 00:00:00,Aeroflot - Russian International Airlines,Parking,Commercial,Antarctica,Antarctica,3,3,3,0,0,3,0,Technical Failure
1989-02-06 00:00:00,Inter Cargo Services - ICS,Takeoff (climb),Operational,France,Europe,3,3,3,0,0,3,0,Technical Failure
1989-03-04 00:00:00,Herbert G. Hinkelman,Flight,Business,United States of America,North America,3,1,1,2,2,3,0,Human Factor
1989-03-13 00:00:00,Air Sud Ouest,Landing (descent or approach),Commercial,France,Europe,3,1,1,2,2,3,0,Unknown
1989-03-21 00:00:00,Transbrasil,Landing (descent or approach),Operational,Brazil,South America,3,3,3,0,0,3,0,Human Factor
1989-04-10 00:00:00,Southern Company Services,Takeoff (climb),Business,United States of America,North America,3,2,2,1,1,3,0,Technical Failure
1989-05-22 00:00:00,Condor Enterprises,Flight,Operational,United States of America,North America,3,3,3,0,0,3,0,Human Factor
1989-05-31 00:00:00,Stout Leasing,Flight,Business,United States of America,North America,3,1,1,2,2,3,0,Weather
1989-06-21 00:00:00,Aerostar Transport,Takeoff (climb),Business,United States of America,North America,3,1,1,2,2,3,0,Technical Failure
1989-06-24 00:00:00,South West Air - Canada,Takeoff (climb),Humanitarian,Canada,North America,5,2,1,3,2,3,2,Unknown
1989-06-28 00:00:00,Cameroon Airlines,Landing (descent or approach),Commercial,Cameroon,Africa,47,5,2,42,1,3,44,Human Factor
1989-07-21 00:00:00,Talair,Landing (descent or approach),Commercial,Papua New Guinea,Oceania,22,2,2,20,1,3,19,Unknown
1989-07-29 00:00:00,École de parachutisme d’Île de France,Flight,Humanitarian,France,Europe,3,1,1,2,2,3,0,Human Factor
1989-07-31 00:00:00,Air Freight NZ,Takeoff (climb),Operational,New Zealand,Oceania,3,3,3,0,0,3,0,Human Factor
1989-08-21 00:00:00,Mercy Flights,Landing (descent or approach),Commercial,United States of America,North America,3,3,3,0,0,3,0,Human Factor
1989-08-22 00:00:00,CVG Ferrominera Orinoco,Takeoff (climb),Operational,Venezuela,South America,4,4,3,0,0,3,1,Unknown
1989-09-15 00:00:00,Widefield Homes,Landing (descent or approach),Specialised Services,United States of America,North America,3,1,1,2,2,3,0,Human Factor
1989-10-02 00:00:00,Bali International Air Service,Landing (descent or approach),Commercial,Indonesia,Asia,7,2,0,5,3,3,4,Human Factor
1989-11-28 00:00:00,Lineas Aéreas CAVE,Takeoff (climb),Commercial,Venezuela,South America,7,1,0,6,3,3,4,Unknown
1990-01-23 00:00:00,Kungsair,Landing (descent or approach),Commercial,Sweden,Europe,3,1,1,2,2,3,0,Unknown
1990-01-28 00:00:00,DOSAAF,Takeoff (climb),Humanitarian,Russia,Asia,15,2,0,13,3,3,12,Other
1990-03-21 00:00:00,TAN Airlines - Transportes Aéreos Nacionales de Honduras,Landing (descent or approach),Operational,Honduras,Central America,3,3,3,0,0,3,0,Human Factor
1990-05-04 00:00:00,Summit Air Charters,Flight,Commercial,Canada,North America,3,1,1,2,2,3,0,Human Factor
1990-05-05 00:00:00,Aerial Transit Company,Takeoff (climb),Operational,Guatemala,Central America,3,3,3,0,0,3,0,Technical Failure
1990-06-26 00:00:00,Aeroflot - Russian International Airlines,Flight,Operational,Russia,Asia,3,2,2,1,1,3,0,Human Factor
1990-08-23 00:00:00,Rowan Drilling Company Marine,Takeoff (climb),Business,United States of America,North America,15,2,2,13,1,3,12,Technical Failure
1990-08-23 00:00:00,Private Colombian,Flight,Humanitarian,Mexico,Central America,3,2,2,1,1,3,0,Human Factor
1990-08-24 00:00:00,Michael D. Spear,Landing (descent or approach),Business,United States of America,North America,3,1,1,2,2,3,0,Human Factor
1990-09-03 00:00:00,Frontier Flying Service,Landing (descent or approach),Commercial,United States of America,North America,10,1,0,9,3,3,7,Technical Failure
1990-09-05 00:00:00,Aeroflot - Russian International Airlines,Flight,Commercial,Russia,Asia,8,2,2,6,1,3,5,Human Factor
1990-09-15 00:00:00,Private Brazilian,Takeoff (climb),Business,Brazil,South America,3,1,1,2,2,3,0,Technical Failure
1990-09-25 00:00:00,Texfi Industries,Takeoff (climb),Business,United States of America,North America,3,2,2,1,1,3,0,Human Factor
1990-10-02 00:00:00,Private Mexican,Flight,Business,Mexico,Central America,3,1,1,2,2,3,0,Unknown
1990-10-11 00:00:00,Alaska Helicopters,Flight,Military / Government,World,World,3,1,1,2,2,3,0,Unknown
1990-10-19 00:00:00,BAFIN - Transportes Aéreos - Bolivian Air Flight International,Flight,Operational,Bolivia,South America,3,3,3,0,0,3,0,Human Factor
1990-10-24 00:00:00,Aeroflot - Russian International Airlines,Landing (descent or approach),Military / Government,Kazakhstan,Asia,5,2,2,3,1,3,2,Human Factor
1990-10-29 00:00:00,Royal Norwegian Air Force - Kongelige Norske Luftforsvaret,Landing (descent or approach),Military / Government,Norway,Europe,15,3,2,12,1,3,12,Human Factor
1990-11-09 00:00:00,Saint Paul Aviation,Flight,Business,United States of America,North America,3,1,1,2,2,3,0,Technical Failure
1990-11-13 00:00:00,Flight Safety International,Landing (descent or approach),Operational,United States of America,North America,3,3,3,0,0,3,0,Human Factor
1990-11-26 00:00:00,Argentinian Navy - Armada Argentina,Landing (descent or approach),Operational,Argentina,South America,3,3,3,0,0,3,0,Unknown
1990-12-01 00:00:00,National Iranian Oil Company,Flight,Business,Iran,Asia,3,2,2,1,1,3,0,Weather
1990-12-05 00:00:00,Tahiti Conquest Airlines,Landing (descent or approach),Humanitarian,French Polynesia,Oceania,3,1,1,2,2,3,0,Technical Failure
1991-01-10 00:00:00,Private Mexican,Landing (descent or approach),Humanitarian,Mexico,Central America,3,1,1,2,2,3,0,Human Factor
1991-02-13 00:00:00,Richmor Aviation,Landing (descent or approach),Commercial,United States of America,North America,3,2,2,1,1,3,0,Human Factor
1991-02-22 00:00:00,Corporate Aviation Services,Takeoff (climb),Specialised Services,United States of America,North America,3,2,2,1,1,3,0,Human Factor
1991-03-03 00:00:00,United States Navy - USN,Landing (descent or approach),Operational,United States of America,North America,3,3,3,0,0,3,0,Unknown
1991-04-01 00:00:00,Kelco Aircraft Company,Landing (descent or approach),Business,United States of America,North America,3,1,1,2,2,3,0,Human Factor
1991-04-04 00:00:00,Lycoming Air Service,Landing (descent or approach),Commercial,United States of America,North America,3,1,1,2,2,3,0,Human Factor
1991-05-21 00:00:00,Chaillotine Air Service,Landing (descent or approach),Commercial,France,Europe,3,2,2,1,1,3,0,Technical Failure
1991-05-21 00:00:00,Ashaka Cement Company,Landing (descent or approach),Business,Nigeria,Africa,3,2,2,1,1,3,0,Unknown
1991-06-02 00:00:00,Tatarstan Airlines,Flight,Humanitarian,Russia,Asia,3,1,1,2,2,3,0,Human Factor
1991-06-22 00:00:00,Yugavia,Flight,Military / Government,Russia,Asia,3,1,1,2,2,3,0,Technical Failure
1991-06-24 00:00:00,Aeroflot - Russian International Airlines,Flight,Military / Government,Kazakhstan,Asia,3,2,2,1,1,3,0,Human Factor
1991-06-25 00:00:00,Aeroflot - Russian International Airlines,Flight,Military / Government,Russia,Asia,3,1,1,2,2,3,0,Unknown
1991-07-04 00:00:00,Helicol Colombia - Helicopteros Nacionales de Colombia,Landing (descent or approach),Commercial,Colombia,South America,3,2,2,1,1,3,0,Human Factor
1991-07-10 00:00:00,Nepalese Army,Takeoff (climb),Military / Government,Nepal,Asia,3,3,3,0,0,3,0,Human Factor
1991-07-22 00:00:00,Jetstream International Inc.,Takeoff (climb),Operational,United States of America,North America,3,2,2,1,1,3,0,Human Factor
1991-08-15 00:00:00,Transportes Aéreos da Guine-Bissau - TAGB - Air Bissau,Landing (descent or approach),Operational,Burkina Faso,Africa,3,3,3,0,0,3,0,Human Factor
1991-08-16 00:00:00,Philip J. Hmiel,Flight,Business,United States of America,North America,3,1,1,2,2,3,0,Human Factor
1991-09-03 00:00:00,Dirgantara Air Service,Takeoff (climb),Commercial,Indonesia,Asia,10,2,2,8,1,3,7,Technical Failure
1991-09-08 00:00:00,Wisconsin-California Forest Products,Takeoff (climb),Business,Canada,North America,3,1,1,2,2,3,0,Technical Failure
1991-10-15 00:00:00,Soviet Air Force - Voyenno-vozdushnye sily CCCP,Landing (descent or approach),Military / Government,Russia,Asia,3,3,3,0,0,3,0,Unknown
1991-11-15 00:00:00,Royal Malaysia Police - Polis Diraja Malaysia,Flight,Military / Government,Malaysia,Asia,3,3,3,0,0,3,0,Unknown
1991-11-22 00:00:00,Ligon Brothers Manufacturing Company,Landing (descent or approach),Business,United States of America,North America,3,2,2,1,1,3,0,Human Factor
1991-12-28 00:00:00,Business Express - USA,Flight,Operational,United States of America,North America,3,3,3,0,0,3,0,Human Factor
1992-01-04 00:00:00,Cebco Aviation,Takeoff (climb),Business,United States of America,North America,9,1,1,8,2,3,6,Human Factor
1992-01-08 00:00:00,Italian Air Force - Aeronautica Militare Italiana,Flight,Military / Government,Italy,Europe,3,3,3,0,0,3,0,Unknown
1992-01-23 00:00:00,Hellenic Air Force - Elleniki Polemiki Aeroporia,Landing (descent or approach),Specialised Services,Greece,Europe,3,3,3,0,0,3,0,Unknown
1992-01-31 00:00:00,Thomas J. Testa,Takeoff (climb),Business,United States of America,North America,3,1,1,2,2,3,0,Unknown
1992-03-05 00:00:00,Airborne Flying Services,Takeoff (climb),Humanitarian,United States of America,North America,3,2,2,1,1,3,0,Human Factor
1992-03-12 00:00:00,Lina Congo,Flight,Commercial,Congo,Africa,8,3,3,5,0,3,5,Weather
1992-04-07 00:00:00,Transportes Aéreos da Guine-Bissau - TAGB - Air Bissau,Flight,Military / Government,Libya,Africa,13,3,3,10,0,3,10,Human Factor
1992-06-08 00:00:00,GP-Express Airlines,Landing (descent or approach),Commercial,United States of America,North America,6,2,1,4,2,3,3,Human Factor
1992-06-21 00:00:00,Aero Star,Takeoff (climb),Humanitarian,Peru,South America,3,1,1,2,2,3,0,Terrorism
1992-06-22 00:00:00,VASP - Viação Aérea de São Paulo,Landing (descent or approach),Operational,Brazil,South America,3,2,2,1,1,3,0,Human Factor
1992-06-24 00:00:00,Judith Rea Enterprises,Takeoff (climb),Business,United States of America,North America,3,1,1,2,2,3,0,Human Factor
1992-06-25 00:00:00,Dirgantara Air Service,Flight,Operational,Indonesia,Asia,3,3,3,0,0,3,0,Other
1992-07-03 00:00:00,Shymkent Air Enterprise,Flight,Military / Government,Kazakhstan,Asia,3,2,2,1,1,3,0,Human Factor
1992-07-09 00:00:00,Chilean Air Force - Fuerza Aérea de Chile,Landing (descent or approach),Military / Government,Chile,South America,3,3,3,0,0,3,0,Human Factor
1992-07-16 00:00:00,United States Air Force - USAF,Flight,Operational,United States of America,North America,3,3,3,0,0,3,0,Unknown
1992-08-25 00:00:00,Lone Star Airlines,Takeoff (climb),Specialised Services,United States of America,North America,3,2,2,1,1,3,0,Human Factor
1992-08-27 00:00:00,NewCal Aviation,Takeoff (climb),Specialised Services,Canada,North America,3,3,3,0,0,3,0,Technical Failure
1992-08-31 00:00:00,Professional Aviation Services,Takeoff (climb),Commercial,Angola,Africa,17,3,3,14,0,3,14,Human Factor
1992-09-05 00:00:00,Potomac Imaging Associates,Landing (descent or approach),Business,United States of America,North America,3,1,1,2,2,3,0,Human Factor
1992-09-18 00:00:00,AeroEjecutivos,Flight,Operational,World,World,3,3,3,0,0,3,0,Weather
1992-10-31 00:00:00,Alpine Air,Landing (descent or approach),Commercial,United States of America,North America,3,1,1,2,2,3,0,Human Factor
1992-11-08 00:00:00,Baker Aviation,Flight,Commercial,United States of America,North America,3,1,1,2,2,3,0,Human Factor
1992-11-19 00:00:00,Wilderness Aviation,Flight,Commercial,United States of America,North America,3,1,1,2,2,3,0,Human Factor
1992-12-03 00:00:00,Sigtuna Aero,Takeoff (climb),Commercial,Sweden,Europe,3,1,1,2,2,3,0,Weather
1992-12-12 00:00:00,Yugavia,Landing (descent or approach),Commercial,Russia,Asia,3,2,2,1,1,3,0,Technical Failure
1992-12-15 00:00:00,AL Aviation Leasing,Takeoff (climb),Operational,Austria,Europe,3,1,1,2,2,3,0,Human Factor
1993-01-25 00:00:00,Transportes Aéreos Regionais da Bacia Amazônica - TABA,Flight,Operational,Brazil,South America,3,3,3,0,0,3,0,Technical Failure
1993-02-16 00:00:00,Ministère des Transports et du Ravitaillement,Landing (descent or approach),Operational,Madagascar,Africa,3,3,3,0,0,3,0,Unknown
1993-03-11 00:00:00,Critical Air Medicine,Flight,Humanitarian,United States of America,North America,3,1,1,2,2,3,0,Technical Failure
1993-03-19 00:00:00,West Aviation,Landing (descent or approach),Commercial,Norway,Europe,10,2,2,8,1,3,7,Human Factor
1993-04-27 00:00:00,Swiss Air Force,Flight,Military / Government,Switzerland,Europe,3,1,1,2,2,3,0,Weather
1993-05-15 00:00:00,Carga del Caribe,Flight,Specialised Services,Mexico,Central America,5,2,1,3,2,3,2,Human Factor
1993-06-03 00:00:00,James C. Spikes,Flight,Business,Mexico,Central America,3,1,1,2,2,3,0,Unknown
1993-06-21 00:00:00,Farnair Switzerland,Takeoff (climb),Humanitarian,Western Sahara,Africa,4,1,1,3,2,3,1,Human Factor
1993-06-24 00:00:00,SATENA - Servicio de Aeronavegacion a Territorios Nacionales,Landing (descent or approach),Military / Government,Colombia,South America,3,2,2,1,1,3,0,Weather
1993-06-28 00:00:00,Letabu Airways,Flight,Commercial,Namibia,Africa,3,1,1,2,2,3,0,Unknown
1993-07-02 00:00:00,ROSTO,Flight,Military / Government,Russia,Asia,3,1,1,2,2,3,0,Human Factor
1993-07-12 00:00:00,Air Nevada,Takeoff (climb),Commercial,United States of America,North America,3,1,1,2,2,3,0,Human Factor
1993-07-26 00:00:00,Bombardier Aerospace,Flight,Specialised Services,United States of America,North America,3,3,3,0,0,3,0,Human Factor
1993-08-31 00:00:00,Rainbow King Lodge,Takeoff (climb),Commercial,United States of America,North America,6,1,0,5,3,3,3,Human Factor
1993-09-15 00:00:00,Italian Air Force - Aeronautica Militare Italiana,Landing (descent or approach),Military / Government,Italy,Europe,3,3,3,0,0,3,0,Technical Failure
1993-10-26 00:00:00,Federal Aviation Administration - FAA,Flight,Specialised Services,United States of America,North America,3,3,3,0,0,3,0,Human Factor
1993-10-26 00:00:00,Brazilian Air Force - Força Aérea Brasileira,Flight,Military / Government,Brazil,South America,3,3,3,0,0,3,0,Unknown
1993-12-09 00:00:00,Air Sénégal - SONATRA Société Nationale de Transports Aériens,Landing (descent or approach),Commercial,Senegal,Africa,3,2,2,1,1,3,0,Human Factor
1993-12-15 00:00:00,Whitham Farms Feed Yard,Landing (descent or approach),Business,United States of America,North America,3,2,2,1,1,3,0,Human Factor
1994-01-21 00:00:00,Heritage Aircraft,Takeoff (climb),Business,United States of America,North America,3,1,1,2,2,3,0,Technical Failure
1994-04-04 00:00:00,KLM Cityhopper,Landing (descent or approach),Commercial,Netherlands,Europe,24,3,1,21,2,3,21,Human Factor
1994-08-11 00:00:00,Talnon Air Service,Flight,Commercial,United States of America,North America,3,1,1,2,2,3,0,Human Factor
1994-08-13 00:00:00,Hemet Valley Flying Service,Flight,Humanitarian,United States of America,North America,3,3,3,0,0,3,0,Technical Failure
1994-09-13 00:00:00,Aero Contractors,Landing (descent or approach),Commercial,Nigeria,Africa,5,2,1,3,2,3,2,Human Factor
1994-09-17 00:00:00,Pacific Coastal Airlines - PCA,Takeoff (climb),Commercial,Canada,North America,4,2,1,2,2,3,1,Technical Failure
1994-10-16 00:00:00,Peruvian Government,Flight,Military / Government,Peru,South America,3,2,2,1,1,3,0,Unknown
1994-12-19 00:00:00,Nigeria Airways,Flight,Operational,Nigeria,Africa,5,3,1,2,2,3,2,Technical Failure
1994-12-22 00:00:00,Ryders Replica Fighter Museum,Takeoff (climb),Business,United States of America,North America,3,1,1,2,2,3,0,Human Factor
1995-01-05 00:00:00,Mt Nebo Aviation,Landing (descent or approach),Business,United States of America,North America,3,1,1,2,2,3,0,Technical Failure
1995-01-20 00:00:00,Abakan Airlines,Takeoff (climb),Commercial,Russia,Asia,19,2,2,17,1,3,16,Technical Failure
1995-02-14 00:00:00,Turkish Air Force - Türk Hava Kuvvetleri,Flight,Military / Government,Turkey,Asia,3,3,3,0,0,3,0,Unknown
1995-02-16 00:00:00,Air Transport International,Takeoff (climb),Operational,United States of America,North America,3,3,3,0,0,3,0,Human Factor
1995-04-04 00:00:00,Transportes Aéreos Nacionales de la Selva - TANS,Takeoff (climb),Operational,Peru,South America,3,3,3,0,0,3,0,Unknown
1995-04-27 00:00:00,Pel-Air,Landing (descent or approach),Operational,Australia,Oceania,3,2,2,1,1,3,0,Human Factor
1995-05-01 00:00:00,Bearskin Airlines - Bearskin Lake Air Services,Landing (descent or approach),Commercial,Canada,North America,3,2,2,1,1,3,0,Human Factor
1995-05-04 00:00:00,ROSTO,Takeoff (climb),Military / Government,Russia,Asia,7,2,1,5,2,3,4,Human Factor
1995-06-01 00:00:00,Frank Casella,Takeoff (climb),Business,United States of America,North America,3,1,1,2,2,3,0,Human Factor
1995-06-14 00:00:00,Executive Aviation,Flight,Commercial,United States of America,North America,3,1,1,2,2,3,0,Weather
1995-07-31 00:00:00,Royal Malaysian Air Force - Tentera Udara Diraja Malaysia,Landing (descent or approach),Operational,Malaysia,Asia,6,6,3,0,0,3,3,Technical Failure
1995-08-02 00:00:00,Aviaexport,Takeoff (climb),Operational,South Africa,Africa,3,2,2,1,1,3,0,Other
1995-09-11 00:00:00,Ariana Afghan Airlines,Landing (descent or approach),Commercial,Afghanistan,Asia,46,6,0,40,3,3,43,Technical Failure
1995-11-28 00:00:00,Transportes Aéreos Regionais da Bacia Amazônica - TABA,Landing (descent or approach),Operational,Brazil,South America,4,2,2,2,1,3,1,Human Factor
1996-01-08 00:00:00,Pacific States Charter Service,Landing (descent or approach),Humanitarian,United States of America,North America,4,2,2,2,1,3,1,Human Factor
1996-01-31 00:00:00,Flagstaff Medical Center,Landing (descent or approach),Humanitarian,United States of America,North America,3,1,1,2,2,3,0,Human Factor
1996-02-11 00:00:00,Hill Construction,Flight,Operational,Puerto Rico,Central America,3,3,3,0,0,3,0,Human Factor
1996-03-09 00:00:00,Carson Helicopters,Flight,Specialised Services,Peru,South America,3,2,2,1,1,3,0,Technical Failure
1996-03-25 00:00:00,United States Navy - USN,Flight,Operational,World,World,3,3,3,0,0,3,0,Unknown
1996-04-29 00:00:00,Monarch Aviation,Flight,Commercial,United States of America,North America,3,1,1,2,2,3,0,Technical Failure
1996-05-02 00:00:00,Domtrav Airways,Flight,Commercial,World,World,3,1,1,2,2,3,0,Technical Failure
1996-06-13 00:00:00,Garuda Indonesian Airways,Takeoff (climb),Commercial,Japan,Asia,275,15,0,260,3,3,272,Technical Failure
1996-06-28 00:00:00,Air Ivoire,Flight,Operational,Ivory Coast,Africa,3,3,3,0,0,3,0,Human Factor
1996-08-18 00:00:00,Harbour Air Seaplanes,Flight,Commercial,Canada,North America,3,1,1,2,2,3,0,Human Factor
1996-10-11 00:00:00,Servicios Petroleros Helimar,Takeoff (climb),Specialised Services,Bolivia,South America,3,1,1,2,2,3,0,Unknown
1996-10-13 00:00:00,Seaside Air Services,Flight,Commercial,United States of America,North America,3,1,1,2,2,3,0,Human Factor
1996-10-18 00:00:00,Aerodat,Flight,Specialised Services,Peru,South America,3,2,2,1,1,3,0,Unknown
1996-11-09 00:00:00,James H. Doering,Takeoff (climb),Business,United States of America,North America,3,2,2,1,1,3,0,Human Factor
1996-11-30 00:00:00,Robert E. J. Morris,Takeoff (climb),Business,United States of America,North America,3,1,1,2,2,3,0,Human Factor
1996-12-13 00:00:00,C90 Partnership,Flight,Operational,South Africa,Africa,3,3,3,0,0,3,0,Unknown
1996-12-16 00:00:00,US Dynamics Corporation,Landing (descent or approach),Business,United States of America,North America,3,1,1,2,2,3,0,Human Factor
1997-01-07 00:00:00,Polynesian Airline of Samoa - Polynesian Airlines,Landing (descent or approach),Commercial,Samoa Islands (Western Samoa),Oceania,5,2,1,3,2,3,2,Human Factor
1997-02-24 00:00:00,Nigerian Air Force,Landing (descent or approach),Operational,Nigeria,Africa,3,3,3,0,0,3,0,Human Factor
1997-04-01 00:00:00,United States Air Force - USAF,Landing (descent or approach),Military / Government,Honduras,Central America,10,10,3,0,0,3,7,Human Factor
1997-04-14 00:00:00,TAAG Angola Airlines - Transportes Aéreos de Angola,Takeoff (climb),Operational,Congo,Africa,7,7,3,0,0,3,4,Other
1997-05-16 00:00:00,Jett Paquetería,Landing (descent or approach),Operational,Mexico,Central America,3,2,2,1,1,3,0,Human Factor
1997-06-20 00:00:00,San-Lo Aerial Surveys,Takeoff (climb),Specialised Services,United States of America,North America,3,3,3,0,0,3,0,Technical Failure
1997-07-09 00:00:00,Merpati Nusantara Airlines - MNA,Landing (descent or approach),Operational,Indonesia,Asia,3,3,3,0,0,3,0,Technical Failure
1997-08-03 00:00:00,Launchapart,Landing (descent or approach),Business,United Kingdom,Europe,4,2,2,2,1,3,1,Technical Failure
1997-10-27 00:00:00,Covington Foods,Landing (descent or approach),Business,United States of America,North America,4,1,1,3,2,3,1,Human Factor
1997-10-31 00:00:00,DM Construtora de Obras,Landing (descent or approach),Business,Brazil,South America,3,2,2,1,1,3,0,Human Factor
1998-01-02 00:00:00,Aerodinamo del Pacifico,Landing (descent or approach),Commercial,Mexico,Central America,8,2,1,6,2,3,5,Human Factor
1998-01-21 00:00:00,Airplanes of Boca,Takeoff (climb),Business,United States of America,North America,3,1,1,2,2,3,0,Human Factor
1998-02-16 00:00:00,Tarkim Aviation,Landing (descent or approach),Commercial,Turkey,Asia,3,2,2,1,1,3,0,Unknown
1998-03-12 00:00:00,Spanish Air Force - Ejército del Aire,Landing (descent or approach),Operational,Spain,Europe,3,3,3,0,0,3,0,Unknown
1998-04-23 00:00:00,Brazilian Air Force - Força Aérea Brasileira,Landing (descent or approach),Humanitarian,Brazil,South America,3,3,3,0,0,3,0,Unknown
1998-05-20 00:00:00,Bahia Táxi Aéreo - BATA,Landing (descent or approach),Operational,Brazil,South America,3,2,2,1,1,3,0,Technical Failure
1998-06-10 00:00:00,Mountain Aerostar,Takeoff (climb),Business,United States of America,North America,3,1,1,2,2,3,0,Human Factor
1998-07-16 00:00:00,Alas del Sur,Landing (descent or approach),Operational,Argentina,South America,3,2,2,1,1,3,0,Human Factor
1998-08-08 00:00:00,Gray Leasing,Flight,Business,United States of America,North America,3,1,1,2,2,3,0,Human Factor
1998-10-21 00:00:00,Capital Taxi Aéreo,Landing (descent or approach),Operational,Brazil,South America,3,2,2,1,1,3,0,Human Factor
1998-10-24 00:00:00,Centrafricain Airlines,Flight,Operational,Democratic Republic of Congo,Africa,3,3,3,0,0,3,0,Technical Failure
1998-10-30 00:00:00,Busscar,Landing (descent or approach),Business,Brazil,South America,3,1,1,2,2,3,0,Human Factor
1998-11-06 00:00:00,AD Aviation Aircharters,Flight,Commercial,Kenya,Africa,3,1,1,2,2,3,0,Unknown
1998-12-08 00:00:00,Bimini Island Air,Landing (descent or approach),Operational,United States of America,North America,3,3,3,0,0,3,0,Human Factor
1999-01-16 00:00:00,Uzu Air,Landing (descent or approach),Commercial,Australia,Oceania,4,1,1,3,2,3,1,Human Factor
1999-04-15 00:00:00,Korean Air Cargo,Takeoff (climb),Operational,China,Asia,3,3,3,0,0,3,0,Human Factor
1999-08-21 00:00:00,Private German,Landing (descent or approach),Business,Germany,Europe,3,1,1,2,2,3,0,Human Factor
1999-08-22 00:00:00,Mandarin Airlines,Landing (descent or approach),Commercial,China,Asia,315,15,0,300,3,3,312,Human Factor
1999-10-24 00:00:00,Avioriprese Jet Executive,Landing (descent or approach),Commercial,Italy,Europe,3,2,2,1,1,3,0,Human Factor
1999-11-11 00:00:00,Jaymar Ruby,Takeoff (climb),Business,United States of America,North America,3,2,2,1,1,3,0,Technical Failure
1999-11-23 00:00:00,Botswana Defence Force - Air Wing,Takeoff (climb),Military / Government,Botswana,Africa,3,3,3,0,0,3,0,Unknown
1999-12-09 00:00:00,United States Air Force - USAF,Landing (descent or approach),Military / Government,Kuwait,Asia,94,8,0,86,3,3,91,Human Factor
1999-12-09 00:00:00,Primorski RLTT,Flight,Commercial,Russia,Asia,6,3,1,3,2,3,3,Human Factor
1999-12-12 00:00:00,Panda Leasing Company,Flight,Business,United States of America,North America,3,2,2,1,1,3,0,Human Factor
2000-01-13 00:00:00,Cargair,Flight,Commercial,Canada,North America,6,1,1,5,2,3,3,Human Factor
2000-02-01 00:00:00,Iran Air,Taxiing,Commercial,Iran,Asia,3,3,3,0,0,3,0,Technical Failure
2000-02-16 00:00:00,Emery Worldwide Airlines,Landing (descent or approach),Operational,United States of America,North America,3,3,3,0,0,3,0,Technical Failure
2000-03-25 00:00:00,Angolan Government,Takeoff (climb),Military / Government,Angola,Africa,33,4,0,29,3,3,30,Unknown
2000-04-05 00:00:00,Bankair,Landing (descent or approach),Operational,United States of America,North America,3,3,3,0,0,3,0,Human Factor
2000-04-12 00:00:00,Cotercon Comercial,Takeoff (climb),Business,Brazil,South America,3,1,1,2,2,3,0,Technical Failure
2000-04-16 00:00:00,ROSTO,Takeoff (climb),Military / Government,Russia,Asia,3,2,2,1,1,3,0,Human Factor
2000-04-17 00:00:00,Desert Research Institute,Takeoff (climb),Other,United States of America,North America,3,3,3,0,0,3,0,Technical Failure
2000-05-18 00:00:00,Avirex,Landing (descent or approach),Commercial,Gabon,Africa,10,2,1,8,2,3,7,Human Factor
2000-05-28 00:00:00,Andrew J. Lowe,Takeoff (climb),Business,United States of America,North America,3,1,1,2,2,3,0,Technical Failure
2000-05-31 00:00:00,Lynch Flying Service,Flight,Business,United States of America,North America,3,2,2,1,1,3,0,Weather
2000-06-19 00:00:00,AvNorth Aviation,Takeoff (climb),Commercial,Canada,North America,6,1,0,5,3,3,3,Human Factor
2000-06-23 00:00:00,Universal Jet Aviation,Takeoff (climb),Operational,United States of America,North America,3,2,2,1,1,3,0,Human Factor
2000-08-04 00:00:00,Medical Enterprises,Takeoff (climb),Business,United States of America,North America,3,1,1,2,2,3,0,Human Factor
2000-08-09 00:00:00,Aircraft Guaranty Title %26 Trust,Landing (descent or approach),Business,Germany,Europe,3,1,1,2,2,3,0,Human Factor
2000-08-15 00:00:00,Holman Funeral Home,Landing (descent or approach),Commercial,United States of America,North America,3,1,1,2,2,3,0,Human Factor
2000-08-23 00:00:00,Aerovias Guayana - Aguaysa,Landing (descent or approach),Commercial,Venezuela,South America,6,1,1,5,2,3,3,Unknown
2000-08-26 00:00:00,Procuraduría General de la República,Landing (descent or approach),Military / Government,Mexico,Central America,3,2,2,1,1,3,0,Human Factor
2000-10-08 00:00:00,Summit Air Charters,Landing (descent or approach),Operational,Canada,North America,3,2,2,1,1,3,0,Human Factor
2000-10-10 00:00:00,Bombardier Aerospace,Takeoff (climb),Specialised Services,United States of America,North America,3,3,3,0,0,3,0,Human Factor
2000-12-11 00:00:00,Gabonese Air Force - Forces Aériennes Gabonaises,Flight,Military / Government,Gabon,Africa,3,2,2,1,1,3,0,Unknown
2001-01-06 00:00:00,Guyana Defence Force,Landing (descent or approach),Military / Government,Guyana,South America,3,2,2,1,1,3,0,Human Factor
2001-01-11 00:00:00,LASA - Engenharia e Prospecções,Flight,Specialised Services,Brazil,South America,3,2,2,1,1,3,0,Weather
2001-01-19 00:00:00,Turkish Air Force - Türk Hava Kuvvetleri,Flight,Operational,Turkey,Asia,3,2,2,1,1,3,0,Human Factor
2001-01-31 00:00:00,Líneas Aéreas Suramericanas,Landing (descent or approach),Operational,Colombia,South America,6,3,1,3,2,3,3,Human Factor
2001-02-08 00:00:00,E.A.S. Aeroservizi - Executive Aviation Services,Landing (descent or approach),Operational,Germany,Europe,3,2,2,1,1,3,0,Human Factor
2001-02-14 00:00:00,Unifly,Landing (descent or approach),Commercial,Cameroon,Africa,4,2,1,2,2,3,1,Human Factor
2001-03-26 00:00:00,Merpati Nusantara Airlines - MNA,Landing (descent or approach),Operational,Indonesia,Asia,3,3,3,0,0,3,0,Human Factor
2001-06-02 00:00:00,ROSTO,Flight,Humanitarian,Russia,Asia,3,1,1,2,2,3,0,Human Factor
2001-06-05 00:00:00,846234 Ontario,Takeoff (climb),Commercial,Canada,North America,4,1,1,3,2,3,1,Human Factor
2001-08-05 00:00:00,Naske Air,Landing (descent or approach),Operational,Greenland,Europe,3,2,2,1,1,3,0,Human Factor
2001-09-13 00:00:00,Aircraft Guaranty Corporation Trustee,Takeoff (climb),Business,Canada,North America,3,1,1,2,2,3,0,Other
2001-09-29 00:00:00,Potter %26 Son,Landing (descent or approach),Business,United States of America,North America,3,1,1,2,2,3,0,Human Factor
2001-10-08 00:00:00,Air Saint-Maurice,Landing (descent or approach),Commercial,Canada,North America,7,1,1,6,2,3,4,Human Factor
2001-10-15 00:00:00,Deh Cho Air,Landing (descent or approach),Commercial,Canada,North America,6,1,0,5,3,3,3,Human Factor
2001-11-02 00:00:00,Transafrican Aviation,Takeoff (climb),Operational,South Africa,Africa,3,2,2,1,1,3,0,Other
2001-11-29 00:00:00,SANSA - Servicios Aéreos Nacionales,Landing (descent or approach),Commercial,Costa Rica,Central America,8,2,2,6,1,3,5,Human Factor
2001-12-12 00:00:00,M %26 M Aero,Landing (descent or approach),Business,United States of America,North America,3,1,1,2,2,3,0,Human Factor
2002-01-14 00:00:00,Ibertrans Aérea,Landing (descent or approach),Operational,Spain,Europe,3,2,2,1,1,3,0,Human Factor
2002-01-17 00:00:00,Harold S. Bercu,Landing (descent or approach),Business,United States of America,North America,5,1,1,4,2,3,2,Human Factor
2002-02-19 00:00:00,SOGEPA,Takeoff (climb),Business,France,Europe,3,2,2,1,1,3,0,Technical Failure
2002-03-06 00:00:00,Henry Guenther,Takeoff (climb),Business,United States of America,North America,3,1,1,2,2,3,0,Human Factor
2002-03-09 00:00:00,Svedijos Prekes,Flight,Operational,Italy,Europe,3,2,2,1,1,3,0,Human Factor
2002-03-12 00:00:00,Idaho Division of Aeronautics,Flight,Military / Government,United States of America,North America,3,1,1,2,2,3,0,Human Factor
2002-04-19 00:00:00,Selva Colombia - Servicios Aéreos del Vaupés,Takeoff (climb),Commercial,Colombia,South America,8,3,0,5,3,3,5,Human Factor
2002-05-08 00:00:00,United States Navy - USN,Flight,Operational,United States of America,North America,3,3,3,0,0,3,0,Human Factor
2002-06-01 00:00:00,Airquarius Air Charter,Landing (descent or approach),Operational,South Africa,Africa,3,2,2,1,1,3,0,Human Factor
2002-06-12 00:00:00,United States Air Force - USAF,Takeoff (climb),Military / Government,Afghanistan,Asia,10,7,2,3,1,3,7,Other
2002-06-14 00:00:00,Calvin M. Miller,Flight,Business,United States of America,North America,3,1,1,2,2,3,0,Human Factor
2002-06-17 00:00:00,Hawkins %26 Powers Aviation,Flight,Humanitarian,United States of America,North America,3,3,3,0,0,3,0,Technical Failure
2002-06-19 00:00:00,Cavin Robert Councilor,Takeoff (climb),Business,United States of America,North America,3,1,1,2,2,3,0,Technical Failure
2002-08-04 00:00:00,Danny L. Williamson,Landing (descent or approach),Business,United States of America,North America,3,1,1,2,2,3,0,Technical Failure
2002-09-02 00:00:00,CAAC - Air Traffic Management Bureau,Flight,Specialised Services,China,Asia,3,3,3,0,0,3,0,Human Factor
2002-09-28 00:00:00,Deraps Aviation,Landing (descent or approach),Commercial,Canada,North America,4,1,0,3,3,3,1,Human Factor
2002-10-20 00:00:00,George W. Willard,Takeoff (climb),Business,United States of America,North America,3,1,1,2,2,3,0,Human Factor
2002-11-01 00:00:00,Robin Williams,Flight,Operational,United States of America,North America,3,1,1,2,2,3,0,Human Factor
2002-12-09 00:00:00,Raytheon Aircraft Services,Flight,Operational,United States of America,North America,3,2,2,1,1,3,0,Human Factor
2002-12-17 00:00:00,Private New Zealand,Takeoff (climb),Business,New Zealand,Oceania,3,1,1,2,2,3,0,Human Factor
2002-12-19 00:00:00,Gavina,Flight,Commercial,Spain,Europe,3,1,1,2,2,3,0,Human Factor
2002-12-26 00:00:00,Brazilian Air Force - Força Aérea Brasileira,Landing (descent or approach),Military / Government,Brazil,South America,16,3,1,13,2,3,13,Human Factor
2003-01-24 00:00:00,African Commuter Services,Takeoff (climb),Military / Government,Kenya,Africa,12,3,2,9,1,3,9,Human Factor
2003-02-16 00:00:00,Great Northern Aircraft,Landing (descent or approach),Business,United States of America,North America,7,1,1,6,2,3,4,Human Factor
2003-03-01 00:00:00,High Performance Technologies,Landing (descent or approach),Business,United States of America,North America,3,2,2,1,1,3,0,Human Factor
2003-03-07 00:00:00,Richard W. Fuller,Landing (descent or approach),Business,United States of America,North America,3,1,1,2,2,3,0,Human Factor
2003-03-15 00:00:00,Dancing Wind Aviation,Flight,Business,United States of America,North America,3,1,1,2,2,3,0,Human Factor
2003-03-25 00:00:00,One Leasing,Flight,Military / Government,Colombia,South America,3,2,2,1,1,3,0,Human Factor
2003-04-08 00:00:00,Grand Aire Express - Executive Aire Express,Landing (descent or approach),Operational,United States of America,North America,3,2,2,1,1,3,0,Human Factor
2003-04-14 00:00:00,Robert F. Carlson,Landing (descent or approach),Business,Mexico,Central America,3,1,1,2,2,3,0,Unknown
2003-04-26 00:00:00,Private thai,Takeoff (climb),Business,Thailand,Asia,3,1,1,2,2,3,0,Unknown
2003-08-29 00:00:00,Harris Air Freight,Takeoff (climb),Business,Canada,North America,3,1,1,2,2,3,0,Human Factor
2003-09-20 00:00:00,Starflite Aviation,Landing (descent or approach),Operational,United States of America,North America,3,3,3,0,0,3,0,Human Factor
2003-09-27 00:00:00,Les Ailes de Gaspé,Landing (descent or approach),Commercial,Canada,North America,3,1,1,2,2,3,0,Human Factor
2003-10-27 00:00:00,Aero Xtra,Landing (descent or approach),Operational,Mexico,Central America,3,2,2,1,1,3,0,Human Factor
2003-12-06 00:00:00,Thys Limburg,Landing (descent or approach),Business,United Kingdom,Europe,3,1,1,2,2,3,0,Human Factor
2003-12-12 00:00:00,Chemtrad Aviation,Landing (descent or approach),Operational,Philippines,Asia,3,3,3,0,0,3,0,Human Factor
2003-12-18 00:00:00,Líneas Aéreas Suramericanas,Flight,Operational,Colombia,South America,3,3,3,0,0,3,0,Technical Failure
2004-01-02 00:00:00,Oracam,Landing (descent or approach),Business,France,Europe,3,1,1,2,2,3,0,Weather
2004-01-31 00:00:00,Hawaii Air Ambulance,Flight,Humanitarian,United States of America,North America,3,1,1,2,2,3,0,Human Factor
2004-02-17 00:00:00,Ballard Aviation,Landing (descent or approach),Humanitarian,United States of America,North America,3,1,1,2,2,3,0,Human Factor
2004-03-04 00:00:00,Azov-Avia Airlines,Takeoff (climb),Operational,Azerbaijan,Asia,7,7,3,0,0,3,4,Human Factor
2004-03-24 00:00:00,V. G. Plyonkin,Landing (descent or approach),Military / Government,Russia,Asia,3,2,2,1,1,3,0,Human Factor
2004-05-25 00:00:00,Yeti Airlines,Landing (descent or approach),Operational,Nepal,Asia,3,3,3,0,0,3,0,Human Factor
2004-08-18 00:00:00,Transworld Safaris,Flight,Operational,Democratic Republic of Congo,Africa,3,1,1,2,2,3,0,Human Factor
2004-09-01 00:00:00,Herme Ortiz,Takeoff (climb),Commercial,Spain,Europe,3,2,2,1,1,3,0,Technical Failure
2004-10-15 00:00:00,Aerovanguardia - Aerovias Vanguardia,Landing (descent or approach),Operational,Colombia,South America,3,2,2,1,1,3,0,Human Factor
2004-11-18 00:00:00,Venezolana - Linea Aérea Bolivariana,Landing (descent or approach),Commercial,Venezuela,South America,21,2,0,19,3,3,18,Unknown
2004-11-22 00:00:00,Business Jet Services,Landing (descent or approach),Operational,United States of America,North America,3,3,3,0,0,3,0,Human Factor
2004-11-28 00:00:00,Hop-a-Jet,Takeoff (climb),Commercial,United States of America,North America,6,3,2,3,1,3,3,Human Factor
2004-12-17 00:00:00,Nadia E. Barghelame,Takeoff (climb),Operational,United States of America,North America,3,3,3,0,0,3,0,Human Factor
2004-12-24 00:00:00,Aéro Pyrénées,Landing (descent or approach),Operational,France,Europe,3,3,3,0,0,3,0,Human Factor
2005-01-11 00:00:00,Mountain Flight Service,Landing (descent or approach),Humanitarian,United States of America,North America,4,1,1,3,2,3,1,Human Factor
2005-03-30 00:00:00,Gran Propeller - Victoria Air,Takeoff (climb),Operational,Democratic Republic of Congo,Africa,4,2,2,2,1,3,1,Technical Failure
2005-04-20 00:00:00,Saha Airlines,Landing (descent or approach),Commercial,Iran,Asia,169,12,0,157,3,3,166,Technical Failure
2005-04-20 00:00:00,Aero Union,Flight,Operational,United States of America,North America,3,3,3,0,0,3,0,Human Factor
2005-05-15 00:00:00,Private Venezuelan,Landing (descent or approach),Business,Venezuela,South America,3,1,1,2,2,3,0,Unknown
2005-06-03 00:00:00,Private American,Flight,Humanitarian,Mexico,Central America,3,2,2,1,1,3,0,Human Factor
2005-07-01 00:00:00,Aero Tech Flight Service,Flight,Business,United States of America,North America,3,1,1,2,2,3,0,Human Factor
2005-07-08 00:00:00,R.L. Aviation,Landing (descent or approach),Commercial,Australia,Oceania,3,1,1,2,2,3,0,Human Factor
2005-07-21 00:00:00,Indonesian Air Force - TNI-AU Tentara Nasional Indonesia - Angkatan Udara,Landing (descent or approach),Military / Government,Indonesia,Asia,23,3,0,20,3,3,20,Technical Failure
2005-09-04 00:00:00,ROSTO,Flight,Operational,Russia,Asia,3,2,2,1,1,3,0,Human Factor
2005-10-30 00:00:00,Trade Air,Takeoff (climb),Operational,Italy,Europe,3,2,2,1,1,3,0,Human Factor
2005-11-04 00:00:00,Vietnam People's Air Force,Flight,Operational,Vietnam,Asia,3,3,3,0,0,3,0,Human Factor
2005-11-18 00:00:00,Blancaneaux Lodge,Landing (descent or approach),Commercial,Belize,Central America,3,1,1,2,2,3,0,Unknown
2006-01-02 00:00:00,Avcom - Aviation Commercial,Landing (descent or approach),Operational,Ukraine,Europe,3,3,3,0,0,3,0,Technical Failure
2006-01-21 00:00:00,Sonicblue Airways,Flight,Commercial,Canada,North America,8,1,1,7,2,3,5,Technical Failure
2006-02-05 00:00:00,Air Cargo Carriers,Flight,Specialised Services,United States of America,North America,3,2,2,1,1,3,0,Human Factor
2006-03-08 00:00:00,Hawaii Air Ambulance,Landing (descent or approach),Humanitarian,United States of America,North America,3,1,1,2,2,3,0,Human Factor
2006-03-23 00:00:00,RAC Ltd,Landing (descent or approach),Business,United States of America,North America,3,1,1,2,2,3,0,Human Factor
2006-04-16 00:00:00,Ocem Avionics,Takeoff (climb),Business,United States of America,North America,3,1,1,2,2,3,0,Unknown
2006-04-28 00:00:00,King Air Charter,Flight,Humanitarian,Uganda,Africa,3,2,2,1,1,3,0,Human Factor
2006-05-24 00:00:00,Colombian Navy - Armada de Colombia,Landing (descent or approach),Military / Government,Colombia,South America,3,2,2,1,1,3,0,Unknown
2006-07-28 00:00:00,Commander Northwest,Landing (descent or approach),Operational,United States of America,North America,3,2,2,1,1,3,0,Unknown
2006-08-13 00:00:00,Air Algérie,Flight,Operational,Italy,Europe,3,3,3,0,0,3,0,Technical Failure
2006-10-31 00:00:00,Armflame,Flight,Business,Australia,Oceania,3,1,1,2,2,3,0,Unknown
2006-11-14 00:00:00,Robert F. Cartwright,Takeoff (climb),Business,United States of America,North America,3,1,1,2,2,3,0,Technical Failure
2006-11-22 00:00:00,Colombian Air Force - Fuerza Aérea Colombiana,Landing (descent or approach),Military / Government,Colombia,South America,3,3,3,0,0,3,0,Unknown
2006-12-25 00:00:00,ATA of Broward,Landing (descent or approach),Business,United States of America,North America,3,1,1,2,2,3,0,Human Factor
2007-02-02 00:00:00,PK Leasing,Landing (descent or approach),Business,United States of America,North America,3,2,2,1,1,3,0,Human Factor
2007-02-06 00:00:00,Metro Aviation,Landing (descent or approach),Humanitarian,United States of America,North America,3,1,1,2,2,3,0,Human Factor
2007-04-25 00:00:00,Air Services - Guyana,Landing (descent or approach),Commercial,Guyana,South America,5,1,1,4,2,3,2,Unknown
2007-05-17 00:00:00,Safe Air Company,Takeoff (climb),Operational,Democratic Republic of Congo,Africa,3,2,2,1,1,3,0,Technical Failure
2007-06-28 00:00:00,MCC Aviation Services,Flight,Business,United States of America,North America,3,1,1,2,2,3,0,Human Factor
2007-07-05 00:00:00,Jett Paquetería,Takeoff (climb),Operational,Mexico,Central America,3,3,3,0,0,3,0,Human Factor
2007-08-15 00:00:00,United States Navy - USN,Takeoff (climb),Operational,World,World,3,3,3,0,0,3,0,Unknown
2007-10-04 00:00:00,Scenic Aviation,Flight,Humanitarian,United States of America,North America,3,1,1,2,2,3,0,Human Factor
2007-10-07 00:00:00,Syrian National Topographic Institute,Flight,Operational,Syria,Asia,3,3,3,0,0,3,0,Technical Failure
2007-10-26 00:00:00,New Century Airplane Sales,Flight,Business,Canada,North America,3,1,1,2,2,3,0,Technical Failure
2007-11-06 00:00:00,Roy E. Ladd,Landing (descent or approach),Business,United States of America,North America,3,1,1,2,2,3,0,Human Factor
2007-11-09 00:00:00,Midwestern Restaurants,Flight,Business,United States of America,North America,3,1,1,2,2,3,0,Human Factor
2007-12-10 00:00:00,Getro,Landing (descent or approach),Business,Slovakia,Europe,3,2,2,1,1,3,0,Unknown
2008-01-26 00:00:00,Dirgantara Air Service,Landing (descent or approach),Operational,Indonesia,Asia,3,3,3,0,0,3,0,Human Factor
2008-02-18 00:00:00,Private American,Flight,Business,Venezuela,South America,3,2,2,1,1,3,0,Unknown
2008-04-15 00:00:00,Hewa Bora Airways,Takeoff (climb),Commercial,Democratic Republic of Congo,Africa,94,8,0,86,3,3,91,Unknown
2008-04-23 00:00:00,Private German,Landing (descent or approach),Operational,Italy,Europe,3,2,2,1,1,3,0,Human Factor
2008-04-28 00:00:00,Aircraft Guaranty Holdings %26 Trust,Takeoff (climb),Business,Venezuela,South America,3,1,1,2,2,3,0,Technical Failure
2008-05-30 00:00:00,TACA International Airlines - Transportes Aéreos Centro Americanos,Landing (descent or approach),Commercial,Honduras,Central America,124,6,1,118,2,3,121,Human Factor
2008-06-15 00:00:00,China Flying Dragon Special Aviation Company,Flight,Specialised Services,China,Asia,4,2,1,2,2,3,1,Unknown
2008-06-20 00:00:00,Helitrans,Flight,Operational,Norway,Europe,3,3,3,0,0,3,0,Human Factor
2008-07-02 00:00:00,Dovler Mangelli Fonialli,Landing (descent or approach),Business,Venezuela,South America,3,1,1,2,2,3,0,Human Factor
2008-07-02 00:00:00,Chilean Air Force - Fuerza Aérea de Chile,Flight,Operational,Chile,South America,3,3,3,0,0,3,0,Human Factor
2008-08-13 00:00:00,Fly540,Landing (descent or approach),Operational,Somalia,Africa,3,3,3,0,0,3,0,Human Factor
2008-08-30 00:00:00,Conviasa - Consorcio Venezolano de Industrias Aeronáuticas y Servicios Aéreos,Flight,Operational,Ecuador,South America,3,3,3,0,0,3,0,Human Factor
2008-09-01 00:00:00,Neptune Aviation Charter,Takeoff (climb),Humanitarian,United States of America,North America,3,3,3,0,0,3,0,Technical Failure
2008-09-01 00:00:00,Air Tahoma,Takeoff (climb),Operational,United States of America,North America,3,3,3,0,0,3,0,Human Factor
2008-10-17 00:00:00,Government of the State of Baja California Sur,Takeoff (climb),Military / Government,Mexico,Central America,3,2,2,1,1,3,0,Human Factor
2008-11-01 00:00:00,Dynamic Aviation,Flight,Specialised Services,Guyana,South America,3,2,2,1,1,3,0,Unknown
2008-11-07 00:00:00,Air Key West,Landing (descent or approach),Humanitarian,United States of America,North America,3,1,1,2,2,3,0,Human Factor
2008-11-22 00:00:00,TES Leasing,Landing (descent or approach),Business,United States of America,North America,3,1,1,2,2,3,0,Human Factor
2008-12-03 00:00:00,Websta's Aviation Services,Flight,Commercial,Puerto Rico,Central America,3,1,1,2,2,3,0,Human Factor
2009-01-15 00:00:00,JW Operating Company,Landing (descent or approach),Business,United States of America,North America,3,2,2,1,1,3,0,Weather
2009-03-06 00:00:00,National Aerospace Laboratories - NAL,Flight,Specialised Services,India,Asia,6,3,3,3,0,3,3,Other
2009-04-25 00:00:00,Neptune Aviation Charter,Flight,Operational,United States of America,North America,3,3,3,0,0,3,0,Human Factor
2009-04-30 00:00:00,ROSTO,Landing (descent or approach),Operational,Russia,Asia,3,3,3,0,0,3,0,Human Factor
2009-05-26 00:00:00,Services Air,Landing (descent or approach),Operational,Democratic Republic of Congo,Africa,4,4,3,0,0,3,1,Unknown
2009-06-29 00:00:00,Aviastar Mandiri,Flight,Operational,Indonesia,Asia,3,3,3,0,0,3,0,Human Factor
2009-09-15 00:00:00,Private Venezuelan,Flight,Business,Venezuela,South America,3,2,2,1,1,3,0,Human Factor
2009-10-13 00:00:00,United States Army,Flight,Military / Government,Afghanistan,Asia,3,3,3,0,0,3,0,Human Factor
2009-10-23 00:00:00,Citrus Aviation,Landing (descent or approach),Business,United States of America,North America,3,1,1,2,2,3,0,Technical Failure
2009-11-15 00:00:00,Aviation at Work,Takeoff (climb),Operational,Namibia,Africa,4,1,1,3,2,3,1,Human Factor
2009-11-28 00:00:00,Avient Aviation,Takeoff (climb),Operational,China,Asia,7,7,3,0,0,3,4,Human Factor
2009-12-07 00:00:00,Eisenmann Industrial Marketing Consult,Landing (descent or approach),Business,Germany,Europe,3,1,1,2,2,3,0,Human Factor
2010-03-10 00:00:00,Copreca,Takeoff (climb),Business,Honduras,Central America,3,1,1,2,2,3,0,Unknown
2010-04-21 00:00:00,Interisland Airlines,Flight,Operational,Philippines,Asia,6,6,3,0,0,3,3,Technical Failure
2010-05-21 00:00:00,Grupo Chicoil,Flight,Commercial,Angola,Africa,3,2,2,1,1,3,0,Unknown
2010-05-26 00:00:00,Ocean City Comercial,Takeoff (climb),Business,Guatemala,Central America,3,1,1,2,2,3,0,Technical Failure
2010-06-12 00:00:00,Venezuelan Army - Ejército Bolivariano,Flight,Military / Government,Venezuela,South America,3,3,3,0,0,3,0,Human Factor
2010-07-10 00:00:00,Chase Bales,Landing (descent or approach),Business,United States of America,North America,3,1,1,2,2,3,0,Technical Failure
2010-08-01 00:00:00,All West Freight,Flight,Operational,United States of America,North America,3,2,2,1,1,3,0,Human Factor
2010-09-02 00:00:00,Private American,Takeoff (climb),Business,United States of America,North America,3,1,1,2,2,3,0,Technical Failure
2010-10-25 00:00:00,Pacific Cataract and Laser Institute,Flight,Business,United States of America,North America,3,1,1,2,2,3,0,Technical Failure
2010-11-23 00:00:00,Coleman Acquisitions,Landing (descent or approach),Business,United States of America,North America,3,1,1,2,2,3,0,Human Factor
2011-01-01 00:00:00,Kolavia,Parking,Commercial,Russia,Asia,134,8,0,126,3,3,131,Technical Failure
2011-03-04 00:00:00,Private Mexican,Flight,Business,Mexico,Central America,6,2,2,4,1,3,3,Technical Failure
2011-03-28 00:00:00,Zhongfei General Aviation Company - CFGAC,Flight,Military / Government,China,Asia,3,3,3,0,0,3,0,Unknown
2011-03-29 00:00:00,Triple F Aviation,Landing (descent or approach),Business,United States of America,North America,3,1,1,2,2,3,0,Human Factor
2011-07-24 00:00:00,Jon Buerkett,Takeoff (climb),Business,United States of America,North America,3,1,1,2,2,3,0,Weather
2011-09-20 00:00:00,SALSA d'Haïti - Services Aériens Latinoaméricains SA,Landing (descent or approach),Commercial,Haiti,Central America,3,2,2,1,1,3,0,Unknown
2011-09-22 00:00:00,Yajasi Aviation,Flight,Commercial,Indonesia,Asia,3,1,1,2,2,3,0,Human Factor
2011-11-28 00:00:00,Trans North Aviation,Landing (descent or approach),Humanitarian,United States of America,North America,5,2,1,3,2,3,2,Human Factor
2011-12-10 00:00:00,Aviation Technology Innovators,Takeoff (climb),Operational,Philippines,Asia,3,1,1,2,2,3,0,Technical Failure
2012-01-30 00:00:00,Tracep,Landing (descent or approach),Operational,Democratic Republic of Congo,Africa,5,2,2,3,1,3,2,Unknown
2012-02-21 00:00:00,Policía Federal,Flight,Military / Government,Mexico,Central America,3,3,3,0,0,3,0,Unknown
2012-04-21 00:00:00,Sky Team Bolivia,Landing (descent or approach),Operational,Bolivia,South America,4,3,3,1,0,3,1,Unknown
2012-05-13 00:00:00,Colin Moyes,Flight,Business,Canada,North America,3,1,1,2,2,3,0,Human Factor
2012-07-12 00:00:00,Banjet Taxi Aéreo,Landing (descent or approach),Commercial,Brazil,South America,3,2,2,1,1,3,0,Human Factor
2012-07-13 00:00:00,Universal Jet Aviation,Landing (descent or approach),Operational,France,Europe,3,3,3,0,0,3,0,Human Factor
2012-07-26 00:00:00,Patrick R. Porter,Takeoff (climb),Business,United States of America,North America,3,1,1,2,2,3,0,Unknown
2012-08-30 00:00:00,Dapeng Airlines,Flight,Specialised Services,Taiwan,Asia,3,2,2,1,1,3,0,Human Factor
2012-10-07 00:00:00,Fly Montserrat,Takeoff (climb),Commercial,Antigua,Central America,4,1,1,3,2,3,1,Other
2012-10-12 00:00:00,Russian Navy - Voyenno-morskoy Flot Rossii,Landing (descent or approach),Operational,Ukraine,Europe,4,4,3,0,0,3,1,Technical Failure
2013-01-12 00:00:00,Celtic Bank Special Assets,Takeoff (climb),Business,United States of America,North America,3,1,1,2,2,3,0,Weather
2013-01-23 00:00:00,Kenn Borek Air,Flight,Operational,Antarctica,Antarctica,3,3,3,0,0,3,0,Human Factor
2013-03-15 00:00:00,Miami Aviation Specialist,Takeoff (climb),Specialised Services,United States of America,North America,3,1,1,2,2,3,0,Human Factor
2013-05-03 00:00:00,United States Air Force - USAF,Flight,Operational,Kyrgyzstan,Asia,3,3,3,0,0,3,0,Technical Failure
2013-05-24 00:00:00,Valor Air,Flight,Military / Government,Kyrgyzstan,Asia,3,2,2,1,1,3,0,Human Factor
2013-07-06 00:00:00,Asiana Airlines,Landing (descent or approach),Commercial,United States of America,North America,307,16,0,291,3,3,304,Human Factor
2013-08-08 00:00:00,Aircraft Guaranty Corporation Trustee,Landing (descent or approach),Business,France,Europe,3,1,1,2,2,3,0,Human Factor
2013-11-25 00:00:00,Tropicair,Landing (descent or approach),Commercial,Papua New Guinea,Oceania,10,1,0,9,3,3,7,Technical Failure
2014-01-09 00:00:00,United States Army,Flight,Military / Government,Afghanistan,Asia,3,2,2,1,1,3,0,Unknown
2014-02-03 00:00:00,Crane Load Technology,Landing (descent or approach),Business,South Africa,Africa,3,1,1,2,2,3,0,Human Factor
2014-02-26 00:00:00,Maui Island Air,Takeoff (climb),Commercial,United States of America,North America,6,1,1,5,2,3,3,Human Factor
2014-06-17 00:00:00,South African Air Force,Flight,Operational,South Africa,Africa,5,2,2,3,1,3,2,Unknown
2014-06-18 00:00:00,Flying Lazy,Flight,Business,United States of America,North America,3,1,1,2,2,3,0,Human Factor
2014-06-18 00:00:00,Synfuels Holdings Finance,Takeoff (climb),Operational,United States of America,North America,3,3,3,0,0,3,0,Human Factor
2014-08-31 00:00:00,Safari Express Cargo,Flight,Operational,Tanzania,Africa,3,3,3,0,0,3,0,Unknown
2014-09-19 00:00:00,Private Venezuelan,Flight,Humanitarian,Venezuela,South America,3,2,2,1,1,3,0,Unknown
2014-11-20 00:00:00,Policía Nacional del Peru,Flight,Military / Government,Peru,South America,3,1,1,2,2,3,0,Human Factor
2014-12-08 00:00:00,Sage Aviation,Landing (descent or approach),Business,United States of America,North America,3,1,1,2,2,3,0,Human Factor
2015-01-29 00:00:00,Dinama Aircorp,Flight,Business,Netherlands,Central America,3,3,3,0,0,3,0,Terrorism
2015-04-01 00:00:00,Private Mexican,Flight,Humanitarian,Venezuela,South America,3,2,2,1,1,3,0,Unknown
2015-06-07 00:00:00,Atlântica Exportaçao e Importaçao,Takeoff (climb),Business,Brazil,South America,3,2,2,1,1,3,0,Human Factor
2015-06-08 00:00:00,Indian Coast Guard,Flight,Military / Government,India,Asia,3,3,3,0,0,3,0,Unknown
2015-08-08 00:00:00,Aeroexpress,Landing (descent or approach),Operational,Colombia,South America,3,2,2,1,1,3,0,Human Factor
2015-08-20 00:00:00,Dubnica Air,Flight,Humanitarian,Slovakia,Europe,19,2,2,17,1,3,16,Human Factor
2015-09-15 00:00:00,Rainbow King Lodge,Takeoff (climb),Commercial,United States of America,North America,10,1,0,9,3,3,7,Human Factor
2015-10-14 00:00:00,Microsurvey Aéreogeofísica e Consultoria Cientifica,Flight,Specialised Services,Colombia,South America,3,3,3,0,0,3,0,Human Factor
2016-01-29 00:00:00,Eros Air,Landing (descent or approach),Operational,Namibia,Africa,3,3,3,0,0,3,0,Human Factor
2016-02-06 00:00:00,Light Air,Flight,Military / Government,Russia,Asia,3,2,2,1,1,3,0,Human Factor
2016-03-09 00:00:00,True Aviation,Takeoff (climb),Operational,Bangladesh,Asia,4,4,3,0,0,3,1,Human Factor
2016-03-16 00:00:00,Iraqi Air Force - Al Quwwat al Jawwiya al Iraqiya,Flight,Military / Government,Iraq,Asia,3,3,3,0,0,3,0,Terrorism
2016-04-01 00:00:00,Aero Servicios Empresariales,Flight,Commercial,Mexico,Central America,10,1,0,9,3,3,7,Technical Failure
2016-07-11 00:00:00,Portuguese Air Force - Força Aerea Portuguesa,Takeoff (climb),Operational,Portugal,Europe,7,7,3,0,0,3,4,Unknown
2016-07-31 00:00:00,Lemaks,Flight,Operational,Russia,Asia,3,2,2,1,1,3,0,Human Factor
2016-08-31 00:00:00,Hageland Aviation Services,Flight,Commercial,United States of America,North America,3,1,1,2,2,3,0,Human Factor
2016-10-02 00:00:00,Hageland Aviation Services,Flight,Commercial,United States of America,North America,3,2,2,1,1,3,0,Human Factor
2016-10-09 00:00:00,Air Majoro,Flight,Commercial,Peru,South America,3,1,1,2,2,3,0,Human Factor
2017-02-09 00:00:00,Botswana Defence Force - Air Wing,Takeoff (climb),Military / Government,Botswana,Africa,3,3,3,0,0,3,0,Unknown
2017-03-14 00:00:00,United States Air Force - USAF,Landing (descent or approach),Operational,United States of America,North America,3,3,3,0,0,3,0,Human Factor
2017-04-28 00:00:00,Rico Aviation,Takeoff (climb),Humanitarian,United States of America,North America,3,1,1,2,2,3,0,Human Factor
2017-05-30 00:00:00,Rossair Charter,Takeoff (climb),Operational,Australia,Oceania,3,3,3,0,0,3,0,Human Factor
2017-07-24 00:00:00,Aibal,Takeoff (climb),Business,Argentina,South America,3,1,1,2,2,3,0,Human Factor
2017-11-22 00:00:00,United States Navy - USN,Landing (descent or approach),Military / Government,World,World,11,2,0,9,3,3,8,Technical Failure
2017-12-08 00:00:00,L3 Airline Academy,Landing (descent or approach),Operational,United States of America,North America,3,2,2,1,1,3,0,Human Factor
2017-12-14 00:00:00,Skytaxi Luftfahrt,Landing (descent or approach),Commercial,Germany,Europe,3,2,2,1,1,3,0,Unknown
2018-01-17 00:00:00,Turkish Air Force - Türk Hava Kuvvetleri,Flight,Operational,Turkey,Asia,3,3,3,0,0,3,0,Unknown
2018-02-22 00:00:00,Ponderosa Aviation,Flight,Business,United States of America,North America,3,1,1,2,2,3,0,Unknown
2018-04-29 00:00:00,Libyan Air Force - Al Quwwat Al-Jawwiya Al Libiyya,Takeoff (climb),Military / Government,Libya,Africa,4,4,3,0,0,3,1,Unknown
2018-05-15 00:00:00,Private Mexican,Flight,Humanitarian,Mexico,Central America,3,2,2,1,1,3,0,Unknown
2018-06-05 00:00:00,Hat Investments,Takeoff (climb),Business,Bahamas,Central America,3,1,1,2,2,3,0,Unknown
2018-07-30 00:00:00,Joe Robertson,Landing (descent or approach),Business,United States of America,North America,3,1,1,2,2,3,0,Human Factor
2018-11-18 00:00:00,Bismarck Air Medical,Takeoff (climb),Humanitarian,United States of America,North America,3,1,1,2,2,3,0,Human Factor
2018-11-30 00:00:00,EstoAir,Takeoff (climb),Business,United States of America,North America,3,1,1,2,2,3,0,Technical Failure
2019-01-29 00:00:00,Guardian Flight,Landing (descent or approach),Humanitarian,United States of America,North America,3,1,1,2,2,3,0,Unknown
2019-02-23 00:00:00,Atlas Air,Flight,Operational,United States of America,North America,3,3,3,0,0,3,0,Human Factor
2019-03-31 00:00:00,Globus Airlines,Landing (descent or approach),Business,Germany,Europe,3,1,1,2,2,3,0,Human Factor
2019-04-13 00:00:00,Classic Aviation,Flight,Business,United States of America,North America,3,2,2,1,1,3,0,Technical Failure
2019-07-12 00:00:00,Jim Duggan,Flight,Business,Canada,North America,4,1,1,3,2,3,1,Human Factor
2019-09-29 00:00:00,Martin Flores,Takeoff (climb),Business,United States of America,North America,3,1,1,2,2,3,0,Human Factor
2019-10-26 00:00:00,Blue Water Aviation - Manitoba Air Charter Services,Landing (descent or approach),Commercial,Canada,North America,3,1,1,2,2,3,0,Technical Failure
2019-11-29 00:00:00,Security Aviation,Flight,Humanitarian,United States of America,North America,3,1,1,2,2,3,0,Human Factor
2019-12-10 00:00:00,Private Canadian,Landing (descent or approach),Business,Canada,North America,3,1,1,2,2,3,0,Technical Failure
2020-01-23 00:00:00,Coulson,Flight,Humanitarian,Australia,Oceania,3,3,3,0,0,3,0,Unknown
2020-01-23 00:00:00,South African Civil Aviation Authority,Flight,Specialised Services,South Africa,Africa,3,3,3,0,0,3,0,Human Factor
2020-01-28 00:00:00,LKJ Properties,Landing (descent or approach),Business,United States of America,North America,3,1,1,2,2,3,0,Unknown
2020-02-05 00:00:00,Pegasus Airlines,Landing (descent or approach),Commercial,Turkey,Asia,183,6,0,177,3,3,180,Unknown
2020-02-20 00:00:00,TLC Air,Flight,Business,United States of America,North America,3,1,1,2,2,3,0,Unknown
2020-03-03 00:00:00,Triple 4 Aviation,Flight,Business,United States of America,North America,3,1,1,2,2,3,0,Unknown
2020-05-05 00:00:00,MD Fly,Landing (descent or approach),Humanitarian,Argentina,South America,4,2,1,2,2,3,1,Human Factor
2021-02-07 00:00:00,BCD Aviation,Landing (descent or approach),Business,United States of America,North America,3,1,1,2,2,3,0,Unknown
2021-05-04 00:00:00,Northshore Group,Landing (descent or approach),Business,United States of America,North America,3,1,1,2,2,3,0,Unknown
2021-06-16 00:00:00,Kin Avia,Takeoff (climb),Operational,Democratic Republic of Congo,Africa,3,2,2,1,1,3,0,Unknown
2021-07-08 00:00:00,Aliansa Colombia - Aerolíneas Andinas,Flight,Operational,Colombia,South America,3,3,3,0,0,3,0,Unknown
2021-07-18 00:00:00,Aspa Servicios,Landing (descent or approach),Commercial,Mexico,Central America,7,2,1,5,2,3,4,Unknown
2021-08-17 00:00:00,United Aircraft Corporation,Landing (descent or approach),Specialised Services,Russia,Asia,3,3,3,0,0,3,0,Technical Failure
2021-09-15 00:00:00,Rimbun Air,Landing (descent or approach),Operational,Indonesia,Asia,3,3,3,0,0,3,0,Unknown
2021-09-28 00:00:00,Surdex Corporation,Flight,Specialised Services,United States of America,North America,3,1,1,2,2,3,0,Unknown
2022-03-28 00:00:00,Bank of Utah,Landing (descent or approach),Business,Mexico,Central America,7,1,1,6,2,3,4,Unknown
1918-05-02 00:00:00,United States Signal Corps - USSC,Takeoff (climb),Specialised Services,United States of America,North America,2,2,2,0,0,2,0,Technical Failure
1918-07-18 00:00:00,Royal Air Force - RAF,Flight,Operational,United Kingdom,Europe,2,2,2,0,0,2,0,Unknown
1918-08-23 00:00:00,Portuguese Air Force - Aeronáutica Militar,Flight,Military / Government,Portugal,Europe,2,2,2,0,0,2,0,Unknown
1918-10-27 00:00:00,Royal Air Force - RAF,Flight,Military / Government,France,Europe,2,2,2,0,0,2,0,Unknown
1918-12-31 00:00:00,Royal Air Force - RAF,Landing (descent or approach),Military / Government,United Kingdom,Europe,2,2,2,0,0,2,0,Unknown
1919-04-21 00:00:00,Private French,Flight,Operational,France,Europe,2,2,2,0,0,2,0,Technical Failure
1919-05-15 00:00:00,Royal Air Force - RAF,Flight,Military / Government,France,Europe,2,1,1,1,1,2,0,Unknown
1919-05-17 00:00:00,Royal Air Force - RAF,Landing (descent or approach),Military / Government,Italy,Europe,5,4,2,1,0,2,3,Unknown
1919-05-24 00:00:00,Royal Air Force - RAF,Flight,Operational,United Kingdom,Europe,2,2,2,0,0,2,0,Unknown
1919-12-09 00:00:00,Martinsyde Ltd,Flight,Business,Greece,Europe,2,2,2,0,0,2,0,Unknown
1919-12-11 00:00:00,Aircraft Transport %26 Travel - AT%26T,Flight,Commercial,United Kingdom,Europe,2,1,1,1,1,2,0,Unknown
1920-05-24 00:00:00,Ad Astra Aero,Flight,Operational,Switzerland,Europe,2,2,2,0,0,2,0,Technical Failure
1920-07-04 00:00:00,Cuban Air Force - Cuerpo de Aviación del Ejército de Cuba,Takeoff (climb),Operational,Cuba,Central America,2,1,1,1,1,2,0,Unknown
1920-07-10 00:00:00,Gordon L. Groah,Flight,Business,United States of America,North America,3,2,1,1,1,2,1,Unknown
1920-07-12 00:00:00,Royal Air Force - RAF,Takeoff (climb),Operational,United Kingdom,Europe,2,2,2,0,0,2,0,Unknown
1920-07-20 00:00:00,Compañia Colombiana de Navegación Aérea,Takeoff (climb),Commercial,Colombia,South America,3,1,1,2,1,2,1,Human Factor
1920-08-12 00:00:00,G. L. P. Henderson,Takeoff (climb),Operational,United Kingdom,Europe,2,2,2,0,0,2,0,Unknown
1920-08-25 00:00:00,Swedish Air Force - Flygvapnet,Flight,Operational,Sweden,Europe,2,2,2,0,0,2,0,Unknown
1920-09-01 00:00:00,U.S. Air Mail Service,Flight,Operational,United States of America,North America,2,2,2,0,0,2,0,Technical Failure
1920-09-07 00:00:00,Finnish Air Force - Suomen Ilmavoimat,Flight,Operational,Switzerland,Europe,2,2,2,0,0,2,0,Other
1920-09-07 00:00:00,Finnish Air Force - Suomen Ilmavoimat,Flight,Operational,Switzerland,Europe,2,2,2,0,0,2,0,Other
1920-09-14 00:00:00,U.S. Air Mail Service,Flight,Operational,United States of America,North America,2,2,2,0,0,2,0,Technical Failure
1920-10-02 00:00:00,Lignes Aériennes Latécoère,Flight,Operational,France,Europe,2,2,2,0,0,2,0,Unknown
1920-10-05 00:00:00,Lignes Aériennes Latécoère,Flight,Operational,Spain,Europe,2,2,2,0,0,2,0,Unknown
1921-01-09 00:00:00,Spanish River Pulp %26 Paper Mills,Flight,Business,United States of America,North America,2,1,1,1,1,2,0,Technical Failure
1921-02-15 00:00:00,Lignes Aériennes Latécoère,Flight,Operational,United Kingdom,Europe,2,2,2,0,0,2,0,Weather
1921-02-18 00:00:00,Lloyd-Ostflug,Flight,Commercial,Poland,Europe,2,2,2,0,0,2,0,Human Factor
1921-03-31 00:00:00,Instrument Design Establishment,Flight,Specialised Services,United Kingdom,Europe,2,2,2,0,0,2,0,Technical Failure
1921-04-06 00:00:00,Royal Australian Air Force - RAAF,Takeoff (climb),Operational,Australia,Oceania,2,2,2,0,0,2,0,Unknown
1921-05-23 00:00:00,Portuguese Air Force - Aeronáutica Militar,Landing (descent or approach),Military / Government,Portugal,Europe,2,2,2,0,0,2,0,Unknown
1921-07-06 00:00:00,Swedish Air Force - Flygvapnet,Flight,Operational,Sweden,Europe,2,2,2,0,0,2,0,Unknown
1921-08-11 00:00:00,Compagnie Générale d'Entreprises Aéronautiques - CGEA,Takeoff (climb),Operational,France,Europe,2,2,2,0,0,2,0,Technical Failure
1921-08-16 00:00:00,Aeroplane %26 Armament Experimental Establishment - A%26AEE,Takeoff (climb),Specialised Services,United Kingdom,Europe,4,4,2,0,0,2,2,Unknown
1921-08-26 00:00:00,Syndicat National pour l'Etude du Transport Aérien - SNETA,Flight,Operational,France,Europe,2,2,2,0,0,2,0,Technical Failure
1921-09-18 00:00:00,Ad Astra Aero,Flight,Commercial,Switzerland,Europe,2,1,1,1,1,2,0,Unknown
1921-11-28 00:00:00,Aircraft Disposal Company,Takeoff (climb),Specialised Services,United Kingdom,Europe,2,2,2,0,0,2,0,Unknown
1921-11-30 00:00:00,United States Army Air Service - USAAS,Flight,Operational,United States of America,North America,2,2,2,0,0,2,0,Human Factor
1921-11-30 00:00:00,United States Army Air Service - USAAS,Flight,Operational,United States of America,North America,2,2,2,0,0,2,0,Human Factor
1921-12-05 00:00:00,Western Australia Airways,Landing (descent or approach),Commercial,Australia,Oceania,2,2,2,0,0,2,0,Unknown
1922-01-06 00:00:00,Royal Air Force - RAF,Landing (descent or approach),Military / Government,Pakistan,Asia,3,3,2,0,0,2,1,Unknown
1922-01-13 00:00:00,Royal Air Force - RAF,Flight,Operational,Iraq,Asia,2,2,2,0,0,2,0,Human Factor
1922-03-28 00:00:00,Royal Air Force - RAF,Takeoff (climb),Operational,United Kingdom,Europe,2,2,2,0,0,2,0,Unknown
1922-04-07 00:00:00,Daimler Airway,Flight,Operational,France,Europe,2,2,2,0,0,2,0,Human Factor
1922-04-13 00:00:00,Ross MacPherson Smith,Flight,Specialised Services,United Kingdom,Europe,2,2,2,0,0,2,0,Human Factor
1922-06-02 00:00:00,École Aéro,Flight,Operational,Switzerland,Europe,2,2,2,0,0,2,0,Unknown
1922-07-12 00:00:00,Turkish Air Force - Türk Hava Kuvvetleri,Flight,Military / Government,Turkey,Asia,2,2,2,0,0,2,0,Terrorism
1922-07-22 00:00:00,JL Tiedemanns Tobaksfabrik,Flight,Business,Norway,Europe,2,1,1,1,1,2,0,Unknown
1922-08-23 00:00:00,Royal Air Force - RAF,Flight,Operational,Egypt,Africa,2,2,2,0,0,2,0,Unknown
1922-08-24 00:00:00,French Air Force - Armée de l'Air,Takeoff (climb),Specialised Services,France,Europe,2,1,1,1,1,2,0,Technical Failure
1922-08-26 00:00:00,Hellenic Air Force - Elleniki Polemiki Aeroporia,Flight,Operational,Greece,Europe,2,2,2,0,0,2,0,Unknown
1922-10-25 00:00:00,Compagnie Générale d'Entreprises Aéronautiques - CGEA,Flight,Operational,Morocco,Africa,2,1,1,1,1,2,0,Unknown
1922-10-30 00:00:00,Compagnie Franco-Roumaine de Navigation Aérienne,Flight,Commercial,Czech Republic,Europe,2,1,1,1,1,2,0,Human Factor
1923-01-18 00:00:00,U.S. Air Mail Service,Flight,Specialised Services,United States of America,North America,2,2,2,0,0,2,0,Human Factor
1923-01-18 00:00:00,United States Army Air Service - USAAS,Flight,Military / Government,United States of America,North America,8,8,2,0,0,2,6,Human Factor
1923-02-08 00:00:00,Belgian Air Force - Force Aérienne Belge - Belgische Luchtmacht,Flight,Operational,Belgium,Europe,2,2,2,0,0,2,0,Unknown
1923-06-14 00:00:00,Royal Aero Club,Landing (descent or approach),Operational,United Kingdom,Europe,2,2,2,0,0,2,0,Unknown
1923-06-25 00:00:00,Junkers Flugzeug %26 Motorenwerke,Takeoff (climb),Operational,Brazil,South America,2,2,2,0,0,2,0,Technical Failure
1923-08-27 00:00:00,Compagnie Franco-Roumaine de Navigation Aérienne,Landing (descent or approach),Commercial,Romania,Europe,2,1,1,1,1,2,0,Unknown
1923-10-18 00:00:00,Brazilian Air Force - Aviação Militar,Flight,Operational,Brazil,South America,3,3,2,0,0,2,1,Unknown
1923-12-14 00:00:00,Royal Air Force - RAF,Flight,Operational,Iraq,Asia,2,2,2,0,0,2,0,Unknown
1924-04-12 00:00:00,Royal Air Force - RAF,Takeoff (climb),Operational,Iraq,Asia,2,2,2,0,0,2,0,Unknown
1924-08-16 00:00:00,Oxford Arctic Expedition,Flight,Business,Norway,Europe,2,2,2,0,0,2,0,Unknown
1925-03-04 00:00:00,Swedish Air Force - Flygvapnet,Flight,Operational,Sweden,Europe,2,2,2,0,0,2,0,Unknown
1925-04-07 00:00:00,Royal Air Force - RAF,Flight,Operational,United Kingdom,Europe,4,4,2,0,0,2,2,Weather
1925-05-01 00:00:00,Royal Air Force - RAF,Flight,Operational,United Kingdom,Europe,2,2,2,0,0,2,0,Human Factor
1925-05-25 00:00:00,Compagnie Générale d'Entreprises Aéronautiques - CGEA,Takeoff (climb),Commercial,Spain,Europe,5,2,2,3,0,2,3,Weather
1925-06-26 00:00:00,Compagnie Générale d'Entreprises Aéronautiques - CGEA,Landing (descent or approach),Operational,Spain,Europe,2,2,2,0,0,2,0,Human Factor
1925-07-20 00:00:00,Lignes Aériennes Latécoère,Flight,Operational,Spain,Europe,2,1,1,1,1,2,0,Unknown
1925-10-28 00:00:00,Turkish Air Force - Türk Hava Kuvvetleri,Flight,Operational,Turkey,Asia,2,2,2,0,0,2,0,Unknown
1925-11-23 00:00:00,United States Army Air Service - USAAS,Flight,Military / Government,United States of America,North America,4,4,2,0,0,2,2,Technical Failure
1926-01-12 00:00:00,Portuguese Air Force - Aeronáutica Militar,Takeoff (climb),Operational,Portugal,Europe,2,2,2,0,0,2,0,Unknown
1926-01-16 00:00:00,Belgian Air Force - Force Aérienne Belge - Belgische Luchtmacht,Flight,Operational,Belgium,Europe,2,2,2,0,0,2,0,Unknown
1926-02-11 00:00:00,Royal Australian Air Force - RAAF,Landing (descent or approach),Specialised Services,Australia,Oceania,2,1,1,1,1,2,0,Human Factor
1926-02-25 00:00:00,Portuguese Air Force - Aeronáutica Militar,Landing (descent or approach),Military / Government,Portugal,Europe,2,2,2,0,0,2,0,Unknown
1926-02-26 00:00:00,Royal Air Force - RAF,Takeoff (climb),Operational,United Kingdom,Europe,2,2,2,0,0,2,0,Unknown
1926-05-07 00:00:00,Leslie Hamilton,Flight,Business,World,World,2,2,2,0,0,2,0,Unknown
1926-07-01 00:00:00,Royal Australian Air Force - RAAF,Flight,Operational,Australia,Oceania,2,2,2,0,0,2,0,Human Factor
1926-07-09 00:00:00,KLM Royal Dutch Airlines - Koninklijke Luchtvaart Maatschappij,Landing (descent or approach),Commercial,Belgium,Europe,2,1,1,1,1,2,0,Weather
1926-07-27 00:00:00,Belgian Air Force - Force Aérienne Belge - Belgische Luchtmacht,Flight,Operational,Belgium,Europe,2,2,2,0,0,2,0,Technical Failure
1926-08-26 00:00:00,Pander,Flight,Business,Germany,Europe,2,1,1,1,1,2,0,Unknown
1926-09-21 00:00:00,Argonauts,Takeoff (climb),Business,United States of America,North America,4,4,2,0,0,2,2,Human Factor
1926-11-11 00:00:00,Royal Air Force - RAF,Takeoff (climb),Operational,United Kingdom,Europe,2,2,2,0,0,2,0,Unknown
1926-11-22 00:00:00,Royal Air Force - RAF,Takeoff (climb),Operational,United Kingdom,Europe,2,2,2,0,0,2,0,Unknown
1926-12-22 00:00:00,United States Army Air Corps - USAAC,Flight,Operational,United States of America,North America,2,2,2,0,0,2,0,Human Factor
1927-04-03 00:00:00,Pacific Air Transport,Flight,Commercial,United States of America,North America,2,1,1,1,1,2,0,Human Factor
1927-04-21 00:00:00,Royal Australian Air Force - RAAF,Flight,Operational,Australia,Oceania,2,2,2,0,0,2,0,Human Factor
1927-04-21 00:00:00,Royal Australian Air Force - RAAF,Flight,Operational,Australia,Oceania,2,2,2,0,0,2,0,Human Factor
1927-04-22 00:00:00,Deutsche Lufthansa,Flight,Commercial,Germany,Europe,2,1,1,1,1,2,0,Technical Failure
1927-04-26 00:00:00,Noel Guy Davis,Takeoff (climb),Operational,United States of America,North America,2,2,2,0,0,2,0,Human Factor
1927-05-09 00:00:00,Charles Nungesser,Flight,Business,World,World,2,2,2,0,0,2,0,Unknown
1927-05-20 00:00:00,Hellenic Air Force - Elleniki Polemiki Aeroporia,Takeoff (climb),Military / Government,Greece,Europe,2,2,2,0,0,2,0,Human Factor
1927-06-04 00:00:00,De Havilland School of Flying,Takeoff (climb),Operational,United Kingdom,Europe,2,2,2,0,0,2,0,Unknown
1927-06-05 00:00:00,SCADTA - Sociedad Colombo-Alemana de Transportes Aéreos,Landing (descent or approach),Commercial,Colombia,South America,5,2,1,3,1,2,3,Unknown
1927-08-16 00:00:00,Jack Frost,Flight,Business,World,World,2,2,2,0,0,2,0,Unknown
1927-09-07 00:00:00,Carling Breweries,Flight,Business,World,World,2,2,2,0,0,2,0,Unknown
1927-09-22 00:00:00,Nordbayerische Verkehrsflug,Takeoff (climb),Commercial,Germany,Europe,4,1,1,3,1,2,2,Technical Failure
1927-10-06 00:00:00,L'Aéropostale,Landing (descent or approach),Operational,Senegal,Africa,2,2,2,0,0,2,0,Unknown
1927-10-20 00:00:00,Royal Air Force - RAF,Takeoff (climb),Operational,United Kingdom,Europe,3,3,2,0,0,2,1,Technical Failure
1928-01-10 00:00:00,George Hood,Flight,Business,World,World,2,2,2,0,0,2,0,Unknown
1928-01-15 00:00:00,L'Aéropostale,Landing (descent or approach),Operational,Uruguay,South America,2,2,2,0,0,2,0,Technical Failure
1928-01-27 00:00:00,L'Aéropostale,Flight,Commercial,Spain,Europe,2,1,1,1,1,2,0,Weather
1928-03-11 00:00:00,Air Union France,Flight,Operational,United Kingdom,Europe,2,2,2,0,0,2,0,Weather
1928-03-12 00:00:00,Maia Carberry,Flight,Operational,Kenya,Africa,2,2,2,0,0,2,0,Unknown
1928-03-12 00:00:00,Henderson Flying School,Takeoff (climb),Business,South Africa,Africa,2,1,1,1,1,2,0,Unknown
1928-03-13 00:00:00,Elsie Mackay,Flight,Business,World,World,2,1,1,1,1,2,0,Unknown
1928-04-11 00:00:00,Shirley G. Kingsley,Flight,Operational,Argentina,South America,2,2,2,0,0,2,0,Unknown
1928-04-17 00:00:00,Cuban Air Force - Cuerpo de Aviación del Ejército de Cuba,Takeoff (climb),Operational,Cuba,Central America,2,2,2,0,0,2,0,Unknown
1928-04-18 00:00:00,Bulgarian Post Office,Flight,Operational,Bulgaria,Europe,2,2,2,0,0,2,0,Unknown
1928-04-24 00:00:00,Royal Netherlands Navy - Marineluchtvaartdienst,Flight,Specialised Services,Indonesia,Asia,5,5,2,0,0,2,3,Technical Failure
1928-05-06 00:00:00,Bristol %26 Wessex Aeroplane Club,Takeoff (climb),Operational,United Kingdom,Europe,2,2,2,0,0,2,0,Unknown
1928-05-09 00:00:00,Private American,Flight,Specialised Services,United States of America,North America,2,1,1,1,1,2,0,Unknown
1928-05-12 00:00:00,Ford Air Freight Lines,Takeoff (climb),Operational,United States of America,North America,2,2,2,0,0,2,0,Human Factor
1928-05-12 00:00:00,Royal Air Force - RAF,Landing (descent or approach),Military / Government,United Kingdom,Europe,3,3,2,0,0,2,1,Unknown
1928-07-01 00:00:00,Royal Air Force - RAF,Takeoff (climb),Military / Government,United Kingdom,Europe,2,2,2,0,0,2,0,Unknown
1928-07-05 00:00:00,Lloyd Aéreo Boliviano - LAB Airlines,Flight,Commercial,Bolivia,South America,2,1,1,1,1,2,0,Unknown
1928-07-06 00:00:00,Austrian Air Force - Österreichische Luftstreitkräfte,Flight,Operational,Austria,Europe,2,2,2,0,0,2,0,Unknown
1928-08-03 00:00:00,London Aeroplane Club,Flight,Operational,United Kingdom,Europe,2,2,2,0,0,2,0,Technical Failure
1928-08-08 00:00:00,Avions René Couzinet,Flight,Specialised Services,France,Europe,3,3,2,0,0,2,1,Technical Failure
1928-08-17 00:00:00,Royal Air Force - RAF,Flight,Operational,United Kingdom,Europe,2,2,2,0,0,2,0,Human Factor
1928-08-22 00:00:00,Nottingham Aero Club,Takeoff (climb),Operational,United Kingdom,Europe,2,2,2,0,0,2,0,Unknown
1928-10-18 00:00:00,Crescent Air Service,Takeoff (climb),Commercial,United States of America,North America,8,2,0,6,2,2,6,Unknown
1928-11-03 00:00:00,Harry J. Tucker,Flight,Business,United States of America,North America,2,1,1,1,1,2,0,Weather
1928-11-30 00:00:00,Portuguese Air Force - Aeronáutica Militar,Flight,Operational,Portugal,Europe,2,2,2,0,0,2,0,Human Factor
1928-12-26 00:00:00,Australian Aero Club,Takeoff (climb),Business,Australia,Oceania,2,1,1,1,1,2,0,Human Factor
1928-12-31 00:00:00,Compagnie Internationale de Navigation Aérienne - CIDNA,Flight,Commercial,France,Europe,3,1,0,2,2,2,1,Weather
1929-01-25 00:00:00,Air Union France,Landing (descent or approach),Commercial,France,Europe,4,2,0,2,2,2,2,Unknown
1929-01-25 00:00:00,Aero Espresso Italiana,Flight,Commercial,Greece,Europe,9,4,1,5,1,2,7,Weather
1929-01-31 00:00:00,L'Aéropostale,Flight,Operational,Morocco,Africa,2,2,2,0,0,2,0,Unknown
1929-02-11 00:00:00,Crimson Aircraft,Flight,Business,Australia,Oceania,2,2,2,0,0,2,0,Weather
1929-03-17 00:00:00,LAN Chile - Linea Aérea Nacional de Chile,Flight,Operational,Chile,South America,2,2,2,0,0,2,0,Unknown
1929-04-11 00:00:00,Eugène de Ligne,Flight,Business,Democratic Republic of Congo,Africa,3,3,2,0,0,2,1,Weather
1929-04-12 00:00:00,Swedish Air Force - Flygvapnet,Flight,Operational,Sweden,Europe,2,2,2,0,0,2,0,Human Factor
1929-04-23 00:00:00,Toronto Flying Club,Takeoff (climb),Business,Canada,North America,2,1,1,1,1,2,0,Unknown
1929-05-16 00:00:00,Vickers-Armstrongs Ltd,Flight,Specialised Services,United Kingdom,Europe,2,2,2,0,0,2,0,Technical Failure
1929-05-18 00:00:00,Malert - Magyar-Szoviet Legiforgalmi Tarseaag,Flight,Commercial,Hungary,Europe,2,1,1,1,1,2,0,Technical Failure
1929-05-18 00:00:00,Irving Air Chute of Great Britain,Flight,Operational,United Kingdom,Europe,2,1,1,1,1,2,0,Technical Failure
1929-05-19 00:00:00,Calgary Flying Club,Flight,Business,Canada,North America,2,1,1,1,1,2,0,Technical Failure
1929-06-13 00:00:00,Pan American World Airways - PAA,Takeoff (climb),Commercial,Cuba,Central America,5,2,1,3,1,2,3,Other
1929-06-25 00:00:00,Ukrvozduchput,Takeoff (climb),Operational,Georgia,Asia,2,2,2,0,0,2,0,Technical Failure
1929-07-08 00:00:00,United States Army Air Corps - USAAC,Flight,Military / Government,Panama,Central America,2,1,1,1,1,2,0,Unknown
1929-07-17 00:00:00,Royal Air Force - RAF,Flight,Operational,United Kingdom,Europe,2,2,2,0,0,2,0,Human Factor
1929-07-29 00:00:00,De Havilland Aircraft UK,Flight,Business,United Kingdom,Europe,2,2,2,0,0,2,0,Human Factor
1929-08-19 00:00:00,Kurt Lüscher,Flight,Business,World,World,2,1,1,1,1,2,0,Unknown
1929-09-12 00:00:00,Ukrvozduchput,Landing (descent or approach),Operational,Georgia,Asia,2,2,2,0,0,2,0,Technical Failure
1929-09-23 00:00:00,Edward Matthias Tiarks,Takeoff (climb),Business,United Kingdom,Europe,2,1,1,1,1,2,0,Unknown
1929-10-05 00:00:00,French Air Force - Armée de l'Air,Flight,Operational,France,Europe,2,2,2,0,0,2,0,Human Factor
1929-10-05 00:00:00,French Air Force - Armée de l'Air,Flight,Operational,France,Europe,2,2,2,0,0,2,0,Human Factor
1929-10-31 00:00:00,Gorst Air Transport,Takeoff (climb),Commercial,United States of America,North America,2,1,1,1,1,2,0,Unknown
1929-11-02 00:00:00,Embry Riddle Company,Landing (descent or approach),Operational,United States of America,North America,2,2,2,0,0,2,0,Human Factor
1929-11-05 00:00:00,Skyways - USA,Takeoff (climb),Commercial,United States of America,North America,2,1,1,1,1,2,0,Unknown
1929-11-16 00:00:00,Jesse E. O’Connor,Flight,Business,Australia,Oceania,2,1,1,1,1,2,0,Unknown
1929-12-04 00:00:00,United States Army Air Corps - USAAC,Flight,Military / Government,United States of America,North America,4,4,2,0,0,2,2,Technical Failure
1929-12-12 00:00:00,Aerial Services New Zealand,Landing (descent or approach),Specialised Services,New Zealand,Oceania,2,1,1,1,1,2,0,Technical Failure
1929-12-17 00:00:00,Royal Air Force - RAF,Flight,Business,Tunisia,Africa,2,2,2,0,0,2,0,Human Factor
1929-12-19 00:00:00,Deutsche Lufthansa,Flight,Operational,Germany,Europe,3,3,2,0,0,2,1,Weather
1929-12-26 00:00:00,Hvalfangstselskapet Kosmos,Flight,Specialised Services,Antarctica,Antarctica,2,2,2,0,0,2,0,Unknown
1930-01-08 00:00:00,Royal Air Force - RAF,Flight,Operational,Egypt,Africa,2,2,2,0,0,2,0,Human Factor
1930-01-08 00:00:00,Royal Air Force - RAF,Flight,Operational,Egypt,Africa,2,2,2,0,0,2,0,Human Factor
1930-01-10 00:00:00,Fairchild Aircraft Corporation,Flight,Specialised Services,United States of America,North America,2,2,2,0,0,2,0,Unknown
1930-01-21 00:00:00,Royal Air Force - RAF,Flight,Military / Government,United Kingdom,Europe,2,2,2,0,0,2,0,Unknown
1930-01-23 00:00:00,Línea Aérea Experimental,Flight,Commercial,Chile,South America,2,2,2,0,0,2,0,Weather
1930-01-25 00:00:00,L'Aéropostale,Flight,Operational,World,World,2,2,2,0,0,2,0,Unknown
1930-01-28 00:00:00,A. J. Murphy,Flight,Business,Australia,Oceania,2,1,1,1,1,2,0,Unknown
1930-02-10 00:00:00,Air Union France,Flight,Commercial,United Kingdom,Europe,6,3,0,3,2,2,4,Technical Failure
1930-02-16 00:00:00,SCADTA - Sociedad Colombo-Alemana de Transportes Aéreos,Flight,Other,Colombia,South America,2,2,2,0,0,2,0,Unknown
1930-03-18 00:00:00,Canadian Airways,Flight,Operational,Canada,North America,2,2,2,0,0,2,0,Technical Failure
1930-03-24 00:00:00,Royal Air Force - RAF,Landing (descent or approach),Operational,United Kingdom,Europe,5,5,2,0,0,2,3,Unknown
1930-04-02 00:00:00,Latécoère Industries,Flight,Operational,France,Europe,2,2,2,0,0,2,0,Human Factor
1930-04-04 00:00:00,Bach Aircraft Company,Landing (descent or approach),Specialised Services,United States of America,North America,2,2,2,0,0,2,0,Technical Failure
1930-04-07 00:00:00,Deutsche Lufthansa,Flight,Operational,United Kingdom,Europe,2,2,2,0,0,2,0,Unknown
1930-04-08 00:00:00,Hellenic Air Force - Elleniki Polemiki Aeroporia,Landing (descent or approach),Operational,Greece,Europe,2,2,2,0,0,2,0,Human Factor
1930-04-23 00:00:00,Royal Air Force - RAF,Landing (descent or approach),Military / Government,Egypt,Africa,2,2,2,0,0,2,0,Technical Failure
1930-04-25 00:00:00,Royal Air Force - RAF,Landing (descent or approach),Operational,United Kingdom,Europe,2,2,2,0,0,2,0,Unknown
1930-04-27 00:00:00,Hellenic Air Force - Elleniki Polemiki Aeroporia,Flight,Operational,Greece,Europe,2,2,2,0,0,2,0,Unknown
1930-05-11 00:00:00,Pablo Sídar Escobar,Flight,Business,Costa Rica,Central America,2,2,2,0,0,2,0,Unknown
1930-05-21 00:00:00,Bryant House Airways,Flight,Operational,New Zealand,Oceania,2,1,1,1,1,2,0,Human Factor
1930-05-31 00:00:00,J. H. Bettington,Flight,Business,Australia,Oceania,2,2,2,0,0,2,0,Technical Failure
1930-06-05 00:00:00,Royal Air Force - RAF,Takeoff (climb),Operational,Malta,Europe,2,2,2,0,0,2,0,Unknown
1930-06-23 00:00:00,French Air Force - Armée de l'Air,Landing (descent or approach),Operational,France,Europe,4,3,2,1,0,2,2,Unknown
1930-06-29 00:00:00,Henderson Flying School,Landing (descent or approach),Business,United Kingdom,Europe,2,1,1,1,1,2,0,Human Factor
1930-07-07 00:00:00,Royal Air Force - RAF,Landing (descent or approach),Operational,Malta,Europe,2,2,2,0,0,2,0,Other
1930-07-20 00:00:00,S. E. H. Spencer,Flight,Business,United Kingdom,Europe,2,1,1,1,1,2,0,Human Factor
1930-07-26 00:00:00,Royal Air Force - RAF,Takeoff (climb),Military / Government,Yemen,Asia,2,2,2,0,0,2,0,Unknown
1930-07-26 00:00:00,Plymouth Airways,Landing (descent or approach),Commercial,United States of America,North America,2,1,1,1,1,2,0,Unknown
1930-08-06 00:00:00,Deutsche Lufthansa,Flight,Operational,Sweden,Europe,2,2,2,0,0,2,0,Unknown
1930-09-04 00:00:00,Polish Air Force - Polska Wojska Lotnicze i Obrony Powietrznej,Flight,Operational,Poland,Europe,2,2,2,0,0,2,0,Human Factor
1930-09-11 00:00:00,SABENA - Société Anonyme Belge d'Exploitation de la Navigation Aérienne,Takeoff (climb),Operational,United Kingdom,Europe,2,2,2,0,0,2,0,Technical Failure
1930-09-15 00:00:00,Svenska Luftfartsförbundet,Flight,Operational,Sweden,Europe,2,2,2,0,0,2,0,Unknown
1930-09-15 00:00:00,Belgian Air Force - Force Aérienne Belge - Belgische Luchtmacht,Flight,Operational,Belgium,Europe,2,2,2,0,0,2,0,Unknown
1930-09-18 00:00:00,Deutsche Versuchsanstalt für Luftfahrt,Flight,Operational,Germany,Europe,2,2,2,0,0,2,0,Weather
1930-09-22 00:00:00,Mexican Air Force - Fuerza Aérea Mexicana,Flight,Operational,Mexico,Central America,2,2,2,0,0,2,0,Unknown
1930-10-15 00:00:00,Royal Air Force - RAF,Flight,Operational,United Kingdom,Europe,2,2,2,0,0,2,0,Unknown
1930-10-20 00:00:00,French Air Force - Armée de l'Air,Flight,Military / Government,Belgium,Europe,2,2,2,0,0,2,0,Human Factor
1930-10-22 00:00:00,National Flying Services,Takeoff (climb),Commercial,United Kingdom,Europe,2,1,1,1,1,2,0,Unknown
1930-10-24 00:00:00,Gilbert Lane,Takeoff (climb),Business,France,Europe,2,2,2,0,0,2,0,Unknown
1930-11-04 00:00:00,Royal Air Force - RAF,Takeoff (climb),Operational,United Kingdom,Europe,3,3,2,0,0,2,1,Unknown
1930-11-24 00:00:00,Ford Motor Company,Landing (descent or approach),Specialised Services,United States of America,North America,2,2,2,0,0,2,0,Unknown
1930-12-19 00:00:00,Frederic M. Greenwood,Flight,Business,United States of America,North America,3,1,0,2,2,2,1,Unknown
1931-01-08 00:00:00,SABENA - Société Anonyme Belge d'Exploitation de la Navigation Aérienne,Flight,Operational,Belgium,Europe,2,2,2,0,0,2,0,Human Factor
1931-01-27 00:00:00,John W. Paulden,Landing (descent or approach),Business,Australia,Oceania,2,1,1,1,1,2,0,Unknown
1931-01-28 00:00:00,Deutsche Verkehrsfliegerschule - DVS,Flight,Business,Argentina,South America,2,2,2,0,0,2,0,Unknown
1931-02-13 00:00:00,Royal Canadian Air Force - RCAF,Landing (descent or approach),Operational,Canada,North America,2,2,2,0,0,2,0,Unknown
1931-02-20 00:00:00,Western Canada Airways,Flight,Commercial,Canada,North America,3,1,1,2,1,2,1,Unknown
1931-04-02 00:00:00,Charles Maurice Brown,Takeoff (climb),Business,United Kingdom,Europe,2,1,1,1,1,2,0,Unknown
1931-04-08 00:00:00,Hellenic Air Force - Elleniki Polemiki Aeroporia,Flight,Military / Government,Greece,Europe,2,2,2,0,0,2,0,Human Factor
1931-04-13 00:00:00,Finnish Air Force - Suomen Ilmavoimat,Flight,Operational,Finland,Europe,2,2,2,0,0,2,0,Unknown
1931-04-14 00:00:00,Deutsche Lufthansa,Flight,Commercial,Germany,Europe,10,3,2,7,0,2,8,Technical Failure
1931-04-23 00:00:00,Royal Air Force - RAF,Takeoff (climb),Military / Government,United Kingdom,Europe,2,2,2,0,0,2,0,Human Factor
1931-04-24 00:00:00,Venezuelan Air Force - Fuerza Aérea Venezolana,Landing (descent or approach),Military / Government,Venezuela,South America,3,2,2,1,0,2,1,Technical Failure
1931-05-05 00:00:00,Pacific Air Transport,Landing (descent or approach),Commercial,United States of America,North America,2,1,1,1,1,2,0,Weather
1931-05-05 00:00:00,Glenn L. Bateman,Flight,Business,South Africa,Africa,2,2,2,0,0,2,0,Weather
1931-05-11 00:00:00,Rubner Flying Service,Landing (descent or approach),Commercial,United States of America,North America,3,2,2,1,0,2,1,Unknown
1931-05-12 00:00:00,Belgian Air Force - Force Aérienne Belge - Belgische Luchtmacht,Takeoff (climb),Military / Government,Belgium,Europe,2,2,2,0,0,2,0,Unknown
1931-05-14 00:00:00,Denys Finch Hatton,Flight,Business,Kenya,Africa,2,1,1,1,1,2,0,Unknown
1931-05-20 00:00:00,Border Cities Aero Club,Landing (descent or approach),Business,Canada,North America,2,1,1,1,1,2,0,Unknown
1931-05-22 00:00:00,Guinea Airways,Flight,Operational,Papua New Guinea,Oceania,2,2,2,0,0,2,0,Human Factor
1931-06-14 00:00:00,Harold Ashley Brock,Flight,Business,France,Europe,2,1,1,1,1,2,0,Weather
1931-06-25 00:00:00,Osoaviakhima,Flight,Operational,Russia,Asia,2,2,2,0,0,2,0,Technical Failure
1931-07-10 00:00:00,Air Survey Company,Flight,Military / Government,South Sudan,Africa,3,1,1,2,1,2,1,Unknown
1931-07-11 00:00:00,A. Bielby,Flight,Business,Canada,North America,3,1,0,2,2,2,1,Unknown
1931-07-12 00:00:00,Braniff Airways,Takeoff (climb),Operational,United States of America,North America,2,2,2,0,0,2,0,Technical Failure
1931-07-14 00:00:00,Australian Aerial Services,Flight,Commercial,Australia,Oceania,2,2,2,0,0,2,0,Unknown
1931-07-18 00:00:00,Philip Ernest Noble,Flight,Business,United Kingdom,Europe,2,1,1,1,1,2,0,Technical Failure
1931-08-09 00:00:00,Trans American Airlines,Flight,Business,World,World,2,2,2,0,0,2,0,Unknown
1931-09-03 00:00:00,Brazilian Navy - Aviação Naval Brasileira,Flight,Military / Government,Brazil,South America,9,9,2,0,0,2,7,Human Factor
1931-09-12 00:00:00,François Coty,Flight,Business,Russia,Asia,3,3,2,0,0,2,1,Technical Failure
1931-09-19 00:00:00,Ford Motor Company,Flight,Specialised Services,United States of America,North America,2,2,2,0,0,2,0,Technical Failure
1931-09-22 00:00:00,Navin Air Transport,Flight,Commercial,United States of America,North America,2,1,1,1,1,2,0,Unknown
1931-10-06 00:00:00,Norddeutsche Luftverkehr,Flight,Operational,Canada,North America,2,2,2,0,0,2,0,Unknown
1931-11-20 00:00:00,The Rhodesian Aviation Company,Takeoff (climb),Commercial,Zimbabwe,Africa,2,1,1,1,1,2,0,Unknown
1931-11-24 00:00:00,Royal Air Force - RAF,Takeoff (climb),Operational,United Kingdom,Europe,2,2,2,0,0,2,0,Human Factor
1931-11-28 00:00:00,Royal Air Force - RAF,Flight,Operational,United Kingdom,Europe,2,2,2,0,0,2,0,Human Factor
1931-12-05 00:00:00,Braniff Airways,Landing (descent or approach),Commercial,United States of America,North America,6,2,0,4,2,2,4,Weather
1931-12-09 00:00:00,L'Aéropostale,Flight,Operational,World,World,2,2,2,0,0,2,0,Technical Failure
1931-12-19 00:00:00,Royal Air Force - RAF,Flight,Operational,United Kingdom,Europe,2,2,2,0,0,2,0,Unknown
1932-01-05 00:00:00,Ruth Stewart,Flight,Business,United States of America,North America,2,2,2,0,0,2,0,Human Factor
1932-01-15 00:00:00,United States Army Air Corps - USAAC,Flight,Military / Government,Philippines,Asia,5,5,2,0,0,2,3,Technical Failure
1932-01-18 00:00:00,Spanish Air Force - Aeronáutica Militar,Takeoff (climb),Military / Government,Spain,Europe,5,5,2,0,0,2,3,Unknown
1932-01-27 00:00:00,Aeroflot - Russian International Airlines,Flight,Operational,Russia,Asia,2,2,2,0,0,2,0,Human Factor
1932-01-29 00:00:00,A. Bischoff,Flight,Business,Spain,Europe,2,1,1,1,1,2,0,Human Factor
1932-02-15 00:00:00,Royal Air Force - RAF,Flight,Operational,United Kingdom,Europe,2,2,2,0,0,2,0,Human Factor
1932-03-07 00:00:00,Ukrvozduchput,Flight,Operational,Russia,Asia,3,3,2,0,0,2,1,Human Factor
1932-03-17 00:00:00,Royal Air Force - RAF,Flight,Operational,United Kingdom,Europe,2,2,2,0,0,2,0,Unknown
1932-03-21 00:00:00,Transcontinental %26 Western Air - TWA,Flight,Operational,United States of America,North America,2,1,1,1,1,2,0,Weather
1932-05-12 00:00:00,Swiss Air Force,Flight,Military / Government,Switzerland,Europe,2,2,2,0,0,2,0,Human Factor
1932-05-15 00:00:00,William Andrews Clark,Flight,Business,United States of America,North America,2,1,1,1,1,2,0,Unknown
1932-05-18 00:00:00,National Flying Services,Flight,Business,United Kingdom,Europe,2,1,1,1,1,2,0,Technical Failure
1932-05-18 00:00:00,Belgian Air Force - Force Aérienne Belge - Belgische Luchtmacht,Landing (descent or approach),Military / Government,Belgium,Europe,2,2,2,0,0,2,0,Unknown
1932-05-21 00:00:00,György Endresz,Landing (descent or approach),Business,Italy,Europe,2,2,2,0,0,2,0,Unknown
1932-05-22 00:00:00,Personal Flying Services,Flight,Business,United Kingdom,Europe,2,1,1,1,1,2,0,Human Factor
1932-05-23 00:00:00,Royal Air Force - RAF,Flight,Military / Government,Palestine,Asia,3,3,2,0,0,2,1,Unknown
1932-05-30 00:00:00,Newfoundland Airways,Flight,Business,Canada,North America,2,1,1,1,1,2,0,Unknown
1932-06-16 00:00:00,N. P. Bolton,Flight,Specialised Services,Australia,Oceania,2,2,2,0,0,2,0,Weather
1932-07-10 00:00:00,Bata Shoes,Takeoff (climb),Business,Czech Republic,Europe,2,1,1,1,1,2,0,Unknown
1932-07-28 00:00:00,Royal Air Force - RAF,Takeoff (climb),Military / Government,South Sudan,Africa,3,1,1,2,1,2,1,Unknown
1932-08-01 00:00:00,Reginald H. Lemon,Landing (descent or approach),Operational,United Kingdom,Europe,3,3,2,0,0,2,1,Unknown
1932-08-12 00:00:00,F. B. Taylor,Flight,Business,Myanmar,Asia,2,2,2,0,0,2,0,Unknown
1932-08-31 00:00:00,Aktiebolaget Aerotransport - ABA,Flight,Operational,Netherlands,Europe,2,2,2,0,0,2,0,Technical Failure
1932-09-15 00:00:00,Royal Air Force - RAF,Landing (descent or approach),Military / Government,Singapore,Asia,5,5,2,0,0,2,3,Human Factor
1932-09-27 00:00:00,Società Aerea Mediterranea - SAM,Flight,Commercial,Italy,Europe,4,2,1,2,1,2,2,Weather
1932-10-06 00:00:00,Royal Air Force - RAF,Flight,Military / Government,United Kingdom,Europe,6,6,2,0,0,2,4,Technical Failure
1932-10-26 00:00:00,Lloyd Aéreo Boliviano - LAB Airlines,Flight,Operational,Bolivia,South America,2,2,2,0,0,2,0,Unknown
1932-10-29 00:00:00,Deutsche Lufthansa,Flight,Operational,World,World,2,2,2,0,0,2,0,Unknown
1932-10-29 00:00:00,Lionel John Porter Fowler,Flight,Business,France,Europe,2,2,2,0,0,2,0,Human Factor
1932-11-25 00:00:00,Hunter Airways,Flight,Commercial,United States of America,North America,2,1,1,1,1,2,0,Human Factor
1932-12-02 00:00:00,Brazilian Navy - Aviação Naval Brasileira,Flight,Operational,Brazil,South America,2,2,2,0,0,2,0,Unknown
1932-12-04 00:00:00,Hampshire Aeroplane Club,Flight,Operational,United Kingdom,Europe,2,2,2,0,0,2,0,Unknown
1932-12-04 00:00:00,Paraguay Air Force - Fuerza Aérea Paraguaya,Flight,Military / Government,Paraguay,South America,2,2,2,0,0,2,0,Terrorism
1932-12-09 00:00:00,Brazilian Air Force - Aviação Militar,Flight,Military / Government,Brazil,South America,2,1,1,1,1,2,0,Unknown
1932-12-14 00:00:00,Transcontinental %26 Western Air - TWA,Landing (descent or approach),Operational,United States of America,North America,2,2,2,0,0,2,0,Weather
1932-12-15 00:00:00,SCADTA - Sociedad Colombo-Alemana de Transportes Aéreos,Flight,Operational,Colombia,South America,2,1,1,1,1,2,0,Unknown
1932-12-26 00:00:00,Guinea Airways,Takeoff (climb),Commercial,Papua New Guinea,Oceania,2,1,1,1,1,2,0,Human Factor
1933-01-14 00:00:00,Eastern Air Transport,Flight,Specialised Services,United States of America,North America,2,2,2,0,0,2,0,Unknown
1933-01-24 00:00:00,Pacific Air Transport,Takeoff (climb),Operational,United States of America,North America,3,3,2,0,0,2,1,Technical Failure
1933-01-28 00:00:00,Wilhelm M. Omsted,Flight,Operational,World,World,2,1,1,1,1,2,0,Unknown
1933-02-13 00:00:00,Aeroflot - Russian International Airlines,Landing (descent or approach),Operational,Russia,Asia,2,2,2,0,0,2,0,Human Factor
1933-03-11 00:00:00,Panagra - Pan American-Grace Airways,Flight,Operational,Argentina,South America,2,2,2,0,0,2,0,Human Factor
1933-03-24 00:00:00,Spanish Air Force - Aeronáutica Militar,Flight,Military / Government,Spain,Europe,4,4,2,0,0,2,2,Unknown
1933-04-30 00:00:00,Marcel Geneux,Flight,Specialised Services,France,Europe,2,1,1,1,1,2,0,Unknown
1933-05-18 00:00:00,Royal Air Force - RAF,Takeoff (climb),Operational,United Kingdom,Europe,2,2,2,0,0,2,0,Human Factor
1933-05-24 00:00:00,Irish Aero Club,Flight,Business,Ireland,Europe,2,1,1,1,1,2,0,Unknown
1933-05-25 00:00:00,Societa Anonima di Navigazione Aerea - SANA,Takeoff (climb),Commercial,France,Europe,6,4,1,2,1,2,4,Unknown
1933-06-06 00:00:00,Charles Richard Vernon Pugh,Takeoff (climb),Business,United Kingdom,Europe,2,1,1,1,1,2,0,Unknown
1933-06-17 00:00:00,Topsy Club,Takeoff (climb),Business,France,Europe,3,1,0,2,2,2,1,Unknown
1933-06-20 00:00:00,Mariano Barberán %26 Joaquín Collar,Flight,Business,Mexico,Central America,2,2,2,0,0,2,0,Unknown
1933-07-07 00:00:00,Irish Aero Club,Flight,Operational,Ireland,Europe,2,1,1,1,1,2,0,Human Factor
1933-07-17 00:00:00,Steponas Darius,Flight,Business,Poland,Europe,2,2,2,0,0,2,0,Weather
1933-08-01 00:00:00,Zagreb Aero Club,Landing (descent or approach),Business,Croatia,Europe,2,1,1,1,1,2,0,Unknown
1933-08-13 00:00:00,Aeroflot - Russian International Airlines,Landing (descent or approach),Operational,Russia,Asia,2,2,2,0,0,2,0,Human Factor
1933-08-13 00:00:00,Aeroflot - Russian International Airlines,Takeoff (climb),Operational,Russia,Asia,2,2,2,0,0,2,0,Human Factor
1933-08-18 00:00:00,Osoaviakhima,Landing (descent or approach),Operational,Russia,Asia,2,2,2,0,0,2,0,Human Factor
1933-09-17 00:00:00,Aeroflot - Russian International Airlines,Landing (descent or approach),Operational,Russia,Asia,2,2,2,0,0,2,0,Technical Failure
1933-09-26 00:00:00,Aircraft Operating Company,Takeoff (climb),Commercial,South Africa,Africa,2,1,1,1,1,2,0,Unknown
1933-10-03 00:00:00,Aéroclub de la Tour du Pin,Flight,Business,France,Europe,2,2,2,0,0,2,0,Unknown
1933-10-17 00:00:00,Royal Air Force - RAF,Takeoff (climb),Operational,United Kingdom,Europe,4,4,2,0,0,2,2,Human Factor
1933-10-31 00:00:00,Air France,Flight,Commercial,France,Europe,5,3,1,2,1,2,3,Weather
1933-11-02 00:00:00,Wilmington-Catalina Airlines,Takeoff (climb),Operational,United States of America,North America,3,2,1,1,1,2,1,Unknown
1933-11-09 00:00:00,Deutsche Verkehrsfliegerschule - DVS,Takeoff (climb),Operational,Germany,Europe,2,1,1,1,1,2,0,Unknown
1933-11-20 00:00:00,Canterbury Aero Club,Flight,Business,New Zealand,Oceania,2,1,1,1,1,2,0,Human Factor
1933-12-22 00:00:00,SABENA - Société Anonyme Belge d'Exploitation de la Navigation Aérienne,Landing (descent or approach),Commercial,Germany,Europe,5,2,1,3,1,2,3,Human Factor
1934-01-01 00:00:00,Valentine Meccas,Flight,Business,France,Europe,2,1,1,1,1,2,0,Human Factor
1934-01-20 00:00:00,Air France,Flight,Operational,France,Europe,2,2,2,0,0,2,0,Weather
1934-02-22 00:00:00,Portuguese Air Force - Aeronáutica Militar,Flight,Operational,Portugal,Europe,2,2,2,0,0,2,0,Human Factor
1934-03-11 00:00:00,Aeroflot - Russian International Airlines,Flight,Operational,Russia,Asia,2,2,2,0,0,2,0,Technical Failure
1934-03-12 00:00:00,Aeroflot - Russian International Airlines,Flight,Operational,Russia,Asia,2,2,2,0,0,2,0,Human Factor
1934-05-05 00:00:00,Aerovias Centrales,Flight,Operational,Mexico,Central America,2,2,2,0,0,2,0,Unknown
1934-05-31 00:00:00,Air France,Takeoff (climb),Operational,United Kingdom,Europe,2,2,2,0,0,2,0,Weather
1934-06-03 00:00:00,Private Trinidad %26 Tobago,Flight,Business,Trinidad and Tobago,Central America,2,1,1,1,1,2,0,Unknown
1934-06-11 00:00:00,French Air Force - Armée de l'Air,Takeoff (climb),Military / Government,France,Europe,4,4,2,0,0,2,2,Technical Failure
1934-06-24 00:00:00,Aerial Explorations,Flight,Specialised Services,United States of America,North America,2,1,1,1,1,2,0,Unknown
1934-06-24 00:00:00,Wedell-Williams Air Services,Flight,Business,United States of America,North America,2,1,1,1,1,2,0,Technical Failure
1934-07-31 00:00:00,Scottish Motor Traction Company,Takeoff (climb),Business,United Kingdom,Europe,3,1,0,2,2,2,1,Unknown
1934-08-05 00:00:00,Air France,Flight,Commercial,Brazil,South America,7,2,2,5,0,2,5,Human Factor
1934-08-17 00:00:00,Northwest Aero Marine,Flight,Humanitarian,Canada,North America,2,1,1,1,1,2,0,Weather
1934-09-02 00:00:00,Robert Christian Ramsey,Flight,Business,United Kingdom,Europe,2,1,1,1,1,2,0,Unknown
1934-09-04 00:00:00,Aeroflot - Russian International Airlines,Landing (descent or approach),Commercial,Russia,Asia,13,4,0,9,2,2,11,Human Factor
1934-09-10 00:00:00,Irish Air Corps - Aer Chór na hÉireann,Flight,Specialised Services,Ireland,Europe,3,3,2,0,0,2,1,Human Factor
1934-09-13 00:00:00,Western Federated Flying Club,Flight,Business,New Zealand,Oceania,2,1,1,1,1,2,0,Human Factor
1934-10-31 00:00:00,Austrian Air Force - Österreichische Luftstreitkräfte,Flight,Operational,Austria,Europe,2,2,2,0,0,2,0,Unknown
1934-10-31 00:00:00,Toronto Flying Club,Flight,Operational,Canada,North America,2,2,2,0,0,2,0,Unknown
1934-11-02 00:00:00,Holden's Air Transport Services,Landing (descent or approach),Commercial,Papua New Guinea,Oceania,4,2,0,2,2,2,2,Human Factor
1934-11-03 00:00:00,Nottingham Aero Club,Flight,Business,United Kingdom,Europe,2,2,2,0,0,2,0,Technical Failure
1934-11-04 00:00:00,Stockholms Flygklubb,Takeoff (climb),Business,Sweden,Europe,2,1,1,1,1,2,0,Human Factor
1934-11-07 00:00:00,Portsmouth Southsea %26 Isle of Wight Aviation,Landing (descent or approach),Business,United Kingdom,Europe,2,1,1,1,1,2,0,Unknown
1934-11-15 00:00:00,Rapid Air Lines,Flight,Operational,United States of America,North America,2,1,1,1,1,2,0,Human Factor
1934-12-25 00:00:00,Aeroflot - Russian International Airlines,Flight,Commercial,Russia,Asia,2,2,2,0,0,2,0,Human Factor
1935-01-11 00:00:00,Aeroflot - Russian International Airlines,Flight,Commercial,Kazakhstan,Asia,2,1,1,1,1,2,0,Human Factor
1935-01-14 00:00:00,Deutsche Lufthansa,Flight,Operational,Germany,Europe,2,2,2,0,0,2,0,Unknown
1935-01-19 00:00:00,Royal Air Force - RAF,Flight,Operational,United Kingdom,Europe,2,2,2,0,0,2,0,Unknown
1935-01-28 00:00:00,French Air Force - Armée de l'Air,Takeoff (climb),Operational,France,Europe,4,4,2,0,0,2,2,Technical Failure
1935-04-12 00:00:00,Avia,Flight,Specialised Services,Czech Republic,Europe,2,2,2,0,0,2,0,Unknown
1935-05-17 00:00:00,Belgian Air Force - Force Aérienne Belge - Belgische Luchtmacht,Flight,Operational,Belgium,Europe,2,2,2,0,0,2,0,Unknown
1935-05-26 00:00:00,Private Australian,Takeoff (climb),Business,Australia,Oceania,2,1,1,1,1,2,0,Other
1935-05-28 00:00:00,Chicago %26 Southern Air Lines,Flight,Operational,United States of America,North America,2,1,1,1,1,2,0,Human Factor
1935-08-15 00:00:00,Private American,Takeoff (climb),Business,United States of America,North America,2,1,1,1,1,2,0,Other
1935-08-27 00:00:00,Austrian Air Force - Österreichische Luftstreitkräfte,Flight,Operational,Austria,Europe,2,2,2,0,0,2,0,Unknown
1935-08-28 00:00:00,Waco Distributors,Landing (descent or approach),Commercial,United States of America,North America,2,1,1,1,1,2,0,Human Factor
1935-09-07 00:00:00,Belgian Air Force - Force Aérienne Belge - Belgische Luchtmacht,Flight,Operational,Belgium,Europe,2,2,2,0,0,2,0,Unknown
1935-10-26 00:00:00,Railway Air Services,Flight,Commercial,United Kingdom,Europe,2,1,1,1,1,2,0,Human Factor
1935-10-30 00:00:00,Boeing Airplane Company,Takeoff (climb),Specialised Services,United States of America,North America,4,4,2,0,0,2,2,Technical Failure
1935-11-08 00:00:00,Private Australian,Flight,Business,Myanmar,Asia,2,2,2,0,0,2,0,Unknown
1935-11-25 00:00:00,Royal Air Force - RAF,Flight,Military / Government,Kenya,Africa,2,1,1,1,1,2,0,Weather
1936-01-12 00:00:00,LAN Chile - Linea Aérea Nacional de Chile,Landing (descent or approach),Operational,Chile,South America,2,2,2,0,0,2,0,Human Factor
1936-01-24 00:00:00,United States Army Air Corps - USAAC,Flight,Operational,United States of America,North America,4,4,2,0,0,2,2,Human Factor
1936-02-01 00:00:00,Private British,Takeoff (climb),Business,United Kingdom,Europe,2,1,1,1,1,2,0,Unknown
1936-02-05 00:00:00,Syndicato Condor,Flight,Operational,Brazil,South America,2,2,2,0,0,2,0,Unknown
1936-02-14 00:00:00,SCADTA - Sociedad Colombo-Alemana de Transportes Aéreos,,Commercial,Colombia,South America,0,0,1,0,1,2,-2,Unknown
1936-02-16 00:00:00,Culver Oil Company,Takeoff (climb),Business,United States of America,North America,2,1,1,1,1,2,0,Technical Failure
1936-02-20 00:00:00,Ala Littoria,Takeoff (climb),Commercial,Croatia,Europe,6,2,1,4,1,2,4,Human Factor
1936-03-06 00:00:00,Austrian Air Force - Österreichische Luftstreitkräfte,Takeoff (climb),Operational,Austria,Europe,2,2,2,0,0,2,0,Unknown
1936-04-01 00:00:00,American Airlines,Flight,Operational,United States of America,North America,2,1,1,1,1,2,0,Unknown
1936-04-21 00:00:00,SABENA - Société Anonyme Belge d'Exploitation de la Navigation Aérienne,Takeoff (climb),Operational,France,Europe,2,2,2,0,0,2,0,Unknown
1936-04-30 00:00:00,Swissair,Flight,Operational,Switzerland,Europe,2,2,2,0,0,2,0,Human Factor
1936-05-12 00:00:00,United States Army Air Corps - USAAC,Flight,Military / Government,Panama,Central America,5,5,2,0,0,2,3,Unknown
1936-05-14 00:00:00,Hellenic Air Force - Elleniki Polemiki Aeroporia,Flight,Operational,Greece,Europe,2,2,2,0,0,2,0,Unknown
1936-06-03 00:00:00,Private Austrian,Landing (descent or approach),Business,Netherlands,Europe,2,1,1,1,1,2,0,Human Factor
1936-06-03 00:00:00,German Air Force - Deutsche Luftwaffe,Takeoff (climb),Military / Government,Germany,Europe,2,2,2,0,0,2,0,Human Factor
1936-06-15 00:00:00,Austrian Air Force - Österreichische Luftstreitkräfte,Flight,Military / Government,Austria,Europe,2,2,2,0,0,2,0,Unknown
1936-07-20 00:00:00,German Air Force - Deutsche Luftwaffe,Flight,Operational,Germany,Europe,4,4,2,0,0,2,2,Human Factor
1936-07-22 00:00:00,Deutsche Lufthansa,Flight,Operational,Czech Republic,Europe,2,2,2,0,0,2,0,Unknown
1936-08-04 00:00:00,Johannesburg Light Plane Club,Flight,Business,South Africa,Africa,2,1,1,1,1,2,0,Unknown
1936-08-06 00:00:00,SCADTA - Sociedad Colombo-Alemana de Transportes Aéreos,Flight,Commercial,Colombia,South America,3,2,1,1,1,2,1,Unknown
1936-08-12 00:00:00,British Airways,Flight,Operational,Germany,Europe,2,2,2,0,0,2,0,Unknown
1936-08-15 00:00:00,British Airways,Landing (descent or approach),Operational,France,Europe,2,2,2,0,0,2,0,Unknown
1936-08-22 00:00:00,Imperial Airways,Landing (descent or approach),Commercial,Greece,Europe,11,3,0,8,2,2,9,Weather
1936-08-27 00:00:00,Spanish Nationalist Air Force,Flight,Military / Government,Spain,Europe,2,2,2,0,0,2,0,Terrorism
1936-08-28 00:00:00,Office Général de l'Air,Flight,Operational,France,Europe,2,2,2,0,0,2,0,Unknown
1936-09-05 00:00:00,Air Taxis,Flight,Business,United Kingdom,Europe,2,1,1,1,1,2,0,Human Factor
1936-09-25 00:00:00,Imperial Airways,Flight,Operational,World,World,2,2,2,0,0,2,0,Unknown
1936-10-01 00:00:00,Private British,Takeoff (climb),Business,Zambia,Africa,4,4,2,0,0,2,2,Unknown
1936-11-19 00:00:00,British Airways,Landing (descent or approach),Operational,United Kingdom,Europe,4,4,2,0,0,2,2,Human Factor
1936-11-20 00:00:00,Northern %26 Scottish Airways,Takeoff (climb),Commercial,United Kingdom,Europe,2,1,1,1,1,2,0,Human Factor
1936-12-18 00:00:00,Northwest Airlines,Flight,Operational,United States of America,North America,2,2,2,0,0,2,0,Human Factor
1936-12-30 00:00:00,Iraq Petroleum Transport Company,Landing (descent or approach),Business,Israel,Asia,2,1,1,1,1,2,0,Unknown
1937-01-22 00:00:00,Air Dispatch,Flight,Operational,United Kingdom,Europe,2,2,2,0,0,2,0,Unknown
1937-01-25 00:00:00,Private British,Flight,Business,United Kingdom,Europe,2,1,1,1,1,2,0,Unknown
1937-03-22 00:00:00,Western Federated Flying Club,Flight,Operational,New Zealand,Oceania,2,2,2,0,0,2,0,Unknown
1937-03-28 00:00:00,Airlines of Australia,Takeoff (climb),Operational,Australia,Oceania,2,1,1,1,1,2,0,Human Factor
1937-04-29 00:00:00,Royal Air Force - RAF,Flight,Operational,United Kingdom,Europe,2,2,2,0,0,2,0,Human Factor
1937-06-24 00:00:00,Cambridge Aero Club,Takeoff (climb),Operational,United Kingdom,Europe,2,2,2,0,0,2,0,Unknown
1937-06-25 00:00:00,Private French,Flight,Business,Tanzania,Africa,2,2,2,0,0,2,0,Unknown
1937-07-02 00:00:00,Private American,Flight,Business,World,World,2,2,2,0,0,2,0,Unknown
1937-09-10 00:00:00,Phillips %26 Powis Aircraft,Flight,Business,United Kingdom,Europe,2,2,2,0,0,2,0,Weather
1937-10-01 00:00:00,Imperial Airways,Landing (descent or approach),Commercial,Greece,Europe,14,3,0,11,2,2,12,Weather
1937-10-16 00:00:00,South African Airways -SAA - Suid Afrikaanse Lugdiens - SAL,Takeoff (climb),Operational,South Africa,Africa,2,2,2,0,0,2,0,Unknown
1937-11-02 00:00:00,Devlet Hava Yollari - DHY,Flight,Commercial,Turkey,Asia,2,2,2,0,0,2,0,Unknown
1937-11-07 00:00:00,Dominion Airways - Canada,Landing (descent or approach),Commercial,Canada,North America,2,1,1,1,1,2,0,Human Factor
1937-12-01 00:00:00,Aktiebolaget Aerotransport - ABA,Landing (descent or approach),Commercial,Sweden,Europe,2,2,2,0,0,2,0,Weather
1937-12-05 00:00:00,Imperial Airways,Takeoff (climb),Commercial,Italy,Europe,8,4,1,4,1,2,6,Human Factor
1937-12-08 00:00:00,Air France,Flight,Commercial,France,Europe,7,4,2,3,0,2,5,Human Factor
1937-12-29 00:00:00,Cuban Air Force - Cuerpo de Aviación del Ejército de Cuba,Flight,Military / Government,Colombia,South America,2,1,1,1,1,2,0,Weather
1937-12-29 00:00:00,Cuban Air Force - Cuerpo de Aviación del Ejército de Cuba,Flight,Military / Government,Colombia,South America,2,1,1,1,1,2,0,Weather
1938-01-29 00:00:00,Gerard F. Vultee,Flight,Business,United States of America,North America,2,1,1,1,1,2,0,Weather
1938-01-30 00:00:00,Private Swedish,Takeoff (climb),Business,Sweden,Europe,2,1,1,1,1,2,0,Technical Failure
1938-04-01 00:00:00,Royal Air Force - RAF,Flight,Operational,United Kingdom,Europe,2,2,2,0,0,2,0,Human Factor
1938-04-10 00:00:00,Private South African,Flight,Business,South Africa,Africa,3,1,0,2,2,2,1,Unknown
1938-05-10 00:00:00,Union Airways,Takeoff (climb),Commercial,New Zealand,Oceania,2,2,2,0,0,2,0,Technical Failure
1938-07-03 00:00:00,Railway Air Services,Landing (descent or approach),Operational,United Kingdom,Europe,2,2,2,0,0,2,0,Unknown
1938-07-10 00:00:00,Aéromaritime,Landing (descent or approach),Operational,Benin,Africa,3,3,2,0,0,2,1,Technical Failure
1938-08-01 00:00:00,Genossenschaft Fliegerlager Grenchen,Flight,Business,Switzerland,Europe,2,1,1,1,1,2,0,Unknown
1938-08-04 00:00:00,French Air Force - Armée de l'Air,Landing (descent or approach),Operational,France,Europe,4,4,2,0,0,2,2,Human Factor
1938-09-20 00:00:00,Royal Air Force - RAF,Landing (descent or approach),Operational,United Kingdom,Europe,8,8,2,0,0,2,6,Unknown
1938-09-30 00:00:00,Sarajevo Aeronautical Club,Flight,Operational,Bosnia and Herzegovina,Europe,2,1,1,1,1,2,0,Unknown
1938-09-30 00:00:00,Royal Air Force - RAF,Flight,Operational,United Kingdom,Europe,2,2,2,0,0,2,0,Unknown
1938-11-18 00:00:00,Trans-Canada Air Lines - TCAL,Takeoff (climb),Operational,Canada,North America,2,2,2,0,0,2,0,Unknown
1938-12-23 00:00:00,Royal Air Force - RAF,Flight,Military / Government,India,Asia,3,3,2,0,0,2,1,Human Factor
1939-01-17 00:00:00,Royal Air Force - RAF,Flight,Operational,United Kingdom,Europe,2,2,2,0,0,2,0,Human Factor
1939-01-17 00:00:00,Royal Air Force - RAF,Flight,Operational,United Kingdom,Europe,4,2,2,2,0,2,2,Human Factor
1939-02-05 00:00:00,Lineas Aéreas Postales Espanolas - LAPE,Takeoff (climb),Commercial,Spain,Europe,3,2,2,1,0,2,1,Unknown
1939-04-15 00:00:00,South American Gulf Oil Company,Flight,Business,Colombia,South America,2,2,2,0,0,2,0,Unknown
1939-05-01 00:00:00,Imperial Airways,Landing (descent or approach),Commercial,Mozambique,Africa,6,4,2,2,0,2,4,Unknown
1939-08-01 00:00:00,Royal Air Force - RAF,Flight,Operational,United Kingdom,Europe,2,2,2,0,0,2,0,Human Factor
1939-08-15 00:00:00,Arthur Kudner,Takeoff (climb),Business,United States of America,North America,5,2,1,3,1,2,3,Technical Failure
1939-08-24 00:00:00,Deutsche Lufthansa,Flight,Specialised Services,Germany,Europe,2,2,2,0,0,2,0,Technical Failure
1939-09-19 00:00:00,Royal Air Force - RAF,Takeoff (climb),Operational,United Kingdom,Europe,2,2,2,0,0,2,0,Human Factor
1939-10-04 00:00:00,Royal Air Force - RAF,Flight,Operational,United Kingdom,Europe,2,2,2,0,0,2,0,Unknown
1939-10-31 00:00:00,Royal Air Force - RAF,Flight,Operational,United Kingdom,Europe,2,2,2,0,0,2,0,Human Factor
1939-11-06 00:00:00,Royal Air Force - RAF,Landing (descent or approach),Operational,United Kingdom,Europe,2,2,2,0,0,2,0,Human Factor
1939-11-19 00:00:00,Royal Air Force - RAF,Takeoff (climb),Operational,United Kingdom,Europe,2,2,2,0,0,2,0,Human Factor
1939-11-20 00:00:00,British Airways,Flight,Operational,United Kingdom,Europe,2,2,2,0,0,2,0,Human Factor
1939-11-29 00:00:00,Royal Australian Air Force - RAAF,Takeoff (climb),Operational,Australia,Oceania,2,2,2,0,0,2,0,Technical Failure
1939-12-13 00:00:00,Royal Air Force - RAF,Landing (descent or approach),Operational,United Kingdom,Europe,2,2,2,0,0,2,0,Unknown
1939-12-15 00:00:00,French Air Force - Armée de l'Air,Flight,Military / Government,France,Europe,6,6,2,0,0,2,4,Technical Failure
1939-12-18 00:00:00,Royal Air Force - RAF,Flight,Military / Government,Germany,Europe,5,5,2,0,0,2,3,Terrorism
1940-02-03 00:00:00,German Air Force - Deutsche Luftwaffe,Flight,Military / Government,United Kingdom,Europe,4,4,2,0,0,2,2,Terrorism
1940-02-03 00:00:00,German Air Force - Deutsche Luftwaffe,Flight,Military / Government,United Kingdom,Europe,5,5,2,0,0,2,3,Terrorism
1940-02-10 00:00:00,Royal Air Force - RAF,Landing (descent or approach),Operational,United Kingdom,Europe,3,3,2,0,0,2,1,Human Factor
1940-03-05 00:00:00,Royal Air Force - RAF,Flight,Specialised Services,United Kingdom,Europe,2,2,2,0,0,2,0,Unknown
1940-03-24 00:00:00,Royal Air Force - RAF,Flight,Military / Government,Germany,Europe,6,6,2,0,0,2,4,Terrorism
1940-04-04 00:00:00,Royal Air Force - RAF,Flight,Military / Government,United Kingdom,Europe,2,2,2,0,0,2,0,Unknown
1940-04-14 00:00:00,German Air Force - Deutsche Luftwaffe,Flight,Military / Government,Norway,Europe,4,4,2,0,0,2,2,Terrorism
1940-04-26 00:00:00,French Air Force - Armée de l'Air,Flight,Specialised Services,France,Europe,2,2,2,0,0,2,0,Human Factor
1940-04-26 00:00:00,Royal Air Force - RAF,Flight,Operational,United Kingdom,Europe,2,2,2,0,0,2,0,Unknown
1940-05-01 00:00:00,Royal Air Force - RAF,Flight,Military / Government,United Kingdom,Europe,6,6,2,0,0,2,4,Human Factor
1940-05-03 00:00:00,Royal Air Force - RAF,Takeoff (climb),Operational,United Kingdom,Europe,2,2,2,0,0,2,0,Unknown
1940-05-13 00:00:00,German Air Force - Deutsche Luftwaffe,Flight,Military / Government,France,Europe,5,5,2,0,0,2,3,Terrorism
1940-05-22 00:00:00,Royal Air Force - RAF,Flight,Military / Government,Belgium,Europe,5,5,2,0,0,2,3,Unknown
1940-05-23 00:00:00,SABENA - Société Anonyme Belge d'Exploitation de la Navigation Aérienne,Flight,Commercial,France,Europe,6,4,2,2,0,2,4,Terrorism
1940-06-06 00:00:00,Royal Air Force - RAF,Flight,Military / Government,Netherlands,Europe,6,6,2,0,0,2,4,Terrorism
1940-06-15 00:00:00,Royal New Zealand Air Force - RNZAF,Flight,Operational,New Zealand,Oceania,2,2,2,0,0,2,0,Human Factor
1940-06-17 00:00:00,Royal Australian Air Force - RAAF,Flight,Operational,Australia,Oceania,2,2,2,0,0,2,0,Unknown
1940-07-17 00:00:00,Royal Air Force - RAF,Flight,Operational,United Kingdom,Europe,2,2,2,0,0,2,0,Human Factor
1940-07-18 00:00:00,Hellenic Air Force - Elleniki Polemiki Aeroporia,Flight,Operational,Greece,Europe,2,2,2,0,0,2,0,Unknown
1940-07-31 00:00:00,Royal Air Force - RAF,Takeoff (climb),Military / Government,United Kingdom,Europe,5,2,0,3,2,2,3,Unknown
1940-08-09 00:00:00,Royal Air Force - RAF,Flight,Military / Government,Netherlands,Europe,4,4,2,0,0,2,2,Terrorism
1940-08-09 00:00:00,Deutsche Lufthansa,Flight,Commercial,Germany,Europe,13,3,0,10,2,2,11,Human Factor
1940-10-15 00:00:00,Royal Air Force - RAF,Flight,Military / Government,United Kingdom,Europe,5,5,2,0,0,2,3,Technical Failure
1940-10-17 00:00:00,Royal Air Force - RAF,Landing (descent or approach),Operational,United Kingdom,Europe,2,2,2,0,0,2,0,Technical Failure
1940-10-17 00:00:00,Royal Air Force - RAF,Flight,Operational,United Kingdom,Europe,2,2,2,0,0,2,0,Human Factor
1940-10-23 00:00:00,Royal Air Force - RAF,Flight,Operational,United Kingdom,Europe,7,7,2,0,0,2,5,Human Factor
1940-10-26 00:00:00,Eurasia Aviation Corporation,Flight,Commercial,China,Asia,4,2,2,2,0,2,2,Terrorism
1940-10-29 00:00:00,Deutsche Lufthansa,Landing (descent or approach),Commercial,Germany,Europe,15,3,2,12,0,2,13,Weather
1940-11-04 00:00:00,Hellenic Air Force - Elleniki Polemiki Aeroporia,Flight,Military / Government,Greece,Europe,2,2,2,0,0,2,0,Terrorism
1940-11-26 00:00:00,Royal Air Force - RAF,Landing (descent or approach),Operational,United Kingdom,Europe,2,2,2,0,0,2,0,Technical Failure
1940-12-11 00:00:00,Royal New Zealand Air Force - RNZAF,Takeoff (climb),Operational,New Zealand,Oceania,2,2,2,0,0,2,0,Unknown
1940-12-30 00:00:00,Royal New Zealand Air Force - RNZAF,Flight,Operational,New Zealand,Oceania,2,2,2,0,0,2,0,Human Factor
1941-01-04 00:00:00,Royal Air Force - RAF,Landing (descent or approach),Operational,United Kingdom,Europe,4,4,2,0,0,2,2,Unknown
1941-01-07 00:00:00,Royal Air Force - RAF,Takeoff (climb),Military / Government,United Kingdom,Europe,9,9,2,0,0,2,7,Unknown
1941-01-23 00:00:00,Transcontinental %26 Western Air - TWA,Landing (descent or approach),Commercial,United States of America,North America,14,3,1,11,1,2,12,Human Factor
1941-04-04 00:00:00,TACA International Airlines - Transportes Aéreos Centro Americanos,Flight,Operational,Nicaragua,Central America,2,2,2,0,0,2,0,Unknown
1941-04-08 00:00:00,Royal Canadian Air Force - RCAF,Flight,Operational,Canada,North America,3,3,2,0,0,2,1,Technical Failure
1941-04-28 00:00:00,Royal Air Force - RAF,Landing (descent or approach),Operational,United Kingdom,Europe,2,2,2,0,0,2,0,Unknown
1941-06-06 00:00:00,Turkish Air Force - Türk Hava Kuvvetleri,Flight,Military / Government,Turkey,Asia,2,2,2,0,0,2,0,Unknown
1941-06-21 00:00:00,Royal Air Force - RAF,Takeoff (climb),Specialised Services,United Kingdom,Europe,3,3,2,0,0,2,1,Technical Failure
1941-06-27 00:00:00,German Air Force - Deutsche Luftwaffe,Flight,Operational,Czech Republic,Europe,2,2,2,0,0,2,0,Unknown
1941-07-15 00:00:00,German Air Force - Deutsche Luftwaffe,Landing (descent or approach),Operational,Czech Republic,Europe,2,2,2,0,0,2,0,Unknown
1941-07-28 00:00:00,Royal Air Force - RAF,Flight,Operational,United Kingdom,Europe,2,2,2,0,0,2,0,Human Factor
1941-08-03 00:00:00,Royal Air Force - RAF,Flight,Military / Government,United Kingdom,Europe,2,2,2,0,0,2,0,Human Factor
1941-08-04 00:00:00,Air France,Flight,Operational,France,Europe,2,2,2,0,0,2,0,Weather
1941-08-10 00:00:00,Royal Netherlands Navy - Marineluchtvaartdienst,Flight,Military / Government,United Kingdom,Europe,2,2,2,0,0,2,0,Unknown
1941-08-17 00:00:00,Royal Air Force - RAF,Flight,Military / Government,Belgium,Europe,7,7,2,0,0,2,5,Terrorism
1941-08-28 00:00:00,Royal New Zealand Air Force - RNZAF,Landing (descent or approach),Operational,New Zealand,Oceania,2,2,2,0,0,2,0,Unknown
1941-09-25 00:00:00,United States Army Air Forces - USAAF,Takeoff (climb),Operational,United States of America,North America,2,2,2,0,0,2,0,Technical Failure
1941-10-03 00:00:00,Pan American World Airways - PAA,Landing (descent or approach),Commercial,Puerto Rico,Central America,27,6,0,21,2,2,25,Human Factor
1941-10-04 00:00:00,Royal New Zealand Air Force - RNZAF,Flight,Operational,Fiji Islands,Oceania,2,2,2,0,0,2,0,Terrorism
1941-10-15 00:00:00,Royal New Zealand Air Force - RNZAF,Flight,Operational,New Zealand,Oceania,2,2,2,0,0,2,0,Unknown
1941-10-22 00:00:00,Royal New Zealand Air Force - RNZAF,Takeoff (climb),Operational,New Zealand,Oceania,2,2,2,0,0,2,0,Unknown
1941-11-02 00:00:00,Royal Air Force - RAF,Flight,Operational,United Kingdom,Europe,2,2,2,0,0,2,0,Human Factor
1941-11-20 00:00:00,Royal New Zealand Air Force - RNZAF,Flight,Operational,New Zealand,Oceania,2,2,2,0,0,2,0,Human Factor
1941-12-17 00:00:00,Royal Air Force - RAF,Flight,Operational,United Kingdom,Europe,3,3,2,0,0,2,1,Technical Failure
1941-12-17 00:00:00,Royal Netherlands Navy - Marineluchtvaartdienst,Flight,Humanitarian,Malaysia,Asia,6,6,2,0,0,2,4,Unknown
1941-12-18 00:00:00,Aeroflot - Russian International Airlines,Takeoff (climb),Specialised Services,Russia,Asia,3,1,0,2,2,2,1,Technical Failure
1942-01-13 00:00:00,Aeroflot - Russian International Airlines,Flight,Military / Government,Russia,Asia,6,5,1,1,1,2,4,Technical Failure
1942-01-14 00:00:00,United States Army Air Forces - USAAF,Flight,Military / Government,United States of America,North America,7,7,2,0,0,2,5,Weather
1942-01-31 00:00:00,Royal Air Force - RAF,Flight,Military / Government,United Kingdom,Europe,2,2,2,0,0,2,0,Unknown
1942-02-01 00:00:00,Royal Air Force - RAF,Flight,Military / Government,World,World,8,8,2,0,0,2,6,Terrorism
1942-02-13 00:00:00,Royal Australian Air Force - RAAF,Landing (descent or approach),Operational,Australia,Oceania,2,2,2,0,0,2,0,Human Factor
1942-02-13 00:00:00,Royal Australian Air Force - RAAF,Takeoff (climb),Operational,Australia,Oceania,2,2,2,0,0,2,0,Human Factor
1942-02-14 00:00:00,WR Carpenter %26 Company,Takeoff (climb),Operational,Australia,Oceania,2,2,2,0,0,2,0,Unknown
1942-02-24 00:00:00,Syndicato Condor,Flight,Operational,Brazil,South America,2,2,2,0,0,2,0,Technical Failure
1942-03-18 00:00:00,Royal Air Force - RAF,Takeoff (climb),Operational,United Kingdom,Europe,3,3,2,0,0,2,1,Human Factor
1942-03-22 00:00:00,British Overseas Airways Corporation - BOAC,Landing (descent or approach),Commercial,Australia,Oceania,15,4,0,11,2,2,13,Other
1942-03-25 00:00:00,Royal Air Force - RAF,Flight,Operational,United Kingdom,Europe,2,2,2,0,0,2,0,Human Factor
1942-04-14 00:00:00,Flugfélag Akureyrar,Landing (descent or approach),Commercial,Iceland,Europe,2,1,1,1,1,2,0,Technical Failure
1942-04-17 00:00:00,Royal Air Force - RAF,Flight,Operational,United Kingdom,Europe,3,2,1,1,1,2,1,Human Factor
1942-04-21 00:00:00,United States Army Air Forces - USAAF,Takeoff (climb),Specialised Services,United States of America,North America,6,6,2,0,0,2,4,Technical Failure
1942-04-30 00:00:00,Royal Air Force - RAF,Flight,Military / Government,Germany,Europe,7,7,2,0,0,2,5,Terrorism
1942-05-02 00:00:00,United States Army Air Forces - USAAF,Flight,Military / Government,Papua New Guinea,Oceania,7,7,2,0,0,2,5,Terrorism
1942-05-21 00:00:00,Royal Air Force - RAF,Flight,Operational,United Kingdom,Europe,5,5,2,0,0,2,3,Human Factor
1942-05-22 00:00:00,Royal Australian Air Force - RAAF,Flight,Military / Government,Indonesia,Asia,4,4,2,0,0,2,2,Terrorism
1942-05-25 00:00:00,United States Army Air Forces - USAAF,Flight,Military / Government,Papua New Guinea,Oceania,7,7,2,0,0,2,5,Terrorism
1942-05-25 00:00:00,United States Army Air Forces - USAAF,Takeoff (climb),Operational,United States of America,North America,6,6,2,0,0,2,4,Unknown
1942-05-31 00:00:00,Royal Air Force - RAF,Flight,Military / Government,Germany,Europe,7,7,2,0,0,2,5,Terrorism
1942-06-07 00:00:00,Royal Air Force - RAF,Flight,Military / Government,World,World,7,7,2,0,0,2,5,Unknown
1942-06-09 00:00:00,Royal Air Force - RAF,Takeoff (climb),Operational,United Kingdom,Europe,2,2,2,0,0,2,0,Unknown
1942-06-23 00:00:00,United States Army Air Forces - USAAF,Flight,Military / Government,United States of America,North America,10,10,2,0,0,2,8,Technical Failure
1942-06-26 00:00:00,Royal Air Force - RAF,Flight,Military / Government,World,World,4,4,2,0,0,2,2,Terrorism
1942-07-13 00:00:00,United States Army Air Forces - USAAF,Takeoff (climb),Military / Government,Australia,Oceania,5,5,2,0,0,2,3,Unknown
1942-07-21 00:00:00,Royal Canadian Air Force - RCAF,Flight,Operational,United States of America,North America,7,7,2,0,0,2,5,Unknown
1942-08-06 00:00:00,Royal Air Force - RAF,Flight,Operational,United Kingdom,Europe,2,2,2,0,0,2,0,Unknown
1942-08-09 00:00:00,Royal Australian Air Force - RAAF,Landing (descent or approach),Operational,Australia,Oceania,2,2,2,0,0,2,0,Unknown
1942-08-09 00:00:00,United States Army Air Forces - USAAF,Flight,Military / Government,Papua New Guinea,Oceania,8,8,2,0,0,2,6,Technical Failure
1942-08-27 00:00:00,Royal Air Force - RAF,Flight,Operational,United Kingdom,Europe,2,2,2,0,0,2,0,Technical Failure
1942-10-13 00:00:00,Royal Air Force - RAF,Landing (descent or approach),Operational,United Kingdom,Europe,2,2,2,0,0,2,0,Unknown
1942-10-20 00:00:00,United States Navy - USN,Landing (descent or approach),Military / Government,United States of America,North America,6,6,2,0,0,2,4,Unknown
1942-10-30 00:00:00,German Air Force - Deutsche Luftwaffe,Flight,Military / Government,Norway,Europe,8,4,2,4,0,2,6,Weather
1942-11-09 00:00:00,Royal Air Force - RAF,Takeoff (climb),Operational,United Kingdom,Europe,2,2,2,0,0,2,0,Human Factor
1942-11-18 00:00:00,Royal New Zealand Air Force - RNZAF,Flight,Operational,New Zealand,Oceania,2,2,2,0,0,2,0,Human Factor
1942-11-21 00:00:00,Atlantic Airmotive,Takeoff (climb),Operational,United States of America,North America,2,2,2,0,0,2,0,Weather
1942-11-30 00:00:00,United States Army Air Forces - USAAF,Flight,Operational,United States of America,North America,7,7,2,0,0,2,5,Weather
1942-12-07 00:00:00,Royal New Zealand Air Force - RNZAF,Flight,Operational,New Zealand,Oceania,2,2,2,0,0,2,0,Unknown
1942-12-18 00:00:00,Royal New Zealand Air Force - RNZAF,Flight,Operational,New Zealand,Oceania,3,3,2,0,0,2,1,Unknown
1942-12-19 00:00:00,Det Danske Luftfartselskab - DDL,Landing (descent or approach),Commercial,Austria,Europe,16,3,0,13,2,2,14,Unknown
1943-01-05 00:00:00,Gillam Airways,Landing (descent or approach),Commercial,United States of America,North America,6,1,1,5,1,2,4,Human Factor
1943-01-14 00:00:00,Royal Air Force - RAF,Flight,Operational,United Kingdom,Europe,4,4,2,0,0,2,2,Human Factor
1943-01-15 00:00:00,Royal Air Force - RAF,Flight,Operational,United Kingdom,Europe,2,2,2,0,0,2,0,Unknown
1943-01-20 00:00:00,Royal Air Force - RAF,Flight,Operational,United Kingdom,Europe,3,3,2,0,0,2,1,Human Factor
1943-01-21 00:00:00,Royal Air Force - RAF,Flight,Military / Government,United Kingdom,Europe,7,7,2,0,0,2,5,Human Factor
1943-01-25 00:00:00,Royal New Zealand Air Force - RNZAF,Landing (descent or approach),Operational,New Zealand,Oceania,2,2,2,0,0,2,0,Unknown
1943-01-30 00:00:00,Royal Air Force - RAF,Flight,Operational,United Kingdom,Europe,5,5,2,0,0,2,3,Human Factor
1943-02-08 00:00:00,United States Navy - USN,Landing (descent or approach),Operational,United States of America,North America,2,2,2,0,0,2,0,Unknown
1943-02-09 00:00:00,United States Army Air Forces - USAAF,Flight,Operational,Mexico,Central America,8,6,2,2,0,2,6,Technical Failure
1943-02-11 00:00:00,Royal Air Force - RAF,Flight,Military / Government,Netherlands,Europe,4,4,2,0,0,2,2,Terrorism
1943-02-15 00:00:00,British Overseas Airways Corporation - BOAC,Landing (descent or approach),Specialised Services,Eritrea,Africa,2,2,2,0,0,2,0,Unknown
1943-02-18 00:00:00,Royal Netherlands East Indies Air Force - ML-KNIL,Flight,Military / Government,World,World,6,6,2,0,0,2,4,Terrorism
1943-02-22 00:00:00,United States Army Air Forces - USAAF,Flight,Operational,United States of America,North America,2,2,2,0,0,2,0,Unknown
1943-03-01 00:00:00,Royal Air Force - RAF,Landing (descent or approach),Operational,Egypt,Africa,2,2,2,0,0,2,0,Unknown
1943-03-03 00:00:00,United States Army Air Forces - USAAF,Takeoff (climb),Military / Government,Guyana,South America,2,2,2,0,0,2,0,Unknown
1943-03-11 00:00:00,Royal Australian Air Force - RAAF,Takeoff (climb),Military / Government,Australia,Oceania,2,2,2,0,0,2,0,Unknown
1943-03-26 00:00:00,Royal New Zealand Air Force - RNZAF,Takeoff (climb),Military / Government,Solomon Islands,Oceania,5,5,2,0,0,2,3,Technical Failure
1943-03-27 00:00:00,Aeroflot - Russian International Airlines,Takeoff (climb),Commercial,Russia,Asia,14,5,2,9,0,2,12,Human Factor
1943-04-08 00:00:00,Royal Air Force - RAF,Flight,Operational,United Kingdom,Europe,2,2,2,0,0,2,0,Unknown
1943-04-23 00:00:00,United States Army Air Forces - USAAF,Takeoff (climb),Military / Government,India,Asia,6,6,2,0,0,2,4,Unknown
1943-05-06 00:00:00,Royal New Zealand Air Force - RNZAF,Takeoff (climb),Operational,New Zealand,Oceania,4,4,2,0,0,2,2,Unknown
1943-05-13 00:00:00,Royal Air Force - RAF,Flight,Military / Government,Netherlands,Europe,7,7,2,0,0,2,5,Terrorism
1943-05-17 00:00:00,United States Army Air Forces - USAAF,Flight,Military / Government,Netherlands,Europe,6,6,2,0,0,2,4,Terrorism
1943-05-27 00:00:00,Royal Air Force - RAF,Landing (descent or approach),Operational,United Kingdom,Europe,4,4,2,0,0,2,2,Technical Failure
1943-05-28 00:00:00,United States Army Air Forces - USAAF,Flight,Military / Government,United States of America,North America,2,2,2,0,0,2,0,Human Factor
1943-05-28 00:00:00,Royal Air Force - RAF,Flight,Operational,United Kingdom,Europe,2,2,2,0,0,2,0,Unknown
1943-06-16 00:00:00,United States Navy - USN,,Military / Government,United States of America,North America,6,6,2,0,0,2,4,Unknown
1943-06-20 00:00:00,Royal Air Force - RAF,Flight,Military / Government,World,World,8,8,2,0,0,2,6,Technical Failure
1943-06-20 00:00:00,United States Army Air Forces - USAAF,Flight,Military / Government,United States of America,North America,2,2,2,0,0,2,0,Unknown
1943-06-22 00:00:00,Royal Air Force - RAF,Flight,Military / Government,Belgium,Europe,7,7,2,0,0,2,5,Terrorism
1943-06-22 00:00:00,Royal Air Force - RAF,Flight,Military / Government,Netherlands,Europe,8,8,2,0,0,2,6,Terrorism
1943-06-23 00:00:00,United States Army Air Forces - USAAF,Takeoff (climb),Operational,China,Asia,2,2,2,0,0,2,0,Unknown
1943-06-30 00:00:00,Royal Air Force - RAF,Flight,Operational,United Kingdom,Europe,11,11,2,0,0,2,9,Unknown
1943-07-08 00:00:00,Royal Air Force - RAF,Flight,Operational,Canada,North America,2,2,2,0,0,2,0,Unknown
1943-07-08 00:00:00,Royal Air Force - RAF,Flight,Operational,Canada,North America,2,2,2,0,0,2,0,Unknown
1943-07-09 00:00:00,Royal Air Force - RAF,Flight,Military / Government,Tunisia,Africa,3,3,2,0,0,2,1,Technical Failure
1943-07-13 00:00:00,United States Army Air Forces - USAAF,Flight,Military / Government,Italy,Europe,4,4,2,0,0,2,2,Terrorism
1943-08-09 00:00:00,Royal Air Force - RAF,Flight,Operational,United Kingdom,Europe,5,5,2,0,0,2,3,Weather
1943-08-21 00:00:00,Royal Air Force - RAF,Flight,Operational,United Kingdom,Europe,2,2,2,0,0,2,0,Technical Failure
1943-08-28 00:00:00,Aeroflot - Russian International Airlines,Landing (descent or approach),Military / Government,Russia,Asia,6,6,2,0,0,2,4,Human Factor
1943-09-01 00:00:00,Royal Air Force - RAF,Flight,Operational,United Kingdom,Europe,5,5,2,0,0,2,3,Human Factor
1943-09-12 00:00:00,United States Army Air Forces - USAAF,Takeoff (climb),Operational,Papua New Guinea,Oceania,5,4,2,1,0,2,3,Technical Failure
1943-09-19 00:00:00,Björkvallsflyg,Flight,Military / Government,Sweden,Europe,2,2,2,0,0,2,0,Technical Failure
1943-09-29 00:00:00,United States Army Air Forces - USAAF,Takeoff (climb),Military / Government,United States of America,North America,2,2,2,0,0,2,0,Unknown
1943-10-18 00:00:00,Royal Air Force - RAF,Flight,Operational,United Kingdom,Europe,4,4,2,0,0,2,2,Weather
1943-11-04 00:00:00,United States Army Air Forces - USAAF,Takeoff (climb),Operational,United States of America,North America,2,2,2,0,0,2,0,Unknown
1943-11-18 00:00:00,United States Army Air Forces - USAAF,Takeoff (climb),Operational,China,Asia,2,2,2,0,0,2,0,Unknown
1943-11-19 00:00:00,China National Aviation Corporation - CNAC,Landing (descent or approach),Operational,China,Asia,3,3,2,0,0,2,1,Weather
1943-11-24 00:00:00,French Navy,Flight,Military / Government,Senegal,Africa,7,7,2,0,0,2,5,Unknown
1943-11-26 00:00:00,Royal Netherlands Navy - Marineluchtvaartdienst,Flight,Military / Government,France,Europe,4,4,2,0,0,2,2,Terrorism
1943-12-06 00:00:00,Royal Australian Air Force - RAAF,Flight,Military / Government,Australia,Oceania,2,2,2,0,0,2,0,Unknown
1943-12-10 00:00:00,Royal Air Force - RAF,Flight,Military / Government,France,Europe,7,7,2,0,0,2,5,Terrorism
1943-12-19 00:00:00,Royal New Zealand Air Force - RNZAF,Takeoff (climb),Operational,New Zealand,Oceania,2,2,2,0,0,2,0,Unknown
1943-12-29 00:00:00,Royal Air Force - RAF,Takeoff (climb),Military / Government,United Kingdom,Europe,4,4,2,0,0,2,2,Unknown
1944-01-02 00:00:00,United States Army Air Forces - USAAF,Landing (descent or approach),Operational,United States of America,North America,5,3,2,2,0,2,3,Human Factor
1944-01-04 00:00:00,United States Army Air Forces - USAAF,Flight,Operational,United States of America,North America,13,3,0,10,2,2,11,Technical Failure
1944-01-24 00:00:00,Royal Air Force - RAF,Flight,Operational,United Kingdom,Europe,2,2,2,0,0,2,0,Human Factor
1944-02-18 00:00:00,United States Army Air Forces - USAAF,Takeoff (climb),Military / Government,United States of America,North America,5,5,2,0,0,2,3,Technical Failure
1944-02-20 00:00:00,Royal Air Force - RAF,Flight,Operational,United Kingdom,Europe,2,2,2,0,0,2,0,Human Factor
1944-02-20 00:00:00,China National Aviation Corporation - CNAC,Flight,Operational,China,Asia,2,2,2,0,0,2,0,Human Factor
1944-02-27 00:00:00,Aeroflot - Russian International Airlines,Flight,Military / Government,Ukraine,Europe,2,2,2,0,0,2,0,Unknown
1944-02-27 00:00:00,United States Army Air Forces - USAAF,Flight,Military / Government,Canada,North America,2,1,1,1,1,2,0,Unknown
1944-03-06 00:00:00,United States Navy - USN,Flight,Military / Government,United States of America,North America,2,2,2,0,0,2,0,Unknown
1944-03-07 00:00:00,China National Aviation Corporation - CNAC,Takeoff (climb),Operational,China,Asia,2,2,2,0,0,2,0,Other
1944-03-11 00:00:00,United States Army Air Forces - USAAF,Takeoff (climb),Operational,United Kingdom,Europe,3,2,2,1,0,2,1,Human Factor
1944-03-14 00:00:00,United States Army Air Forces - USAAF,Landing (descent or approach),Business,United States of America,North America,2,2,2,0,0,2,0,Human Factor
1944-03-17 00:00:00,Royal Canadian Air Force - RCAF,Flight,Military / Government,World,World,2,2,2,0,0,2,0,Unknown
1944-03-24 00:00:00,Östersunds Flygklubb,Flight,Operational,Sweden,Europe,2,1,1,1,1,2,0,Technical Failure
1944-03-24 00:00:00,United States Army Air Forces - USAAF,Landing (descent or approach),Military / Government,Australia,Oceania,17,10,2,7,0,2,15,Unknown
1944-03-29 00:00:00,United States Army Air Forces - USAAF,Flight,Operational,United States of America,North America,2,2,2,0,0,2,0,Human Factor
1944-04-13 00:00:00,Royal Air Force - RAF,Flight,Military / Government,United Kingdom,Europe,2,2,2,0,0,2,0,Unknown
1944-04-16 00:00:00,United States Army Air Forces - USAAF,Flight,Operational,United States of America,North America,2,2,2,0,0,2,0,Human Factor
1944-04-16 00:00:00,United States Army Air Forces - USAAF,Flight,Military / Government,Papua New Guinea,Oceania,3,3,2,0,0,2,1,Unknown
1944-04-19 00:00:00,Royal Canadian Air Force - RCAF,Landing (descent or approach),Operational,Canada,North America,3,3,2,0,0,2,1,Technical Failure
1944-05-12 00:00:00,United States Army Air Forces - USAAF,Flight,Military / Government,France,Europe,4,4,2,0,0,2,2,Terrorism
1944-05-14 00:00:00,United States Army Air Forces - USAAF,Flight,Military / Government,Italy,Europe,0,0,2,0,0,2,-2,Unknown
1944-05-20 00:00:00,United States Army Air Forces - USAAF,Takeoff (climb),Operational,United States of America,North America,6,6,2,0,0,2,4,Unknown
1944-05-25 00:00:00,Royal Air Force - RAF,Flight,Military / Government,Netherlands,Europe,9,9,2,0,0,2,7,Terrorism
1944-05-26 00:00:00,United States Army Air Forces - USAAF,Takeoff (climb),Military / Government,United States of America,North America,7,7,2,0,0,2,5,Unknown
1944-05-27 00:00:00,United States Army Air Forces - USAAF,Takeoff (climb),Military / Government,Brazil,South America,5,2,2,3,0,2,3,Unknown
1944-06-06 00:00:00,Royal Air Force - RAF,Flight,Operational,United Kingdom,Europe,2,2,2,0,0,2,0,Technical Failure
1944-06-06 00:00:00,United States Army Air Forces - USAAF,Flight,Military / Government,France,Europe,24,5,1,19,1,2,22,Terrorism
1944-06-07 00:00:00,United States Army Air Forces - USAAF,Flight,Military / Government,World,World,7,5,2,2,0,2,5,Unknown
1944-06-19 00:00:00,United States Army Air Forces - USAAF,Flight,Operational,Ireland,Europe,10,10,2,0,0,2,8,Technical Failure
1944-06-22 00:00:00,Royal Air Force - RAF,Flight,Military / Government,Netherlands,Europe,8,8,2,0,0,2,6,Terrorism
1944-06-27 00:00:00,Aeroflot - Russian International Airlines,Flight,Military / Government,Belarus,Europe,5,5,2,0,0,2,3,Technical Failure
1944-06-30 00:00:00,Air Travel,Flight,Commercial,New Zealand,Oceania,7,1,0,6,2,2,5,Weather
1944-07-11 00:00:00,United States Army Air Forces - USAAF,Landing (descent or approach),Military / Government,United States of America,North America,2,2,2,0,0,2,0,Weather
1944-08-12 00:00:00,Royal Canadian Air Force - RCAF,Flight,Operational,Canada,North America,4,4,2,0,0,2,2,Unknown
1944-08-22 00:00:00,Lineas Aéreas Mineras - LAMSA,Flight,Commercial,Mexico,Central America,0,0,1,0,1,2,-2,Unknown
1944-08-31 00:00:00,China National Aviation Corporation - CNAC,Flight,Operational,China,Asia,3,3,2,0,0,2,1,Technical Failure
1944-09-02 00:00:00,Royal Australian Air Force - RAAF,Flight,Military / Government,Australia,Oceania,2,2,2,0,0,2,0,Unknown
1944-09-04 00:00:00,Royal New Zealand Air Force - RNZAF,Flight,Operational,New Zealand,Oceania,4,4,2,0,0,2,2,Human Factor
1944-09-14 00:00:00,United States Army Air Forces - USAAF,Landing (descent or approach),Operational,United States of America,North America,2,2,2,0,0,2,0,Human Factor
1944-09-14 00:00:00,United States Army Air Forces - USAAF,Landing (descent or approach),Operational,United States of America,North America,2,2,2,0,0,2,0,Human Factor
1944-09-16 00:00:00,Royal Air Force - RAF,Takeoff (climb),Military / Government,United Kingdom,Europe,5,5,2,0,0,2,3,Unknown
1944-09-17 00:00:00,United States Army Air Forces - USAAF,Flight,Military / Government,Netherlands,Europe,15,5,2,10,0,2,13,Terrorism
1944-09-18 00:00:00,United States Army Air Forces - USAAF,Flight,Military / Government,Netherlands,Europe,2,2,2,0,0,2,0,Terrorism
1944-09-23 00:00:00,United States Army Air Forces - USAAF,Flight,Military / Government,Netherlands,Europe,5,5,2,0,0,2,3,Terrorism
1944-10-10 00:00:00,Royal New Zealand Air Force - RNZAF,Takeoff (climb),Military / Government,New Zealand,Oceania,3,3,2,0,0,2,1,Weather
1944-10-17 00:00:00,Royal Air Force - RAF,Takeoff (climb),Operational,Bahamas,Central America,2,2,2,0,0,2,0,Technical Failure
1944-10-18 00:00:00,United States Navy - USN,Landing (descent or approach),Specialised Services,Palau,Asia,4,4,2,0,0,2,2,Human Factor
1944-11-04 00:00:00,Royal Air Force - RAF,Landing (descent or approach),Military / Government,Netherlands,Europe,4,4,2,0,0,2,2,Terrorism
1944-11-17 00:00:00,United States Army Air Forces - USAAF,Takeoff (climb),Operational,United States of America,North America,2,2,2,0,0,2,0,Human Factor
1944-11-19 00:00:00,Royal Canadian Air Force - RCAF,Flight,Operational,United Kingdom,Europe,10,10,2,0,0,2,8,Human Factor
1944-12-03 00:00:00,United States Army Air Forces - USAAF,Landing (descent or approach),Military / Government,France,Europe,2,2,2,0,0,2,0,Human Factor
1944-12-27 00:00:00,United States Army Air Forces - USAAF,Flight,Military / Government,Belgium,Europe,5,5,2,0,0,2,3,Terrorism
1945-01-14 00:00:00,United States Navy - USN,Takeoff (climb),Military / Government,Philippines,Asia,10,10,2,0,0,2,8,Technical Failure
1945-01-27 00:00:00,German Air Force - Deutsche Luftwaffe,Landing (descent or approach),Military / Government,Hungary,Europe,3,3,2,0,0,2,1,Terrorism
1945-01-28 00:00:00,United States Navy - USN,Flight,Military / Government,Greece,Europe,0,0,2,0,0,2,-2,Human Factor
1945-02-02 00:00:00,Royal Australian Air Force - RAAF,Landing (descent or approach),Military / Government,Australia,Oceania,11,11,2,0,0,2,9,Technical Failure
1945-02-04 00:00:00,Royal Air Force - RAF,Landing (descent or approach),Operational,United Kingdom,Europe,2,2,2,0,0,2,0,Human Factor
1945-02-09 00:00:00,Royal Air Force - RAF,Takeoff (climb),Military / Government,United Kingdom,Europe,11,11,2,0,0,2,9,Unknown
1945-02-09 00:00:00,Royal Netherlands Navy - Marineluchtvaartdienst,Flight,Military / Government,Belgium,Europe,4,4,2,0,0,2,2,Unknown
1945-02-14 00:00:00,Royal Australian Air Force - RAAF,Landing (descent or approach),Operational,Australia,Oceania,11,11,2,0,0,2,9,Unknown
1945-02-19 00:00:00,Royal Air Force - RAF,Landing (descent or approach),Operational,United Kingdom,Europe,2,2,2,0,0,2,0,Human Factor
1945-02-19 00:00:00,United States Army Air Forces - USAAF,Flight,Operational,Papua New Guinea,Oceania,2,2,2,0,0,2,0,Unknown
1945-02-23 00:00:00,United States Coast Guard - USCG,Flight,Military / Government,United States of America,North America,2,2,2,0,0,2,0,Unknown
1945-02-28 00:00:00,French Air Force - Armée de l'Air,Flight,Military / Government,France,Europe,6,6,2,0,0,2,4,Technical Failure
1945-03-04 00:00:00,United States Army Air Forces - USAAF,Landing (descent or approach),Operational,United States of America,North America,2,2,2,0,0,2,0,Unknown
1945-03-09 00:00:00,United States Army Air Forces - USAAF,Landing (descent or approach),Operational,Egypt,Africa,2,2,2,0,0,2,0,Unknown
1945-03-09 00:00:00,United States Army Air Forces - USAAF,Takeoff (climb),Operational,Myanmar,Asia,2,2,2,0,0,2,0,Unknown
1945-03-14 00:00:00,United States Army Air Forces - USAAF,Flight,Military / Government,Australia,Oceania,22,2,1,20,1,2,20,Technical Failure
1945-03-21 00:00:00,United States Army Air Forces - USAAF,Flight,Military / Government,Bangladesh,Asia,2,2,2,0,0,2,0,Unknown
1945-03-22 00:00:00,United States Army Air Forces - USAAF,Flight,Operational,United States of America,North America,2,2,2,0,0,2,0,Unknown
1945-03-22 00:00:00,United States Army Air Forces - USAAF,Flight,Operational,United States of America,North America,2,2,2,0,0,2,0,Unknown
1945-03-24 00:00:00,United States Army Air Forces - USAAF,Flight,Military / Government,Germany,Europe,4,4,2,0,0,2,2,Terrorism
1945-03-24 00:00:00,United States Army Air Forces - USAAF,Flight,Military / Government,Myanmar,Asia,2,2,2,0,0,2,0,Unknown
1945-03-29 00:00:00,United States Army Air Forces - USAAF,Takeoff (climb),Military / Government,Italy,Europe,2,2,2,0,0,2,0,Unknown
1945-03-29 00:00:00,United States Army Air Forces - USAAF,Takeoff (climb),Military / Government,China,Asia,2,2,2,0,0,2,0,Unknown
1945-03-31 00:00:00,United States Army Air Forces - USAAF,Takeoff (climb),Military / Government,United Kingdom,Europe,2,2,2,0,0,2,0,Human Factor
1945-04-05 00:00:00,Brazilian Air Force - Força Aérea Brasileira,Flight,Operational,Brazil,South America,2,2,2,0,0,2,0,Human Factor
1945-04-07 00:00:00,United States Army Air Forces - USAAF,Takeoff (climb),Military / Government,United States of America,North America,2,2,2,0,0,2,0,Human Factor
1945-04-09 00:00:00,Royal Air Force - RAF,Takeoff (climb),Military / Government,Canada,North America,18,7,0,11,2,2,16,Technical Failure
1945-04-16 00:00:00,United States Army Air Forces - USAAF,Takeoff (climb),Military / Government,Pakistan,Asia,2,2,2,0,0,2,0,Unknown
1945-04-27 00:00:00,United States Army Air Forces - USAAF,Flight,Operational,United States of America,North America,4,4,2,0,0,2,2,Human Factor
1945-04-29 00:00:00,United States Army Air Forces - USAAF,Flight,Military / Government,Myanmar,Asia,2,2,2,0,0,2,0,Unknown
1945-05-01 00:00:00,Royal Air Force - RAF,Flight,Military / Government,Canada,North America,2,2,2,0,0,2,0,Unknown
1945-05-06 00:00:00,United States Army Air Forces - USAAF,Flight,Military / Government,United Kingdom,Europe,2,2,2,0,0,2,0,Unknown
1945-05-09 00:00:00,China National Aviation Corporation - CNAC,Flight,Operational,Myanmar,Asia,2,2,2,0,0,2,0,Human Factor
1945-05-11 00:00:00,United States Navy - USN,Takeoff (climb),Military / Government,United States of America,North America,8,8,2,0,0,2,6,Technical Failure
1945-05-19 00:00:00,United States Army Air Forces - USAAF,Flight,Military / Government,Myanmar,Asia,2,2,2,0,0,2,0,Unknown
1945-05-30 00:00:00,United States Army Air Forces - USAAF,Takeoff (climb),Operational,Myanmar,Asia,2,2,2,0,0,2,0,Unknown
1945-06-06 00:00:00,United States Army Air Forces - USAAF,Flight,Military / Government,Myanmar,Asia,2,2,2,0,0,2,0,Unknown
1945-06-14 00:00:00,Royal Air Force - RAF,Flight,Military / Government,Myanmar,Asia,5,5,2,0,0,2,3,Technical Failure
1945-06-24 00:00:00,MacRobertson Miller Airlines,Takeoff (climb),Commercial,Australia,Oceania,11,2,1,9,1,2,9,Human Factor
1945-07-12 00:00:00,United States Army Air Forces - USAAF,Flight,Operational,United States of America,North America,2,2,2,0,0,2,0,Human Factor
1945-07-16 00:00:00,United States Army Air Forces - USAAF,Takeoff (climb),Operational,United States of America,North America,2,2,2,0,0,2,0,Human Factor
1945-08-26 00:00:00,United States Army Air Forces - USAAF,Flight,Operational,World,World,2,2,2,0,0,2,0,Unknown
1945-08-28 00:00:00,United States Army Air Forces - USAAF,Flight,Specialised Services,Japan,Asia,13,13,2,0,0,2,11,Technical Failure
1945-09-05 00:00:00,United States Navy - USN,Flight,Specialised Services,United States of America,North America,2,2,2,0,0,2,0,Human Factor
1945-10-05 00:00:00,National Airlines,Landing (descent or approach),Commercial,United States of America,North America,15,3,0,12,2,2,13,Human Factor
1945-11-07 00:00:00,National Skyway Freight,Flight,Operational,United States of America,North America,3,3,2,0,0,2,1,Technical Failure
1945-11-09 00:00:00,Royal Air Force - RAF,Flight,Military / Government,United Kingdom,Europe,3,3,2,0,0,2,1,Technical Failure
1945-12-03 00:00:00,Handley Page Aircraft Company Ltd,Takeoff (climb),Specialised Services,United Kingdom,Europe,2,2,2,0,0,2,0,Technical Failure
1946-01-11 00:00:00,Royal Air Force - RAF,Flight,Operational,United Kingdom,Europe,2,2,2,0,0,2,0,Human Factor
1946-01-29 00:00:00,United States Army Air Forces - USAAF,Takeoff (climb),Operational,India,Asia,3,3,2,0,0,2,1,Technical Failure
1946-02-21 00:00:00,Colombian Air Force - Fuerza Aérea Colombiana,Flight,Military / Government,Colombia,South America,2,2,2,0,0,2,0,Unknown
1946-03-14 00:00:00,Royal Air Force - RAF,Takeoff (climb),Operational,United Kingdom,Europe,2,2,2,0,0,2,0,Human Factor
1946-04-03 00:00:00,Royal Air Force - RAF,Landing (descent or approach),Operational,United Kingdom,Europe,2,2,2,0,0,2,0,Human Factor
1946-04-08 00:00:00,United States Army Air Forces - USAAF,Flight,Military / Government,United States of America,North America,2,2,2,0,0,2,0,Human Factor
1946-04-08 00:00:00,Indian National Airways - INA,Flight,Commercial,India,Asia,2,2,2,0,0,2,0,Unknown
1946-04-09 00:00:00,Royal Australian Air Force - RAAF,Flight,Military / Government,World,World,10,8,1,2,1,2,8,Technical Failure
1946-06-03 00:00:00,United States Navy - USN,Flight,Operational,United States of America,North America,2,2,2,0,0,2,0,Unknown
1946-06-15 00:00:00,Compania Argentina de Aeronavegacion Dodero,Flight,Operational,Argentina,South America,2,2,2,0,0,2,0,Unknown
1946-06-28 00:00:00,Air France,Landing (descent or approach),Operational,France,Europe,3,3,2,0,0,2,1,Human Factor
1946-07-01 00:00:00,Royal Air Force - RAF,Flight,Military / Government,United Kingdom,Europe,2,2,2,0,0,2,0,Weather
1946-07-22 00:00:00,Air France,Landing (descent or approach),Operational,France,Europe,2,2,2,0,0,2,0,Unknown
1946-07-27 00:00:00,SNCASO - Société Nationale de Constructions Aéronautiques du Sud-Ouest,Flight,Operational,Argentina,South America,2,2,2,0,0,2,0,Unknown
1946-08-14 00:00:00,British Overseas Airways Corporation - BOAC,Takeoff (climb),Operational,United Kingdom,Europe,4,1,1,3,1,2,2,Unknown
1946-08-21 00:00:00,Trans-Luxury Airlines - TLA,Landing (descent or approach),Commercial,United States of America,North America,25,3,2,22,0,2,23,Technical Failure
1946-08-25 00:00:00,American Airlines,Flight,Operational,United States of America,North America,2,2,2,0,0,2,0,Human Factor
1946-09-02 00:00:00,Trans-Canada Air Lines - TCAL,Flight,Operational,Canada,North America,2,2,2,0,0,2,0,Technical Failure
1946-10-08 00:00:00,United Airlines,Landing (descent or approach),Commercial,United States of America,North America,47,4,0,43,2,2,45,Human Factor
1946-11-11 00:00:00,United Airlines,Landing (descent or approach),Commercial,United States of America,North America,21,3,2,18,0,2,19,Human Factor
1946-12-28 00:00:00,American Airlines,Flight,Commercial,United States of America,North America,21,3,2,18,0,2,19,Weather
1946-12-28 00:00:00,Kansas City Southern Skyways,Flight,Operational,United States of America,North America,2,2,2,0,0,2,0,Weather
1947-01-16 00:00:00,Rijksluchtvaartschool - RLS,Takeoff (climb),Operational,Netherlands,Europe,3,3,2,0,0,2,1,Technical Failure
1947-01-23 00:00:00,Trans-Canada Air Lines - TCAL,Takeoff (climb),Operational,Canada,North America,2,2,2,0,0,2,0,Unknown
1947-02-14 00:00:00,Slick Airways,Landing (descent or approach),Operational,United States of America,North America,2,2,2,0,0,2,0,Human Factor
1947-03-14 00:00:00,US Airlines,Landing (descent or approach),Operational,United States of America,North America,2,2,2,0,0,2,0,Human Factor
1947-03-24 00:00:00,Misrair,Landing (descent or approach),Operational,Portugal,Europe,2,2,2,0,0,2,0,Human Factor
1947-04-29 00:00:00,Milburn Air,Landing (descent or approach),Business,United Kingdom,Europe,2,1,1,1,1,2,0,Unknown
1947-05-02 00:00:00,Italian Air Force - Aeronautica Militare Italiana,Landing (descent or approach),Military / Government,Italy,Europe,5,5,2,0,0,2,3,Unknown
1947-05-04 00:00:00,Union Southern Airlines,Landing (descent or approach),Commercial,United States of America,North America,12,3,2,9,0,2,10,Human Factor
1947-05-07 00:00:00,Royal Air Force - RAF,Landing (descent or approach),Operational,United Kingdom,Europe,2,2,2,0,0,2,0,Technical Failure
1947-05-10 00:00:00,Compañia Transandina de Aviación,Takeoff (climb),Operational,Colombia,South America,2,2,2,0,0,2,0,Unknown
1947-07-01 00:00:00,Transportes Aéreos Nacionales - TAN Costa Rica,Flight,Operational,World,World,2,2,2,0,0,2,0,Unknown
1947-07-03 00:00:00,Air Transport Association,Flight,Operational,United Kingdom,Europe,2,2,2,0,0,2,0,Unknown
1947-07-21 00:00:00,Turkish Air Force - Türk Hava Kuvvetleri,Flight,Operational,Turkey,Asia,2,2,2,0,0,2,0,Unknown
1947-07-25 00:00:00,Flota Aerea Mercante Argentina - FAMA,Landing (descent or approach),Specialised Services,Argentina,South America,6,6,2,0,0,2,4,Human Factor
1947-08-01 00:00:00,United States Army Air Forces - USAAF,Flight,Military / Government,United States of America,North America,4,4,2,0,0,2,2,Technical Failure
1947-08-28 00:00:00,Royal Air Force - RAF,Flight,Operational,United Kingdom,Europe,2,2,2,0,0,2,0,Human Factor
1947-10-27 00:00:00,China National Aviation Corporation - CNAC,Flight,Operational,China,Asia,3,3,2,0,0,2,1,Terrorism
1947-10-30 00:00:00,John Fairfax %26 Sons,Flight,Operational,Australia,Oceania,2,2,2,0,0,2,0,Other
1947-11-03 00:00:00,French Navy,Takeoff (climb),Operational,Morocco,Africa,5,5,2,0,0,2,3,Unknown
1947-11-20 00:00:00,British Air Transport - BAT,Flight,Operational,United Kingdom,Europe,2,2,2,0,0,2,0,Human Factor
1947-12-14 00:00:00,Indonesian Air Force - TNI-AU Tentara Nasional Indonesia - Angkatan Udara,Flight,Operational,Malaysia,Asia,2,2,2,0,0,2,0,Unknown
1947-12-23 00:00:00,United States Air Force - USAF,Flight,Operational,United States of America,North America,8,8,2,0,0,2,6,Unknown
1948-01-02 00:00:00,United States Coast Guard - USCG,Landing (descent or approach),Military / Government,United States of America,North America,2,2,2,0,0,2,0,Human Factor
1948-02-09 00:00:00,Royal Air Force - RAF,Landing (descent or approach),Operational,United Kingdom,Europe,2,2,2,0,0,2,0,Human Factor
1948-02-10 00:00:00,United States Navy - USN,Landing (descent or approach),Military / Government,United States of America,North America,7,7,2,0,0,2,5,Human Factor
1948-02-27 00:00:00,Pullman Airways,Flight,Commercial,World,World,2,1,1,1,1,2,0,Human Factor
1948-03-08 00:00:00,Eagle Air Freight,Landing (descent or approach),Operational,United States of America,North America,2,2,2,0,0,2,0,Human Factor
1948-03-12 00:00:00,Italian Air Force - Aeronautica Militare Italiana,Takeoff (climb),Operational,Italy,Europe,3,3,2,0,0,2,1,Technical Failure
1948-04-21 00:00:00,Brazilian Air Force - Força Aérea Brasileira,Flight,Military / Government,Brazil,South America,2,2,2,0,0,2,0,Unknown
1948-04-23 00:00:00,Israeli Air Force - Heyl Ha'avir,Takeoff (climb),Operational,Mexico,Central America,2,2,2,0,0,2,0,Technical Failure
1948-05-05 00:00:00,Superior Oil Corporation,Flight,Business,World,World,2,2,2,0,0,2,0,Unknown
1948-05-16 00:00:00,Slick Airways,Landing (descent or approach),Operational,United States of America,North America,2,2,2,0,0,2,0,Technical Failure
1948-05-20 00:00:00,SOMACO,Takeoff (climb),Operational,Italy,Europe,2,2,2,0,0,2,0,Terrorism
1948-05-28 00:00:00,Aeroplane %26 Armament Experimental Establishment - A%26AEE,Flight,Specialised Services,United Kingdom,Europe,2,2,2,0,0,2,0,Technical Failure
1948-06-29 00:00:00,Airlines WA,Takeoff (climb),Operational,Australia,Oceania,2,2,2,0,0,2,0,Technical Failure
1948-07-25 00:00:00,United States Air Force - USAF,Landing (descent or approach),Operational,Germany,Europe,2,2,2,0,0,2,0,Unknown
1948-08-09 00:00:00,New Zealand National Airways,Flight,Operational,New Zealand,Oceania,2,2,2,0,0,2,0,Human Factor
1948-08-24 00:00:00,United States Air Force - USAF,Flight,Operational,Germany,Europe,2,2,2,0,0,2,0,Human Factor
1948-08-24 00:00:00,United States Air Force - USAF,Flight,Operational,Germany,Europe,2,2,2,0,0,2,0,Human Factor
1948-08-25 00:00:00,Turkish Air Force - Türk Hava Kuvvetleri,Takeoff (climb),Operational,Turkey,Asia,2,2,2,0,0,2,0,Unknown
1948-10-27 00:00:00,Northwest Airlines,Flight,Operational,Canada,North America,5,5,2,0,0,2,3,Human Factor
1948-12-12 00:00:00,China National Aviation Corporation - CNAC,Landing (descent or approach),Commercial,Taiwan,Asia,10,2,2,8,0,2,8,Unknown
1948-12-24 00:00:00,Queen Charlotte Airlines,Flight,Commercial,Canada,North America,2,2,2,0,0,2,0,Unknown
1948-12-29 00:00:00,Indonesian Air Force - TNI-AU Tentara Nasional Indonesia - Angkatan Udara,Takeoff (climb),Military / Government,Indonesia,Asia,2,2,2,0,0,2,0,Unknown
1949-01-06 00:00:00,Coastal Cargo,Flight,Operational,United States of America,North America,2,2,2,0,0,2,0,Weather
1949-01-07 00:00:00,French Navy,Flight,Military / Government,Algeria,Africa,0,0,0,0,2,2,-2,Technical Failure
1949-01-26 00:00:00,Elfving Flyg,Takeoff (climb),Commercial,Sweden,Europe,5,1,0,4,2,2,3,Human Factor
1949-02-01 00:00:00,Royal Air Force - RAF,Flight,Military / Government,Uganda,Africa,4,4,2,0,0,2,2,Human Factor
1949-02-01 00:00:00,Royal Air Force - RAF,Flight,Military / Government,Uganda,Africa,4,4,2,0,0,2,2,Human Factor
1949-02-02 00:00:00,United States Air Force - USAF,Flight,Operational,United States of America,North America,2,2,2,0,0,2,0,Unknown
1949-02-06 00:00:00,Aeroservicios Ecuatorianos,Landing (descent or approach),Operational,Ecuador,South America,9,9,2,0,0,2,7,Unknown
1949-02-08 00:00:00,Sudbury Airways,Landing (descent or approach),Commercial,Canada,North America,3,1,0,2,2,2,1,Unknown
1949-02-10 00:00:00,United States Navy - USN,Landing (descent or approach),Military / Government,United States of America,North America,8,8,2,0,0,2,6,Unknown
1949-02-11 00:00:00,Air Enterprises,Flight,Humanitarian,Lebanon,Asia,2,2,2,0,0,2,0,Unknown
1949-02-18 00:00:00,United Nations Organization,Flight,Humanitarian,Macedonia,Europe,2,2,2,0,0,2,0,Unknown
1949-03-25 00:00:00,United States Air Force - USAF,Landing (descent or approach),Military / Government,United States of America,North America,2,2,2,0,0,2,0,Unknown
1949-04-28 00:00:00,Shell Company of Ecuador,Flight,Specialised Services,Ecuador,South America,2,2,2,0,0,2,0,Unknown
1949-04-29 00:00:00,Private Mexican,Flight,Business,Mexico,Central America,2,1,1,1,1,2,0,Unknown
1949-05-15 00:00:00,United States Navy - USN,Landing (descent or approach),Military / Government,United States of America,North America,8,8,2,0,0,2,6,Unknown
1949-05-27 00:00:00,Trans-Air Hawaii,Landing (descent or approach),Operational,United States of America,North America,2,2,2,0,0,2,0,Technical Failure
1949-07-19 00:00:00,Air Transport Associates,Takeoff (climb),Commercial,United States of America,North America,32,4,0,28,2,2,30,Human Factor
1949-08-01 00:00:00,Aeroflot - Russian International Airlines,Flight,Commercial,Russia,Asia,8,4,2,4,0,2,6,Technical Failure
1949-08-23 00:00:00,Royal Air Force - RAF,Landing (descent or approach),Operational,United Kingdom,Europe,3,3,2,0,0,2,1,Human Factor
1949-09-03 00:00:00,United States Air Force - USAF,Flight,Military / Government,United States of America,North America,8,2,2,6,0,2,6,Technical Failure
1949-11-16 00:00:00,United States Air Force - USAF,Flight,Military / Government,World,World,20,20,2,0,0,2,18,Technical Failure
1949-11-19 00:00:00,Meteor Air Transport,Landing (descent or approach),Operational,United States of America,North America,2,2,2,0,0,2,0,Human Factor
1950-01-01 00:00:00,John Fairfax %26 Sons,Takeoff (climb),Operational,Australia,Oceania,2,2,2,0,0,2,0,Human Factor
1950-01-03 00:00:00,United Air Services - Tanzania,Landing (descent or approach),Commercial,Tanzania,Africa,2,2,2,0,0,2,0,Unknown
1950-01-05 00:00:00,United States Air Force - USAF,Flight,Operational,United States of America,North America,11,11,2,0,0,2,9,Technical Failure
1950-03-01 00:00:00,SAM Colombia - Sociedad Aeronáutica de Medellín,Landing (descent or approach),Specialised Services,Colombia,South America,4,2,1,2,1,2,2,Weather
1950-03-23 00:00:00,United States Air Force - USAF,Takeoff (climb),Military / Government,United States of America,North America,5,5,2,0,0,2,3,Weather
1950-03-26 00:00:00,Royal Air Force - RAF,Parking,Military / Government,Singapore,Asia,11,9,1,2,1,2,9,Terrorism
1950-04-15 00:00:00,LANSA Colombia - Limitada Nacional de Servicio Aéreo,Flight,Operational,Colombia,South America,2,2,2,0,0,2,0,Human Factor
1950-04-26 00:00:00,United States Air Force - USAF,Flight,Operational,United States of America,North America,2,2,2,0,0,2,0,Technical Failure
1950-05-09 00:00:00,Royal Air Force - RAF,Flight,Military / Government,Greece,Europe,2,2,2,0,0,2,0,Human Factor
1950-05-27 00:00:00,Private American,Flight,Military / Government,United States of America,North America,2,2,2,0,0,2,0,Human Factor
1950-06-03 00:00:00,Turkish Air Force - Türk Hava Kuvvetleri,Flight,Operational,Turkey,Asia,2,2,2,0,0,2,0,Unknown
1950-06-14 00:00:00,Royal Air Force - RAF,Landing (descent or approach),Operational,United Kingdom,Europe,3,3,2,0,0,2,1,Human Factor
1950-06-16 00:00:00,Private Indian,Landing (descent or approach),Business,India,Asia,5,1,1,4,1,2,3,Unknown
1950-06-26 00:00:00,Polyarnaya Aviatsiya,Landing (descent or approach),Specialised Services,Russia,Asia,6,5,2,1,0,2,4,Human Factor
1950-06-28 00:00:00,United States Air Force - USAF,Flight,Military / Government,World,World,3,3,2,0,0,2,1,Technical Failure
1950-06-28 00:00:00,United States Air Force - USAF,Landing (descent or approach),Military / Government,Japan,Asia,2,2,2,0,0,2,0,Unknown
1950-06-29 00:00:00,United States Air Force - USAF,Flight,Military / Government,South Korea,Asia,2,2,2,0,0,2,0,Human Factor
1950-06-30 00:00:00,SNCASE - Société Nationale de Constructions Aéronautiques du Sud-Est,Takeoff (climb),Specialised Services,France,Europe,11,4,0,7,2,2,9,Technical Failure
1950-07-03 00:00:00,Brazilian Air Force - Força Aérea Brasileira,,Military / Government,Brazil,South America,11,11,2,0,0,2,9,Unknown
1950-07-06 00:00:00,Royal Air Force - RAF,Landing (descent or approach),Operational,Germany,Europe,2,2,2,0,0,2,0,Human Factor
1950-08-18 00:00:00,Newfoundland Airways,Takeoff (climb),Commercial,Canada,North America,2,1,1,1,1,2,0,Human Factor
1950-08-23 00:00:00,United States Air Force - USAF,Flight,Operational,United States of America,North America,2,2,2,0,0,2,0,Human Factor
1950-08-24 00:00:00,Royal Air Force - RAF,Flight,Military / Government,United Kingdom,Europe,2,1,1,1,1,2,0,Human Factor
1950-09-18 00:00:00,Royal Air Force - RAF,Flight,Operational,United Kingdom,Europe,2,2,2,0,0,2,0,Unknown
1950-09-21 00:00:00,United States Air Force - USAF,Flight,Operational,United States of America,North America,2,2,2,0,0,2,0,Unknown
1950-10-12 00:00:00,John Fairfax %26 Sons,Flight,Operational,Australia,Oceania,2,2,2,0,0,2,0,Human Factor
1950-10-13 00:00:00,Turkish Air Force - Türk Hava Kuvvetleri,Flight,Military / Government,Turkey,Asia,2,2,2,0,0,2,0,Unknown
1950-10-23 00:00:00,Directorate of Geodesy and Cartography,Takeoff (climb),Specialised Services,Russia,Asia,5,5,2,0,0,2,3,Technical Failure
1950-11-09 00:00:00,Aeroflot - Russian International Airlines,Landing (descent or approach),Commercial,Russia,Asia,12,4,0,8,2,2,10,Human Factor
1950-11-17 00:00:00,Garuda Indonesian Airways,Landing (descent or approach),Commercial,Indonesia,Asia,23,3,2,20,0,2,21,Unknown
1950-11-22 00:00:00,United States Air Force - USAF,Flight,Operational,United States of America,North America,16,16,2,0,0,2,14,Technical Failure
1950-11-25 00:00:00,Eagle Aviation - UK,Takeoff (climb),Operational,India,Asia,6,6,2,0,0,2,4,Unknown
1950-11-30 00:00:00,Turkish Air Force - Türk Hava Kuvvetleri,Takeoff (climb),Operational,Turkey,Asia,2,2,2,0,0,2,0,Unknown
1950-12-05 00:00:00,Turkish Air Force - Türk Hava Kuvvetleri,Flight,Operational,Turkey,Asia,2,2,2,0,0,2,0,Unknown
1950-12-06 00:00:00,United States Air Force - USAF,Flight,Military / Government,South Korea,Asia,3,3,2,0,0,2,1,Technical Failure
1950-12-06 00:00:00,United States Air Force - USAF,Flight,Operational,United States of America,North America,2,2,2,0,0,2,0,Unknown
1950-12-11 00:00:00,United States Air Force - USAF,Takeoff (climb),Operational,United States of America,North America,3,3,2,0,0,2,1,Unknown
1950-12-12 00:00:00,French Navy,Takeoff (climb),Operational,Algeria,Africa,2,2,2,0,0,2,0,Unknown
1950-12-22 00:00:00,Canadian Pacific Airlines - CP Air,Landing (descent or approach),Commercial,Canada,North America,18,3,2,15,0,2,16,Human Factor
1950-12-23 00:00:00,Ontario Central Airlines,Flight,Commercial,Canada,North America,2,1,1,1,1,2,0,Human Factor
1951-01-04 00:00:00,Spanish Air Force - Ejército del Aire,Takeoff (climb),Military / Government,Spain,Europe,2,2,2,0,0,2,0,Technical Failure
1951-01-08 00:00:00,United States Air Force - USAF,Landing (descent or approach),Military / Government,South Korea,Asia,3,3,2,0,0,2,1,Technical Failure
1951-01-09 00:00:00,United States Air Force - USAF,Flight,Military / Government,South Korea,Asia,3,3,2,0,0,2,1,Unknown
1951-01-14 00:00:00,United States Air Force - USAF,Flight,Military / Government,North Korea,Asia,3,3,2,0,0,2,1,Terrorism
1951-01-21 00:00:00,United States Navy - USN,Takeoff (climb),Operational,Japan,Asia,13,13,2,0,0,2,11,Technical Failure
1951-02-01 00:00:00,Soviet Air Force - Voyenno-vozdushnye sily CCCP,Takeoff (climb),Operational,Russia,Asia,7,7,2,0,0,2,5,Human Factor
1951-02-06 00:00:00,Yellowknife Airways,Takeoff (climb),Commercial,Canada,North America,2,1,1,1,1,2,0,Other
1951-02-14 00:00:00,LANSA Colombia - Limitada Nacional de Servicio Aéreo,Flight,Operational,Colombia,South America,2,2,2,0,0,2,0,Unknown
1951-03-07 00:00:00,Royal Air Force - RAF,Landing (descent or approach),Operational,United Kingdom,Europe,2,2,2,0,0,2,0,Human Factor
1951-03-23 00:00:00,United States Air Force - USAF,Flight,Military / Government,South Korea,Asia,8,8,2,0,0,2,6,Technical Failure
1951-03-27 00:00:00,Air Transport Charter,Takeoff (climb),Operational,United Kingdom,Europe,3,3,2,0,0,2,1,Weather
1951-03-28 00:00:00,Belgian Air Force - Force Aérienne Belge - Belgische Luchtmacht,Flight,Operational,Belgium,Europe,2,2,2,0,0,2,0,Unknown
1951-03-30 00:00:00,United States Air Force - USAF,Landing (descent or approach),Military / Government,Japan,Asia,2,2,2,0,0,2,0,Unknown
1951-05-09 00:00:00,United States Navy - USN,Takeoff (climb),Operational,United States of America,North America,7,2,2,5,0,2,5,Technical Failure
1951-05-11 00:00:00,United States Air Force - USAF,Flight,Military / Government,United States of America,North America,2,2,2,0,0,2,0,Unknown
1951-05-21 00:00:00,United States Air Force - USAF,Flight,Military / Government,North Korea,Asia,4,4,2,0,0,2,2,Terrorism
1951-05-29 00:00:00,Royal Air Force - RAF,Landing (descent or approach),Operational,United Kingdom,Europe,4,4,2,0,0,2,2,Human Factor
1951-05-29 00:00:00,Royal Air Force - RAF,Landing (descent or approach),Operational,United Kingdom,Europe,3,3,2,0,0,2,1,Human Factor
1951-06-02 00:00:00,Aero Geral,Flight,Operational,Brazil,South America,4,4,2,0,0,2,2,Unknown
1951-06-06 00:00:00,Linha Aérea Transcontinental Brasileira - LATB,Landing (descent or approach),Commercial,Brazil,South America,19,3,1,16,1,2,17,Human Factor
1951-06-11 00:00:00,Royal Air Force - RAF,Landing (descent or approach),Operational,United Kingdom,Europe,3,3,2,0,0,2,1,Human Factor
1951-06-13 00:00:00,SAM Colombia - Sociedad Aeronáutica de Medellín,Landing (descent or approach),Operational,Colombia,South America,2,2,2,0,0,2,0,Technical Failure
1951-07-10 00:00:00,Anglo-Iranian Oil Company,Takeoff (climb),Business,Iran,Asia,2,1,1,1,1,2,0,Human Factor
1951-08-08 00:00:00,Trans Australia Airlines - TAA,Takeoff (climb),Operational,Australia,Oceania,2,2,2,0,0,2,0,Weather
1951-08-12 00:00:00,Aeroflot - Russian International Airlines,Landing (descent or approach),Commercial,Russia,Asia,16,5,0,11,2,2,14,Human Factor
1951-08-30 00:00:00,United States Air Force - USAF,Takeoff (climb),Military / Government,South Korea,Asia,3,3,2,0,0,2,1,Technical Failure
1951-09-12 00:00:00,United States Air Force - USAF,Flight,Military / Government,North Korea,Asia,3,3,2,0,0,2,1,Unknown
1951-09-25 00:00:00,United States Air Force - USAF,Takeoff (climb),Military / Government,South Korea,Asia,4,4,2,0,0,2,2,Unknown
1951-10-06 00:00:00,Russian Ministry of Geology,Flight,Specialised Services,Russia,Asia,5,5,2,0,0,2,3,Human Factor
1951-10-24 00:00:00,United States Air Force - USAF,Flight,Military / Government,North Korea,Asia,11,11,2,0,0,2,9,Terrorism
1951-11-12 00:00:00,Spanish Air Force - Ejército del Aire,Takeoff (climb),Military / Government,Spain,Europe,4,4,2,0,0,2,2,Unknown
1951-11-16 00:00:00,Royal Air Force - RAF,Landing (descent or approach),Operational,United Kingdom,Europe,5,5,2,0,0,2,3,Human Factor
1951-11-26 00:00:00,Royal Air Force - RAF,Landing (descent or approach),Military / Government,United Kingdom,Europe,15,4,0,11,2,2,13,Human Factor
1951-12-01 00:00:00,Royal Air Force - RAF,Landing (descent or approach),Operational,United Kingdom,Europe,5,5,2,0,0,2,3,Human Factor
1951-12-06 00:00:00,Aerotaxi Servicios Aéreos,Landing (descent or approach),Operational,Colombia,South America,2,1,1,1,1,2,0,Technical Failure
1951-12-26 00:00:00,United States Navy - USN,Flight,Military / Government,World,World,7,7,2,0,0,2,5,Technical Failure
1952-01-12 00:00:00,General Airways,Flight,Operational,United States of America,North America,2,2,2,0,0,2,0,Human Factor
1952-01-13 00:00:00,United States Air Force - USAF,Flight,Military / Government,North Korea,Asia,4,4,2,0,0,2,2,Unknown
1952-01-13 00:00:00,Overland Air Services,Landing (descent or approach),Operational,Australia,Oceania,3,2,2,1,0,2,1,Technical Failure
1952-01-17 00:00:00,Italian Air Force - Aeronautica Militare Italiana,Flight,Military / Government,Italy,Europe,2,2,2,0,0,2,0,Human Factor
1952-01-23 00:00:00,Royal Air Force - RAF,Flight,Operational,World,World,7,6,1,1,1,2,5,Technical Failure
1952-02-04 00:00:00,Turkish Air Force - Türk Hava Kuvvetleri,Landing (descent or approach),Operational,Turkey,Asia,2,2,2,0,0,2,0,Unknown
1952-02-28 00:00:00,United States Air Force - USAF,Flight,Military / Government,North Korea,Asia,2,2,2,0,0,2,0,Unknown
1952-02-29 00:00:00,De Havilland Aircraft of Canada,Landing (descent or approach),Operational,Canada,North America,2,2,2,0,0,2,0,Weather
1952-04-03 00:00:00,United States Air Force - USAF,Flight,Operational,United States of America,North America,12,12,2,0,0,2,10,Unknown
1952-04-05 00:00:00,US Airlines,Landing (descent or approach),Operational,United States of America,North America,2,2,2,0,0,2,0,Technical Failure
1952-04-19 00:00:00,United States Air Force - USAF,Takeoff (climb),Military / Government,South Korea,Asia,4,4,2,0,0,2,2,Technical Failure
1952-07-04 00:00:00,United States Air Force - USAF,Flight,Military / Government,North Korea,Asia,13,13,2,0,0,2,11,Terrorism
1952-07-16 00:00:00,Royal Air Force - RAF,Landing (descent or approach),Operational,United Kingdom,Europe,5,2,2,3,0,2,3,Human Factor
1952-07-18 00:00:00,Hunting Aerosurveys,Flight,Specialised Services,Luxembourg,Europe,2,1,1,1,1,2,0,Human Factor
1952-07-21 00:00:00,Royal Canadian Air Force - RCAF,Landing (descent or approach),Military / Government,Canada,North America,2,2,2,0,0,2,0,Unknown
1952-07-21 00:00:00,Royal Air Force - RAF,Landing (descent or approach),Operational,United Kingdom,Europe,2,2,2,0,0,2,0,Human Factor
1952-07-25 00:00:00,United States Air Force - USAF,Flight,Military / Government,North Korea,Asia,4,4,2,0,0,2,2,Unknown
1952-07-31 00:00:00,United States Navy - USN,Flight,Military / Government,South Korea,Asia,11,11,2,0,0,2,9,Terrorism
1952-08-05 00:00:00,United States Air Force - USAF,Flight,Specialised Services,United States of America,North America,8,8,2,0,0,2,6,Technical Failure
1952-08-07 00:00:00,United States Air Force - USAF,Takeoff (climb),Military / Government,Germany,Europe,4,4,2,0,0,2,2,Technical Failure
1952-08-18 00:00:00,Royal Canadian Air Force - RCAF,Flight,Operational,Canada,North America,3,3,2,0,0,2,1,Unknown
1952-08-19 00:00:00,Royal Air Force - RAF,Flight,Operational,United Kingdom,Europe,2,2,2,0,0,2,0,Unknown
1952-08-29 00:00:00,Phoenix Airlines,Landing (descent or approach),Operational,Sudan,Africa,4,4,2,0,0,2,2,Human Factor
1952-09-25 00:00:00,Pakistan Air Force - Pakistan Fiza'ya,Takeoff (climb),Military / Government,Pakistan,Asia,2,2,2,0,0,2,0,Unknown
1952-11-10 00:00:00,Mark Hurd Mapping Company,Flight,Military / Government,United States of America,North America,3,3,2,0,0,2,1,Unknown
1952-11-26 00:00:00,Aero-Nord Sweden,Landing (descent or approach),Operational,Sweden,Europe,2,2,2,0,0,2,0,Human Factor
1952-11-29 00:00:00,Civil Air Transport,Flight,Military / Government,China,Asia,4,4,2,0,0,2,2,Terrorism
1952-12-02 00:00:00,Royal Air Force - RAF,Flight,Operational,United Kingdom,Europe,2,2,2,0,0,2,0,Human Factor
1952-12-09 00:00:00,Pacific Airmotive Corporation,Landing (descent or approach),Operational,United States of America,North America,4,2,2,2,0,2,2,Human Factor
1953-01-11 00:00:00,Aktiebolaget Aerotransport Express - AB Express,Landing (descent or approach),Operational,Sweden,Europe,2,2,2,0,0,2,0,Unknown
1953-02-13 00:00:00,United States Air Force - USAF,Landing (descent or approach),Military / Government,Canada,North America,17,17,2,0,0,2,15,Human Factor
1953-02-13 00:00:00,Royal Air Force - RAF,Landing (descent or approach),Operational,United Kingdom,Europe,2,2,2,0,0,2,0,Human Factor
1953-02-27 00:00:00,United States Air Force - USAF,Takeoff (climb),Military / Government,North Korea,Asia,3,3,2,0,0,2,1,Unknown
1953-03-04 00:00:00,Slick Airways,Landing (descent or approach),Operational,United States of America,North America,2,2,2,0,0,2,0,Human Factor
1953-03-19 00:00:00,Royal Danish Air Force - Flyvevåbnet,Landing (descent or approach),Operational,Denmark,Europe,2,2,2,0,0,2,0,Human Factor
1953-04-06 00:00:00,Ecuadorian Air Force - Fuerza Aérea Ecuatoriana,Landing (descent or approach),Military / Government,Ecuador,South America,2,2,2,0,0,2,0,Unknown
1953-04-09 00:00:00,Avianca,Flight,Operational,Colombia,South America,2,2,2,0,0,2,0,Human Factor
1953-04-10 00:00:00,Nanyang Airways,Landing (descent or approach),Operational,Malaysia,Asia,2,2,2,0,0,2,0,Human Factor
1953-04-23 00:00:00,American Air Transport,Flight,Operational,United States of America,North America,4,2,2,2,0,2,2,Human Factor
1953-05-11 00:00:00,Canadian Pacific Airlines - CP Air,Landing (descent or approach),Commercial,Canada,North America,19,3,1,16,1,2,17,Human Factor
1953-05-15 00:00:00,United States Air Force - USAF,Flight,Operational,Germany,Europe,6,6,2,0,0,2,4,Human Factor
1953-05-17 00:00:00,United States Air Force - USAF,Flight,Military / Government,North Korea,Asia,4,4,2,0,0,2,2,Terrorism
1953-05-17 00:00:00,Royal Air Force - RAF,Takeoff (climb),Military / Government,Malta,Europe,22,4,0,18,2,2,20,Technical Failure
1953-05-21 00:00:00,United States Air Force - USAF,Flight,Military / Government,South Korea,Asia,4,4,2,0,0,2,2,Weather
1953-05-22 00:00:00,Resort Airlines,Flight,Operational,United States of America,North America,2,2,2,0,0,2,0,Weather
1953-06-19 00:00:00,Czech Air Force - Ceské Vojenské Letectvo,Landing (descent or approach),Operational,Czech Republic,Europe,3,3,2,0,0,2,1,Unknown
1953-07-14 00:00:00,Johnson Flying Service,Flight,Military / Government,United States of America,North America,2,2,2,0,0,2,0,Human Factor
1953-08-18 00:00:00,Aerovias Contreras Ensenada,Flight,Operational,United States of America,North America,2,2,2,0,0,2,0,Unknown
1953-08-20 00:00:00,United States Air Force - USAF,Flight,Operational,United States of America,North America,12,12,2,0,0,2,10,Unknown
1953-08-30 00:00:00,CB Montgomery Construction Company,Landing (descent or approach),Business,United States of America,North America,2,1,1,1,1,2,0,Unknown
1953-09-27 00:00:00,Hawera Aero Club,Landing (descent or approach),Business,New Zealand,Oceania,3,1,0,2,2,2,1,Unknown
1953-10-19 00:00:00,Eastern Airlines,Takeoff (climb),Commercial,United States of America,North America,27,5,0,22,2,2,25,Human Factor
1953-10-20 00:00:00,Trans Australia Airlines - TAA,Takeoff (climb),Humanitarian,Australia,Oceania,5,1,1,4,1,2,3,Technical Failure
1953-10-26 00:00:00,Queensland Ambulance Transport Brigade,Flight,Humanitarian,Australia,Oceania,3,1,1,2,1,2,1,Technical Failure
1953-12-09 00:00:00,United States Air Force - USAF,Flight,Operational,United States of America,North America,3,3,2,0,0,2,1,Unknown
1953-12-12 00:00:00,Aeronorte,Flight,Operational,Brazil,South America,2,2,2,0,0,2,0,Unknown
1953-12-15 00:00:00,Aviateca,Flight,Operational,Guatemala,Central America,2,2,2,0,0,2,0,Human Factor
1954-01-14 00:00:00,United States Air Force - USAF,Flight,Operational,Morocco,Africa,4,4,2,0,0,2,2,Technical Failure
1954-02-09 00:00:00,Avianca,Takeoff (climb),Operational,Colombia,South America,2,2,2,0,0,2,0,Unknown
1954-03-05 00:00:00,United States Navy - USN,Flight,Operational,United States of America,North America,2,2,2,0,0,2,0,Human Factor
1954-03-14 00:00:00,Queensland Airlines,Takeoff (climb),Operational,Australia,Oceania,2,2,2,0,0,2,0,Other
1954-03-30 00:00:00,United States Air Force - USAF,Takeoff (climb),Military / Government,United States of America,North America,6,6,2,0,0,2,4,Technical Failure
1954-04-22 00:00:00,United States Air Force - USAF,Flight,Operational,United States of America,North America,4,4,2,0,0,2,2,Unknown
1954-05-06 00:00:00,Civil Air Transport,Flight,Military / Government,Laos,Asia,2,2,2,0,0,2,0,Terrorism
1954-05-22 00:00:00,United States Navy - USN,Flight,Military / Government,Cuba,Central America,2,2,2,0,0,2,0,Unknown
1954-06-15 00:00:00,Aeroservices,Flight,Operational,India,Asia,2,2,2,0,0,2,0,Unknown
1954-08-08 00:00:00,Alaska Airlines,Flight,Operational,United States of America,North America,2,2,2,0,0,2,0,Unknown
1954-08-16 00:00:00,United States Air Force - USAF,Flight,Military / Government,United States of America,North America,2,1,1,1,1,2,0,Unknown
1954-08-28 00:00:00,DTA Angola Airlines - Direcção dos Transportes Aéreos,Landing (descent or approach),Commercial,Angola,Africa,4,2,2,2,0,2,2,Technical Failure
1954-09-18 00:00:00,Argentinian Air Force - Fuerza Aérea Argentina,Landing (descent or approach),Military / Government,Argentina,South America,7,2,1,5,1,2,5,Unknown
1954-09-29 00:00:00,Brazilian Air Force - Força Aérea Brasileira,Takeoff (climb),Military / Government,Brazil,South America,13,8,2,5,0,2,11,Technical Failure
1954-10-06 00:00:00,United States Air Force - USAF,Takeoff (climb),Operational,United States of America,North America,12,5,2,7,0,2,10,Technical Failure
1954-11-25 00:00:00,French Air Force - Armée de l'Air,Flight,Military / Government,France,Europe,2,2,2,0,0,2,0,Weather
1954-11-30 00:00:00,Northeast Airlines - USA,Landing (descent or approach),Commercial,United States of America,North America,7,4,2,3,0,2,5,Human Factor
1954-12-18 00:00:00,Sangamo Electric Company,Landing (descent or approach),Business,United States of America,North America,3,2,2,1,0,2,1,Human Factor
1954-12-18 00:00:00,Linea Aeropostal Venezolana - LAV,Flight,Operational,Venezuela,South America,2,2,2,0,0,2,0,Unknown
1955-01-11 00:00:00,United States Air Force - USAF,Takeoff (climb),Military / Government,United States of America,North America,42,5,2,37,0,2,40,Technical Failure
1955-01-12 00:00:00,Castelton,Flight,Business,United States of America,North America,2,2,2,0,0,2,0,Human Factor
1955-01-24 00:00:00,Brazilian Air Force - Força Aérea Brasileira,Landing (descent or approach),Operational,Brazil,South America,2,2,2,0,0,2,0,Unknown
1955-02-17 00:00:00,Royal New Zealand Air Force - RNZAF,Flight,Operational,New Zealand,Oceania,2,2,2,0,0,2,0,Human Factor
1955-03-02 00:00:00,Royal Air Force - RAF,Takeoff (climb),Operational,United Kingdom,Europe,4,4,2,0,0,2,2,Human Factor
1955-03-16 00:00:00,Chilean Navy,Flight,Military / Government,Chile,South America,2,2,2,0,0,2,0,Unknown
1955-04-02 00:00:00,Aaxico Airlines - American Air Export %26 Import Company,Flight,Operational,United States of America,North America,2,2,2,0,0,2,0,Weather
1955-04-02 00:00:00,French Air Force - Armée de l'Air,Flight,Operational,France,Europe,2,2,2,0,0,2,0,Unknown
1955-04-05 00:00:00,Royal Air Force - RAF,Landing (descent or approach),Operational,Germany,Europe,2,2,2,0,0,2,0,Human Factor
1955-05-26 00:00:00,Associated Airways,Takeoff (climb),Operational,Canada,North America,2,2,2,0,0,2,0,Human Factor
1955-06-18 00:00:00,World-Wide Airways,Takeoff (climb),Operational,Canada,North America,2,2,2,0,0,2,0,Unknown
1955-06-27 00:00:00,Spanish Air Force - Ejército del Aire,Flight,Military / Government,Morocco,Africa,4,4,2,0,0,2,2,Unknown
1955-08-30 00:00:00,Kalinga Airlines,Takeoff (climb),Operational,Nepal,Asia,3,3,2,0,0,2,1,Human Factor
1955-09-05 00:00:00,Brazilian Air Force - Força Aérea Brasileira,Takeoff (climb),Operational,Brazil,South America,2,2,2,0,0,2,0,Technical Failure
1955-09-17 00:00:00,Pacific Western Airlines - PWA,Flight,Commercial,Canada,North America,6,2,1,4,1,2,4,Technical Failure
1955-12-17 00:00:00,Riddle Airlines,Flight,Operational,United States of America,North America,2,2,2,0,0,2,0,Human Factor
1955-12-29 00:00:00,Gulf Oil Corporation,Flight,Business,United States of America,North America,2,2,2,0,0,2,0,Weather
1956-02-04 00:00:00,United States Navy - USN,Takeoff (climb),Operational,United States of America,North America,4,4,2,0,0,2,2,Technical Failure
1956-02-14 00:00:00,Maritime Central Airways,Flight,Operational,Canada,North America,3,3,2,0,0,2,1,Human Factor
1956-03-04 00:00:00,Royal Air Force - RAF,Flight,Humanitarian,Germany,Europe,4,2,0,2,2,2,2,Technical Failure
1956-03-11 00:00:00,Cuban Air Force - Fuerza Aérea del Ejército de Cuba,Takeoff (climb),Military / Government,Cuba,Central America,2,2,2,0,0,2,0,Technical Failure
1956-03-20 00:00:00,United States Air Force - USAF,Landing (descent or approach),Military / Government,United States of America,North America,2,2,2,0,0,2,0,Unknown
1956-03-21 00:00:00,Indian Airlines,Landing (descent or approach),Commercial,India,Asia,21,3,2,18,0,2,19,Human Factor
1956-04-30 00:00:00,Scottish Airlines,Takeoff (climb),Commercial,United Kingdom,Europe,54,5,0,49,2,2,52,Human Factor
1956-05-08 00:00:00,Swedish Air Force - Flygvapnet,Takeoff (climb),Specialised Services,Sweden,Europe,4,4,2,0,0,2,2,Technical Failure
1956-06-05 00:00:00,Arctic Wings,Flight,Commercial,Canada,North America,4,1,1,3,1,2,2,Unknown
1956-06-13 00:00:00,Italian Air Force - Aeronautica Militare Italiana,Flight,Military / Government,Italy,Europe,6,2,2,4,0,2,4,Unknown
1956-08-13 00:00:00,French Air Force - Armée de l'Air,Landing (descent or approach),Operational,United Kingdom,Europe,2,2,2,0,0,2,0,Unknown
1956-08-25 00:00:00,Lloyd Aéreo Boliviano - LAB Airlines,Landing (descent or approach),Operational,Bolivia,South America,2,2,2,0,0,2,0,Unknown
1956-09-26 00:00:00,Maritime Central Airways,Flight,Operational,Canada,North America,3,3,2,0,0,2,1,Technical Failure
1956-10-05 00:00:00,Zonen Aviation - Zone-Redningskorpset Flyve-Tjenesten,Flight,Humanitarian,Switzerland,Europe,2,2,2,0,0,2,0,Human Factor
1956-10-05 00:00:00,Central African Airways - CAA,Takeoff (climb),Operational,Zimbabwe,Africa,2,2,2,0,0,2,0,Human Factor
1956-10-30 00:00:00,Spanish Air Force - Ejército del Aire,Flight,Operational,Spain,Europe,5,5,2,0,0,2,3,Unknown
1956-11-01 00:00:00,South African Air Force,Landing (descent or approach),Operational,South Africa,Africa,10,10,2,0,0,2,8,Human Factor
1956-11-02 00:00:00,Aeroflot - Russian International Airlines,Landing (descent or approach),Commercial,Russia,Asia,5,3,2,2,0,2,3,Technical Failure
1956-11-07 00:00:00,Braathens SAFE - South America %26 Far East,Flight,Commercial,Norway,Europe,12,2,1,10,1,2,10,Weather
1956-11-18 00:00:00,United States Air Force - USAF,Flight,Military / Government,United States of America,North America,3,3,2,0,0,2,1,Unknown
1956-12-05 00:00:00,United States Air Force - USAF,Flight,Military / Government,United Kingdom,Europe,2,1,1,1,1,2,0,Human Factor
1957-01-29 00:00:00,Société Auxiliaire de Gérance et d’Exploitation de Transports Aériens - SAGETA,Landing (descent or approach),Commercial,France,Europe,70,10,1,60,1,2,68,Human Factor
1957-03-13 00:00:00,Indian Airlines,Landing (descent or approach),Operational,India,Asia,2,2,2,0,0,2,0,Human Factor
1957-04-11 00:00:00,Northern Wings,Flight,Operational,Canada,North America,3,3,2,0,0,2,1,Human Factor
1957-05-05 00:00:00,Honduran Air Force - Fuerza Aérea Hondureña,Flight,Military / Government,Salvador,Central America,2,2,2,0,0,2,0,Unknown
1957-05-13 00:00:00,United States Overseas Airlines - USOA,Flight,Operational,Greenland,Europe,3,3,2,0,0,2,1,Human Factor
1957-05-18 00:00:00,United States Coast Guard - USCG,Flight,Operational,United States of America,North America,6,6,2,0,0,2,4,Unknown
1957-06-03 00:00:00,United States Air Force - USAF,Landing (descent or approach),Military / Government,United States of America,North America,9,2,0,7,2,2,7,Technical Failure
1957-06-04 00:00:00,Aerotaxi Servicios Aéreos,Flight,Commercial,Colombia,South America,9,1,0,8,2,2,7,Human Factor
1957-06-25 00:00:00,SAM Colombia - Sociedad Aeronáutica de Medellín,Landing (descent or approach),Operational,Colombia,South America,2,2,2,0,0,2,0,Unknown
1957-06-26 00:00:00,Argentinian Air Force - Fuerza Aérea Argentina,Takeoff (climb),Operational,Argentina,South America,2,2,2,0,0,2,0,Unknown
1957-08-14 00:00:00,Royal Air Force - RAF,Takeoff (climb),Operational,United Kingdom,Europe,4,4,2,0,0,2,2,Human Factor
1957-08-21 00:00:00,TAM Paraguay - Transporte Aéreo Militar,Flight,Operational,Paraguay,South America,5,5,2,0,0,2,3,Unknown
1957-08-30 00:00:00,NNGLM - Nederlands Nieuw Guinea Luchtvaart Maatschappij de Kroonduif,Flight,Operational,Indonesia,Asia,2,2,2,0,0,2,0,Technical Failure
1957-09-24 00:00:00,United States Air Force - USAF,Landing (descent or approach),Operational,United States of America,North America,2,2,2,0,0,2,0,Unknown
1957-10-20 00:00:00,Fieldair,Takeoff (climb),Military / Government,New Zealand,Oceania,2,2,2,0,0,2,0,Human Factor
1957-12-11 00:00:00,Philippine Airlines - PAL,Takeoff (climb),Commercial,Philippines,Asia,12,1,1,11,1,2,10,Human Factor
1957-12-24 00:00:00,Ángel Lascurain y Osio,Landing (descent or approach),Specialised Services,Mexico,Central America,2,2,2,0,0,2,0,Technical Failure
1958-01-10 00:00:00,Royal Air Force - RAF,Landing (descent or approach),Operational,United Kingdom,Europe,9,9,2,0,0,2,7,Human Factor
1958-01-31 00:00:00,United States Air Force - USAF,Flight,Operational,United States of America,North America,2,2,2,0,0,2,0,Human Factor
1958-02-11 00:00:00,United States Air Force - USAF,Landing (descent or approach),Operational,United States of America,North America,8,8,2,0,0,2,6,Technical Failure
1958-05-31 00:00:00,Reeve Aleutian Airways - RAA,Takeoff (climb),Operational,United States of America,North America,2,2,2,0,0,2,0,Unknown
1958-06-27 00:00:00,Aeroflot - Russian International Airlines,Flight,Specialised Services,Russia,Asia,6,4,2,2,0,2,4,Human Factor
1958-07-17 00:00:00,Dominicana de Aviación,Takeoff (climb),Operational,Dominican Republic,Central America,2,2,2,0,0,2,0,Technical Failure
1958-09-08 00:00:00,United States Forest Service - USFS,Flight,Humanitarian,United States of America,North America,2,2,2,0,0,2,0,Unknown
1958-10-18 00:00:00,Royal Canadian Air Force - RCAF,Flight,Military / Government,Canada,North America,2,2,2,0,0,2,0,Unknown
1958-11-05 00:00:00,Colombian Air Force - Fuerza Aérea Colombiana,Landing (descent or approach),Military / Government,Colombia,South America,2,2,2,0,0,2,0,Unknown
1958-11-16 00:00:00,Capitol Airways,Flight,Operational,United States of America,North America,2,2,2,0,0,2,0,Technical Failure
1958-12-05 00:00:00,Royal Norwegian Air Force - Kongelige Norske Luftforsvaret,Flight,Humanitarian,Norway,Europe,2,2,2,0,0,2,0,Unknown
1959-01-04 00:00:00,United States Navy - USN,Takeoff (climb),Military / Government,Antarctica,Antarctica,2,2,2,0,0,2,0,Human Factor
1959-01-12 00:00:00,United States Army,Flight,Military / Government,United States of America,North America,2,1,1,1,1,2,0,Unknown
1959-01-14 00:00:00,California Air Freight,Flight,Operational,United States of America,North America,2,2,2,0,0,2,0,Human Factor
1959-01-27 00:00:00,Air Charter Ltd London,Takeoff (climb),Operational,Italy,Europe,6,6,2,0,0,2,4,Weather
1959-02-09 00:00:00,Jokai Assam Tea Company,Landing (descent or approach),Business,India,Asia,2,1,1,1,1,2,0,Unknown
1959-03-30 00:00:00,Riddle Airlines,Flight,Operational,United States of America,North America,2,2,2,0,0,2,0,Technical Failure
1959-04-21 00:00:00,Brazilian Air Force - Força Aérea Brasileira,Landing (descent or approach),Military / Government,Brazil,South America,6,6,2,0,0,2,4,Unknown
1959-05-12 00:00:00,Capital Airlines,Landing (descent or approach),Commercial,United States of America,North America,44,6,1,38,1,2,42,Human Factor
1959-05-29 00:00:00,Brazilian Air Force - Força Aérea Brasileira,Flight,Operational,Brazil,South America,4,4,2,0,0,2,2,Unknown
1959-06-19 00:00:00,Hessenatie-Sotramat Aviation,Flight,Operational,France,Europe,2,2,2,0,0,2,0,Human Factor
1959-07-07 00:00:00,Don Everall Aviation,Flight,Commercial,United Kingdom,Europe,6,1,1,5,1,2,4,Unknown
1959-07-15 00:00:00,Paraense Transportes Aéreos,Flight,Operational,Brazil,South America,3,3,2,0,0,2,1,Technical Failure
1959-08-14 00:00:00,Pakistan International Airlines - PIA,Landing (descent or approach),Operational,Pakistan,Asia,3,3,2,0,0,2,1,Human Factor
1959-08-27 00:00:00,Aerolineas Argentinas,Landing (descent or approach),Commercial,Paraguay,South America,50,6,1,44,1,2,48,Human Factor
1959-09-02 00:00:00,Aaxico Airlines - American Air Export %26 Import Company,Landing (descent or approach),Operational,United States of America,North America,2,2,2,0,0,2,0,Technical Failure
1959-10-06 00:00:00,SLM Surinam Airways - Surinaamse Luchtvaart Maatschappij,Landing (descent or approach),Operational,Suriname,South America,2,2,2,0,0,2,0,Technical Failure
1959-10-16 00:00:00,Superior Airways,Landing (descent or approach),Commercial,Canada,North America,4,1,0,3,2,2,2,Weather
1959-10-19 00:00:00,Royal Air Force - RAF,Flight,Specialised Services,United Kingdom,Europe,2,2,2,0,0,2,0,Human Factor
1959-10-23 00:00:00,Royal Air Force - RAF,Takeoff (climb),Operational,Malaysia,Asia,2,2,2,0,0,2,0,Human Factor
1959-11-22 00:00:00,Navegação Aérea Brasileira - NAB,Takeoff (climb),Operational,Brazil,South America,2,2,2,0,0,2,0,Unknown
1959-11-24 00:00:00,Royal Air Force - RAF,Takeoff (climb),Operational,United Kingdom,Europe,2,2,2,0,0,2,0,Technical Failure
1959-11-28 00:00:00,Sargo Servicios Aéreos,Flight,Operational,Argentina,South America,2,2,2,0,0,2,0,Human Factor
1959-12-21 00:00:00,Alitalia - Linee Aeree Italiane,Landing (descent or approach),Operational,Italy,Europe,2,2,2,0,0,2,0,Human Factor
1960-02-07 00:00:00,Cuban Air Force - Fuerza Aérea del Ejército de Cuba,Flight,Operational,United States of America,North America,2,2,2,0,0,2,0,Unknown
1960-02-10 00:00:00,Flinders Island Airways,Flight,Operational,Australia,Oceania,2,2,2,0,0,2,0,Technical Failure
1960-02-19 00:00:00,Hunting Aerosurveys,Landing (descent or approach),Operational,Pakistan,Asia,3,3,2,0,0,2,1,Unknown
1960-02-25 00:00:00,Portuguese Air Force - Força Aerea Portuguesa,Landing (descent or approach),Military / Government,Portugal,Europe,6,6,2,0,0,2,4,Unknown
1960-03-10 00:00:00,Scottish Aviation,Takeoff (climb),Operational,India,Asia,3,3,2,0,0,2,1,Human Factor
1960-03-30 00:00:00,United States Air Force - USAF,Flight,Military / Government,World,World,14,14,2,0,0,2,12,Unknown
1960-04-05 00:00:00,Lineas Aéreas de Nicaragua - LANICA,Takeoff (climb),Commercial,Nicaragua,Central America,18,4,1,14,1,2,16,Technical Failure
1960-09-11 00:00:00,Italian Air Force - Aeronautica Militare Italiana,Landing (descent or approach),Humanitarian,Italy,Europe,2,2,2,0,0,2,0,Unknown
1960-10-15 00:00:00,Capitol Airways,Landing (descent or approach),Operational,United States of America,North America,2,2,2,0,0,2,0,Technical Failure
1960-11-26 00:00:00,Air America,Flight,Military / Government,Laos,Asia,3,3,2,0,0,2,1,Technical Failure
1960-12-15 00:00:00,Mandated Airlines,Flight,Operational,Papua New Guinea,Oceania,2,1,1,1,1,2,0,Unknown
1961-01-22 00:00:00,Capitol Airways,Flight,Operational,United States of America,North America,2,2,2,0,0,2,0,Technical Failure
1961-01-27 00:00:00,Argentinian Air Force - Fuerza Aérea Argentina,Flight,Military / Government,Argentina,South America,2,2,2,0,0,2,0,Unknown
1961-02-19 00:00:00,Lindon B. Johnson - LBJ,Landing (descent or approach),Operational,United States of America,North America,2,2,2,0,0,2,0,Human Factor
1961-03-04 00:00:00,Private Brazilian,Flight,Business,Brazil,South America,2,2,2,0,0,2,0,Unknown
1961-03-17 00:00:00,Aeroflot - Russian International Airlines,Takeoff (climb),Operational,Russia,Asia,4,4,2,0,0,2,2,Human Factor
1961-04-04 00:00:00,Aeroflot - Russian International Airlines,Flight,Operational,Russia,Asia,2,2,2,0,0,2,0,Technical Failure
1961-04-15 00:00:00,Cuban Air Force - Fuerza Aérea del Ejército de Cuba,Flight,Military / Government,United States of America,North America,2,2,2,0,0,2,0,Terrorism
1961-05-12 00:00:00,Lineas Aéreas Costarricenses - LACSA,Flight,Operational,Costa Rica,Central America,2,2,2,0,0,2,0,Human Factor
1961-05-24 00:00:00,Trans Australia Airlines - TAA,Landing (descent or approach),Operational,Australia,Oceania,2,2,2,0,0,2,0,Human Factor
1961-07-10 00:00:00,Metropolitan Air Movements,Takeoff (climb),Operational,United Kingdom,Europe,2,2,2,0,0,2,0,Human Factor
1961-08-08 00:00:00,Finnish Air Force - Suomen Ilmavoimat,Takeoff (climb),Military / Government,Finland,Europe,2,1,1,1,1,2,0,Technical Failure
1961-09-15 00:00:00,United Nations Organization,Flight,Humanitarian,Democratic Republic of Congo,Africa,2,2,2,0,0,2,0,Terrorism
1961-09-19 00:00:00,United States Air Force - USAF,Takeoff (climb),Military / Government,United States of America,North America,2,2,2,0,0,2,0,Unknown
1961-10-22 00:00:00,Transavia Italia,Flight,Operational,Italy,Europe,2,2,2,0,0,2,0,Weather
1961-11-01 00:00:00,Silver City Airways,Landing (descent or approach),Commercial,United Kingdom,Europe,10,3,2,7,0,2,8,Technical Failure
1961-11-22 00:00:00,Rhodesian Air Services,Takeoff (climb),Operational,Zimbabwe,Africa,3,3,2,0,0,2,1,Human Factor
1961-11-28 00:00:00,Chilean Air Force - Fuerza Aérea de Chile,Flight,Military / Government,Chile,South America,2,2,2,0,0,2,0,Unknown
1961-12-02 00:00:00,Trans Australia Airlines - TAA,Flight,Operational,Papua New Guinea,Oceania,2,2,2,0,0,2,0,Unknown
1961-12-15 00:00:00,Lineas Aéreas de Nicaragua - LANICA,Takeoff (climb),Operational,Nicaragua,Central America,2,2,2,0,0,2,0,Other
1961-12-16 00:00:00,Private American,Flight,Business,United States of America,North America,2,1,1,1,1,2,0,Unknown
1961-12-26 00:00:00,Indian Air Force - Bharatiya Vayu Sena,Flight,Military / Government,India,Asia,2,2,2,0,0,2,0,Unknown
1962-01-10 00:00:00,Italian Air Force - Aeronautica Militare Italiana,Flight,Military / Government,Italy,Europe,2,2,2,0,0,2,0,Weather
1962-02-25 00:00:00,Avianca,Flight,Operational,Colombia,South America,2,2,2,0,0,2,0,Human Factor
1962-03-06 00:00:00,South African Airways -SAA - Suid Afrikaanse Lugdiens - SAL,Flight,Commercial,South Africa,Africa,7,4,2,3,0,2,5,Human Factor
1962-04-26 00:00:00,Argentinian Air Force - Fuerza Aérea Argentina,Takeoff (climb),Military / Government,Argentina,South America,2,2,2,0,0,2,0,Unknown
1962-05-11 00:00:00,Aeroflot - Russian International Airlines,Flight,Military / Government,Russia,Asia,2,2,2,0,0,2,0,Human Factor
1962-05-17 00:00:00,Royal Air Force - RAF,Flight,Operational,United Kingdom,Europe,2,2,2,0,0,2,0,Technical Failure
1962-05-21 00:00:00,Honduras International Airlines,Takeoff (climb),Operational,Honduras,Central America,2,2,2,0,0,2,0,Unknown
1962-05-24 00:00:00,Canadian Government,Takeoff (climb),Military / Government,Canada,North America,2,1,1,1,1,2,0,Human Factor
1962-06-20 00:00:00,Aeroflot - Russian International Airlines,Flight,Operational,Georgia,Asia,2,2,2,0,0,2,0,Human Factor
1962-07-03 00:00:00,Aeroflot - Russian International Airlines,Flight,Military / Government,Russia,Asia,2,2,2,0,0,2,0,Human Factor
1962-07-07 00:00:00,Aeroflot - Russian International Airlines,Flight,Military / Government,Kazakhstan,Asia,2,2,2,0,0,2,0,Human Factor
1962-07-27 00:00:00,Philippine Airlines - PAL,Flight,Commercial,Philippines,Asia,2,1,1,1,1,2,0,Human Factor
1962-07-29 00:00:00,United States Air Force - USAF,Landing (descent or approach),Operational,United States of America,North America,2,2,2,0,0,2,0,Technical Failure
1962-08-17 00:00:00,BorgWarner,Takeoff (climb),Operational,United States of America,North America,2,2,2,0,0,2,0,Technical Failure
1962-09-20 00:00:00,United Nations Organization,Flight,Humanitarian,Democratic Republic of Congo,Africa,10,3,0,7,2,2,8,Terrorism
1962-11-26 00:00:00,Lineas Aéreas La Urraca,Takeoff (climb),Operational,Jamaica,Central America,3,3,2,0,0,2,1,Human Factor
1963-01-01 00:00:00,Indian Air Force - Bharatiya Vayu Sena,Flight,Military / Government,India,Asia,2,2,2,0,0,2,0,Unknown
1963-01-30 00:00:00,United States Air Force - USAF,Flight,Operational,United States of America,North America,6,6,2,0,0,2,4,Technical Failure
1963-03-08 00:00:00,Soviet Air Force - Voyenno-vozdushnye sily CCCP,Flight,Military / Government,Russia,Asia,8,8,2,0,0,2,6,Human Factor
1963-03-18 00:00:00,Royal Netherlands Navy - Marineluchtvaartdienst,Flight,Military / Government,United Kingdom,Europe,4,4,2,0,0,2,2,Unknown
1963-03-27 00:00:00,Smiths Aviation,Takeoff (climb),Operational,United Kingdom,Europe,2,2,2,0,0,2,0,Human Factor
1963-04-13 00:00:00,Royal Air Force - RAF,Landing (descent or approach),Military / Government,Libya,Africa,7,7,2,0,0,2,5,Human Factor
1963-04-23 00:00:00,United States Army,Takeoff (climb),Military / Government,Iraq,Asia,3,2,2,1,0,2,1,Weather
1963-05-18 00:00:00,Peruvian Air Force - Fuerza Aérea del Perú,Flight,Military / Government,Peru,South America,4,4,2,0,0,2,2,Unknown
1963-06-14 00:00:00,Aeroflot - Russian International Airlines,Flight,Military / Government,Russia,Asia,9,2,1,7,1,2,7,Human Factor
1963-07-03 00:00:00,Argentinian Air Force - Fuerza Aérea Argentina,Landing (descent or approach),Military / Government,Argentina,South America,2,2,2,0,0,2,0,Unknown
1963-07-16 00:00:00,Indian Air Force - Bharatiya Vayu Sena,Landing (descent or approach),Military / Government,India,Asia,0,0,2,0,0,2,-2,Unknown
1963-09-05 00:00:00,Air America,Flight,Military / Government,Laos,Asia,7,2,2,5,0,2,5,Terrorism
1964-01-03 00:00:00,Aeroflot - Russian International Airlines,Landing (descent or approach),Operational,Russia,Asia,2,2,2,0,0,2,0,Human Factor
1964-01-04 00:00:00,Private Brazilian,Flight,Business,Brazil,South America,2,1,1,1,1,2,0,Unknown
1964-01-09 00:00:00,National Executive Flight Service,Takeoff (climb),Operational,United States of America,North America,2,2,2,0,0,2,0,Human Factor
1964-02-04 00:00:00,Lloyd Aéreo Boliviano - LAB Airlines,Takeoff (climb),Commercial,Bolivia,South America,29,3,0,26,2,2,27,Unknown
1964-02-06 00:00:00,Perdigão SA Comercio y Industria,Landing (descent or approach),Operational,Brazil,South America,3,3,2,0,0,2,1,Unknown
1964-02-18 00:00:00,Nitto Airlines,Takeoff (climb),Commercial,Japan,Asia,10,2,0,8,2,2,8,Technical Failure
1964-03-19 00:00:00,BC Air Lines,Landing (descent or approach),Commercial,Canada,North America,2,1,1,1,1,2,0,Unknown
1964-03-21 00:00:00,Chilean Air Force - Fuerza Aérea de Chile,Flight,Operational,Chile,South America,3,3,2,0,0,2,1,Technical Failure
1964-03-28 00:00:00,Private American,Landing (descent or approach),Business,Libya,Africa,2,1,1,1,1,2,0,Weather
1964-04-11 00:00:00,Italian Air Force - Aeronautica Militare Italiana,Flight,Humanitarian,Italy,Europe,2,2,2,0,0,2,0,Human Factor
1964-06-08 00:00:00,Aeroflot - Russian International Airlines,Takeoff (climb),Operational,Russia,Asia,5,4,1,1,1,2,3,Human Factor
1964-06-13 00:00:00,Saudi Arabian Airlines - SAUDIA,Flight,Operational,Saudi Arabia,Asia,2,2,2,0,0,2,0,Unknown
1964-06-19 00:00:00,Private American,Landing (descent or approach),Business,United States of America,North America,5,1,1,4,1,2,3,Human Factor
1964-06-20 00:00:00,Ohio Valley Aviation,Takeoff (climb),Operational,United States of America,North America,2,2,2,0,0,2,0,Human Factor
1964-07-26 00:00:00,Interflug,Flight,Operational,Germany,Europe,2,2,2,0,0,2,0,Unknown
1964-08-20 00:00:00,United States Army,Flight,Military / Government,Peru,South America,2,2,2,0,0,2,0,Unknown
1964-08-22 00:00:00,Private American,Landing (descent or approach),Business,United States of America,North America,2,1,1,1,1,2,0,Human Factor
1964-08-25 00:00:00,Private American,Flight,Business,United States of America,North America,2,2,2,0,0,2,0,Human Factor
1964-08-25 00:00:00,Royal Air Force - RAF,Landing (descent or approach),Operational,United Kingdom,Europe,2,2,2,0,0,2,0,Human Factor
1964-08-26 00:00:00,United States Forest Service - USFS,Flight,Military / Government,United States of America,North America,2,2,2,0,0,2,0,Human Factor
1964-09-06 00:00:00,Private American,Landing (descent or approach),Business,United States of America,North America,7,1,0,6,2,2,5,Technical Failure
1964-09-15 00:00:00,Avianca,Landing (descent or approach),Operational,Colombia,South America,2,2,2,0,0,2,0,Human Factor
1964-10-14 00:00:00,Northland Airlines,Takeoff (climb),Commercial,Canada,North America,3,1,1,2,1,2,1,Technical Failure
1964-10-24 00:00:00,Aeroflot - Russian International Airlines,Flight,Operational,Russia,Asia,2,2,2,0,0,2,0,Human Factor
1964-11-07 00:00:00,Steward-Davis,Flight,Operational,Mexico,Central America,2,2,2,0,0,2,0,Unknown
1964-12-09 00:00:00,Argentinian Air Force - Fuerza Aérea Argentina,Flight,Operational,Argentina,South America,2,2,2,0,0,2,0,Unknown
1964-12-19 00:00:00,John Mechan Oil Company,Flight,Business,Egypt,Africa,2,2,2,0,0,2,0,Terrorism
1964-12-31 00:00:00,Aeroflot - Russian International Airlines,Flight,Commercial,Russia,Asia,10,2,0,8,2,2,8,Weather
1965-01-11 00:00:00,Civil Air Patrol,Flight,Military / Government,United States of America,North America,2,1,1,1,1,2,0,Human Factor
1965-01-14 00:00:00,Burroughs Corporation,Landing (descent or approach),Operational,United States of America,North America,2,2,2,0,0,2,0,Technical Failure
1965-01-23 00:00:00,Royal Netherlands Navy - Marineluchtvaartdienst,Takeoff (climb),Military / Government,Netherlands,Europe,2,2,2,0,0,2,0,Human Factor
1965-01-26 00:00:00,Lineas Aéreas La Urraca,Flight,Operational,Colombia,South America,4,3,2,1,0,2,2,Unknown
1965-02-13 00:00:00,Aerolineas El Salvador - AESA,Takeoff (climb),Operational,United States of America,North America,2,2,2,0,0,2,0,Technical Failure
1965-02-14 00:00:00,Japan Domestic Airlines,Flight,Operational,Japan,Asia,2,2,2,0,0,2,0,Human Factor
1965-03-05 00:00:00,Pine Paper Products Company,Landing (descent or approach),Business,United States of America,North America,3,1,1,2,1,2,1,Human Factor
1965-03-05 00:00:00,Fruehauf Corp.,Takeoff (climb),Operational,United States of America,North America,2,2,2,0,0,2,0,Technical Failure
1965-03-18 00:00:00,Miami Aviation,Flight,Operational,Canada,North America,2,2,2,0,0,2,0,Technical Failure
1965-03-25 00:00:00,United States Air Force - USAF,Landing (descent or approach),Operational,Philippines,Asia,2,2,2,0,0,2,0,Human Factor
1965-04-09 00:00:00,Ortner Air Services,Flight,Operational,United States of America,North America,2,1,1,1,1,2,0,Human Factor
1965-04-29 00:00:00,Ipsen Industries,Landing (descent or approach),Business,United States of America,North America,2,1,1,1,1,2,0,Technical Failure
1965-07-09 00:00:00,Johnson Flying Service,Flight,Humanitarian,United States of America,North America,2,2,2,0,0,2,0,Human Factor
1965-07-20 00:00:00,Cambrian Airways,Landing (descent or approach),Operational,United Kingdom,Europe,2,2,2,0,0,2,0,Unknown
1965-07-22 00:00:00,Portuguese Air Force - Força Aerea Portuguesa,Flight,Operational,Portugal,Europe,2,2,2,0,0,2,0,Unknown
1965-08-25 00:00:00,United States Air Force - USAF,Landing (descent or approach),Operational,United States of America,North America,2,2,2,0,0,2,0,Human Factor
1965-09-07 00:00:00,Micronesian Airlines,Takeoff (climb),Operational,United States of America,North America,3,1,1,2,1,2,1,Human Factor
1965-09-24 00:00:00,Italian Air Force - Aeronautica Militare Italiana,Flight,Operational,Italy,Europe,4,4,2,0,0,2,2,Unknown
1965-09-28 00:00:00,Brazilian Air Force - Força Aérea Brasileira,Flight,Military / Government,Brazil,South America,4,4,2,0,0,2,2,Unknown
1965-10-04 00:00:00,Liston Aircraft,Flight,Humanitarian,United States of America,North America,2,2,2,0,0,2,0,Technical Failure
1965-10-16 00:00:00,Business Aviation - USA,Landing (descent or approach),Operational,United States of America,North America,2,1,1,1,1,2,0,Human Factor
1965-10-21 00:00:00,Lear Jet Corporation,Flight,Operational,United States of America,North America,2,2,2,0,0,2,0,Technical Failure
1965-11-04 00:00:00,Aeropesca Colombia,Flight,Commercial,Colombia,South America,6,3,2,3,0,2,4,Unknown
1965-11-12 00:00:00,Skyway Air Cargo,Landing (descent or approach),Operational,United States of America,North America,2,1,1,1,1,2,0,Human Factor
1965-12-16 00:00:00,Air Manila International,Landing (descent or approach),Commercial,Philippines,Asia,21,3,2,18,0,2,19,Human Factor
1966-01-08 00:00:00,United States Air Force - USAF,Flight,Military / Government,United States of America,North America,3,3,2,0,0,2,1,Technical Failure
1966-01-18 00:00:00,Flugsyn,Landing (descent or approach),Humanitarian,Iceland,Europe,2,2,2,0,0,2,0,Unknown
1966-02-03 00:00:00,Private American,Landing (descent or approach),Operational,United States of America,North America,2,2,2,0,0,2,0,Technical Failure
1966-02-15 00:00:00,Indian Airlines,Landing (descent or approach),Commercial,India,Asia,81,7,0,74,2,2,79,Human Factor
1966-02-25 00:00:00,Private American,Landing (descent or approach),Business,United States of America,North America,2,1,1,1,1,2,0,Technical Failure
1966-03-02 00:00:00,Aeroflot - Russian International Airlines,Flight,Operational,Russia,Asia,2,2,2,0,0,2,0,Unknown
1966-03-14 00:00:00,United States Air Force - USAF,Parking,Humanitarian,Vietnam,Asia,6,6,2,0,0,2,4,Terrorism
1966-03-20 00:00:00,Servicios Americanos,Takeoff (climb),Operational,Paraguay,South America,2,2,2,0,0,2,0,Unknown
1966-04-05 00:00:00,Kimex,Flight,Operational,Bahamas,Central America,2,2,2,0,0,2,0,Unknown
1966-04-17 00:00:00,Continental Air Services,Flight,Operational,Laos,Asia,2,2,2,0,0,2,0,Unknown
1966-04-23 00:00:00,Rexall Drug and Chemical Corporation,Flight,Operational,United States of America,North America,2,2,2,0,0,2,0,Technical Failure
1966-05-06 00:00:00,Bulair,Flight,Military / Government,Bulgaria,Europe,2,2,2,0,0,2,0,Unknown
1966-05-10 00:00:00,United States Army,Flight,Military / Government,Vietnam,Asia,4,4,2,0,0,2,2,Other
1966-05-14 00:00:00,Aspen Airways,Flight,Operational,United States of America,North America,2,2,2,0,0,2,0,Human Factor
1966-06-05 00:00:00,Air Affaires,Landing (descent or approach),Operational,France,Europe,2,2,2,0,0,2,0,Human Factor
1966-06-15 00:00:00,Chilean Air Force - Fuerza Aérea de Chile,Flight,Military / Government,Chile,South America,2,2,2,0,0,2,0,Unknown
1966-06-16 00:00:00,Zantop Air Transport,Flight,Operational,United States of America,North America,2,2,2,0,0,2,0,Human Factor
1966-06-20 00:00:00,Nordair,Flight,Operational,Canada,North America,2,2,2,0,0,2,0,Unknown
1966-06-27 00:00:00,Aeronaut Air Services,Takeoff (climb),Commercial,United States of America,North America,12,2,1,10,1,2,10,Technical Failure
1966-07-04 00:00:00,Air New Zealand,Takeoff (climb),Operational,New Zealand,Oceania,5,5,2,0,0,2,3,Human Factor
1966-07-10 00:00:00,Chatham Aviation,Flight,Operational,United States of America,North America,2,2,2,0,0,2,0,Human Factor
1966-07-24 00:00:00,United States Air Force - USAF,Landing (descent or approach),Military / Government,Thailand,Asia,2,2,2,0,0,2,0,Technical Failure
1966-08-17 00:00:00,Mexican Air Force - Fuerza Aérea Mexicana,Flight,Operational,Mexico,Central America,2,2,2,0,0,2,0,Human Factor
1966-09-22 00:00:00,Avianca,Takeoff (climb),Operational,Colombia,South America,2,2,2,0,0,2,0,Technical Failure
1966-11-02 00:00:00,Gastonia Aviation,Flight,Commercial,United States of America,North America,2,1,1,1,1,2,0,Weather
1966-11-09 00:00:00,Britten-Norman,Flight,Operational,Netherlands,Europe,2,1,1,1,1,2,0,Weather
1966-11-15 00:00:00,United States Army,Landing (descent or approach),Military / Government,Vietnam,Asia,2,1,1,1,1,2,0,Unknown
1966-11-26 00:00:00,Morgan Distribution,Flight,Business,United States of America,North America,2,1,1,1,1,2,0,Human Factor
1966-12-06 00:00:00,Private American,Takeoff (climb),Operational,United States of America,North America,2,2,2,0,0,2,0,Technical Failure
1966-12-18 00:00:00,Aeroflot - Russian International Airlines,Flight,Military / Government,Uzbekistan,Asia,2,2,2,0,0,2,0,Human Factor
1967-01-21 00:00:00,Air Ferry,Landing (descent or approach),Operational,Germany,Europe,2,2,2,0,0,2,0,Human Factor
1967-02-16 00:00:00,Royal Canadian Air Force - RCAF,Flight,Operational,Canada,North America,2,2,2,0,0,2,0,Unknown
1967-02-21 00:00:00,Sudan Airways,Landing (descent or approach),Operational,Sudan,Africa,4,4,2,0,0,2,2,Human Factor
1967-02-21 00:00:00,United States Air Force - USAF,Flight,Military / Government,Laos,Asia,2,2,2,0,0,2,0,Terrorism
1967-02-23 00:00:00,Air Lloyd,Flight,Operational,Switzerland,Europe,2,2,2,0,0,2,0,Unknown
1967-02-28 00:00:00,Manor Aviation,Takeoff (climb),Operational,United States of America,North America,2,2,2,0,0,2,0,Technical Failure
1967-03-16 00:00:00,Harveys Flying Service,Takeoff (climb),Commercial,United States of America,North America,2,1,1,1,1,2,0,Human Factor
1967-04-11 00:00:00,Private American,Flight,Operational,United States of America,North America,2,2,2,0,0,2,0,Human Factor
1967-04-15 00:00:00,Lytle’s Transfer %26 Storage,Flight,Business,United States of America,North America,3,1,1,2,1,2,1,Human Factor
1967-05-11 00:00:00,Italian Air Force - Aeronautica Militare Italiana,Flight,Operational,Italy,Europe,2,2,2,0,0,2,0,Unknown
1967-05-13 00:00:00,United States Navy - USN,Flight,Military / Government,Vietnam,Asia,3,3,2,0,0,2,1,Technical Failure
1967-05-14 00:00:00,Container Corporation of America,Flight,Operational,United States of America,North America,2,2,2,0,0,2,0,Unknown
1967-06-12 00:00:00,Aer Turas,Landing (descent or approach),Operational,Ireland,Europe,2,2,2,0,0,2,0,Technical Failure
1967-06-27 00:00:00,Colco Aviation,Flight,Humanitarian,United States of America,North America,2,2,2,0,0,2,0,Human Factor
1967-07-11 00:00:00,Honeywell,Flight,Operational,United States of America,North America,2,2,2,0,0,2,0,Technical Failure
1967-07-16 00:00:00,The Flying Fireman,Flight,Humanitarian,Canada,North America,2,2,2,0,0,2,0,Human Factor
1967-08-09 00:00:00,Aeroflot - Russian International Airlines,Flight,Military / Government,Kyrgyzstan,Asia,2,2,2,0,0,2,0,Human Factor
1967-08-13 00:00:00,Aeroflot - Russian International Airlines,Flight,Business,Russia,Asia,3,2,1,1,1,2,1,Human Factor
1967-09-03 00:00:00,Saudi Binladin Group,Landing (descent or approach),Business,Saudi Arabia,Asia,2,1,1,1,1,2,0,Human Factor
1967-11-04 00:00:00,Crest Airlines,Flight,Operational,United States of America,North America,2,2,2,0,0,2,0,Unknown
1967-11-20 00:00:00,United States Navy - USN,Flight,Operational,World,World,2,2,2,0,0,2,0,Unknown
1967-11-26 00:00:00,Aeroflot - Russian International Airlines,Flight,Operational,Russia,Asia,3,2,1,1,1,2,1,Human Factor
1967-12-11 00:00:00,Corley Manufacturing Company,Flight,Business,United States of America,North America,2,1,1,1,1,2,0,Human Factor
1967-12-12 00:00:00,Virgin Islands Airways - VIA,Landing (descent or approach),Operational,United States of America,Central America,2,2,2,0,0,2,0,Human Factor
1967-12-13 00:00:00,Continental Air Services,Flight,Military / Government,Laos,Asia,2,2,2,0,0,2,0,Unknown
1967-12-21 00:00:00,Frontier Airlines,Takeoff (climb),Operational,United States of America,North America,2,2,2,0,0,2,0,Human Factor
1967-12-23 00:00:00,Autair International Airways,Takeoff (climb),Operational,United Kingdom,Europe,2,2,2,0,0,2,0,Human Factor
1968-01-04 00:00:00,Aeroflot - Russian International Airlines,Flight,Operational,Russia,Asia,2,2,2,0,0,2,0,Human Factor
1968-01-04 00:00:00,French Navy,Takeoff (climb),Military / Government,France,Europe,2,2,2,0,0,2,0,Unknown
1968-01-29 00:00:00,Trojan Airways,Landing (descent or approach),Operational,United States of America,North America,2,2,2,0,0,2,0,Human Factor
1968-02-08 00:00:00,Brazilian Air Force - Força Aérea Brasileira,Flight,Specialised Services,Brazil,South America,2,2,2,0,0,2,0,Technical Failure
1968-02-19 00:00:00,Aeroflot - Russian International Airlines,Landing (descent or approach),Commercial,Iraq,Asia,2,2,2,0,0,2,0,Unknown
1968-02-23 00:00:00,Vercoa Commuter,Flight,Operational,United States of America,North America,2,2,2,0,0,2,0,Human Factor
1968-02-27 00:00:00,United States Navy - USN,Flight,Military / Government,Laos,Asia,9,9,2,0,0,2,7,Terrorism
1968-03-04 00:00:00,Servencin Despachos Gerais,Takeoff (climb),Business,Brazil,South America,4,2,2,2,0,2,2,Technical Failure
1968-03-04 00:00:00,Colombian Air Force - Fuerza Aérea Colombiana,Flight,Operational,Colombia,South America,2,2,2,0,0,2,0,Unknown
1968-03-31 00:00:00,United States Air Force - USAF,Flight,Military / Government,Vietnam,Asia,4,4,2,0,0,2,2,Technical Failure
1968-04-18 00:00:00,Tempor Airship,Flight,Business,Greece,Europe,4,1,1,3,1,2,2,Technical Failure
1968-04-23 00:00:00,Royal Netherlands Air Force - Koninklijke Luchtmacht,Flight,Humanitarian,Netherlands,Europe,4,1,0,3,2,2,2,Human Factor
1968-05-04 00:00:00,Eastex Inc.,Landing (descent or approach),Operational,United States of America,North America,2,2,2,0,0,2,0,Human Factor
1968-05-11 00:00:00,Indian Air Force - Bharatiya Vayu Sena,Flight,Specialised Services,India,Asia,2,2,2,0,0,2,0,Unknown
1968-05-19 00:00:00,Aeroflot - Russian International Airlines,Flight,Military / Government,Russia,Asia,2,2,2,0,0,2,0,Human Factor
1968-05-28 00:00:00,Aeroflot - Russian International Airlines,Flight,Military / Government,Ukraine,Europe,2,2,2,0,0,2,0,Human Factor
1968-06-17 00:00:00,Buckner Company,Flight,Business,United States of America,North America,2,1,1,1,1,2,0,Unknown
1968-06-28 00:00:00,Mey-Air,Landing (descent or approach),Operational,Norway,Europe,2,2,2,0,0,2,0,Human Factor
1968-06-28 00:00:00,Takuuvalmiste,Takeoff (climb),Operational,Finland,Europe,2,2,2,0,0,2,0,Human Factor
1968-07-01 00:00:00,Aeroflot - Russian International Airlines,Takeoff (climb),Military / Government,Ukraine,Europe,3,1,1,2,1,2,1,Human Factor
1968-07-13 00:00:00,Chilean Air Force - Fuerza Aérea de Chile,Takeoff (climb),Military / Government,Chile,South America,2,2,2,0,0,2,0,Unknown
1968-07-20 00:00:00,Far Airlines,Flight,Operational,United States of America,North America,2,2,2,0,0,2,0,Human Factor
1968-07-25 00:00:00,United States Air Force - USAF,Flight,Military / Government,Vietnam,Asia,4,4,2,0,0,2,2,Human Factor
1968-08-08 00:00:00,The Flying Fireman,Flight,Humanitarian,Canada,North America,2,2,2,0,0,2,0,Human Factor
1968-09-13 00:00:00,Eversharp,Landing (descent or approach),Operational,United States of America,North America,2,2,2,0,0,2,0,Weather
1968-09-15 00:00:00,VASP - Viação Aérea de São Paulo,Takeoff (climb),Operational,Brazil,South America,2,2,2,0,0,2,0,Human Factor
1968-09-21 00:00:00,E.J. Benes %26 Company,Takeoff (climb),Operational,United States of America,North America,2,2,2,0,0,2,0,Human Factor
1968-09-25 00:00:00,Air Time,Landing (descent or approach),Operational,United States of America,North America,2,2,2,0,0,2,0,Human Factor
1968-11-18 00:00:00,Executive Air,Landing (descent or approach),Commercial,United States of America,North America,6,2,0,4,2,2,4,Human Factor
1968-11-18 00:00:00,United States Air Force - USAF,Takeoff (climb),Military / Government,Japan,Asia,7,7,2,0,0,2,5,Unknown
1968-11-29 00:00:00,Aerochaco,Takeoff (climb),Specialised Services,Argentina,South America,2,1,1,1,1,2,0,Unknown
1968-11-29 00:00:00,Ecuadorian Air Force - Fuerza Aérea Ecuatoriana,Flight,Military / Government,Ecuador,South America,12,2,2,10,0,2,10,Technical Failure
1968-12-20 00:00:00,Mexican Air Force - Fuerza Aérea Mexicana,Landing (descent or approach),Military / Government,Mexico,Central America,4,2,2,2,0,2,2,Unknown
1968-12-24 00:00:00,Interior Airways,Landing (descent or approach),Operational,United States of America,North America,4,4,2,0,0,2,2,Human Factor
1968-12-31 00:00:00,Northland Airlines,Flight,Commercial,Canada,North America,2,1,1,1,1,2,0,Unknown
1969-01-10 00:00:00,Aeroflot - Russian International Airlines,Flight,Commercial,Russia,Asia,13,2,2,11,0,2,11,Human Factor
1969-01-17 00:00:00,Aerotaxi Servicios Aéreos,Landing (descent or approach),Commercial,Colombia,South America,2,1,1,1,1,2,0,Unknown
1969-01-17 00:00:00,The Hindu,Takeoff (climb),Operational,India,Asia,2,2,2,0,0,2,0,Human Factor
1969-02-06 00:00:00,United States Army,Flight,Military / Government,United States of America,North America,3,3,2,0,0,2,1,Unknown
1969-03-03 00:00:00,Aeroflot - Russian International Airlines,Flight,Military / Government,Russia,Asia,2,1,1,1,1,2,0,Human Factor
1969-03-10 00:00:00,United States Air Force - USAF,Landing (descent or approach),Military / Government,Thailand,Asia,2,2,2,0,0,2,0,Technical Failure
1969-04-01 00:00:00,Italian Air Force - Aeronautica Militare Italiana,Flight,Operational,Italy,Europe,2,2,2,0,0,2,0,Unknown
1969-04-02 00:00:00,Islands of the Bahamas,Takeoff (climb),Operational,Bahamas,Central America,2,2,2,0,0,2,0,Technical Failure
1969-04-17 00:00:00,Volkswagen Pacific,Flight,Operational,Switzerland,Europe,2,2,2,0,0,2,0,Human Factor
1969-05-07 00:00:00,Flying West Airways,Takeoff (climb),Operational,United States of America,North America,2,2,2,0,0,2,0,Human Factor
1969-05-08 00:00:00,Fairchild Aircraft Corporation,Takeoff (climb),Operational,Paraguay,South America,4,1,1,3,1,2,2,Unknown
1969-05-15 00:00:00,Aeroflot - Russian International Airlines,Flight,Military / Government,Russia,Asia,2,1,1,1,1,2,0,Human Factor
1969-05-24 00:00:00,United States Air Force - USAF,Landing (descent or approach),Military / Government,Thailand,Asia,13,13,2,0,0,2,11,Terrorism
1969-05-29 00:00:00,Río Táxi Aéreo,Flight,Operational,Brazil,South America,2,2,2,0,0,2,0,Technical Failure
1969-06-20 00:00:00,Cascade Airways,Takeoff (climb),Operational,United States of America,North America,2,2,2,0,0,2,0,Human Factor
1969-07-13 00:00:00,Interior Airways,Landing (descent or approach),Commercial,United States of America,North America,2,1,1,1,1,2,0,Human Factor
1969-07-18 00:00:00,United Clearing,Takeoff (climb),Operational,United States of America,North America,3,2,2,1,0,2,1,Human Factor
1969-08-01 00:00:00,Aerotaxi Servicios Aéreos,Landing (descent or approach),Commercial,Colombia,South America,8,1,0,7,2,2,6,Unknown
1969-08-14 00:00:00,Harris Moda,Takeoff (climb),Operational,Italy,Europe,2,2,2,0,0,2,0,Unknown
1969-09-03 00:00:00,Hawkins %26 Powers Aviation,Flight,Humanitarian,United States of America,North America,2,2,2,0,0,2,0,Human Factor
1969-09-06 00:00:00,Interior Airways,Landing (descent or approach),Operational,United States of America,North America,2,2,2,0,0,2,0,Human Factor
1969-09-15 00:00:00,Private American,Takeoff (climb),Business,United States of America,North America,2,1,1,1,1,2,0,Human Factor
1969-09-22 00:00:00,Private Canadian,Landing (descent or approach),Business,Canada,North America,4,1,0,3,2,2,2,Human Factor
1969-10-11 00:00:00,San Juan Air,Flight,Operational,World,World,2,1,1,1,1,2,0,Unknown
1969-12-03 00:00:00,Royal Australian Army,Flight,Operational,Vietnam,Asia,2,2,2,0,0,2,0,Terrorism
1969-12-04 00:00:00,Ehrenström Flyg,Takeoff (climb),Operational,Sweden,Europe,2,2,2,0,0,2,0,Weather
1969-12-06 00:00:00,Private Canadian,Landing (descent or approach),Business,Canada,North America,2,1,1,1,1,2,0,Human Factor
1969-12-16 00:00:00,American Smelting %26 Refining Company,Takeoff (climb),Business,United States of America,North America,2,2,2,0,0,2,0,Human Factor
1969-12-19 00:00:00,Trans-Pacific Supply Company,Flight,Business,France,Europe,2,2,2,0,0,2,0,Human Factor
1969-12-26 00:00:00,United States Air Force - USAF,Landing (descent or approach),Military / Government,Vietnam,Asia,3,3,2,0,0,2,1,Terrorism
1970-01-21 00:00:00,Antonio Pesce,Landing (descent or approach),Business,Italy,Europe,2,1,1,1,1,2,0,Technical Failure
1970-01-24 00:00:00,Buckeye Air Services,Landing (descent or approach),Operational,United States of America,North America,2,2,2,0,0,2,0,Human Factor
1970-01-31 00:00:00,Aeroflot - Russian International Airlines,Flight,Operational,Russia,Asia,2,2,2,0,0,2,0,Human Factor
1970-02-03 00:00:00,Shenandoah Air,Landing (descent or approach),Operational,United States of America,North America,2,2,2,0,0,2,0,Technical Failure
1970-02-20 00:00:00,Far Eastern Air Transport - FAT,Takeoff (climb),Operational,Taiwan,Asia,2,2,2,0,0,2,0,Unknown
1970-03-19 00:00:00,Aeroflot - Russian International Airlines,Flight,Military / Government,Russia,Asia,2,2,2,0,0,2,0,Human Factor
1970-03-21 00:00:00,Aircraft Charters,Flight,Operational,Mexico,Central America,2,2,2,0,0,2,0,Unknown
1970-04-09 00:00:00,McAlpine Aviation,Landing (descent or approach),Operational,United Kingdom,Europe,2,2,2,0,0,2,0,Human Factor
1970-04-14 00:00:00,Ecuatoriana - Compañia Ecuatoriana de Aviacion,Takeoff (climb),Operational,United States of America,North America,2,2,2,0,0,2,0,Human Factor
1970-04-20 00:00:00,Aeroflot - Russian International Airlines,Flight,Military / Government,Russia,Asia,4,2,1,2,1,2,2,Human Factor
1970-04-22 00:00:00,United States Air Force - USAF,Flight,Military / Government,Vietnam,Asia,9,3,2,6,0,2,7,Terrorism
1970-04-28 00:00:00,Aeroflot - Russian International Airlines,Flight,Military / Government,Russia,Asia,2,2,2,0,0,2,0,Human Factor
1970-05-10 00:00:00,Aeroflot - Russian International Airlines,Flight,Military / Government,Russia,Asia,3,2,1,1,1,2,1,Human Factor
1970-05-19 00:00:00,Georgia Air,Takeoff (climb),Operational,United States of America,North America,2,2,2,0,0,2,0,Technical Failure
1970-06-22 00:00:00,Aeroflot - Russian International Airlines,Flight,Commercial,Russia,Asia,7,2,0,5,2,2,5,Human Factor
1970-07-02 00:00:00,Jetco Aviation International,Landing (descent or approach),Operational,United States of America,North America,2,2,2,0,0,2,0,Other
1970-07-18 00:00:00,Hemet Valley Flying Service,Landing (descent or approach),Humanitarian,United States of America,North America,2,2,2,0,0,2,0,Human Factor
1970-07-27 00:00:00,Aero Taxi - USA,Flight,Operational,United States of America,North America,2,1,1,1,1,2,0,Human Factor
1970-08-16 00:00:00,Dayton Steel %26 Metal,Flight,Business,United States of America,North America,2,1,1,1,1,2,0,Human Factor
1970-08-18 00:00:00,Aeroflite,Flight,Humanitarian,United States of America,North America,2,2,2,0,0,2,0,Human Factor
1970-09-05 00:00:00,Aeroflot - Russian International Airlines,Flight,Military / Government,Uzbekistan,Asia,2,2,2,0,0,2,0,Human Factor
1970-09-14 00:00:00,United States Army,Flight,Operational,United States of America,North America,2,2,2,0,0,2,0,Human Factor
1970-09-20 00:00:00,Tunis Air,Flight,Operational,Tunisia,Africa,2,2,2,0,0,2,0,Unknown
1970-10-01 00:00:00,Carl W. Bauer,Flight,Business,United States of America,North America,2,1,1,1,1,2,0,Human Factor
1970-10-01 00:00:00,Federal Aviation Administration - FAA,Takeoff (climb),Operational,United States of America,North America,2,2,2,0,0,2,0,Human Factor
1970-10-04 00:00:00,Red Wing Shoe Company,Landing (descent or approach),Business,United States of America,North America,2,1,1,1,1,2,0,Human Factor
1970-10-15 00:00:00,Barringer Research,Takeoff (climb),Specialised Services,United States of America,North America,5,3,2,2,0,2,3,Weather
1970-10-28 00:00:00,Aerocosta Colombia,Landing (descent or approach),Operational,Guadeloupe,Central America,4,3,2,1,0,2,2,Technical Failure
1970-10-29 00:00:00,United States Army,Flight,Operational,United States of America,North America,2,2,2,0,0,2,0,Unknown
1970-11-11 00:00:00,Narco Scientific,Flight,Specialised Services,United States of America,North America,2,2,2,0,0,2,0,Human Factor
1970-11-14 00:00:00,Royal Crown Cola Corporation,Landing (descent or approach),Operational,United States of America,North America,2,2,2,0,0,2,0,Human Factor
1970-11-30 00:00:00,Israeli Air Force - Heyl Ha'avir,Taxiing,Military / Government,Israel,Asia,2,2,2,0,0,2,0,Human Factor
1970-12-28 00:00:00,Morrison-Knudsen Corporation,Landing (descent or approach),Business,United States of America,North America,2,2,2,0,0,2,0,Human Factor
1970-12-28 00:00:00,Trans Caribbean Airways - TCA,Landing (descent or approach),Commercial,United States of America,Central America,55,7,0,48,2,2,53,Human Factor
1971-01-12 00:00:00,Racran Corporation,Landing (descent or approach),Business,United States of America,North America,2,1,1,1,1,2,0,Human Factor
1971-01-23 00:00:00,Korean Air,Flight,Commercial,South Korea,Asia,60,5,1,55,1,2,58,Terrorism
1971-02-14 00:00:00,Continental Air Services,Takeoff (climb),Operational,Cambodia,Asia,2,2,2,0,0,2,0,Technical Failure
1971-02-28 00:00:00,Private French,Flight,Business,France,Europe,2,1,1,1,1,2,0,Unknown
1971-03-19 00:00:00,World West Aviation,Landing (descent or approach),Specialised Services,United States of America,North America,2,1,1,1,1,2,0,Human Factor
1971-04-19 00:00:00,Private American,Flight,Business,United States of America,North America,2,2,2,0,0,2,0,Human Factor
1971-06-02 00:00:00,Air America,Flight,Operational,Laos,Asia,2,2,2,0,0,2,0,Terrorism
1971-06-18 00:00:00,Antilles Air Boats,Flight,Commercial,Puerto Rico,Central America,11,1,0,10,2,2,9,Technical Failure
1971-06-22 00:00:00,Hankins Airways,Takeoff (climb),Operational,United States of America,North America,2,2,2,0,0,2,0,Human Factor
1971-07-02 00:00:00,Minnesota Rubber %26 Plastics,Takeoff (climb),Business,United States of America,North America,6,1,1,5,1,2,4,Human Factor
1971-07-08 00:00:00,Buckeye Air Services,Landing (descent or approach),Operational,United States of America,North America,2,2,2,0,0,2,0,Human Factor
1971-07-15 00:00:00,Command Air - USA,Flight,Operational,United States of America,North America,2,1,1,1,1,2,0,Human Factor
1971-07-15 00:00:00,Aeroflot - Russian International Airlines,Flight,Military / Government,Russia,Asia,2,2,2,0,0,2,0,Human Factor
1971-07-22 00:00:00,REI Industries,Takeoff (climb),Specialised Services,United States of America,North America,2,2,2,0,0,2,0,Human Factor
1971-08-03 00:00:00,Sécurité civile française,Landing (descent or approach),Humanitarian,France,Europe,2,2,2,0,0,2,0,Unknown
1971-08-16 00:00:00,Continental Air Services,Flight,Commercial,Laos,Asia,2,1,1,1,1,2,0,Unknown
1971-08-20 00:00:00,Robert C. Haase,Landing (descent or approach),Business,United States of America,North America,2,1,1,1,1,2,0,Human Factor
1971-08-25 00:00:00,Private Austrian,Flight,Business,Germany,Europe,2,1,1,1,1,2,0,Weather
1971-08-31 00:00:00,Laboratoires UPSA,Flight,Business,France,Europe,2,1,1,1,1,2,0,Human Factor
1971-09-03 00:00:00,Norcanair - North Canada Air,Flight,Humanitarian,Canada,North America,2,2,2,0,0,2,0,Human Factor
1971-09-03 00:00:00,Field Aviation,Flight,Humanitarian,Canada,North America,2,2,2,0,0,2,0,Human Factor
1971-09-09 00:00:00,Carib West Airways,Landing (descent or approach),Operational,Guadeloupe,Central America,2,2,2,0,0,2,0,Human Factor
1971-11-05 00:00:00,Colombian Air Force - Fuerza Aérea Colombiana,Takeoff (climb),Military / Government,Colombia,South America,2,2,2,0,0,2,0,Technical Failure
1971-12-05 00:00:00,Rousseau Aviation,Landing (descent or approach),Operational,France,Europe,3,3,2,0,0,2,1,Human Factor
1971-12-12 00:00:00,Aeroflot - Russian International Airlines,Takeoff (climb),Operational,Russia,Asia,2,2,2,0,0,2,0,Human Factor
1971-12-21 00:00:00,Lao Airlines,Flight,Commercial,Laos,Asia,3,2,2,1,0,2,1,Unknown
1972-01-29 00:00:00,United States Navy - USN,Flight,Military / Government,World,World,10,10,2,0,0,2,8,Technical Failure
1972-02-16 00:00:00,Hankins Airways,Takeoff (climb),Operational,United States of America,North America,2,1,1,1,1,2,0,Technical Failure
1972-02-18 00:00:00,Olympic Airways,Landing (descent or approach),Operational,France,Europe,2,2,2,0,0,2,0,Unknown
1972-03-02 00:00:00,Winer Sportswear,Takeoff (climb),Business,United States of America,North America,2,1,1,1,1,2,0,Human Factor
1972-03-04 00:00:00,Private American,Takeoff (climb),Business,Bahamas,Central America,6,1,1,5,1,2,4,Unknown
1972-03-15 00:00:00,Picoma Industries,Landing (descent or approach),Business,United States of America,North America,2,1,1,1,1,2,0,Human Factor
1972-04-06 00:00:00,AVENSA - Aerovias Venezolanas,Takeoff (climb),Operational,Venezuela,South America,2,2,2,0,0,2,0,Unknown
1972-04-08 00:00:00,Red Carpet Flying Service,Flight,Specialised Services,United States of America,North America,2,2,2,0,0,2,0,Weather
1972-04-09 00:00:00,United States Army,Landing (descent or approach),Military / Government,United States of America,North America,2,1,1,1,1,2,0,Human Factor
1972-04-13 00:00:00,Brazilian Air Force - Força Aérea Brasileira,Flight,Military / Government,Brazil,South America,10,5,1,5,1,2,8,Technical Failure
1972-04-17 00:00:00,Aeroflot - Russian International Airlines,Flight,Military / Government,Russia,Asia,2,2,2,0,0,2,0,Human Factor
1972-04-21 00:00:00,Navco International,Takeoff (climb),Business,United States of America,North America,6,2,2,4,0,2,4,Human Factor
1972-05-05 00:00:00,Aeroflot - Russian International Airlines,Flight,Military / Government,Ukraine,Europe,2,2,2,0,0,2,0,Human Factor
1972-05-08 00:00:00,Aeroflot - Russian International Airlines,Takeoff (climb),Military / Government,Russia,Asia,2,2,2,0,0,2,0,Human Factor
1972-05-09 00:00:00,Merry Company,Flight,Business,United States of America,North America,2,1,1,1,1,2,0,Human Factor
1972-06-02 00:00:00,Alpine Aviation,Flight,Humanitarian,United States of America,North America,2,2,2,0,0,2,0,Human Factor
1972-06-02 00:00:00,Nusantara Air Taxi,Landing (descent or approach),Commercial,Indonesia,Asia,2,1,1,1,1,2,0,Unknown
1972-06-03 00:00:00,Smyer Commuter Air Lines,Flight,Operational,United States of America,North America,2,1,1,1,1,2,0,Technical Failure
1972-06-15 00:00:00,Aeroflot - Russian International Airlines,Flight,Military / Government,Russia,Asia,2,2,2,0,0,2,0,Technical Failure
1972-07-11 00:00:00,Aeroflot - Russian International Airlines,Takeoff (climb),Operational,Russia,Asia,2,2,2,0,0,2,0,Human Factor
1972-07-12 00:00:00,Black Hills Aviation,Flight,Humanitarian,United States of America,North America,2,2,2,0,0,2,0,Human Factor
1972-08-09 00:00:00,Gateway Aviation,Flight,Specialised Services,Canada,North America,5,1,1,4,1,2,3,Human Factor
1972-08-25 00:00:00,ADM Industries,Landing (descent or approach),Operational,United States of America,North America,2,2,2,0,0,2,0,Human Factor
1972-08-28 00:00:00,Vodavia,Landing (descent or approach),Operational,Austria,Europe,2,2,2,0,0,2,0,Human Factor
1972-08-28 00:00:00,KLM Aerocarto,Flight,Operational,Bolivia,South America,2,2,2,0,0,2,0,Unknown
1972-08-30 00:00:00,Aeroflot - Russian International Airlines,Flight,Military / Government,Russia,Asia,2,2,2,0,0,2,0,Human Factor
1972-09-07 00:00:00,SAVCO - Servicios Aéreos Virgen de Copacabana,Takeoff (climb),Commercial,Bolivia,South America,8,2,2,6,0,2,6,Technical Failure
1972-09-10 00:00:00,Aeroflot - Russian International Airlines,Takeoff (climb),Operational,Ukraine,Europe,2,2,2,0,0,2,0,Human Factor
1972-09-23 00:00:00,Tobey Inc.,Takeoff (climb),Operational,United States of America,North America,2,2,2,0,0,2,0,Technical Failure
1972-10-12 00:00:00,Flamingo Airlines,Flight,Commercial,Bahamas,Central America,2,1,1,1,1,2,0,Weather
1972-10-29 00:00:00,Private American,Flight,Business,United States of America,North America,2,1,1,1,1,2,0,Human Factor
1972-10-31 00:00:00,Avions Marcel Dassault - Groupe Dassault,Flight,Specialised Services,France,Europe,2,2,2,0,0,2,0,Technical Failure
1972-11-06 00:00:00,Sportsman Air,Takeoff (climb),Business,United States of America,North America,2,1,1,1,1,2,0,Human Factor
1972-11-13 00:00:00,Aeroflot - Russian International Airlines,Flight,Commercial,Russia,Asia,14,2,1,12,1,2,12,Human Factor
1972-11-22 00:00:00,Long Island Airlines,Flight,Operational,World,World,2,1,1,1,1,2,0,Unknown
1972-11-29 00:00:00,Luthi Aviation,Landing (descent or approach),Operational,United States of America,North America,2,1,1,1,1,2,0,Technical Failure
1972-12-01 00:00:00,Reindeer Air Service,Flight,Operational,Canada,North America,2,2,2,0,0,2,0,Human Factor
1972-12-15 00:00:00,Zantop International Airlines,Takeoff (climb),Operational,United States of America,North America,2,2,2,0,0,2,0,Unknown
1972-12-18 00:00:00,United States Air Force - USAF,Flight,Military / Government,Vietnam,Asia,6,6,2,0,0,2,4,Terrorism
1972-12-20 00:00:00,United States Air Force - USAF,Flight,Military / Government,Vietnam,Asia,6,6,2,0,0,2,4,Terrorism
1972-12-21 00:00:00,Williams Patent Crusher %26 Pulverizer Company,Landing (descent or approach),Business,United States of America,North America,2,1,1,1,1,2,0,Human Factor
1972-12-26 00:00:00,United States Air Force - USAF,Flight,Military / Government,Vietnam,Asia,6,6,2,0,0,2,4,Terrorism
1972-12-27 00:00:00,United States Air Force - USAF,Flight,Military / Government,Vietnam,Asia,6,6,2,0,0,2,4,Terrorism
1973-02-08 00:00:00,Walker's Truck Contractors,Flight,Business,United States of America,North America,2,1,1,1,1,2,0,Human Factor
1973-02-21 00:00:00,Air Taxi Services,Landing (descent or approach),Commercial,United States of America,North America,3,2,2,1,0,2,1,Human Factor
1973-02-21 00:00:00,Joanne Fashions,Landing (descent or approach),Operational,Colombia,South America,2,2,2,0,0,2,0,Technical Failure
1973-03-07 00:00:00,Ziegler,Takeoff (climb),Operational,United States of America,North America,2,2,2,0,0,2,0,Unknown
1973-03-13 00:00:00,International Paper Company,Landing (descent or approach),Operational,United States of America,North America,3,2,2,1,0,2,1,Technical Failure
1973-03-24 00:00:00,Aeroflot - Russian International Airlines,Flight,Operational,Russia,Asia,3,2,1,1,1,2,1,Human Factor
1973-03-29 00:00:00,Argentinian Air Force - Fuerza Aérea Argentina,Flight,Operational,Argentina,South America,2,2,2,0,0,2,0,Unknown
1973-03-29 00:00:00,Argentinian Air Force - Fuerza Aérea Argentina,Flight,Operational,Argentina,South America,2,2,2,0,0,2,0,Unknown
1973-03-30 00:00:00,Italian Air Force - Aeronautica Militare Italiana,Landing (descent or approach),Operational,Italy,Europe,2,2,2,0,0,2,0,Unknown
1973-03-31 00:00:00,Midwest Tankers,Landing (descent or approach),Business,United States of America,North America,2,1,1,1,1,2,0,Human Factor
1973-04-11 00:00:00,Japan Air Self-Defense Force - Kōkū Jieitai,Flight,Operational,Japan,Asia,2,2,2,0,0,2,0,Human Factor
1973-04-13 00:00:00,Continental Airlines,Takeoff (climb),Operational,United States of America,North America,2,2,2,0,0,2,0,Technical Failure
1973-04-23 00:00:00,Aeroflot - Russian International Airlines,Landing (descent or approach),Commercial,Russia,Asia,57,6,1,51,1,2,55,Terrorism
1973-05-04 00:00:00,Clark Aerial Service,Flight,Military / Government,United States of America,North America,2,2,2,0,0,2,0,Human Factor
1973-05-06 00:00:00,Karol Investment,Landing (descent or approach),Business,Bahamas,Central America,2,2,2,0,0,2,0,Unknown
1973-05-16 00:00:00,Winship Air Services,Landing (descent or approach),Commercial,United States of America,North America,5,1,0,4,2,2,3,Human Factor
1973-06-01 00:00:00,Midwest Air Charter,Flight,Operational,United States of America,North America,2,2,2,0,0,2,0,Technical Failure
1973-06-02 00:00:00,Edwin L. Cook,Flight,Business,United States of America,North America,2,1,1,1,1,2,0,Technical Failure
1973-06-09 00:00:00,VARIG - Viação Aérea Rio Grandense,Landing (descent or approach),Operational,Brazil,South America,4,4,2,0,0,2,2,Human Factor
1973-06-13 00:00:00,Wooley Tool %26 Manufacturing Company,Flight,Business,Mexico,Central America,2,1,1,1,1,2,0,Unknown
1973-06-21 00:00:00,Aeroflot - Russian International Airlines,Flight,Military / Government,Russia,Asia,3,2,1,1,1,2,1,Human Factor
1973-06-24 00:00:00,Aeroflot - Russian International Airlines,Flight,Military / Government,Russia,Asia,2,1,1,1,1,2,0,Human Factor
1973-06-30 00:00:00,Aeroflot - Russian International Airlines,Takeoff (climb),Commercial,Jordan,Asia,85,7,2,78,0,2,83,Human Factor
1973-07-12 00:00:00,Aircraft Specialties Company,Flight,Humanitarian,United States of America,North America,2,2,2,0,0,2,0,Human Factor
1973-07-14 00:00:00,Continental Air Services,Flight,Commercial,Laos,Asia,2,1,1,1,1,2,0,Unknown
1973-07-23 00:00:00,Ehrenström Flyg,Landing (descent or approach),Specialised Services,Greenland,Europe,2,2,2,0,0,2,0,Unknown
1973-07-25 00:00:00,Sécurité civile française,Flight,Humanitarian,France,Europe,2,2,2,0,0,2,0,Human Factor
1973-08-22 00:00:00,Rockwell Aircraft,Flight,Specialised Services,United States of America,North America,2,2,2,0,0,2,0,Human Factor
1973-09-20 00:00:00,Royal Canadian Air Force - RCAF,Flight,Military / Government,Canada,North America,4,4,2,0,0,2,2,Unknown
1973-10-25 00:00:00,Michigan Airtravel Corporation,Takeoff (climb),Business,United States of America,North America,3,1,1,2,1,2,1,Human Factor
1973-10-31 00:00:00,Jack N. Bostwick,Takeoff (climb),Commercial,United States of America,North America,7,2,0,5,2,2,5,Human Factor
1973-11-03 00:00:00,Joseph P. White,Flight,Business,United States of America,North America,2,1,1,1,1,2,0,Unknown
1973-11-21 00:00:00,Landis Sales,Flight,Business,United States of America,North America,2,1,1,1,1,2,0,Technical Failure
1973-12-07 00:00:00,Wyman Pilot Services,Takeoff (climb),Operational,United States of America,North America,2,2,2,0,0,2,0,Human Factor
1973-12-19 00:00:00,Aeroflot - Russian International Airlines,Flight,Commercial,Russia,Asia,2,2,2,0,0,2,0,Weather
1973-12-20 00:00:00,Federal Land Bank of Columbia,Landing (descent or approach),Business,United States of America,North America,3,1,1,2,1,2,1,Human Factor
1974-01-02 00:00:00,Jim Lewis,Flight,Business,United States of America,North America,2,1,1,1,1,2,0,Human Factor
1974-01-04 00:00:00,Midwest Oil Corporation,Takeoff (climb),Operational,United States of America,North America,2,2,2,0,0,2,0,Unknown
1974-01-11 00:00:00,UC Leasing Company,Landing (descent or approach),Business,United States of America,North America,2,2,2,0,0,2,0,Human Factor
1974-01-15 00:00:00,Kerr-McGee Corporation,Landing (descent or approach),Business,United States of America,North America,2,2,2,0,0,2,0,Human Factor
1974-01-22 00:00:00,Aeroflot - Russian International Airlines,Landing (descent or approach),Military / Government,Russia,Asia,2,2,2,0,0,2,0,Human Factor
1974-03-05 00:00:00,United States Air Force - USAF,Takeoff (climb),Operational,United States of America,North America,7,7,2,0,0,2,5,Technical Failure
1974-03-13 00:00:00,Skyway Airlines,Flight,Operational,Australia,Oceania,2,2,2,0,0,2,0,Human Factor
1974-03-24 00:00:00,MU-2 Corporation,Takeoff (climb),Business,Canada,North America,2,2,2,0,0,2,0,Unknown
1974-04-19 00:00:00,Benders Spreading Services,Flight,Military / Government,Australia,Oceania,2,1,1,1,1,2,0,Human Factor
1974-05-12 00:00:00,Aeroflot - Russian International Airlines,Flight,Military / Government,Russia,Asia,2,2,2,0,0,2,0,Human Factor
1974-05-31 00:00:00,Lambair - Lamb Airways,Landing (descent or approach),Operational,Canada,North America,2,2,2,0,0,2,0,Technical Failure
1974-06-07 00:00:00,Varbus Enterprises,Takeoff (climb),Business,United States of America,North America,2,1,1,1,1,2,0,Human Factor
1974-06-09 00:00:00,Air Alpes,Flight,Commercial,France,Europe,8,1,0,7,2,2,6,Unknown
1974-06-12 00:00:00,Master Equipment Company,Flight,Humanitarian,United States of America,North America,2,2,2,0,0,2,0,Human Factor
1974-06-22 00:00:00,Holladay Aero Sales,Landing (descent or approach),Operational,United States of America,North America,2,2,2,0,0,2,0,Human Factor
1974-06-27 00:00:00,SS%26T Aerial Contractors,Flight,Humanitarian,United States of America,North America,2,2,2,0,0,2,0,Human Factor
1974-06-27 00:00:00,Brazilian Air Force - Força Aérea Brasileira,Takeoff (climb),Military / Government,Brazil,South America,2,2,2,0,0,2,0,Unknown
1974-07-04 00:00:00,Aeroflot - Russian International Airlines,Flight,Business,Russia,Asia,2,1,1,1,1,2,0,Human Factor
1974-08-07 00:00:00,Aero Proveedora Proa,Landing (descent or approach),Operational,Colombia,South America,6,6,2,0,0,2,4,Human Factor
1974-08-12 00:00:00,Conair Aviation,Flight,Humanitarian,Canada,North America,2,2,2,0,0,2,0,Unknown
1974-08-23 00:00:00,Aeroflot - Russian International Airlines,Flight,Military / Government,Russia,Asia,7,2,0,5,2,2,5,Human Factor
1974-08-24 00:00:00,Aircraft Mobilehomes,Flight,Business,United States of America,North America,2,1,1,1,1,2,0,Human Factor
1974-09-02 00:00:00,Anglo Normandy Airways,Takeoff (climb),Operational,New Zealand,Oceania,2,1,1,1,1,2,0,Technical Failure
1974-09-11 00:00:00,Madison Nation Airways,Takeoff (climb),Operational,United States of America,North America,2,2,2,0,0,2,0,Human Factor
1974-10-02 00:00:00,North Cay Airways,Landing (descent or approach),Operational,United States of America,Central America,2,1,1,1,1,2,0,Unknown
1974-10-18 00:00:00,Brazilian Air Force - Força Aérea Brasileira,Takeoff (climb),Operational,Brazil,South America,4,4,2,0,0,2,2,Unknown
1974-10-24 00:00:00,Altus Airlines,Landing (descent or approach),Commercial,United States of America,North America,4,1,0,3,2,2,2,Human Factor
1974-10-30 00:00:00,Río Táxi Aéreo,Takeoff (climb),Operational,Brazil,South America,2,2,2,0,0,2,0,Technical Failure
1974-11-02 00:00:00,V.J. Corporation,Flight,Business,United States of America,North America,2,1,1,1,1,2,0,Weather
1974-11-20 00:00:00,Ethiopian Airlines,Takeoff (climb),Commercial,Ethiopia,Africa,24,3,2,21,0,2,22,Unknown
1974-11-21 00:00:00,Air Taxi Company,Landing (descent or approach),Operational,Iran,Asia,3,3,2,0,0,2,1,Human Factor
1974-12-01 00:00:00,Southern Services,Landing (descent or approach),Business,United States of America,North America,4,2,2,2,0,2,2,Human Factor
1974-12-30 00:00:00,Argentinian Air Force - Fuerza Aérea Argentina,Flight,Operational,Argentina,South America,2,2,2,0,0,2,0,Unknown
1974-12-31 00:00:00,Misener Marine,Landing (descent or approach),Business,United States of America,North America,2,1,1,1,1,2,0,Weather
1975-01-02 00:00:00,United States Air Force - USAF,Takeoff (climb),Military / Government,United States of America,North America,6,6,2,0,0,2,4,Technical Failure
1975-01-11 00:00:00,Real Aero Club de Barcelona,Takeoff (climb),Operational,Switzerland,Europe,2,2,2,0,0,2,0,Human Factor
1975-01-19 00:00:00,Faulkner Concrete Pipe Company,Landing (descent or approach),Business,United States of America,North America,2,1,1,1,1,2,0,Human Factor
1975-01-30 00:00:00,Lineas Aérea Nacional - LAN,Takeoff (climb),Commercial,Dominican Republic,Central America,30,3,1,27,1,2,28,Technical Failure
1975-02-01 00:00:00,Aeroflot - Russian International Airlines,Flight,Operational,Russia,Asia,2,2,2,0,0,2,0,Other
1975-02-01 00:00:00,EBCO Manufacturing Company,Landing (descent or approach),Business,United States of America,North America,2,2,2,0,0,2,0,Human Factor
1975-02-01 00:00:00,Kenai Air Services,Flight,Commercial,United States of America,North America,2,1,1,1,1,2,0,Human Factor
1975-02-05 00:00:00,Agrocom Servicios Aéreos,Takeoff (climb),Operational,Argentina,South America,2,2,2,0,0,2,0,Technical Failure
1975-02-08 00:00:00,Aeroflot - Russian International Airlines,Takeoff (climb),Operational,Russia,Asia,2,2,2,0,0,2,0,Technical Failure
1975-03-01 00:00:00,Airwork - New Zealand,Flight,Military / Government,New Zealand,Oceania,2,1,1,1,1,2,0,Unknown
1975-03-07 00:00:00,Aeroflot - Russian International Airlines,Flight,Operational,Russia,Asia,2,2,2,0,0,2,0,Weather
1975-03-08 00:00:00,Kerr-McGee Corporation,Flight,Business,United States of America,North America,2,1,1,1,1,2,0,Human Factor
1975-03-19 00:00:00,Aeroflot - Russian International Airlines,Landing (descent or approach),Operational,Turkmenistan,Asia,3,2,1,1,1,2,1,Human Factor
1975-03-31 00:00:00,Hartzog Aviation,Takeoff (climb),Humanitarian,Mexico,Central America,2,2,2,0,0,2,0,Human Factor
1975-04-01 00:00:00,Dallas Chapter,Flight,Humanitarian,Mexico,Central America,2,2,2,0,0,2,0,Human Factor
1975-04-14 00:00:00,Magnavox Corporation,Landing (descent or approach),Business,United States of America,North America,2,2,2,0,0,2,0,Human Factor
1975-04-28 00:00:00,Aeroflot - Russian International Airlines,Flight,Operational,Russia,Asia,2,2,2,0,0,2,0,Unknown
1975-05-10 00:00:00,Air Express - Australia,Flight,Operational,Australia,Oceania,2,2,2,0,0,2,0,Technical Failure
1975-05-29 00:00:00,Colonial Bank,Landing (descent or approach),Humanitarian,United States of America,North America,2,2,2,0,0,2,0,Human Factor
1975-06-03 00:00:00,Private American,Flight,Humanitarian,United States of America,North America,2,2,2,0,0,2,0,Human Factor
1975-06-16 00:00:00,Aeroflot - Russian International Airlines,Flight,Military / Government,Russia,Asia,2,1,1,1,1,2,0,Human Factor
1975-06-26 00:00:00,Hamilton Aviation,Landing (descent or approach),Operational,United States of America,North America,2,2,2,0,0,2,0,Human Factor
1975-07-02 00:00:00,Southern Aviation - USA,Takeoff (climb),Operational,United States of America,North America,2,2,2,0,0,2,0,Human Factor
1975-07-10 00:00:00,Aerocondor de Colombia - Aerovias Condor,Takeoff (climb),Operational,Colombia,South America,4,4,2,0,0,2,2,Human Factor
1975-07-22 00:00:00,United States Forest Service - USFS,Flight,Operational,United States of America,North America,2,2,2,0,0,2,0,Technical Failure
1975-07-28 00:00:00,Airea Enterprises,Flight,Business,United States of America,North America,2,2,2,0,0,2,0,Human Factor
1975-08-03 00:00:00,Aeroflot - Russian International Airlines,Flight,Military / Government,Moldova,Europe,4,2,1,2,1,2,2,Human Factor
1975-09-11 00:00:00,Stoney's Rainbow Lanes %26 Lounge,Takeoff (climb),Operational,United States of America,North America,2,2,2,0,0,2,0,Unknown
1975-09-19 00:00:00,Bulair,Flight,Military / Government,Bulgaria,Europe,2,2,2,0,0,2,0,Unknown
1975-10-28 00:00:00,Klorer-Willhardt Inc.,Flight,Business,United States of America,North America,2,1,1,1,1,2,0,Human Factor
1975-10-28 00:00:00,Lee R. Griffith,Flight,Business,United States of America,North America,2,1,1,1,1,2,0,Unknown
1975-11-30 00:00:00,Scenic Airlines,Landing (descent or approach),Commercial,United States of America,North America,2,1,1,1,1,2,0,Human Factor
1975-12-21 00:00:00,United States Navy - USN,Flight,Operational,United States of America,North America,2,2,2,0,0,2,0,Unknown
1975-12-24 00:00:00,SS Airways,Landing (descent or approach),Operational,United States of America,North America,2,1,1,1,1,2,0,Technical Failure
1975-12-29 00:00:00,Bayview Air Services,Landing (descent or approach),Commercial,Canada,North America,11,2,2,9,0,2,9,Human Factor
1976-01-07 00:00:00,Labrador Airways,Takeoff (climb),Commercial,Canada,North America,6,1,0,5,2,2,4,Unknown
1976-01-21 00:00:00,West Virginia Division of Natural Resources,Flight,Military / Government,United States of America,North America,2,2,2,0,0,2,0,Technical Failure
1976-02-03 00:00:00,Falcon Airways - USA,Takeoff (climb),Operational,United States of America,North America,2,1,1,1,1,2,0,Human Factor
1976-02-24 00:00:00,Gateway Aviation,Landing (descent or approach),Commercial,Canada,North America,3,1,1,2,1,2,1,Unknown
1976-03-23 00:00:00,Private American,Flight,Business,United States of America,North America,2,1,1,1,1,2,0,Human Factor
1976-03-29 00:00:00,Private American,Takeoff (climb),Business,United States of America,North America,2,1,1,1,1,2,0,Human Factor
1976-04-09 00:00:00,Connecticut National Bank,Takeoff (climb),Business,United States of America,North America,2,2,2,0,0,2,0,Human Factor
1976-04-09 00:00:00,Aviatia Utilitara,Flight,Military / Government,Romania,Europe,2,2,2,0,0,2,0,Weather
1976-04-14 00:00:00,Beau Morgan,Flight,Business,Jamaica,Central America,2,1,1,1,1,2,0,Technical Failure
1976-04-27 00:00:00,681 Ltd,Landing (descent or approach),Operational,United States of America,North America,2,1,1,1,1,2,0,Human Factor
1976-04-27 00:00:00,Royal Air Force - RAF,Landing (descent or approach),Operational,United Kingdom,Europe,3,3,2,0,0,2,1,Human Factor
1976-05-06 00:00:00,South African Air Force,Flight,Military / Government,South Africa,Africa,2,2,2,0,0,2,0,Unknown
1976-05-08 00:00:00,Bill Hames Shows,Takeoff (climb),Specialised Services,United States of America,North America,2,2,2,0,0,2,0,Human Factor
1976-05-23 00:00:00,Bulair,Flight,Military / Government,Bulgaria,Europe,2,2,2,0,0,2,0,Unknown
1976-06-11 00:00:00,Alaska Aeronautical Industries,Flight,Commercial,United States of America,North America,2,1,1,1,1,2,0,Human Factor
1976-06-20 00:00:00,Aeroflot - Russian International Airlines,Flight,Military / Government,Russia,Asia,2,2,2,0,0,2,0,Human Factor
1976-07-01 00:00:00,Aeroflot - Russian International Airlines,Flight,Commercial,Armenia,Asia,2,2,2,0,0,2,0,Human Factor
1976-07-01 00:00:00,Aeroflot - Russian International Airlines,Flight,Military / Government,Russia,Asia,3,2,1,1,1,2,1,Technical Failure
1976-07-18 00:00:00,Aeroflot - Russian International Airlines,Takeoff (climb),Military / Government,Kazakhstan,Asia,2,2,2,0,0,2,0,Technical Failure
1976-08-03 00:00:00,Aeroflot - Russian International Airlines,Flight,Business,Russia,Asia,5,2,0,3,2,2,3,Human Factor
1976-08-06 00:00:00,War Aero,Takeoff (climb),Operational,United States of America,North America,2,2,2,0,0,2,0,Technical Failure
1976-08-06 00:00:00,Government Aircraft Factories - GAF,Takeoff (climb),Specialised Services,Australia,Oceania,3,3,2,0,0,2,1,Other
1976-08-17 00:00:00,Frank M. Stankovich,Flight,Business,United States of America,North America,2,1,1,1,1,2,0,Human Factor
1976-09-01 00:00:00,Ortner Air Services,Landing (descent or approach),Operational,United States of America,North America,2,2,2,0,0,2,0,Unknown
1976-09-15 00:00:00,Open Air International,Takeoff (climb),Business,United States of America,North America,2,1,1,1,1,2,0,Human Factor
1976-09-19 00:00:00,Private American,Flight,Humanitarian,United States of America,North America,2,1,1,1,1,2,0,Human Factor
1976-09-24 00:00:00,Aerosucre Colombia,Takeoff (climb),Operational,Netherlands,Central America,2,2,2,0,0,2,0,Unknown
1976-10-05 00:00:00,Royal Canadian Air Force - RCAF,Flight,Operational,Canada,North America,2,2,2,0,0,2,0,Unknown
1976-10-28 00:00:00,Nordeste Linhas Aéreas Regionais,Takeoff (climb),Commercial,Brazil,South America,7,2,2,5,0,2,5,Unknown
1976-11-05 00:00:00,Inair Panama - Internacional de Aviación,Takeoff (climb),Operational,Netherlands,Central America,2,2,2,0,0,2,0,Unknown
1976-11-11 00:00:00,Centurion Builders,Landing (descent or approach),Business,United States of America,North America,9,1,1,8,1,2,7,Technical Failure
1976-11-18 00:00:00,Depositor Canales,Flight,Business,Mexico,Central America,2,2,2,0,0,2,0,Unknown
1976-11-19 00:00:00,Portuguese Air Force - Força Aerea Portuguesa,Landing (descent or approach),Military / Government,Portugal,Europe,2,2,2,0,0,2,0,Human Factor
1976-11-29 00:00:00,Crowley Maritime Corporation,Takeoff (climb),Business,United States of America,North America,2,1,1,1,1,2,0,Human Factor
1976-12-09 00:00:00,Red River Ranch Inc.,Flight,Humanitarian,United States of America,North America,2,2,2,0,0,2,0,Technical Failure
1976-12-29 00:00:00,J %26 L Aircraft,Landing (descent or approach),Business,United States of America,North America,2,1,1,1,1,2,0,Technical Failure
1977-01-06 00:00:00,Jet Avia,Landing (descent or approach),Operational,United States of America,North America,2,2,2,0,0,2,0,Human Factor
1977-01-16 00:00:00,John D. Fonseca,Landing (descent or approach),Business,United States of America,North America,2,2,2,0,0,2,0,Human Factor
1977-01-25 00:00:00,Herman E. Shaw Jr.,Landing (descent or approach),Operational,United States of America,North America,2,2,2,0,0,2,0,Human Factor
1977-02-01 00:00:00,Royal Thai Air Force - Kong Thap Akat Thai,Flight,Military / Government,Thailand,Asia,2,1,1,1,1,2,0,Unknown
1977-02-03 00:00:00,Swearingen Aviation,Landing (descent or approach),Business,United States of America,North America,2,2,2,0,0,2,0,Human Factor
1977-02-09 00:00:00,Argentinian Air Force - Fuerza Aérea Argentina,Flight,Operational,Argentina,South America,2,2,2,0,0,2,0,Unknown
1977-03-04 00:00:00,Overseas National Airways - ONA,Landing (descent or approach),Operational,Niger,Africa,4,4,2,0,0,2,2,Human Factor
1977-03-18 00:00:00,Aeroflot - Russian International Airlines,Flight,Military / Government,Uzbekistan,Asia,2,2,2,0,0,2,0,Human Factor
1977-04-13 00:00:00,Equipment Specialists,Flight,Business,Colombia,South America,2,2,2,0,0,2,0,Unknown
1977-04-20 00:00:00,Aeroflot - Russian International Airlines,Takeoff (climb),Military / Government,Belarus,Europe,2,2,2,0,0,2,0,Human Factor
1977-04-28 00:00:00,Arab Wings,Takeoff (climb),Operational,Saudi Arabia,Asia,2,2,2,0,0,2,0,Human Factor
1977-07-02 00:00:00,Aeroexpreso de Cañar,Takeoff (climb),Commercial,Colombia,South America,2,1,1,1,1,2,0,Unknown
1977-07-18 00:00:00,Private American,Flight,Military / Government,United States of America,North America,2,2,2,0,0,2,0,Human Factor
1977-07-20 00:00:00,Northern Flying Service,Takeoff (climb),Operational,Canada,North America,2,2,2,0,0,2,0,Unknown
1977-08-22 00:00:00,Air Fast Freight,Takeoff (climb),Operational,United States of America,North America,2,2,2,0,0,2,0,Technical Failure
1977-08-25 00:00:00,Air Cargo Hawaii,Landing (descent or approach),Operational,United States of America,North America,2,2,2,0,0,2,0,Human Factor
1977-09-23 00:00:00,Drives Inc.,Flight,Business,United States of America,North America,2,1,1,1,1,2,0,Technical Failure
1977-09-28 00:00:00,Sky Line Flying Services,Flight,Operational,United States of America,North America,2,2,2,0,0,2,0,Human Factor
1977-10-06 00:00:00,Turkish Navy - Türk Deniz Kuvvetleri,Flight,Operational,Turkey,Asia,2,2,2,0,0,2,0,Unknown
1977-10-18 00:00:00,Mandala Airlines,Takeoff (climb),Operational,Philippines,Asia,5,3,2,2,0,2,3,Human Factor
1977-11-08 00:00:00,Argentinian Air Force - Fuerza Aérea Argentina,Flight,Operational,Argentina,South America,2,2,2,0,0,2,0,Unknown
1977-11-21 00:00:00,Munz Northern Airlines,Flight,Commercial,United States of America,North America,2,1,1,1,1,2,0,Unknown
1977-12-08 00:00:00,Líder Taxi Aéreo,Landing (descent or approach),Business,Brazil,South America,2,2,2,0,0,2,0,Unknown
1978-01-20 00:00:00,Argentinian Navy - Armada Argentina,Takeoff (climb),Military / Government,Argentina,South America,5,1,0,4,2,2,3,Unknown
1978-01-24 00:00:00,Henry Weber Air,Takeoff (climb),Commercial,United States of America,North America,2,1,1,1,1,2,0,Technical Failure
1978-01-25 00:00:00,Argentinian Air Force - Fuerza Aérea Argentina,Flight,Military / Government,Argentina,South America,2,2,2,0,0,2,0,Unknown
1978-01-28 00:00:00,Air Tchad,Landing (descent or approach),Operational,Chad,Africa,2,2,2,0,0,2,0,Terrorism
1978-01-31 00:00:00,Transportes Aéreos Regionais da Bacia Amazônica - TABA,Takeoff (climb),Commercial,Brazil,South America,14,2,2,12,0,2,12,Unknown
1978-02-01 00:00:00,Aeroflot - Russian International Airlines,Flight,Operational,Russia,Asia,2,2,2,0,0,2,0,Human Factor
1978-02-11 00:00:00,C %26 M Aircraft Parts %26 Salvage Company,Flight,Humanitarian,United States of America,North America,2,1,1,1,1,2,0,Human Factor
1978-02-18 00:00:00,Harding College,Landing (descent or approach),Operational,United States of America,North America,4,2,0,2,2,2,2,Human Factor
1978-03-01 00:00:00,Continental Airlines,Takeoff (climb),Commercial,United States of America,North America,200,14,0,186,2,2,198,Technical Failure
1978-03-05 00:00:00,Norving,Landing (descent or approach),Commercial,Norway,Europe,3,2,2,1,0,2,1,Weather
1978-03-12 00:00:00,Aircraft Brokers,Flight,Operational,Colombia,South America,2,2,2,0,0,2,0,Technical Failure
1978-03-14 00:00:00,Wyman Pilot Services,Landing (descent or approach),Operational,United States of America,North America,2,1,1,1,1,2,0,Weather
1978-03-17 00:00:00,Vernair Transport,Flight,Operational,Greenland,Europe,2,2,2,0,0,2,0,Human Factor
1978-03-19 00:00:00,J %26 W Refining Company,Flight,Business,United States of America,North America,2,1,1,1,1,2,0,Human Factor
1978-03-25 00:00:00,Eulalio Castro,Flight,Business,World,World,2,2,2,0,0,2,0,Human Factor
1978-04-02 00:00:00,Bush Air,Landing (descent or approach),Operational,United States of America,North America,2,2,2,0,0,2,0,Other
1978-04-05 00:00:00,Antilles Air Boats,Flight,Commercial,United States of America,Central America,9,2,2,7,0,2,7,Human Factor
1978-04-17 00:00:00,Linea Aeropostal Venezolana - LAV,Takeoff (climb),Operational,Venezuela,South America,2,2,2,0,0,2,0,Unknown
1978-04-18 00:00:00,Chitna Air Service,Takeoff (climb),Operational,United States of America,North America,2,2,2,0,0,2,0,Human Factor
1978-04-20 00:00:00,Korean Air,Flight,Commercial,Russia,Asia,109,12,0,97,2,2,107,Terrorism
1978-04-27 00:00:00,Universal Air Leasing,Flight,Business,United States of America,North America,2,2,2,0,0,2,0,Technical Failure
1978-04-30 00:00:00,Southern Aero Traders,Flight,Humanitarian,United States of America,North America,2,2,2,0,0,2,0,Human Factor
1978-05-17 00:00:00,Jamaica Defence Force,Landing (descent or approach),Operational,Jamaica,Central America,2,2,2,0,0,2,0,Unknown
1978-05-21 00:00:00,The Flying Fireman,Flight,Humanitarian,Canada,North America,2,2,2,0,0,2,0,Technical Failure
1978-05-23 00:00:00,Aeroflot - Russian International Airlines,Flight,Specialised Services,Russia,Asia,8,8,2,0,0,2,6,Technical Failure
1978-05-26 00:00:00,Lumanair,Flight,Business,Bahamas,Central America,2,2,2,0,0,2,0,Unknown
1978-05-27 00:00:00,International Crystal Manufacturing Company,Flight,Business,United States of America,North America,2,2,2,0,0,2,0,Weather
1978-06-13 00:00:00,Argentinian Air Force - Fuerza Aérea Argentina,Flight,Operational,Argentina,South America,2,2,2,0,0,2,0,Unknown
1978-06-26 00:00:00,Air Canada,Takeoff (climb),Commercial,Canada,North America,107,5,0,102,2,2,105,Technical Failure
1978-07-02 00:00:00,I. Tippett,Flight,Business,Australia,Oceania,2,1,1,1,1,2,0,Unknown
1978-07-09 00:00:00,Lineas Aéreas Orientales,Flight,Operational,Colombia,South America,2,2,2,0,0,2,0,Unknown
1978-07-17 00:00:00,Private Venezuelan,Takeoff (climb),Business,Venezuela,South America,2,1,1,1,1,2,0,Unknown
1978-07-18 00:00:00,Latimer W. Spinney,Flight,Business,World,World,2,1,1,1,1,2,0,Unknown
1978-07-19 00:00:00,Custom Air,Landing (descent or approach),Business,United States of America,North America,2,2,2,0,0,2,0,Human Factor
1978-08-07 00:00:00,Central Flying Service,Flight,Business,Bahamas,Central America,2,1,1,1,1,2,0,Technical Failure
1978-08-10 00:00:00,Encal Servicio Aéreo,Flight,Commercial,Brazil,South America,3,1,1,2,1,2,1,Unknown
1978-08-14 00:00:00,United States Navy - USN,Flight,Military / Government,Guam Island,Asia,30,5,1,25,1,2,28,Technical Failure
1978-08-18 00:00:00,Royal Thai Air Force - Kong Thap Akat Thai,Takeoff (climb),Operational,Thailand,Asia,2,2,2,0,0,2,0,Unknown
1978-08-24 00:00:00,United States Navy - USN,Landing (descent or approach),Operational,United States of America,North America,2,2,2,0,0,2,0,Technical Failure
1978-08-28 00:00:00,Arthur B. Lee Jr.,Takeoff (climb),Business,United States of America,North America,2,2,2,0,0,2,0,Human Factor
1978-09-04 00:00:00,Mission Air Lift,Takeoff (climb),Operational,United States of America,North America,2,2,2,0,0,2,0,Human Factor
1978-09-08 00:00:00,Aeroflot - Russian International Airlines,Flight,Military / Government,Ukraine,Europe,2,2,2,0,0,2,0,Human Factor
1978-09-18 00:00:00,Palmer Air Charter,Flight,Operational,United States of America,North America,2,1,1,1,1,2,0,Human Factor
1978-10-03 00:00:00,Burma Airways,Takeoff (climb),Commercial,Myanmar,Asia,44,4,1,40,1,2,42,Technical Failure
1978-10-17 00:00:00,Aeroflot - Russian International Airlines,Flight,Military / Government,Ukraine,Europe,2,2,2,0,0,2,0,Human Factor
1978-11-16 00:00:00,Festus Flying Service,Landing (descent or approach),Operational,United States of America,North America,2,1,1,1,1,2,0,Human Factor
1978-12-04 00:00:00,Rocky Mountain Airways,Takeoff (climb),Commercial,United States of America,North America,22,2,1,20,1,2,20,Weather
1978-12-11 00:00:00,Aircraft Sales %26 Leasing - ASL,Landing (descent or approach),Humanitarian,United States of America,North America,2,2,2,0,0,2,0,Technical Failure
1978-12-21 00:00:00,Chugiak Aviation,Landing (descent or approach),Commercial,United States of America,North America,7,1,0,6,2,2,5,Human Factor
1979-01-04 00:00:00,Union Flights,Takeoff (climb),Operational,United States of America,North America,2,2,2,0,0,2,0,Human Factor
1979-01-11 00:00:00,Northeast Cellulose,Flight,Business,United States of America,North America,2,1,1,1,1,2,0,Human Factor
1979-01-16 00:00:00,Steele Aviation,Landing (descent or approach),Humanitarian,United States of America,North America,2,1,1,1,1,2,0,Human Factor
1979-02-12 00:00:00,Allegheny Airlines,Takeoff (climb),Commercial,United States of America,North America,25,3,1,22,1,2,23,Weather
1979-02-17 00:00:00,Velocity,Flight,Business,United States of America,North America,2,1,1,1,1,2,0,Human Factor
1979-02-17 00:00:00,Air New Zealand,Landing (descent or approach),Commercial,New Zealand,Oceania,4,2,1,2,1,2,2,Human Factor
1979-02-18 00:00:00,Aeroflot - Russian International Airlines,Flight,Operational,Kyrgyzstan,Asia,3,2,1,1,1,2,1,Human Factor
1979-03-11 00:00:00,Dale Langley,Flight,Business,United States of America,North America,3,1,1,2,1,2,1,Technical Failure
1979-03-19 00:00:00,Private American,Landing (descent or approach),Humanitarian,United States of America,North America,2,2,2,0,0,2,0,Technical Failure
1979-03-23 00:00:00,Great Western Airlines,Takeoff (climb),Operational,United States of America,North America,2,2,2,0,0,2,0,Human Factor
1979-04-20 00:00:00,South Central Aviation,Landing (descent or approach),Operational,Mexico,Central America,2,2,2,0,0,2,0,Unknown
1979-04-27 00:00:00,Bay Aerostar Sales %26 Service,Landing (descent or approach),Operational,United States of America,North America,2,2,2,0,0,2,0,Human Factor
1979-04-27 00:00:00,Triple D Transport Company,Flight,Business,Cuba,Central America,2,2,2,0,0,2,0,Technical Failure
1979-04-28 00:00:00,Florida Aircraft Exchange,Landing (descent or approach),Humanitarian,United States of America,North America,2,2,2,0,0,2,0,Human Factor
1979-04-29 00:00:00,Ecuadorian Navy - Aviación Naval Ecuatoriana,Flight,Military / Government,Ecuador,South America,7,2,0,5,2,2,5,Unknown
1979-05-01 00:00:00,Canadian Government,Flight,Military / Government,Canada,North America,2,2,2,0,0,2,0,Technical Failure
1979-05-13 00:00:00,Verna Drilling Company,Takeoff (climb),Business,United States of America,North America,6,1,1,5,1,2,4,Technical Failure
1979-05-26 00:00:00,Inter Island Shipping Inc.,Takeoff (climb),Business,United States of America,North America,2,1,1,1,1,2,0,Technical Failure
1979-06-07 00:00:00,Aeroflot - Russian International Airlines,Flight,Military / Government,Russia,Asia,2,2,2,0,0,2,0,Human Factor
1979-06-09 00:00:00,Skystream Airlines,Landing (descent or approach),Operational,United States of America,North America,2,1,1,1,1,2,0,Human Factor
1979-06-12 00:00:00,Bradley Aviation,Takeoff (climb),Operational,United States of America,North America,2,2,2,0,0,2,0,Human Factor
1979-06-20 00:00:00,Aeroflot - Russian International Airlines,Flight,Military / Government,Russia,Asia,2,2,2,0,0,2,0,Human Factor
1979-07-03 00:00:00,Aeroflot - Russian International Airlines,Flight,Military / Government,Ukraine,Europe,2,1,1,1,1,2,0,Human Factor
1979-07-06 00:00:00,Chapman Commodities,Landing (descent or approach),Operational,United States of America,North America,3,3,2,0,0,2,1,Human Factor
1979-07-20 00:00:00,Trans National Airlines - TNA,Flight,Operational,United States of America,North America,2,2,2,0,0,2,0,Technical Failure
1979-07-20 00:00:00,Kimex,Landing (descent or approach),Operational,Jamaica,Central America,4,3,1,1,1,2,2,Human Factor
1979-08-09 00:00:00,MOM - Ministerstvo Obshego Mashinostroenia,Taxiing,Operational,Russia,Asia,10,8,1,2,1,2,8,Technical Failure
1979-08-09 00:00:00,Botswana Defence Force - Air Wing,Flight,Operational,Botswana,Africa,2,2,2,0,0,2,0,Terrorism
1979-08-10 00:00:00,Norfish,Landing (descent or approach),Operational,Australia,Oceania,2,1,1,1,1,2,0,Technical Failure
1979-09-15 00:00:00,Private Brazilian,Landing (descent or approach),Business,Brazil,South America,3,1,1,2,1,2,1,Human Factor
1979-09-25 00:00:00,Eagle Aircraft Services,Flight,Operational,France,Europe,2,2,2,0,0,2,0,Human Factor
1979-09-30 00:00:00,West Coast Air Services,Landing (descent or approach),Commercial,Canada,North America,16,2,1,14,1,2,14,Human Factor
1979-10-19 00:00:00,Valley Equity Management Group,Landing (descent or approach),Business,United States of America,North America,3,1,0,2,2,2,1,Other
1979-10-30 00:00:00,Frontier Flying Service,Landing (descent or approach),Operational,United States of America,North America,2,2,2,0,0,2,0,Human Factor
1979-11-11 00:00:00,Aeroflot - Russian International Airlines,Takeoff (climb),Commercial,Russia,Asia,17,2,0,15,2,2,15,Human Factor
1979-11-19 00:00:00,National Jet Industries,Landing (descent or approach),Operational,United States of America,North America,3,2,1,1,1,2,1,Human Factor
1979-11-19 00:00:00,Tiburon Aircraft,Landing (descent or approach),Humanitarian,United States of America,North America,2,2,2,0,0,2,0,Human Factor
1979-12-15 00:00:00,Venezuelan Government,Flight,Military / Government,Venezuela,South America,5,2,2,3,0,2,3,Unknown
1979-12-18 00:00:00,Eastern Flying Services,Landing (descent or approach),Commercial,Canada,North America,2,1,1,1,1,2,0,Unknown
1979-12-21 00:00:00,Brad Ragan Inc.,Landing (descent or approach),Business,United States of America,North America,2,1,1,1,1,2,0,Human Factor
1979-12-22 00:00:00,Hudson %26 Marshall,Flight,Business,United States of America,North America,2,1,1,1,1,2,0,Human Factor
1979-12-27 00:00:00,Honduran Air Force - Fuerza Aérea Hondureña,Flight,Military / Government,Honduras,Central America,7,2,2,5,0,2,5,Unknown
1980-01-08 00:00:00,Polynesian Air-Ways,Takeoff (climb),Operational,United States of America,North America,2,2,2,0,0,2,0,Human Factor
1980-01-11 00:00:00,Nichols Construction,Flight,Business,World,World,2,1,1,1,1,2,0,Technical Failure
1980-01-14 00:00:00,British Army Air Corps,Landing (descent or approach),Military / Government,United Kingdom,Europe,2,1,1,1,1,2,0,Human Factor
1980-01-15 00:00:00,Umbufto Swaziland Defence Force,Flight,Operational,Malawi,Africa,2,2,2,0,0,2,0,Unknown
1980-01-21 00:00:00,Sea Bee Air,Landing (descent or approach),Operational,New Zealand,Oceania,2,2,2,0,0,2,0,Unknown
1980-01-30 00:00:00,Bardhal de Mexico,Landing (descent or approach),Business,United States of America,North America,2,2,2,0,0,2,0,Human Factor
1980-01-30 00:00:00,Kellogg Company,Takeoff (climb),Business,United States of America,North America,6,2,1,4,1,2,4,Human Factor
1980-02-04 00:00:00,Air National,Flight,Specialised Services,United States of America,North America,2,1,1,1,1,2,0,Human Factor
1980-02-14 00:00:00,Nilo Batista,Flight,Business,United States of America,North America,2,1,1,1,1,2,0,Human Factor
1980-02-27 00:00:00,China Airlines,Landing (descent or approach),Commercial,Philippines,Asia,135,11,0,124,2,2,133,Human Factor
1980-03-06 00:00:00,Century Airlines,Takeoff (climb),Operational,United States of America,North America,2,2,2,0,0,2,0,Human Factor
1980-03-07 00:00:00,Ecuavia,Flight,Operational,Ecuador,South America,2,2,2,0,0,2,0,Unknown
1980-03-10 00:00:00,Joseph L. Gallagher,Landing (descent or approach),Business,United States of America,North America,2,1,1,1,1,2,0,Human Factor
1980-03-14 00:00:00,Nolen Truly,Takeoff (climb),Specialised Services,United States of America,North America,2,1,1,1,1,2,0,Human Factor
1980-03-20 00:00:00,Peterson Industries,Landing (descent or approach),Business,United States of America,North America,2,1,1,1,1,2,0,Human Factor
1980-03-23 00:00:00,Northair Aviation,Landing (descent or approach),Specialised Services,United Kingdom,Europe,2,1,1,1,1,2,0,Human Factor
1980-04-01 00:00:00,Montana Power Company,Landing (descent or approach),Business,United States of America,North America,2,1,1,1,1,2,0,Human Factor
1980-04-08 00:00:00,Bjornson Development Company,Takeoff (climb),Business,United States of America,North America,3,1,0,2,2,2,1,Human Factor
1980-04-08 00:00:00,Bali International Air Service,Takeoff (climb),Commercial,Indonesia,Asia,9,2,0,7,2,2,7,Unknown
1980-04-11 00:00:00,Thunderbird Airways,Flight,Operational,United States of America,North America,2,2,2,0,0,2,0,Unknown
1980-04-11 00:00:00,Wekos Schrotthandels,Landing (descent or approach),Business,Switzerland,Europe,2,1,1,1,1,2,0,Human Factor
1980-04-14 00:00:00,Aeroflot - Russian International Airlines,Landing (descent or approach),Commercial,Russia,Asia,53,4,0,49,2,2,51,Technical Failure
1980-04-16 00:00:00,Belgian Air Force - Force Aérienne Belge - Belgische Luchtmacht,Landing (descent or approach),Operational,France,Europe,2,2,2,0,0,2,0,Technical Failure
1980-05-06 00:00:00,Kennedy Flite Center,Landing (descent or approach),Operational,United States of America,North America,2,2,2,0,0,2,0,Human Factor
1980-05-19 00:00:00,Northeast Jet,Flight,Operational,World,World,2,2,2,0,0,2,0,Weather
1980-05-22 00:00:00,German Air Force - Deutsche Luftwaffe,Flight,Operational,Germany,Europe,2,2,2,0,0,2,0,Unknown
1980-07-02 00:00:00,Royal Thai Navy - Kong Thap Ruea Thai,Flight,Operational,World,World,21,2,0,19,2,2,19,Unknown
1980-07-04 00:00:00,Marian Air Service,Flight,Military / Government,United States of America,North America,2,2,2,0,0,2,0,Other
1980-07-06 00:00:00,Aeroflot - Russian International Airlines,Flight,Military / Government,Russia,Asia,2,1,1,1,1,2,0,Human Factor
1980-07-24 00:00:00,ATESA - Aero Taxis Ecuatorianos,Landing (descent or approach),Operational,Ecuador,South America,2,2,2,0,0,2,0,Unknown
1980-07-25 00:00:00,Flying Eagles,Flight,Humanitarian,United States of America,North America,2,1,1,1,1,2,0,Technical Failure
1980-07-30 00:00:00,First Interamerica Corporation,Flight,Humanitarian,United States of America,North America,2,1,1,1,1,2,0,Human Factor
1980-08-03 00:00:00,Yute Air Alaska,Flight,Commercial,United States of America,North America,9,1,1,8,1,2,7,Human Factor
1980-08-10 00:00:00,V. G. Livingston,Takeoff (climb),Specialised Services,United States of America,North America,2,2,2,0,0,2,0,Human Factor
1980-08-10 00:00:00,Kyoritsu Koku Satsueiki,Takeoff (climb),Commercial,Japan,Asia,2,1,1,1,1,2,0,Unknown
1980-08-11 00:00:00,Salmon Air,Flight,Operational,United States of America,North America,2,1,1,1,1,2,0,Human Factor
1980-08-12 00:00:00,Meriden Airways,Landing (descent or approach),Commercial,United States of America,North America,2,1,1,1,1,2,0,Human Factor
1980-08-18 00:00:00,Burt H. Clubb,Landing (descent or approach),Humanitarian,United States of America,North America,2,2,2,0,0,2,0,Human Factor
1980-08-19 00:00:00,Taxis Aéreos Uruguayos,Landing (descent or approach),Commercial,Uruguay,South America,2,1,1,1,1,2,0,Human Factor
1980-08-28 00:00:00,Private American,Flight,Humanitarian,United States of America,North America,2,2,2,0,0,2,0,Human Factor
1980-09-16 00:00:00,Private American,Takeoff (climb),Business,United States of America,North America,2,1,1,1,1,2,0,Technical Failure
1980-09-24 00:00:00,Commander 6206,Landing (descent or approach),Business,United States of America,North America,2,1,1,1,1,2,0,Human Factor
1980-09-24 00:00:00,Mooney Aviation,Flight,Operational,France,Europe,2,2,2,0,0,2,0,Unknown
1980-09-30 00:00:00,Air Bahia,Landing (descent or approach),Commercial,Mexico,Central America,2,1,1,1,1,2,0,Technical Failure
1980-10-03 00:00:00,Kurfiss Aviation,Flight,Operational,World,World,2,2,2,0,0,2,0,Human Factor
1980-10-12 00:00:00,Spanish Air Force - Ejército del Aire,Flight,Humanitarian,Spain,Europe,2,2,2,0,0,2,0,Unknown
1980-10-16 00:00:00,Air Freight Express,Flight,Operational,United States of America,North America,2,2,2,0,0,2,0,Human Factor
1980-10-23 00:00:00,West Coast Insulation Company,Flight,Business,United States of America,North America,2,1,1,1,1,2,0,Unknown
1980-11-17 00:00:00,Royal Air Force - RAF,Takeoff (climb),Military / Government,United Kingdom,Europe,20,4,2,16,0,2,18,Other
1980-11-21 00:00:00,Lapeyrouse Grain Corporation,Flight,Business,United States of America,North America,2,2,2,0,0,2,0,Human Factor
1980-11-21 00:00:00,Private American,Flight,Business,Bahamas,Central America,2,1,1,1,1,2,0,Unknown
1980-11-28 00:00:00,Central Air Service,Takeoff (climb),Business,United States of America,North America,2,2,2,0,0,2,0,Technical Failure
1980-12-01 00:00:00,Waig Aircraft,Flight,Specialised Services,United States of America,North America,2,2,2,0,0,2,0,Human Factor
1980-12-16 00:00:00,Eagle Airways - Australia,Flight,Operational,Australia,Oceania,2,1,1,1,1,2,0,Weather
1981-01-19 00:00:00,Kenting Aviation,Flight,Operational,World,World,2,2,2,0,0,2,0,Unknown
1981-01-21 00:00:00,Larry Johnson Air Services,Landing (descent or approach),Operational,United States of America,North America,3,1,1,2,1,2,1,Human Factor
1981-01-23 00:00:00,PenAir - Peninsula Airways - Alaska Airlines Commuter,Flight,Commercial,United States of America,North America,2,1,1,1,1,2,0,Unknown
1981-01-27 00:00:00,Orcon Inc.,Landing (descent or approach),Commercial,United States of America,North America,3,1,1,2,1,2,1,Human Factor
1981-01-28 00:00:00,Western States Express,Flight,Operational,United States of America,North America,2,1,1,1,1,2,0,Human Factor
1981-02-04 00:00:00,Fiesta Photo,Landing (descent or approach),Business,United States of America,North America,2,1,1,1,1,2,0,Human Factor
1981-02-11 00:00:00,Argentinian Air Force - Fuerza Aérea Argentina,Flight,Operational,Argentina,South America,2,2,2,0,0,2,0,Unknown
1981-02-12 00:00:00,Aeroflot - Russian International Airlines,Landing (descent or approach),Military / Government,Russia,Asia,13,6,0,7,2,2,11,Human Factor
1981-02-12 00:00:00,Jack Dean Franks,Landing (descent or approach),Business,United States of America,North America,2,1,1,1,1,2,0,Human Factor
1981-02-27 00:00:00,Canadian Government,Flight,Operational,Canada,North America,3,3,2,0,0,2,1,Technical Failure
1981-03-09 00:00:00,Zimex Aviation,Takeoff (climb),Operational,Libya,Africa,2,2,2,0,0,2,0,Human Factor
1981-03-18 00:00:00,North Cariboo Flying Service,Landing (descent or approach),Operational,United States of America,North America,2,2,2,0,0,2,0,Unknown
1981-03-27 00:00:00,Paul B. Knight,Takeoff (climb),Specialised Services,United States of America,North America,2,2,2,0,0,2,0,Human Factor
1981-04-02 00:00:00,Private American,Landing (descent or approach),Humanitarian,United States of America,North America,2,1,1,1,1,2,0,Human Factor
1981-04-02 00:00:00,Skytrain Air,Landing (descent or approach),Humanitarian,Mexico,Central America,2,2,2,0,0,2,0,Human Factor
1981-04-10 00:00:00,Atlas Aviation,Takeoff (climb),Business,United States of America,North America,2,2,2,0,0,2,0,Human Factor
1981-04-19 00:00:00,Viking Aviation,Takeoff (climb),Business,United States of America,North America,10,1,1,9,1,2,8,Human Factor
1981-05-03 00:00:00,Aeroflot - Russian International Airlines,Flight,Military / Government,Russia,Asia,3,1,0,2,2,2,1,Human Factor
1981-05-04 00:00:00,Papua New Guinea Defence Force,Flight,Military / Government,Papua New Guinea,Oceania,2,2,2,0,0,2,0,Unknown
1981-05-23 00:00:00,Gull Air - Air Florida Commuter,Takeoff (climb),Operational,United States of America,North America,2,2,2,0,0,2,0,Human Factor
1981-06-10 00:00:00,Private American,Flight,Humanitarian,United States of America,North America,2,2,2,0,0,2,0,Human Factor
1981-06-13 00:00:00,Aeroflot - Russian International Airlines,Takeoff (climb),Military / Government,Latvia,Europe,2,2,2,0,0,2,0,Technical Failure
1981-06-13 00:00:00,Taiwan Airlines,Takeoff (climb),Commercial,Taiwan,Asia,2,2,2,0,0,2,0,Weather
1981-06-17 00:00:00,Taxi Aéreo El Venado,Landing (descent or approach),Commercial,Colombia,South America,12,4,1,8,1,2,10,Technical Failure
1981-06-22 00:00:00,Stuart J. Steele,Takeoff (climb),Business,United States of America,North America,2,1,1,1,1,2,0,Technical Failure
1981-06-28 00:00:00,Aeroflot - Russian International Airlines,Flight,Military / Government,Russia,Asia,2,2,2,0,0,2,0,Human Factor
1981-07-08 00:00:00,Hemet Valley Flying Service,Flight,Humanitarian,United States of America,North America,2,2,2,0,0,2,0,Technical Failure
1981-07-17 00:00:00,Ernest J. Kuney,Flight,Business,United States of America,North America,2,1,1,1,1,2,0,Human Factor
1981-07-18 00:00:00,Aeroflot - Russian International Airlines,Takeoff (climb),Military / Government,Uzbekistan,Asia,2,2,2,0,0,2,0,Human Factor
1981-07-18 00:00:00,Roger A. Hoekstra,Landing (descent or approach),Business,United States of America,North America,5,1,1,4,1,2,3,Human Factor
1981-07-22 00:00:00,Mid Eastern Airways,Takeoff (climb),Operational,United States of America,North America,2,1,1,1,1,2,0,Human Factor
1981-07-28 00:00:00,Private American,Takeoff (climb),Business,United States of America,North America,2,1,1,1,1,2,0,Human Factor
1981-08-13 00:00:00,Joseph P. Navik,Landing (descent or approach),Operational,United States of America,North America,2,1,1,1,1,2,0,Human Factor
1981-09-16 00:00:00,Air Kipawa,Flight,Humanitarian,Canada,North America,2,1,1,1,1,2,0,Unknown
1981-09-29 00:00:00,United States Air Force - USAF,Landing (descent or approach),Operational,United States of America,North America,2,2,2,0,0,2,0,Human Factor
1981-11-05 00:00:00,Arapahoe Drilling Company,Takeoff (climb),Business,United States of America,North America,2,1,1,1,1,2,0,Unknown
1981-11-06 00:00:00,Galena Air Service,Flight,Operational,United States of America,North America,2,1,1,1,1,2,0,Human Factor
1981-11-13 00:00:00,Gates Learjet Aircraft Corporation,Flight,Operational,South Africa,Africa,2,2,2,0,0,2,0,Human Factor
1981-11-16 00:00:00,Aeroflot - Russian International Airlines,Takeoff (climb),Commercial,Kazakhstan,Asia,14,2,0,12,2,2,12,Human Factor
1981-11-19 00:00:00,Gladstone Group,Flight,Operational,United States of America,North America,2,2,2,0,0,2,0,Unknown
1981-12-08 00:00:00,Piper Aircraft Corporation,Flight,Specialised Services,United States of America,North America,2,2,2,0,0,2,0,Unknown
1981-12-12 00:00:00,Burwick Bay Oil Company,Landing (descent or approach),Business,United States of America,North America,2,1,1,1,1,2,0,Human Factor
1981-12-23 00:00:00,Aeroflot - Russian International Airlines,Landing (descent or approach),Operational,Russia,Asia,7,6,2,1,0,2,5,Human Factor
1982-01-05 00:00:00,Empire Airlines,Landing (descent or approach),Commercial,United States of America,North America,2,2,2,0,0,2,0,Technical Failure
1982-01-11 00:00:00,Redec Aviation,Flight,Operational,Greenland,Europe,2,2,2,0,0,2,0,Human Factor
1982-01-18 00:00:00,Kelowna Flightcraft Air Charter,Flight,Commercial,Canada,North America,2,2,2,0,0,2,0,Unknown
1982-01-23 00:00:00,World Airways,Landing (descent or approach),Commercial,United States of America,North America,212,12,0,200,2,2,210,Human Factor
1982-01-25 00:00:00,Air Service Hungary - Repülögépes Szolgalat Allami Vallat,Flight,Military / Government,Hungary,Europe,2,2,2,0,0,2,0,Human Factor
1982-02-11 00:00:00,Bruce L. McWhorter,Flight,Business,United States of America,North America,2,1,1,1,1,2,0,Technical Failure
1982-03-03 00:00:00,Coal Air,Landing (descent or approach),Operational,Australia,Oceania,2,1,1,1,1,2,0,Unknown
1982-03-10 00:00:00,Aeroflot - Russian International Airlines,Flight,Operational,Russia,Asia,2,2,2,0,0,2,0,Human Factor
1982-04-29 00:00:00,Island Airlines,Takeoff (climb),Operational,United States of America,North America,2,2,2,0,0,2,0,Technical Failure
1982-05-04 00:00:00,Government of the Province of Córdoba,Landing (descent or approach),Specialised Services,Argentina,South America,2,2,2,0,0,2,0,Unknown
1982-05-08 00:00:00,Judith Gill Wagner,Takeoff (climb),Business,United States of America,North America,2,2,2,0,0,2,0,Human Factor
1982-05-12 00:00:00,Sweetwater Drilling Company,Takeoff (climb),Operational,United States of America,North America,2,2,2,0,0,2,0,Weather
1982-05-13 00:00:00,Private American,Landing (descent or approach),Humanitarian,Mexico,Central America,2,2,2,0,0,2,0,Human Factor
1982-05-19 00:00:00,Cooper Merseyside,Flight,Business,France,Europe,2,1,1,1,1,2,0,Unknown
1982-05-19 00:00:00,Tyee Airlines,Flight,Commercial,Canada,North America,2,1,1,1,1,2,0,Unknown
1982-05-24 00:00:00,VASP - Viação Aérea de São Paulo,Landing (descent or approach),Commercial,Brazil,South America,118,6,0,112,2,2,116,Human Factor
1982-05-29 00:00:00,Aeroflot - Russian International Airlines,Flight,Military / Government,Russia,Asia,2,2,2,0,0,2,0,Human Factor
1982-06-14 00:00:00,Soviet Navy - Voyenno-morskoy flot CCCP,Flight,Operational,Ukraine,Europe,4,4,2,0,0,2,2,Technical Failure
1982-07-23 00:00:00,Robert McClure,Flight,Business,United States of America,North America,2,1,1,1,1,2,0,Human Factor
1982-07-26 00:00:00,Royal Thai Air Force - Kong Thap Akat Thai,Flight,Military / Government,Thailand,Asia,2,2,2,0,0,2,0,Unknown
1982-07-30 00:00:00,United States Coast Guard - USCG,Landing (descent or approach),Military / Government,United States of America,North America,11,8,1,3,1,2,9,Unknown
1982-07-31 00:00:00,National Argentinian Police,Flight,Military / Government,Argentina,South America,2,2,2,0,0,2,0,Unknown
1982-08-23 00:00:00,Pesquara Coloso Servicios Aéreos,Flight,Operational,Chile,South America,2,2,2,0,0,2,0,Unknown
1982-09-02 00:00:00,Piper Aircraft Corporation,Landing (descent or approach),Specialised Services,United States of America,North America,2,2,2,0,0,2,0,Technical Failure
1982-09-14 00:00:00,James F. Searles,Flight,Business,United States of America,North America,2,1,1,1,1,2,0,Human Factor
1982-11-12 00:00:00,Denver Charters,Flight,Business,United States of America,North America,2,2,2,0,0,2,0,Unknown
1982-11-19 00:00:00,Private American,Flight,Humanitarian,Colombia,South America,2,2,2,0,0,2,0,Human Factor
1982-11-20 00:00:00,Private American,Landing (descent or approach),Business,United States of America,North America,2,1,1,1,1,2,0,Human Factor
1982-11-20 00:00:00,Alfred Wonesh,Landing (descent or approach),Operational,United States of America,North America,2,1,1,1,1,2,0,Human Factor
1982-12-07 00:00:00,Pioneer Airlines - USA,Landing (descent or approach),Operational,United States of America,North America,2,2,2,0,0,2,0,Human Factor
1982-12-09 00:00:00,Brent's International,Flight,Operational,World,World,2,2,2,0,0,2,0,Technical Failure
1982-12-16 00:00:00,Raymond Tamez Jr.,Landing (descent or approach),Humanitarian,United States of America,North America,2,1,1,1,1,2,0,Human Factor
1982-12-24 00:00:00,American Central Airlines,Landing (descent or approach),Operational,United States of America,North America,2,2,2,0,0,2,0,Human Factor
1983-01-03 00:00:00,A. E. Staley Manufacturing Company,Landing (descent or approach),Operational,United States of America,North America,2,2,2,0,0,2,0,Human Factor
1983-01-16 00:00:00,Libyan Government,Takeoff (climb),Military / Government,Libya,Africa,2,2,2,0,0,2,0,Unknown
1983-02-03 00:00:00,Robert G. Mainhardt,Flight,Business,United States of America,North America,2,2,2,0,0,2,0,Weather
1983-02-13 00:00:00,Allen N. Trask,Takeoff (climb),Business,United States of America,North America,3,1,1,2,1,2,1,Human Factor
1983-02-22 00:00:00,VASP - Viação Aérea de São Paulo,Takeoff (climb),Operational,Brazil,South America,2,2,2,0,0,2,0,Human Factor
1983-03-09 00:00:00,Rodney F. McClean,Flight,Business,Jamaica,Central America,2,2,2,0,0,2,0,Unknown
1983-03-18 00:00:00,Petroquimica Dominicana,Landing (descent or approach),Business,United States of America,North America,2,2,2,0,0,2,0,Human Factor
1983-03-18 00:00:00,Private German,Landing (descent or approach),Business,Sweden,Europe,3,1,1,2,1,2,1,Human Factor
1983-03-30 00:00:00,Hughes Charter Air,Landing (descent or approach),Operational,United States of America,North America,2,2,2,0,0,2,0,Human Factor
1983-04-07 00:00:00,Munz Northern Airlines,Landing (descent or approach),Commercial,United States of America,North America,3,1,1,2,1,2,1,Human Factor
1983-04-16 00:00:00,Aeroclub di Forli,Flight,Business,Italy,Europe,2,1,1,1,1,2,0,Technical Failure
1983-04-21 00:00:00,Private German,Flight,Business,Italy,Europe,2,1,1,1,1,2,0,Human Factor
1983-04-29 00:00:00,Private Venezuelan,Flight,Business,Venezuela,South America,2,1,1,1,1,2,0,Unknown
1983-06-01 00:00:00,Aeroflot - Russian International Airlines,Flight,Military / Government,Russia,Asia,2,2,2,0,0,2,0,Unknown
1983-06-02 00:00:00,Geodata International,Flight,Military / Government,United States of America,North America,2,2,2,0,0,2,0,Human Factor
1983-06-22 00:00:00,Skycraft Air Transport,Landing (descent or approach),Operational,Canada,North America,2,2,2,0,0,2,0,Human Factor
1983-06-23 00:00:00,Falcon Leasing Corporation,Landing (descent or approach),Humanitarian,United States of America,North America,2,1,1,1,1,2,0,Human Factor
1983-06-27 00:00:00,Private German,Landing (descent or approach),Business,Germany,Europe,2,1,1,1,1,2,0,Human Factor
1983-06-28 00:00:00,Kansas Aircraft Corporation,Landing (descent or approach),Operational,United States of America,North America,2,2,2,0,0,2,0,Unknown
1983-07-17 00:00:00,Private Australian,Flight,Business,Australia,Oceania,2,2,2,0,0,2,0,Unknown
1983-07-18 00:00:00,Taxi Aéreo Selva,Landing (descent or approach),Commercial,Peru,South America,2,2,2,0,0,2,0,Weather
1983-07-28 00:00:00,Tomar Airways,Takeoff (climb),Operational,United States of America,North America,2,1,1,1,1,2,0,Technical Failure
1983-08-04 00:00:00,Sécurité civile française,Flight,Humanitarian,France,Europe,2,2,2,0,0,2,0,Human Factor
1983-08-05 00:00:00,Bali International Air Service,Landing (descent or approach),Operational,Indonesia,Asia,2,2,2,0,0,2,0,Unknown
1983-08-11 00:00:00,Northern Air Service - USA,Takeoff (climb),Commercial,United States of America,North America,2,2,2,0,0,2,0,Technical Failure
1983-09-18 00:00:00,Sam W. Rankin,Landing (descent or approach),Operational,United States of America,North America,2,1,1,1,1,2,0,Human Factor
1983-11-04 00:00:00,Argentinian Air Force - Fuerza Aérea Argentina,Flight,Operational,Argentina,South America,2,2,2,0,0,2,0,Unknown
1983-11-07 00:00:00,Private Swiss,Takeoff (climb),Business,France,Europe,2,1,1,1,1,2,0,Human Factor
1983-11-08 00:00:00,Raymond M. Tolles,Flight,Operational,United States of America,North America,2,1,1,1,1,2,0,Human Factor
1983-11-22 00:00:00,William Geary,Landing (descent or approach),Business,United States of America,North America,2,1,1,1,1,2,0,Human Factor
1983-11-24 00:00:00,Martin Tool Works,Flight,Business,United States of America,North America,2,1,1,1,1,2,0,Human Factor
1983-12-04 00:00:00,Piper Aircraft Corporation,Takeoff (climb),Specialised Services,United States of America,North America,2,2,2,0,0,2,0,Human Factor
1983-12-17 00:00:00,Inuvik Coastal Airways,Landing (descent or approach),Commercial,Canada,North America,12,1,1,11,1,2,10,Human Factor
1984-01-07 00:00:00,Stanley R. Bateman,Takeoff (climb),Business,United States of America,North America,2,1,1,1,1,2,0,Human Factor
1984-02-03 00:00:00,Tartan Leasing,Flight,Business,United States of America,North America,2,2,2,0,0,2,0,Weather
1984-02-15 00:00:00,Wirt Davis III,Landing (descent or approach),Business,United States of America,North America,2,1,1,1,1,2,0,Human Factor
1984-02-20 00:00:00,Flight Safety Australia,Landing (descent or approach),Operational,Australia,Oceania,2,2,2,0,0,2,0,Human Factor
1984-03-16 00:00:00,Holiday Tours,Landing (descent or approach),Humanitarian,United States of America,North America,2,2,2,0,0,2,0,Human Factor
1984-04-28 00:00:00,G and J Leasing,Flight,Business,United States of America,North America,2,1,1,1,1,2,0,Human Factor
1984-06-02 00:00:00,Private American,Landing (descent or approach),Humanitarian,United States of America,North America,2,1,1,1,1,2,0,Human Factor
1984-06-20 00:00:00,Barkers Metal %26 Mining,Takeoff (climb),Business,South Africa,Africa,2,1,1,1,1,2,0,Unknown
1984-07-04 00:00:00,Aeroflot - Russian International Airlines,Flight,Commercial,Kazakhstan,Asia,6,3,0,3,2,2,4,Human Factor
1984-07-14 00:00:00,Aeroflot - Russian International Airlines,Flight,Military / Government,Russia,Asia,3,2,1,1,1,2,1,Human Factor
1984-07-26 00:00:00,Promech Air,Landing (descent or approach),Commercial,United States of America,North America,7,1,0,6,2,2,5,Human Factor
1984-08-02 00:00:00,Sac Air,Flight,Business,United States of America,North America,2,2,2,0,0,2,0,Human Factor
1984-08-15 00:00:00,Airfast Indonesia,Takeoff (climb),Operational,Indonesia,Asia,3,3,2,0,0,2,1,Human Factor
1984-08-31 00:00:00,Peterson Industries,Landing (descent or approach),Business,United States of America,North America,2,1,1,1,1,2,0,Human Factor
1984-09-12 00:00:00,Private American,Flight,Business,Mexico,Central America,2,2,2,0,0,2,0,Unknown
1984-09-26 00:00:00,Air Niagara,Flight,Operational,Canada,North America,2,2,2,0,0,2,0,Human Factor
1984-10-09 00:00:00,Gulfstream Aerospace Corporation,Flight,Specialised Services,United States of America,North America,2,2,2,0,0,2,0,Human Factor
1984-10-16 00:00:00,United States Air Force - USAF,Flight,Operational,United States of America,North America,7,7,2,0,0,2,5,Technical Failure
1984-10-31 00:00:00,H%26H Industrial Sales,Landing (descent or approach),Business,United States of America,North America,2,1,1,1,1,2,0,Human Factor
1984-11-10 00:00:00,Macton Corporation,Landing (descent or approach),Business,United States of America,Central America,4,2,1,2,1,2,2,Human Factor
1984-12-03 00:00:00,August G. Swoboda,Flight,Business,Jamaica,Central America,2,2,2,0,0,2,0,Unknown
1984-12-05 00:00:00,Private South African,Flight,Operational,World,World,2,2,2,0,0,2,0,Unknown
1984-12-11 00:00:00,Richards Aviation,Landing (descent or approach),Operational,United States of America,North America,2,2,2,0,0,2,0,Human Factor
1985-02-01 00:00:00,Lisa Flite Corporation,Landing (descent or approach),Operational,United States of America,North America,2,2,2,0,0,2,0,Human Factor
1985-02-06 00:00:00,Altus Airlines,Takeoff (climb),Commercial,United States of America,North America,2,1,1,1,1,2,0,Human Factor
1985-02-08 00:00:00,SIAI-Marchetti Aeronautica,Flight,Specialised Services,Italy,Europe,2,2,2,0,0,2,0,Unknown
1985-02-13 00:00:00,Beechwoods Flying Service,Landing (descent or approach),Business,United States of America,North America,2,1,1,1,1,2,0,Human Factor
1985-02-22 00:00:00,Norment Industries,Landing (descent or approach),Business,United States of America,North America,2,1,1,1,1,2,0,Human Factor
1985-03-01 00:00:00,National Bank of Commerce,Flight,Business,United States of America,North America,2,1,1,1,1,2,0,Technical Failure
1985-03-11 00:00:00,Soviet Air Force - Voyenno-vozdushnye sily CCCP,Landing (descent or approach),Military / Government,Afghanistan,Asia,6,6,2,0,0,2,4,Terrorism
1985-04-02 00:00:00,Bradley Machine Company,Takeoff (climb),Business,United States of America,North America,2,2,2,0,0,2,0,Human Factor
1985-04-20 00:00:00,Aeronica - Aerolineas Nicaraguenses,Flight,Operational,Greenland,Europe,5,5,2,0,0,2,3,Technical Failure
1985-05-16 00:00:00,David Olson,Flight,Commercial,United States of America,North America,5,1,0,4,2,2,3,Human Factor
1985-05-21 00:00:00,Target Development %26 Consulting,Landing (descent or approach),Operational,United States of America,North America,2,2,2,0,0,2,0,Human Factor
1985-05-28 00:00:00,AVENSA - Aerovias Venezolanas,Takeoff (climb),Commercial,Venezuela,South America,13,5,2,8,0,2,11,Unknown
1985-05-31 00:00:00,General Aviation Inc.,Takeoff (climb),Operational,United States of America,North America,2,2,2,0,0,2,0,Human Factor
1985-06-09 00:00:00,Jaradac International Corporation,Landing (descent or approach),Operational,United States of America,North America,2,2,2,0,0,2,0,Human Factor
1985-06-10 00:00:00,Aeroflot - Russian International Airlines,Flight,Military / Government,Russia,Asia,3,2,2,1,0,2,1,Human Factor
1985-06-10 00:00:00,Euralair International,Flight,Operational,France,Europe,2,2,2,0,0,2,0,Technical Failure
1985-06-11 00:00:00,Eurocommander,Takeoff (climb),Operational,Spain,Europe,2,2,2,0,0,2,0,Technical Failure
1985-06-20 00:00:00,Comercializadora del Pacifico,Flight,Humanitarian,Ecuador,South America,2,2,2,0,0,2,0,Terrorism
1985-06-28 00:00:00,Atlanta Air Service,Landing (descent or approach),Operational,United States of America,North America,2,1,1,1,1,2,0,Human Factor
1985-07-19 00:00:00,North Coast Aviation - USA,Flight,Operational,United States of America,North America,2,1,1,1,1,2,0,Human Factor
1985-07-25 00:00:00,Aeroflot - Russian International Airlines,Flight,Military / Government,Russia,Asia,3,2,2,1,0,2,1,Human Factor
1985-07-29 00:00:00,Aries Aire,Landing (descent or approach),Humanitarian,United States of America,North America,2,2,2,0,0,2,0,Human Factor
1985-08-14 00:00:00,Aeroflot - Russian International Airlines,Flight,Operational,Russia,Asia,2,2,2,0,0,2,0,Human Factor
1985-08-17 00:00:00,United States Navy - USN,Landing (descent or approach),Operational,United States of America,North America,5,5,2,0,0,2,3,Unknown
1985-08-20 00:00:00,Sécurité civile française,Flight,Humanitarian,France,Europe,2,2,2,0,0,2,0,Technical Failure
1985-08-27 00:00:00,Private Bolivian,Takeoff (climb),Operational,Bolivia,South America,2,1,1,1,1,2,0,Unknown
1985-10-09 00:00:00,National Flights Services,Landing (descent or approach),Business,United States of America,North America,2,1,1,1,1,2,0,Human Factor
1985-10-09 00:00:00,Nordeste Linhas Aéreas Regionais,Takeoff (climb),Operational,Brazil,South America,2,2,2,0,0,2,0,Human Factor
1985-10-10 00:00:00,Pel-Air,Takeoff (climb),Operational,Australia,Oceania,2,2,2,0,0,2,0,Technical Failure
1985-10-11 00:00:00,Sabeni - Servicios Aéreos Beni,Takeoff (climb),Operational,Bolivia,South America,2,2,2,0,0,2,0,Technical Failure
1985-11-01 00:00:00,Hermens Air,Takeoff (climb),Commercial,United States of America,North America,4,1,1,3,1,2,2,Human Factor
1985-11-05 00:00:00,Starflight,Takeoff (climb),Operational,United States of America,North America,2,2,2,0,0,2,0,Human Factor
1985-11-09 00:00:00,Private Australian,Flight,Business,Australia,Oceania,2,1,1,1,1,2,0,Technical Failure
1985-11-10 00:00:00,Nabisco,Landing (descent or approach),Operational,United States of America,North America,2,2,2,0,0,2,0,Human Factor
1985-11-27 00:00:00,Jen Rob Aviation,Landing (descent or approach),Operational,United States of America,North America,2,2,2,0,0,2,0,Human Factor
1985-12-12 00:00:00,General Telephone Company,Takeoff (climb),Business,United States of America,North America,3,2,1,1,1,2,1,Technical Failure
1986-01-04 00:00:00,William P. Gundy,Landing (descent or approach),Business,United States of America,North America,2,1,1,1,1,2,0,Human Factor
1986-01-09 00:00:00,Peachtree City Leasing,Landing (descent or approach),Business,United States of America,North America,2,1,1,1,1,2,0,Human Factor
1986-01-15 00:00:00,Air BG,Landing (descent or approach),Operational,France,Europe,2,2,2,0,0,2,0,Unknown
1986-01-16 00:00:00,Islandair,Flight,Business,Canada,North America,2,2,2,0,0,2,0,Unknown
1986-01-24 00:00:00,Luftfahrtzeug-Finanz,Landing (descent or approach),Business,Austria,Europe,2,1,1,1,1,2,0,Human Factor
1986-01-29 00:00:00,Ratioflug,Takeoff (climb),Operational,Germany,Europe,2,2,2,0,0,2,0,Unknown
1986-01-29 00:00:00,John F. Cabe,Takeoff (climb),Business,United States of America,North America,2,1,1,1,1,2,0,Technical Failure
1986-02-05 00:00:00,GLM Aviation,Flight,Commercial,Democratic Republic of Congo,Africa,14,4,0,10,2,2,12,Technical Failure
1986-02-14 00:00:00,Universal Flyers,Takeoff (climb),Operational,United States of America,North America,2,2,2,0,0,2,0,Technical Failure
1986-02-16 00:00:00,Nyge-Aero,Flight,Military / Government,Sweden,Europe,2,2,2,0,0,2,0,Human Factor
1986-02-17 00:00:00,John Jeffers,Flight,Humanitarian,United States of America,North America,2,1,1,1,1,2,0,Human Factor
1986-02-27 00:00:00,Safcol Seafoods,Flight,Specialised Services,Australia,Oceania,3,3,2,0,0,2,1,Human Factor
1986-03-05 00:00:00,Flight International,Flight,Military / Government,United States of America,North America,2,2,2,0,0,2,0,Human Factor
1986-03-05 00:00:00,Flight International,Flight,Military / Government,United States of America,North America,2,2,2,0,0,2,0,Human Factor
1986-03-15 00:00:00,Nyge-Aero,Flight,Military / Government,Sweden,Europe,2,2,2,0,0,2,0,Terrorism
1986-03-20 00:00:00,Woods Air Service - Woods Air Fuel,Landing (descent or approach),Operational,United States of America,North America,2,2,2,0,0,2,0,Human Factor
1986-03-20 00:00:00,Merpati Nusantara Airlines - MNA,Landing (descent or approach),Commercial,Indonesia,Asia,16,2,2,14,0,2,14,Human Factor
1986-03-23 00:00:00,Richard H. Turner,Landing (descent or approach),Business,United States of America,North America,2,1,1,1,1,2,0,Human Factor
1986-05-05 00:00:00,Italian Police - Polizia di Stato,Landing (descent or approach),Operational,Italy,Europe,2,2,2,0,0,2,0,Unknown
1986-05-29 00:00:00,John K. Gray,Takeoff (climb),Business,United States of America,North America,2,1,1,1,1,2,0,Human Factor
1986-06-13 00:00:00,Southern Enterprises,Flight,Business,United States of America,North America,2,1,1,1,1,2,0,Unknown
1986-07-17 00:00:00,Aeroflot - Russian International Airlines,Takeoff (climb),Military / Government,Russia,Asia,2,2,2,0,0,2,0,Unknown
1986-07-24 00:00:00,William H. Adams,Takeoff (climb),Business,United States of America,North America,2,1,1,1,1,2,0,Human Factor
1986-08-02 00:00:00,American Agronomics Corporation,Landing (descent or approach),Business,United States of America,North America,2,2,2,0,0,2,0,Human Factor
1986-08-11 00:00:00,Aeroflot - Russian International Airlines,Flight,Operational,Russia,Asia,4,2,2,2,0,2,2,Human Factor
1986-08-15 00:00:00,J. Meade Williamson,Flight,Business,United States of America,North America,4,1,0,3,2,2,2,Technical Failure
1986-08-25 00:00:00,James William Barnard,Flight,Business,United States of America,North America,2,2,2,0,0,2,0,Weather
1986-08-28 00:00:00,Southwest Airlift,Landing (descent or approach),Operational,United States of America,North America,2,2,2,0,0,2,0,Human Factor
1986-08-28 00:00:00,Sandinist Air Force - Fuerza Aérea Sandinista,Flight,Operational,Nicaragua,Central America,2,2,2,0,0,2,0,Terrorism
1986-10-01 00:00:00,Aeroflot - Russian International Airlines,Flight,Operational,Armenia,Asia,2,2,2,0,0,2,0,Human Factor
1986-10-19 00:00:00,Aviones de Colombia,Takeoff (climb),Commercial,Colombia,South America,2,1,1,1,1,2,0,Unknown
1986-10-24 00:00:00,Salim Ben Laden,Landing (descent or approach),Operational,Saudi Arabia,Asia,2,2,2,0,0,2,0,Technical Failure
1986-11-06 00:00:00,South Aero Service,Flight,Commercial,United States of America,North America,2,1,1,1,1,2,0,Technical Failure
1986-12-14 00:00:00,Private American,Flight,Humanitarian,Dominican Republic,Central America,2,2,2,0,0,2,0,Terrorism
1987-01-06 00:00:00,Aeroflot - Russian International Airlines,Flight,Operational,Kazakhstan,Asia,2,2,2,0,0,2,0,Human Factor
1987-01-14 00:00:00,United States Air Force - USAF,Takeoff (climb),Operational,United States of America,North America,3,3,2,0,0,2,1,Unknown
1987-01-31 00:00:00,Wayne A. Bower,Flight,Business,United States of America,North America,2,1,1,1,1,2,0,Human Factor
1987-02-08 00:00:00,Islamic Republic of Iran Air Force,Landing (descent or approach),Operational,Iran,Asia,2,2,2,0,0,2,0,Terrorism
1987-02-13 00:00:00,Spanish Air Force - Ejército del Aire,Landing (descent or approach),Operational,Spain,Europe,2,2,2,0,0,2,0,Unknown
1987-02-13 00:00:00,Spanish Air Force - Ejército del Aire,Landing (descent or approach),Operational,Spain,Europe,2,2,2,0,0,2,0,Unknown
1987-02-18 00:00:00,Active Aero Charter,Landing (descent or approach),Operational,United States of America,North America,2,1,1,1,1,2,0,Human Factor
1987-02-20 00:00:00,Samaritan AirEvac - Samaritan Health Services,Landing (descent or approach),Humanitarian,United States of America,North America,2,1,1,1,1,2,0,Technical Failure
1987-03-31 00:00:00,ZUA - Zakładu Usług Agrolotniczych - AET Agroaviation Services,Flight,Operational,Hungary,Europe,2,2,2,0,0,2,0,Weather
1987-04-01 00:00:00,Wilbur's Flight Operations,Landing (descent or approach),Commercial,United States of America,North America,2,1,1,1,1,2,0,Technical Failure
1987-04-23 00:00:00,Air-Lift Commuter,Takeoff (climb),Operational,United States of America,North America,2,2,2,0,0,2,0,Technical Failure
1987-04-26 00:00:00,OASIS - Orient Air System %26 Integrated Services,Flight,Operational,Philippines,Asia,2,2,2,0,0,2,0,Technical Failure
1987-05-08 00:00:00,American Eagle,Landing (descent or approach),Commercial,Puerto Rico,Central America,6,2,2,4,0,2,4,Human Factor
1987-05-11 00:00:00,Northland Air Manitoba,Landing (descent or approach),Operational,Canada,North America,2,2,2,0,0,2,0,Technical Failure
1987-05-12 00:00:00,Corporate Jets,Takeoff (climb),Operational,United States of America,North America,2,2,2,0,0,2,0,Human Factor
1987-06-20 00:00:00,Kiunga Aviation,Flight,Operational,Papua New Guinea,Oceania,2,2,2,0,0,2,0,Human Factor
1987-06-21 00:00:00,Reno Flying Service,Landing (descent or approach),Humanitarian,United States of America,North America,2,1,1,1,1,2,0,Human Factor
1987-06-24 00:00:00,Bankair,Flight,Operational,United States of America,North America,2,2,2,0,0,2,0,Human Factor
1987-07-07 00:00:00,John Gerlach,Landing (descent or approach),Business,United States of America,North America,2,1,1,1,1,2,0,Human Factor
1987-07-25 00:00:00,Shebandowan Air,Landing (descent or approach),Commercial,Canada,North America,2,1,1,1,1,2,0,Human Factor
1987-07-31 00:00:00,Dolphin Aviation,Landing (descent or approach),Operational,Guatemala,Central America,3,3,2,0,0,2,1,Technical Failure
1987-09-10 00:00:00,Black Hills Aviation,Flight,Humanitarian,United States of America,North America,2,2,2,0,0,2,0,Unknown
1987-09-25 00:00:00,Air Cargo America,Takeoff (climb),Operational,United States of America,North America,2,2,2,0,0,2,0,Other
1987-09-25 00:00:00,Thomas McVea,Landing (descent or approach),Humanitarian,United States of America,North America,2,2,2,0,0,2,0,Human Factor
1987-10-11 00:00:00,Aeroejecutivos Colombia - Aeroservicios Ejecutivos de Colombia,Landing (descent or approach),Commercial,Colombia,South America,9,2,2,7,0,2,7,Human Factor
1987-10-12 00:00:00,R. S. Jones %26 Associates,Takeoff (climb),Business,United States of America,North America,2,1,1,1,1,2,0,Technical Failure
1987-10-16 00:00:00,Sandinist Air Force - Fuerza Aérea Sandinista,Flight,Military / Government,Nicaragua,Central America,2,2,2,0,0,2,0,Unknown
1987-10-16 00:00:00,Talair,Landing (descent or approach),Commercial,Papua New Guinea,Oceania,2,1,1,1,1,2,0,Unknown
1987-10-24 00:00:00,Aeroflot - Russian International Airlines,Flight,Military / Government,Ukraine,Europe,2,2,2,0,0,2,0,Technical Failure
1987-10-31 00:00:00,Southern Cross Aviation,Flight,Operational,United States of America,North America,2,1,1,1,1,2,0,Human Factor
1987-11-10 00:00:00,Kenn Borek Air,Landing (descent or approach),Operational,Canada,North America,4,2,2,2,0,2,2,Technical Failure
1987-11-15 00:00:00,United States Government,Flight,Military / Government,Mexico,Central America,2,1,1,1,1,2,0,Human Factor
1987-11-27 00:00:00,Outdoor Aviation,Flight,Operational,New Zealand,Oceania,2,1,1,1,1,2,0,Weather
1987-11-30 00:00:00,Joseph R. Leon,Flight,Business,United States of America,North America,2,1,1,1,1,2,0,Technical Failure
1987-12-05 00:00:00,Scott Cable Communications,Landing (descent or approach),Business,United States of America,North America,4,2,2,2,0,2,2,Technical Failure
1987-12-07 00:00:00,Businessair,Flight,Commercial,Austria,Europe,2,1,1,1,1,2,0,Human Factor
1987-12-09 00:00:00,United States Navy - USN,Landing (descent or approach),Military / Government,Antarctica,Antarctica,13,5,0,8,2,2,11,Technical Failure
1987-12-10 00:00:00,Tennessee Wings,Takeoff (climb),Business,United States of America,North America,2,1,1,1,1,2,0,Human Factor
1987-12-22 00:00:00,GP-Express Airlines,Landing (descent or approach),Commercial,United States of America,North America,3,2,2,1,0,2,1,Human Factor
1987-12-22 00:00:00,Private Australian,Flight,Operational,Australia,Oceania,2,1,1,1,1,2,0,Human Factor
1988-01-08 00:00:00,Phoenix Air Group,Landing (descent or approach),Operational,United States of America,North America,2,2,2,0,0,2,0,Human Factor
1988-01-11 00:00:00,Amspray Sales Corporation,Flight,Commercial,United States of America,North America,2,1,1,1,1,2,0,Human Factor
1988-02-07 00:00:00,Crown Aviation Services,Flight,Commercial,World,World,2,1,1,1,1,2,0,Unknown
1988-02-11 00:00:00,Air Niagara Express,Landing (descent or approach),Operational,Canada,North America,2,2,2,0,0,2,0,Unknown
1988-02-24 00:00:00,Transamérica Táxi Aéreo,Landing (descent or approach),Commercial,Brazil,South America,6,4,2,2,0,2,4,Technical Failure
1988-03-03 00:00:00,Midwest Executive,Landing (descent or approach),Operational,United States of America,North America,2,1,1,1,1,2,0,Human Factor
1988-03-25 00:00:00,Starcraft Aviation,Landing (descent or approach),Business,United States of America,North America,2,1,1,1,1,2,0,Technical Failure
1988-04-08 00:00:00,Corporate Air - USA,Flight,Operational,United States of America,North America,2,2,2,0,0,2,0,Weather
1988-04-21 00:00:00,Aeroflot - Russian International Airlines,Flight,Military / Government,Ukraine,Europe,5,2,1,3,1,2,3,Human Factor
1988-04-21 00:00:00,African Air Charters,Takeoff (climb),Operational,Mozambique,Africa,2,2,2,0,0,2,0,Terrorism
1988-05-09 00:00:00,Jochen Pemöller,Landing (descent or approach),Business,Germany,Europe,6,1,0,5,2,2,4,Unknown
1988-05-17 00:00:00,TTA - Sociedade de Transportes e Trabalhos Aéreos,Flight,Commercial,South Africa,Africa,3,1,1,2,1,2,1,Weather
1988-05-26 00:00:00,StarAir,Landing (descent or approach),Operational,Germany,Europe,2,2,2,0,0,2,0,Human Factor
1988-06-06 00:00:00,M. C. Services,Takeoff (climb),Operational,United States of America,North America,2,2,2,0,0,2,0,Human Factor
1988-06-09 00:00:00,Aeroflot - Russian International Airlines,Flight,Operational,Russia,Asia,2,2,2,0,0,2,0,Human Factor
1988-06-26 00:00:00,Edward G. Counselman,Flight,Business,United States of America,North America,2,1,1,1,1,2,0,Human Factor
1988-07-30 00:00:00,Jet Management - USA,Landing (descent or approach),Operational,United States of America,North America,2,2,2,0,0,2,0,Technical Failure
1988-08-17 00:00:00,Wilbur's Flight Operations,Flight,Operational,United States of America,North America,2,2,2,0,0,2,0,Human Factor
1988-09-12 00:00:00,Rijnmond Air Services - RAS,Landing (descent or approach),Operational,Netherlands,Europe,2,2,2,0,0,2,0,Human Factor
1988-09-15 00:00:00,Bradley Air Services,Landing (descent or approach),Operational,Canada,North America,2,2,2,0,0,2,0,Human Factor
1988-09-21 00:00:00,Aeroflot - Russian International Airlines,Flight,Operational,Russia,Asia,2,2,2,0,0,2,0,Human Factor
1988-10-26 00:00:00,Charlie Gill Enterprises,Landing (descent or approach),Business,United States of America,North America,2,1,1,1,1,2,0,Human Factor
1988-10-26 00:00:00,Aero Technik,Takeoff (climb),Operational,Austria,Europe,2,2,2,0,0,2,0,Human Factor
1988-11-01 00:00:00,Air Ontario,Landing (descent or approach),Operational,Canada,North America,2,2,2,0,0,2,0,Unknown
1988-11-02 00:00:00,Airborne Geophysics,Landing (descent or approach),Operational,United States of America,North America,2,2,2,0,0,2,0,Technical Failure
1988-11-06 00:00:00,"Jordan, Parry y Perez Importaciones",Flight,Business,Chile,South America,2,2,2,0,0,2,0,Unknown
1988-11-16 00:00:00,Arjay Medical,Flight,Business,United States of America,North America,2,1,1,1,1,2,0,Human Factor
1988-12-01 00:00:00,Private Colombian,Flight,Humanitarian,Colombia,South America,2,2,2,0,0,2,0,Human Factor
1988-12-09 00:00:00,Commuter Craft,Landing (descent or approach),Business,United States of America,North America,2,1,1,1,1,2,0,Human Factor
1988-12-16 00:00:00,Crown Center Aviation,Flight,Business,Mexico,Central America,2,2,2,0,0,2,0,Technical Failure
1988-12-22 00:00:00,Donald I. Kapetansky,Flight,Business,United States of America,North America,2,1,1,1,1,2,0,Human Factor
1988-12-22 00:00:00,Erie Airways,Flight,Operational,United States of America,North America,2,2,2,0,0,2,0,Human Factor
1988-12-23 00:00:00,LBC Air Cargo,Landing (descent or approach),Operational,Philippines,Asia,2,2,2,0,0,2,0,Human Factor
1989-01-05 00:00:00,Royal Thai Air Force - Kong Thap Akat Thai,Takeoff (climb),Military / Government,Thailand,Asia,2,2,2,0,0,2,0,Unknown
1989-01-12 00:00:00,Corporación Metalmen,Landing (descent or approach),Business,Venezuela,South America,2,2,2,0,0,2,0,Unknown
1989-01-12 00:00:00,Bradley Air Services,Takeoff (climb),Operational,United States of America,North America,2,2,2,0,0,2,0,Human Factor
1989-01-15 00:00:00,Temsco Helicopters,Flight,Commercial,United States of America,North America,2,1,1,1,1,2,0,Human Factor
1989-01-27 00:00:00,Socièta Italiana Servizi Aerei Mediterranei - SISAM,Landing (descent or approach),Humanitarian,Italy,Europe,2,2,2,0,0,2,0,Human Factor
1989-02-28 00:00:00,Trans Fair,Takeoff (climb),Operational,Canada,North America,2,2,2,0,0,2,0,Technical Failure
1989-03-15 00:00:00,Mid Pacific Air,Landing (descent or approach),Operational,United States of America,North America,2,2,2,0,0,2,0,Human Factor
1989-03-15 00:00:00,Private Argentinian,Takeoff (climb),Business,Argentina,South America,7,2,2,5,0,2,5,Unknown
1989-03-18 00:00:00,Evergreen International Airlines,Takeoff (climb),Operational,United States of America,North America,2,2,2,0,0,2,0,Human Factor
1989-04-13 00:00:00,United States Navy - USN,Flight,Operational,United States of America,North America,2,2,2,0,0,2,0,Human Factor
1989-04-15 00:00:00,Aeroflot - Russian International Airlines,Flight,Business,Ukraine,Europe,2,2,2,0,0,2,0,Human Factor
1989-04-19 00:00:00,Channel Flying Services,Flight,Commercial,United States of America,North America,2,1,1,1,1,2,0,Human Factor
1989-05-02 00:00:00,Monroe County Mosquito Control District,Flight,Military / Government,United States of America,North America,2,2,2,0,0,2,0,Human Factor
1989-05-08 00:00:00,Royal Navy,Flight,Operational,United Kingdom,Europe,2,2,2,0,0,2,0,Unknown
1989-05-21 00:00:00,Enrico Recchi,Landing (descent or approach),Business,Italy,Europe,5,2,2,3,0,2,3,Human Factor
1989-06-04 00:00:00,Lawrence Vansertima,Takeoff (climb),Business,Guyana,South America,2,1,1,1,1,2,0,Unknown
1989-06-15 00:00:00,Curtain Brothers,Flight,Operational,Papua New Guinea,Oceania,2,2,2,0,0,2,0,Unknown
1989-06-29 00:00:00,Phoenix Air - USA,Takeoff (climb),Operational,United States of America,North America,2,2,2,0,0,2,0,Human Factor
1989-07-21 00:00:00,Aeroflot - Russian International Airlines,Flight,Military / Government,Russia,Asia,2,2,2,0,0,2,0,Human Factor
1989-09-04 00:00:00,Conair Aviation,Flight,Humanitarian,France,Europe,2,2,2,0,0,2,0,Human Factor
1989-09-16 00:00:00,Private Danish,Takeoff (climb),Business,Denmark,Europe,4,1,1,3,1,2,2,Technical Failure
1989-09-20 00:00:00,USAir - US Airways,Takeoff (climb),Commercial,United States of America,North America,63,6,0,57,2,2,61,Human Factor
1989-09-20 00:00:00,United States Air Force - USAF,Parking,Operational,United States of America,North America,7,7,2,0,0,2,5,Technical Failure
1989-09-22 00:00:00,Aeroflot - Russian International Airlines,Flight,Military / Government,Tajikistan,Asia,2,2,2,0,0,2,0,Unknown
1989-09-23 00:00:00,Government of the Province of Misiones,Landing (descent or approach),Military / Government,Argentina,South America,7,2,0,5,2,2,5,Human Factor
1989-10-01 00:00:00,GTE South,Landing (descent or approach),Business,United States of America,North America,2,2,2,0,0,2,0,Human Factor
1989-10-01 00:00:00,Roy Beatty,Takeoff (climb),Business,United States of America,North America,2,1,1,1,1,2,0,Technical Failure
1989-10-06 00:00:00,Argentinian Air Force - Fuerza Aérea Argentina,Flight,Operational,Argentina,South America,2,2,2,0,0,2,0,Weather
1989-10-24 00:00:00,Besit Servizi Aerei,Flight,Operational,Italy,Europe,2,2,2,0,0,2,0,Unknown
1989-11-01 00:00:00,RV-Aviation - Rauno Virtanen Aviation,Landing (descent or approach),Operational,Finland,Europe,2,2,2,0,0,2,0,Human Factor
1989-11-02 00:00:00,Cherokee Express Air Cargo,Flight,Operational,United States of America,North America,2,1,1,1,1,2,0,Human Factor
1989-11-05 00:00:00,Nevada Flyco,Takeoff (climb),Business,United States of America,North America,2,2,2,0,0,2,0,Human Factor
1989-11-07 00:00:00,Weasua Air Transport,Takeoff (climb),Commercial,Liberia,Africa,10,1,1,9,1,2,8,Technical Failure
1989-11-18 00:00:00,Australian Government,Flight,Military / Government,Australia,Oceania,2,2,2,0,0,2,0,Human Factor
1989-11-23 00:00:00,Nav Air Charter,Flight,Commercial,Canada,North America,2,1,1,1,1,2,0,Human Factor
1989-11-30 00:00:00,Douglas W. Johnston,Takeoff (climb),Business,United States of America,North America,2,1,1,1,1,2,0,Unknown
1989-12-02 00:00:00,R W F Inc.,Landing (descent or approach),Business,United States of America,North America,2,1,1,1,1,2,0,Human Factor
1989-12-28 00:00:00,Automation Devices,Landing (descent or approach),Specialised Services,United States of America,North America,2,1,1,1,1,2,0,Human Factor
1989-12-30 00:00:00,Private Mexican,Takeoff (climb),Humanitarian,Mexico,Central America,4,4,2,0,0,2,2,Terrorism
1990-01-18 00:00:00,Aeroflight Services,Flight,Operational,United States of America,North America,2,2,2,0,0,2,0,Technical Failure
1990-01-26 00:00:00,Great Western Aviation,Flight,Commercial,Australia,Oceania,2,1,1,1,1,2,0,Human Factor
1990-01-29 00:00:00,Business Air,Takeoff (climb),Operational,United States of America,North America,2,1,1,1,1,2,0,Weather
1990-02-06 00:00:00,James W. Hager,Flight,Business,United States of America,North America,2,1,1,1,1,2,0,Human Factor
1990-02-13 00:00:00,Holt Manufacturing Company,Landing (descent or approach),Business,United States of America,North America,2,1,1,1,1,2,0,Human Factor
1990-02-28 00:00:00,Aero San Martín,Takeoff (climb),Commercial,Peru,South America,2,1,1,1,1,2,0,Unknown
1990-03-10 00:00:00,BHP Inc.,Flight,Business,United States of America,North America,2,1,1,1,1,2,0,Weather
1990-04-01 00:00:00,Rocky Mountain Intensive,Flight,Commercial,United States of America,North America,3,2,2,1,0,2,1,Terrorism
1990-04-06 00:00:00,Transamérica Táxi Aéreo,Landing (descent or approach),Operational,Brazil,South America,4,2,1,2,1,2,2,Human Factor
1990-04-08 00:00:00,Roma Air,Flight,Operational,Italy,Europe,2,1,1,1,1,2,0,Human Factor
1990-05-04 00:00:00,Tar Heel Aviation,Landing (descent or approach),Operational,United States of America,North America,2,1,1,1,1,2,0,Human Factor
1990-05-19 00:00:00,K %26 K Aircraft,Flight,Military / Government,United States of America,North America,2,2,2,0,0,2,0,Human Factor
1990-05-27 00:00:00,Frank M. Adams,Flight,Business,United States of America,North America,2,1,1,1,1,2,0,Weather
1990-06-11 00:00:00,Aeroflot - Russian International Airlines,Flight,Military / Government,Russia,Asia,2,1,1,1,1,2,0,Human Factor
1990-06-15 00:00:00,Private Colombian,Flight,Business,Colombia,South America,2,2,2,0,0,2,0,Unknown
1990-06-21 00:00:00,Ptarmigan Airways,Takeoff (climb),Operational,Canada,North America,2,2,2,0,0,2,0,Unknown
1990-06-25 00:00:00,PropAir,Takeoff (climb),Commercial,Canada,North America,2,1,1,1,1,2,0,Unknown
1990-06-26 00:00:00,Panama Aviation,Takeoff (climb),Operational,United States of America,North America,2,2,2,0,0,2,0,Human Factor
1990-07-12 00:00:00,Eagle Air Services - Saint Lucia,Landing (descent or approach),Commercial,Saint Vincent and Grenadines,Central America,2,1,1,1,1,2,0,Human Factor
1990-07-25 00:00:00,Varmlandsflyg,Flight,Military / Government,Sweden,Europe,2,2,2,0,0,2,0,Technical Failure
1990-08-28 00:00:00,Stewart Clark Sale,Takeoff (climb),Business,United States of America,North America,2,1,1,1,1,2,0,Human Factor
1990-09-11 00:00:00,Stonewall Transport,Takeoff (climb),Business,United States of America,North America,2,1,1,1,1,2,0,Human Factor
1990-09-24 00:00:00,Swedish Air Force - Flygvapnet,Landing (descent or approach),Military / Government,Sweden,Europe,2,2,2,0,0,2,0,Unknown
1990-09-29 00:00:00,Black Hills Aviation,Flight,Humanitarian,United States of America,North America,2,2,2,0,0,2,0,Unknown
1990-09-30 00:00:00,Aerochago Airlines,Flight,Operational,Puerto Rico,Central America,2,2,2,0,0,2,0,Technical Failure
1990-11-03 00:00:00,Mack L. Bryan Jr.,Landing (descent or approach),Specialised Services,United States of America,North America,2,2,2,0,0,2,0,Human Factor
1991-01-05 00:00:00,Nealco Air Services,Takeoff (climb),Commercial,Guyana,South America,2,1,1,1,1,2,0,Unknown
1991-02-08 00:00:00,Business Express - France,Landing (descent or approach),Operational,France,Europe,2,2,2,0,0,2,0,Human Factor
1991-02-10 00:00:00,Private German,Landing (descent or approach),Business,Germany,Europe,2,1,1,1,1,2,0,Weather
1991-02-17 00:00:00,Ryan International Airlines,Takeoff (climb),Operational,United States of America,North America,2,2,2,0,0,2,0,Human Factor
1991-03-25 00:00:00,Ecuadorian Air Force - Fuerza Aérea Ecuatoriana,Flight,Military / Government,Ecuador,South America,3,3,2,0,0,2,1,Unknown
1991-05-06 00:00:00,Oakley Air,Landing (descent or approach),Operational,Canada,North America,2,2,2,0,0,2,0,Unknown
1991-05-10 00:00:00,Four Star Air Cargo,Takeoff (climb),Operational,Puerto Rico,Central America,2,2,2,0,0,2,0,Technical Failure
1991-05-14 00:00:00,Aeroflot - Russian International Airlines,Flight,Operational,Uzbekistan,Asia,2,2,2,0,0,2,0,Human Factor
1991-05-16 00:00:00,MAP - Ministerstvo Aviatsionnoi Promyshlennosti - Minaviaprom,Landing (descent or approach),Operational,Russia,Asia,9,6,1,3,1,2,7,Human Factor
1991-06-01 00:00:00,Agape Flights,Landing (descent or approach),Commercial,Bahamas,Central America,3,1,0,2,2,2,1,Technical Failure
1991-06-16 00:00:00,Evan Boddy %26 Elliott Hutchinson,Flight,Business,World,World,2,2,2,0,0,2,0,Unknown
1991-06-19 00:00:00,Transport Canada,Flight,Humanitarian,Canada,North America,2,2,2,0,0,2,0,Human Factor
1991-06-20 00:00:00,Aerosucre Colombia,Landing (descent or approach),Operational,Colombia,South America,20,3,0,17,2,2,18,Human Factor
1991-06-21 00:00:00,AOC Survey,Takeoff (climb),Military / Government,South Africa,Africa,4,1,1,3,1,2,2,Technical Failure
1991-06-30 00:00:00,Kras Air - Krasnoyarsk Avia - Krasnoyarskie Avialinii,Flight,Humanitarian,Russia,Asia,2,2,2,0,0,2,0,Human Factor
1991-08-06 00:00:00,Socièta Italiana Servizi Aerei Mediterranei - SISAM,Flight,Humanitarian,Italy,Europe,2,2,2,0,0,2,0,Human Factor
1991-08-21 00:00:00,Private Colombian,Flight,Business,Colombia,South America,2,1,1,1,1,2,0,Unknown
1991-09-11 00:00:00,Jimmy M. Franklin,Takeoff (climb),Business,United States of America,North America,3,1,1,2,1,2,1,Human Factor
1991-09-18 00:00:00,CanAir Cargo,Flight,Operational,United States of America,North America,2,2,2,0,0,2,0,Human Factor
1991-10-16 00:00:00,Aero Union,Landing (descent or approach),Operational,United States of America,North America,2,2,2,0,0,2,0,Human Factor
1991-10-26 00:00:00,William T. Crago,Takeoff (climb),Business,United States of America,North America,2,1,1,1,1,2,0,Human Factor
1991-11-02 00:00:00,Mid Plains Corporation,Takeoff (climb),Business,United States of America,North America,2,1,1,1,1,2,0,Human Factor
1991-11-12 00:00:00,Royal Australian Army,Takeoff (climb),Humanitarian,Australia,Oceania,10,1,0,9,2,2,8,Unknown
1991-11-16 00:00:00,Regional Express,Takeoff (climb),Operational,United States of America,North America,2,1,1,1,1,2,0,Human Factor
1991-11-23 00:00:00,Aeroflot - Russian International Airlines,Landing (descent or approach),Operational,Uzbekistan,Asia,4,2,1,2,1,2,2,Human Factor
1991-12-25 00:00:00,Dominican Air Force - Fuerza Aérea Dominicana,Takeoff (climb),Military / Government,Dominican Republic,Central America,2,2,2,0,0,2,0,Unknown
1991-12-30 00:00:00,English Aero Services,Landing (descent or approach),Business,United States of America,North America,2,1,1,1,1,2,0,Human Factor
1992-01-03 00:00:00,USAir Express - US Airways Express,Landing (descent or approach),Commercial,United States of America,North America,4,2,1,2,1,2,2,Human Factor
1992-01-23 00:00:00,Air Sunshine,Flight,Commercial,United States of America,North America,2,1,1,1,1,2,0,Human Factor
1992-01-23 00:00:00,Nature Island Express,Takeoff (climb),Operational,Dominica,Central America,2,2,2,0,0,2,0,Human Factor
1992-02-08 00:00:00,Hawkins %26 Powers Aviation,Flight,Operational,United States of America,North America,2,2,2,0,0,2,0,Human Factor
1992-03-12 00:00:00,CC Air,Takeoff (climb),Operational,United States of America,North America,2,2,2,0,0,2,0,Human Factor
1992-04-09 00:00:00,Government of Florida,Landing (descent or approach),Military / Government,United States of America,North America,2,1,1,1,1,2,0,Human Factor
1992-05-02 00:00:00,Transamérica Táxi Aéreo,Landing (descent or approach),Humanitarian,Mexico,Central America,2,2,2,0,0,2,0,Human Factor
1992-05-14 00:00:00,Transportes Aéreos Marañón,Flight,Operational,Peru,South America,2,1,1,1,1,2,0,Unknown
1992-05-16 00:00:00,McGee Timber Corporation,Flight,Business,United States of America,North America,2,1,1,1,1,2,0,Human Factor
1992-05-18 00:00:00,Flight International,Landing (descent or approach),Commercial,United States of America,North America,9,2,2,7,0,2,7,Human Factor
1992-06-06 00:00:00,Private Mexican,Flight,Business,Mexico,Central America,2,1,1,1,1,2,0,Unknown
1992-06-12 00:00:00,Jet Charter Group,Takeoff (climb),Operational,United States of America,North America,2,2,2,0,0,2,0,Human Factor
1992-07-09 00:00:00,Richard R. Hough,Takeoff (climb),Business,United States of America,North America,2,1,1,1,1,2,0,Human Factor
1992-07-10 00:00:00,German Air Force - Deutsche Luftwaffe,Landing (descent or approach),Operational,Germany,Europe,2,2,2,0,0,2,0,Unknown
1992-08-27 00:00:00,Global Air Enterprises,Takeoff (climb),Humanitarian,United States of America,North America,3,1,1,2,1,2,1,Human Factor
1992-10-01 00:00:00,United States Forest Service - USFS,Flight,Humanitarian,United States of America,North America,2,2,2,0,0,2,0,Human Factor
1992-10-06 00:00:00,British Aerospace Corporation,Takeoff (climb),Operational,United Kingdom,Europe,2,2,2,0,0,2,0,Human Factor
1992-11-06 00:00:00,Harbor Air Service,Flight,Commercial,United States of America,North America,2,1,1,1,1,2,0,Human Factor
1992-12-02 00:00:00,Berliner Spezialflug - BZF,Flight,Military / Government,Germany,Europe,2,1,1,1,1,2,0,Unknown
1992-12-12 00:00:00,Arthur B. Higgins,Flight,Business,United States of America,North America,2,1,1,1,1,2,0,Unknown
1992-12-14 00:00:00,Timothy W. Eksted,Flight,Business,United States of America,North America,2,1,1,1,1,2,0,Unknown
1992-12-31 00:00:00,Medic Air,Flight,Humanitarian,United States of America,North America,2,1,1,1,1,2,0,Weather
1993-01-13 00:00:00,Titan Airways,Flight,Operational,United Kingdom,Europe,2,2,2,0,0,2,0,Human Factor
1993-01-14 00:00:00,Central Mountain Air,Takeoff (climb),Operational,Canada,North America,2,2,2,0,0,2,0,Human Factor
1993-01-15 00:00:00,Plane Wrap,Takeoff (climb),Business,United States of America,North America,2,1,1,1,1,2,0,Human Factor
1993-02-14 00:00:00,Geoffrey D. Lewis,Takeoff (climb),Specialised Services,United States of America,North America,2,1,1,1,1,2,0,Human Factor
1993-02-20 00:00:00,Cargo Three Panama - C3 Panama,Takeoff (climb),Operational,Colombia,South America,2,2,2,0,0,2,0,Technical Failure
1993-02-27 00:00:00,Kenneth R. Huddleston,Landing (descent or approach),Business,United States of America,North America,2,1,1,1,1,2,0,Human Factor
1993-03-02 00:00:00,Tadair,Takeoff (climb),Operational,Spain,Europe,2,2,2,0,0,2,0,Technical Failure
1993-03-02 00:00:00,American Check Transport,Flight,Commercial,United States of America,North America,2,1,1,1,1,2,0,Human Factor
1993-04-03 00:00:00,Ryan Air,Takeoff (climb),Commercial,United States of America,North America,2,1,1,1,1,2,0,Human Factor
1993-04-20 00:00:00,Trans Aereos Cochabamba,Takeoff (climb),Operational,Colombia,South America,2,2,2,0,0,2,0,Technical Failure
1993-04-28 00:00:00,GP-Express Airlines,Flight,Operational,United States of America,North America,2,2,2,0,0,2,0,Human Factor
1993-04-29 00:00:00,Private Wing Flugreisen,Landing (descent or approach),Business,United States of America,North America,2,2,2,0,0,2,0,Human Factor
1993-05-01 00:00:00,Arkansas Flight Management,Takeoff (climb),Business,United States of America,North America,2,1,1,1,1,2,0,Human Factor
1993-05-11 00:00:00,Fiji Air Services,Landing (descent or approach),Operational,Fiji Islands,Oceania,2,1,1,1,1,2,0,Human Factor
1993-05-22 00:00:00,Loon Air,Takeoff (climb),Specialised Services,Canada,North America,3,2,2,1,0,2,1,Human Factor
1993-06-06 00:00:00,Aerotaca Colombia - Aerotaxi Casanare,Landing (descent or approach),Operational,Colombia,South America,2,2,2,0,0,2,0,Human Factor
1993-07-06 00:00:00,Transkei Defence Force Air Wing,Takeoff (climb),Operational,South Africa,Africa,2,2,2,0,0,2,0,Unknown
1993-08-07 00:00:00,Biplane Adventure Tours,Takeoff (climb),Business,United States of America,North America,3,1,0,2,2,2,1,Technical Failure
1993-08-16 00:00:00,ROSTO,Takeoff (climb),Operational,Russia,Asia,2,2,2,0,0,2,0,Unknown
1993-08-17 00:00:00,Aviation Services,Landing (descent or approach),Operational,United States of America,North America,2,2,2,0,0,2,0,Human Factor
1993-08-22 00:00:00,Hellenic Air Force - Elleniki Polemiki Aeroporia,Flight,Humanitarian,Greece,Europe,2,2,2,0,0,2,0,Unknown
1993-08-31 00:00:00,Trans Oriente Colombia - Transportes Aéreos Regular Secundario Oriental,Landing (descent or approach),Operational,Colombia,South America,6,3,2,3,0,2,4,Technical Failure
1993-09-14 00:00:00,Lufthansa,Landing (descent or approach),Commercial,Poland,Europe,70,6,1,64,1,2,68,Human Factor
1993-09-15 00:00:00,A. K. Penner %26 Sons,Flight,Business,Canada,North America,2,1,1,1,1,2,0,Unknown
1993-09-27 00:00:00,Midwest Flying Service,Takeoff (climb),Operational,United States of America,North America,2,2,2,0,0,2,0,Technical Failure
1993-09-29 00:00:00,Chaillotine Air Service,Takeoff (climb),Commercial,France,Europe,3,2,2,1,0,2,1,Human Factor
1993-10-12 00:00:00,KMC Ventures,Takeoff (climb),Military / Government,Bahamas,Central America,2,2,2,0,0,2,0,Unknown
1993-10-13 00:00:00,Royal Malaysian Air Force - Tentera Udara Diraja Malaysia,Takeoff (climb),Military / Government,Malaysia,Asia,2,2,2,0,0,2,0,Unknown
1993-10-26 00:00:00,China Eastern Airlines,Landing (descent or approach),Commercial,China,Asia,80,9,0,71,2,2,78,Human Factor
1993-11-20 00:00:00,Phenix Air Service,Landing (descent or approach),Operational,France,Europe,2,2,2,0,0,2,0,Unknown
1993-11-22 00:00:00,Scan Transportes Aéreos,Landing (descent or approach),Humanitarian,Mozambique,Africa,3,3,2,0,0,2,1,Technical Failure
1993-11-25 00:00:00,Ray Steves and Associates,Landing (descent or approach),Business,United States of America,North America,2,1,1,1,1,2,0,Human Factor
1993-12-02 00:00:00,Airwork - USA,Flight,Operational,United States of America,North America,2,2,2,0,0,2,0,Human Factor
1993-12-04 00:00:00,Waglisla Air - Wagair,Takeoff (climb),Commercial,Canada,North America,5,1,1,4,1,2,3,Technical Failure
1993-12-16 00:00:00,Raff Aviation,Flight,Specialised Services,United States of America,North America,2,1,1,1,1,2,0,Human Factor
1993-12-17 00:00:00,Air Link International Aviation,Takeoff (climb),Operational,Philippines,Asia,2,2,2,0,0,2,0,Unknown
1994-01-01 00:00:00,George M. Batsche,Landing (descent or approach),Business,United States of America,North America,2,1,1,1,1,2,0,Human Factor
1994-01-02 00:00:00,JSCTD,Takeoff (climb),Business,Venezuela,South America,2,2,2,0,0,2,0,Unknown
1994-01-04 00:00:00,Preferred Flights,Landing (descent or approach),Operational,Canada,North America,2,2,2,0,0,2,0,Human Factor
1994-01-11 00:00:00,Trans-Côte,Landing (descent or approach),Operational,Canada,North America,2,2,2,0,0,2,0,Human Factor
1994-01-18 00:00:00,Scibe-Airlift Zaïre,Landing (descent or approach),Operational,Democratic Republic of Congo,Africa,2,2,2,0,0,2,0,Unknown
1994-01-26 00:00:00,Sky Harbor Air Service,Landing (descent or approach),Commercial,United States of America,North America,7,1,1,6,1,2,5,Human Factor
1994-01-27 00:00:00,Millar Western Industries,Landing (descent or approach),Operational,Canada,North America,2,2,2,0,0,2,0,Human Factor
1994-02-10 00:00:00,Critical Air Medicine,Landing (descent or approach),Humanitarian,United States of America,North America,3,1,1,2,1,2,1,Human Factor
1994-03-03 00:00:00,James Flying Service,Landing (descent or approach),Business,United States of America,North America,2,1,1,1,1,2,0,Weather
1994-03-18 00:00:00,Chalk's Ocean Airways,Takeoff (climb),Operational,United States of America,North America,2,2,2,0,0,2,0,Human Factor
1994-03-18 00:00:00,K %26 L Microwave,Takeoff (climb),Business,United States of America,North America,3,1,1,2,1,2,1,Human Factor
1994-03-18 00:00:00,Salair,Takeoff (climb),Operational,United States of America,North America,2,2,2,0,0,2,0,Technical Failure
1994-03-25 00:00:00,Transportadora Fruyleg,Landing (descent or approach),Operational,Mexico,Central America,2,2,2,0,0,2,0,Human Factor
1994-04-07 00:00:00,Augusta Aviation,Landing (descent or approach),Humanitarian,United States of America,North America,2,1,1,1,1,2,0,Human Factor
1994-04-26 00:00:00,PENTA - PENA Táxi Aéreo,Landing (descent or approach),Operational,Brazil,South America,2,2,2,0,0,2,0,Human Factor
1994-05-18 00:00:00,Ben A. Lesbo,Flight,Business,United States of America,North America,2,1,1,1,1,2,0,Human Factor
1994-05-21 00:00:00,Tanzania Peoples Defence Forces,Landing (descent or approach),Military / Government,Tanzania,Africa,2,2,2,0,0,2,0,Human Factor
1994-06-01 00:00:00,Keewatin Air,Landing (descent or approach),Humanitarian,Canada,North America,3,2,2,1,0,2,1,Human Factor
1994-06-02 00:00:00,Rent-a-Plane,Takeoff (climb),Operational,Argentina,South America,2,2,2,0,0,2,0,Unknown
1994-06-09 00:00:00,IK Curtis Services,Flight,Specialised Services,United States of America,North America,2,1,1,1,1,2,0,Human Factor
1994-06-15 00:00:00,Alexander A. Greco,Takeoff (climb),Business,United States of America,North America,3,1,1,2,1,2,1,Technical Failure
1994-06-23 00:00:00,Harbour Air Seaplanes,Takeoff (climb),Commercial,Canada,North America,2,1,1,1,1,2,0,Human Factor
1994-06-24 00:00:00,Roscoe M. Thorne,Takeoff (climb),Business,United States of America,North America,2,1,1,1,1,2,0,Human Factor
1994-07-07 00:00:00,Varmlandsflyg,Flight,Military / Government,Sweden,Europe,2,1,1,1,1,2,0,Human Factor
1994-07-17 00:00:00,Sécurité civile française,Takeoff (climb),Military / Government,France,Europe,2,1,1,1,1,2,0,Technical Failure
1994-07-29 00:00:00,Neptune Aviation Charter,Flight,Humanitarian,United States of America,North America,2,2,2,0,0,2,0,Human Factor
1994-09-01 00:00:00,BMI Enterprises,Landing (descent or approach),Business,United States of America,North America,2,1,1,1,1,2,0,Human Factor
1994-09-21 00:00:00,Chechnya Air Force,Flight,Military / Government,Russia,Asia,2,2,2,0,0,2,0,Terrorism
1994-09-23 00:00:00,Eagle Air International,Landing (descent or approach),Operational,Iceland,Europe,2,2,2,0,0,2,0,Technical Failure
1994-09-23 00:00:00,Purus Aerotaxi,Takeoff (climb),Operational,Brazil,South America,2,2,2,0,0,2,0,Human Factor
1994-10-10 00:00:00,S%26T,Flight,Business,France,Europe,2,1,1,1,1,2,0,Human Factor
1994-10-11 00:00:00,Alaska Department of Public Safety,Flight,Military / Government,United States of America,North America,2,2,2,0,0,2,0,Unknown
1994-11-09 00:00:00,Private Australian,Flight,Military / Government,Australia,Oceania,2,2,2,0,0,2,0,Human Factor
1994-11-19 00:00:00,Intan Angkasa Air Service,Flight,Operational,Indonesia,Asia,2,2,2,0,0,2,0,Unknown
1994-11-22 00:00:00,Superior Aviation,Taxiing,Operational,United States of America,North America,2,2,2,0,0,2,0,Human Factor
1994-11-29 00:00:00,Charles B. Fain,Flight,Business,United States of America,North America,2,1,1,1,1,2,0,Human Factor
1994-12-14 00:00:00,Phoenix Air Group,Landing (descent or approach),Military / Government,United States of America,North America,2,2,2,0,0,2,0,Human Factor
1994-12-16 00:00:00,SL Aviation Services,Takeoff (climb),Humanitarian,Angola,Africa,2,2,2,0,0,2,0,Other
1994-12-18 00:00:00,Terra Surveys,Flight,Military / Government,Namibia,Africa,2,2,2,0,0,2,0,Unknown
1994-12-20 00:00:00,United Seafood,Landing (descent or approach),Business,Finland,Europe,3,1,1,2,1,2,1,Human Factor
1995-01-03 00:00:00,Airborne Flying Services,Flight,Operational,United States of America,North America,2,1,1,1,1,2,0,Human Factor
1995-01-04 00:00:00,Eduardo Mata,Takeoff (climb),Business,Mexico,Central America,2,1,1,1,1,2,0,Technical Failure
1995-01-17 00:00:00,Royal Nepal Airlines,Takeoff (climb),Commercial,Nepal,Asia,24,3,1,21,1,2,22,Human Factor
1995-01-25 00:00:00,United Airlines of Kenya,Landing (descent or approach),Operational,Kenya,Africa,2,1,1,1,1,2,0,Technical Failure
1995-01-25 00:00:00,Viessmann Werke,Landing (descent or approach),Operational,Germany,Europe,2,2,2,0,0,2,0,Human Factor
1995-01-28 00:00:00,Sociedad de Aviaçao Ligeira - SAL,Takeoff (climb),Commercial,Angola,Africa,6,2,0,4,2,2,4,Terrorism
1995-02-09 00:00:00,Mistystar,Landing (descent or approach),Business,United States of America,North America,2,1,1,1,1,2,0,Human Factor
1995-02-12 00:00:00,Thomas M. McMullen,Landing (descent or approach),Business,United States of America,North America,2,1,1,1,1,2,0,Weather
1995-02-14 00:00:00,Air Excursions,Landing (descent or approach),Business,United States of America,North America,4,2,2,2,0,2,2,Human Factor
1995-03-03 00:00:00,DMC Flying Service,Landing (descent or approach),Business,United States of America,North America,2,2,2,0,0,2,0,Human Factor
1995-04-13 00:00:00,Wonderair,Landing (descent or approach),Humanitarian,Democratic Republic of Congo,Africa,2,2,2,0,0,2,0,Human Factor
1995-04-29 00:00:00,Private French,Flight,Business,Italy,Europe,2,1,1,1,1,2,0,Human Factor
1995-05-03 00:00:00,Transportes Aéreos Petroleros - TAPSA,Takeoff (climb),Operational,Argentina,South America,2,2,2,0,0,2,0,Other
1995-05-09 00:00:00,Leonard Schroetlin,Landing (descent or approach),Business,United States of America,North America,2,1,1,1,1,2,0,Human Factor
1995-06-07 00:00:00,Latvian Air Force - Latvijas Gaisa Spēki,Flight,Operational,Latvia,Europe,2,2,2,0,0,2,0,Human Factor
1995-06-13 00:00:00,Air Classic Museum,Takeoff (climb),Operational,United States of America,North America,2,1,1,1,1,2,0,Human Factor
1995-06-21 00:00:00,Aero Union,Landing (descent or approach),Humanitarian,United States of America,North America,2,2,2,0,0,2,0,Human Factor
1995-06-22 00:00:00,Aero Reservaciones Ejecutivas - ARE,Landing (descent or approach),Commercial,Mexico,Central America,6,2,2,4,0,2,4,Human Factor
1995-06-27 00:00:00,Salair,Flight,Operational,Dominican Republic,Central America,2,2,2,0,0,2,0,Technical Failure
1995-07-01 00:00:00,Garamut Aviation,Landing (descent or approach),Operational,Papua New Guinea,Oceania,3,2,1,1,1,2,1,Technical Failure
1995-07-25 00:00:00,Transniugini Airways,Takeoff (climb),Commercial,Papua New Guinea,Oceania,2,1,1,1,1,2,0,Technical Failure
1995-08-18 00:00:00,Pietsch Flying Service,Flight,Business,United States of America,North America,2,1,1,1,1,2,0,Human Factor
1995-08-20 00:00:00,Blair M. Bycura,Landing (descent or approach),Business,United States of America,North America,2,1,1,1,1,2,0,Human Factor
1995-09-08 00:00:00,Elmer C. Rigby,Landing (descent or approach),Business,United States of America,North America,2,1,1,1,1,2,0,Human Factor
1995-09-16 00:00:00,Tamair,Takeoff (climb),Operational,Australia,Oceania,3,3,2,0,0,2,1,Human Factor
1995-09-16 00:00:00,Aviotransport,Flight,Humanitarian,Macedonia,Europe,2,2,2,0,0,2,0,Unknown
1995-09-25 00:00:00,Transportes Aéreos Meridionais,Flight,Operational,Brazil,South America,2,2,2,0,0,2,0,Human Factor
1995-10-07 00:00:00,Waglisla Air - Wagair,Flight,Operational,Canada,North America,3,1,0,2,2,2,1,Unknown
1995-10-15 00:00:00,TyumenAviaTrans,Flight,Commercial,Russia,Asia,10,2,2,8,0,2,8,Human Factor
1995-11-30 00:00:00,Azerbaijan Airlines - AZAL Airlines,Landing (descent or approach),Operational,Azerbaijan,Asia,6,6,2,0,0,2,4,Human Factor
1995-12-05 00:00:00,Missionary Aviation Ministries,Takeoff (climb),Humanitarian,United States of America,North America,2,1,1,1,1,2,0,Human Factor
1995-12-14 00:00:00,American Air Network,Landing (descent or approach),Operational,Guatemala,Central America,2,2,2,0,0,2,0,Technical Failure
1995-12-22 00:00:00,Islands Nationair,Landing (descent or approach),Commercial,Papua New Guinea,Oceania,12,1,1,11,1,2,10,Human Factor
1995-12-23 00:00:00,Ameriflight,Landing (descent or approach),Operational,United States of America,North America,2,2,2,0,0,2,0,Human Factor
1995-12-30 00:00:00,Iowa Packing Company,Landing (descent or approach),Business,United States of America,North America,2,2,2,0,0,2,0,Human Factor
1995-12-31 00:00:00,Moran Foods,Landing (descent or approach),Operational,United States of America,North America,2,2,2,0,0,2,0,Human Factor
1996-01-04 00:00:00,Private German,Landing (descent or approach),Business,Germany,Europe,2,1,1,1,1,2,0,Human Factor
1996-01-16 00:00:00,Toki Leasing Corporation,Landing (descent or approach),Business,United States of America,North America,2,2,2,0,0,2,0,Human Factor
1996-01-26 00:00:00,Magnum Airlines,Takeoff (climb),Operational,South Africa,Africa,2,2,2,0,0,2,0,Unknown
1996-02-16 00:00:00,Avcom - Aviones Comerciales de Guatemala,Landing (descent or approach),Operational,Guatemala,Central America,2,2,2,0,0,2,0,Human Factor
1996-03-04 00:00:00,KASET - Bureau of Royal Rainmaking and Agricultural Aviation,Takeoff (climb),Operational,Thailand,Asia,2,2,2,0,0,2,0,Unknown
1996-04-27 00:00:00,Central Azucarero Portuguesa C. A.,Landing (descent or approach),Operational,Venezuela,South America,2,2,2,0,0,2,0,Unknown
1996-04-30 00:00:00,Royal Cambodian Air Force - Kangtorp Cheung Akas,Flight,Military / Government,Cambodia,Asia,2,2,2,0,0,2,0,Unknown
1996-05-09 00:00:00,Buffalo Narrows Airways,Flight,Operational,Canada,North America,2,2,2,0,0,2,0,Human Factor
1996-05-15 00:00:00,R%26B Leasing,Takeoff (climb),Business,Bahamas,Central America,2,2,2,0,0,2,0,Human Factor
1996-06-10 00:00:00,Ruma Advisory Company,Takeoff (climb),Business,United States of America,North America,2,2,2,0,0,2,0,Human Factor
1996-06-13 00:00:00,Aviaagro,Flight,Military / Government,Russia,Asia,2,2,2,0,0,2,0,Human Factor
1996-06-21 00:00:00,China Flying Dragon Special Aviation Company,Landing (descent or approach),Commercial,China,Asia,12,3,1,9,1,2,10,Human Factor
1996-07-27 00:00:00,FBN Inc.,Landing (descent or approach),Operational,United States of America,North America,2,2,2,0,0,2,0,Human Factor
1996-08-11 00:00:00,PenAir - Peninsula Airways - Alaska Airlines Commuter,Flight,Commercial,United States of America,North America,2,1,1,1,1,2,0,Unknown
1996-08-12 00:00:00,First Air,Landing (descent or approach),Operational,Canada,North America,2,2,2,0,0,2,0,Human Factor
1996-08-27 00:00:00,Moldaeroservice,Flight,Military / Government,Moldova,Europe,2,2,2,0,0,2,0,Human Factor
1996-09-13 00:00:00,Helisul Taxi Aéreo,Landing (descent or approach),Operational,Brazil,South America,2,2,2,0,0,2,0,Human Factor
1996-09-20 00:00:00,Schönhagen Air,Landing (descent or approach),Business,Germany,Europe,2,1,1,1,1,2,0,Unknown
1996-09-30 00:00:00,Castle Rock Exploration Corporation,Takeoff (climb),Commercial,Canada,North America,2,1,1,1,1,2,0,Human Factor
1996-10-08 00:00:00,Aeroflot - Russian International Airlines,Landing (descent or approach),Operational,Italy,Europe,23,4,2,19,0,2,21,Human Factor
1996-10-23 00:00:00,Líneas Aéreas del Estado - LADE,Landing (descent or approach),Operational,Argentina,South America,8,8,2,0,0,2,6,Human Factor
1996-11-19 00:00:00,Aviation Materials %26 Technic,Takeoff (climb),Business,United States of America,North America,2,2,2,0,0,2,0,Human Factor
1996-11-26 00:00:00,Frank J. Mazzei Jr.,Flight,Humanitarian,United States of America,North America,2,1,1,1,1,2,0,Human Factor
1996-12-06 00:00:00,Chrysler Aviation,Landing (descent or approach),Operational,Canada,North America,2,2,2,0,0,2,0,Human Factor
1996-12-09 00:00:00,Desert Air Transport,Takeoff (climb),Operational,United States of America,North America,2,2,2,0,0,2,0,Technical Failure
1996-12-24 00:00:00,Aircraft Charter Group,Landing (descent or approach),Operational,United States of America,North America,2,2,2,0,0,2,0,Human Factor
1997-01-02 00:00:00,Tar Heel Aviation,Landing (descent or approach),Operational,United States of America,North America,2,2,2,0,0,2,0,Human Factor
1997-02-01 00:00:00,Airspan Corporation,Flight,Operational,Philippines,Asia,2,2,2,0,0,2,0,Human Factor
1997-02-08 00:00:00,Air Sunshine,Landing (descent or approach),Commercial,United States of America,Central America,5,1,0,4,2,2,3,Human Factor
1997-03-06 00:00:00,Polaris Aviation,Flight,Operational,United States of America,North America,2,1,1,1,1,2,0,Weather
1997-03-07 00:00:00,Aerotaxi del Oriente,Takeoff (climb),Business,Colombia,South America,2,2,2,0,0,2,0,Human Factor
1997-03-15 00:00:00,Basler Airlines,Flight,Specialised Services,United States of America,North America,2,2,2,0,0,2,0,Human Factor
1997-04-04 00:00:00,Custom Air Service,Takeoff (climb),Operational,United States of America,North America,2,2,2,0,0,2,0,Technical Failure
1997-04-08 00:00:00,Mirko M. Nussbaum,Landing (descent or approach),Business,United States of America,North America,2,1,1,1,1,2,0,Human Factor
1997-04-16 00:00:00,United States Army,Flight,Operational,United States of America,North America,2,2,2,0,0,2,0,Unknown
1997-04-20 00:00:00,Hirth Air Tankers,Flight,Humanitarian,United States of America,North America,2,2,2,0,0,2,0,Human Factor
1997-04-27 00:00:00,Gary L. Blackman,Landing (descent or approach),Business,United States of America,North America,2,1,1,1,1,2,0,Human Factor
1997-04-30 00:00:00,TransNorthern Aviation,Flight,Military / Government,Cambodia,Asia,2,1,1,1,1,2,0,Human Factor
1997-06-27 00:00:00,Olson Air Service,Landing (descent or approach),Commercial,United States of America,North America,2,1,1,1,1,2,0,Human Factor
1997-07-03 00:00:00,Elbee Airlines,Takeoff (climb),Operational,India,Asia,2,2,2,0,0,2,0,Weather
1997-07-18 00:00:00,Goroka Air Services,Landing (descent or approach),Commercial,Papua New Guinea,Oceania,4,2,1,2,1,2,2,Human Factor
1997-07-21 00:00:00,Singapore Airlines,Landing (descent or approach),Operational,Thailand,Asia,2,2,2,0,0,2,0,Human Factor
1997-08-15 00:00:00,Riana Táxi Aéreo,Flight,Operational,Brazil,South America,2,2,2,0,0,2,0,Human Factor
1997-09-06 00:00:00,Robert Kirke Dent,Flight,Business,United States of America,North America,2,1,1,1,1,2,0,Human Factor
1997-10-29 00:00:00,Ariana Afghan Airlines,Landing (descent or approach),Commercial,Afghanistan,Asia,26,6,1,20,1,2,24,Unknown
1997-12-12 00:00:00,Yakima Theatres,Landing (descent or approach),Business,United States of America,North America,2,1,1,1,1,2,0,Unknown
1997-12-21 00:00:00,Aviation Charter,Landing (descent or approach),Commercial,United States of America,North America,3,1,1,2,1,2,1,Human Factor
1997-12-29 00:00:00,Valley Forge Manufacturing Corporation,Flight,Business,United States of America,North America,2,1,1,1,1,2,0,Technical Failure
1997-12-30 00:00:00,PVS International,Takeoff (climb),Operational,United States of America,North America,2,2,2,0,0,2,0,Human Factor
1998-01-10 00:00:00,MGS Corporation,Landing (descent or approach),Business,United States of America,North America,3,2,2,1,0,2,1,Technical Failure
1998-01-13 00:00:00,Aeroservice International,Landing (descent or approach),Operational,Czech Republic,Europe,2,2,2,0,0,2,0,Human Factor
1998-01-13 00:00:00,American Corporate Aviation,Landing (descent or approach),Operational,United States of America,North America,2,2,2,0,0,2,0,Human Factor
1998-02-16 00:00:00,West Virginia University Foundation,Flight,Operational,United States of America,North America,2,2,2,0,0,2,0,Technical Failure
1998-02-19 00:00:00,Ibertrans Aérea,Landing (descent or approach),Operational,Spain,Europe,2,2,2,0,0,2,0,Human Factor
1998-03-01 00:00:00,Bird Air Fleet,Landing (descent or approach),Commercial,United States of America,North America,2,1,1,1,1,2,0,Human Factor
1998-03-31 00:00:00,Linea Aérea Mexicana de Carga,Landing (descent or approach),Operational,Mexico,Central America,4,2,1,2,1,2,2,Technical Failure
1998-04-11 00:00:00,CMSystems,Flight,Business,United States of America,North America,2,1,1,1,1,2,0,Human Factor
1998-05-01 00:00:00,Société Soon,Landing (descent or approach),Business,France,Europe,2,1,1,1,1,2,0,Human Factor
1998-05-09 00:00:00,Rentair,Landing (descent or approach),Commercial,Spain,Europe,2,1,1,1,1,2,0,Human Factor
1998-05-19 00:00:00,Bruce L. Erickson,Landing (descent or approach),Operational,United States of America,North America,2,2,2,0,0,2,0,Human Factor
1998-05-26 00:00:00,Adolf Henschel,Landing (descent or approach),Business,Czech Republic,Europe,2,1,1,1,1,2,0,Technical Failure
1998-06-27 00:00:00,Neptune Aviation Charter,Flight,Humanitarian,United States of America,North America,2,2,2,0,0,2,0,Human Factor
1998-07-07 00:00:00,F.S. Air Service,Landing (descent or approach),Operational,United States of America,North America,2,2,2,0,0,2,0,Human Factor
1998-07-18 00:00:00,Executive Aircraft Group,Flight,Business,United States of America,North America,2,2,2,0,0,2,0,Human Factor
1998-07-20 00:00:00,Fitzroy Aviation Queensland,Landing (descent or approach),Operational,Australia,Oceania,2,1,1,1,1,2,0,Human Factor
1998-07-27 00:00:00,Plane Sailing Air Displays,Landing (descent or approach),Business,United Kingdom,Europe,18,4,0,14,2,2,16,Technical Failure
1998-07-28 00:00:00,Swiftair,Landing (descent or approach),Operational,Spain,Europe,2,2,2,0,0,2,0,Human Factor
1998-09-18 00:00:00,Private Costarican,Takeoff (climb),Business,Costa Rica,Central America,2,1,1,1,1,2,0,Unknown
1998-11-04 00:00:00,LW Aviation,Flight,Specialised Services,United States of America,North America,2,2,2,0,0,2,0,Human Factor
1998-11-06 00:00:00,United States Army,Landing (descent or approach),Military / Government,Germany,Europe,2,2,2,0,0,2,0,Unknown
1998-11-23 00:00:00,Regency Express Air,Landing (descent or approach),Operational,Canada,North America,2,2,2,0,0,2,0,Human Factor
1998-11-28 00:00:00,DNK Aviation Services,Flight,Specialised Services,United Kingdom,Europe,2,2,2,0,0,2,0,Human Factor
1998-12-05 00:00:00,Dogus Air,Landing (descent or approach),Operational,Turkey,Asia,2,2,2,0,0,2,0,Technical Failure
1998-12-16 00:00:00,Transportes Aéreos de El Salvador,Landing (descent or approach),Operational,Honduras,Central America,2,2,2,0,0,2,0,Human Factor
1998-12-17 00:00:00,Air Affaires Gabon,Landing (descent or approach),Operational,Gabon,Africa,2,2,2,0,0,2,0,Technical Failure
1999-01-12 00:00:00,Channel Express - Air Services,Landing (descent or approach),Operational,United Kingdom,Europe,2,2,2,0,0,2,0,Other
1999-01-13 00:00:00,Kelowna Flightcraft Air Charter,Flight,Operational,Canada,North America,2,2,2,0,0,2,0,Human Factor
1999-01-14 00:00:00,USA Healthcare Leasing,Landing (descent or approach),Business,United States of America,North America,2,1,1,1,1,2,0,Human Factor
1999-01-30 00:00:00,Bryant Monturiol,Landing (descent or approach),Business,United States of America,North America,4,1,0,3,2,2,2,Technical Failure
1999-02-27 00:00:00,John P. Silberman,Takeoff (climb),Business,United States of America,North America,2,1,1,1,1,2,0,Human Factor
1999-03-08 00:00:00,John E. Hoesly,Takeoff (climb),Business,United States of America,North America,2,1,1,1,1,2,0,Unknown
1999-03-16 00:00:00,James R. Browning,Landing (descent or approach),Business,United States of America,North America,2,1,1,1,1,2,0,Technical Failure
1999-03-23 00:00:00,No Limits Taxi Aéreo,Takeoff (climb),Operational,Brazil,South America,2,2,2,0,0,2,0,Human Factor
1999-04-01 00:00:00,Manfred W. Engler,Flight,Business,United States of America,North America,2,1,1,1,1,2,0,Unknown
1999-04-23 00:00:00,Michael H. Wright,Takeoff (climb),Business,United States of America,North America,2,1,1,1,1,2,0,Unknown
1999-05-03 00:00:00,Aircraft Guaranty Corporation Trustee,Flight,Business,Thailand,Asia,2,1,1,1,1,2,0,Unknown
1999-05-24 00:00:00,Lucky Landings Charter,Takeoff (climb),Business,Canada,North America,2,1,1,1,1,2,0,Human Factor
1999-05-29 00:00:00,Malindi Air Services,Takeoff (climb),Operational,Kenya,Africa,2,2,2,0,0,2,0,Human Factor
1999-06-08 00:00:00,Irwin P. Pochter,Landing (descent or approach),Business,United States of America,North America,2,1,1,1,1,2,0,Human Factor
1999-06-22 00:00:00,Boogie Performance,Landing (descent or approach),Humanitarian,France,Europe,2,2,2,0,0,2,0,Technical Failure
1999-06-25 00:00:00,AeroCenter,Flight,Commercial,United States of America,North America,2,1,1,1,1,2,0,Human Factor
1999-06-30 00:00:00,NightExpress Luftverkehrs,Landing (descent or approach),Operational,Belgium,Europe,2,2,2,0,0,2,0,Human Factor
1999-07-15 00:00:00,Air Care,Flight,Operational,Italy,Europe,2,2,2,0,0,2,0,Unknown
1999-07-23 00:00:00,Mark H. Johnson,Takeoff (climb),Business,United States of America,North America,2,1,1,1,1,2,0,Human Factor
1999-08-26 00:00:00,Uzbekistan Airways - Uzbekistan Havo Jullary,Landing (descent or approach),Commercial,Uzbekistan,Asia,33,4,0,29,2,2,31,Human Factor
1999-08-29 00:00:00,Corporate Jets,Flight,Operational,Ethiopia,Africa,2,2,2,0,0,2,0,Terrorism
1999-09-05 00:00:00,Amicale des Avions anciens de la Drôme,Flight,Operational,France,Europe,2,2,2,0,0,2,0,Unknown
1999-09-14 00:00:00,Norte Jet Taxi Aéreo,Landing (descent or approach),Operational,Brazil,South America,2,2,2,0,0,2,0,Technical Failure
1999-09-19 00:00:00,Compania Aerospace de Venezuela,Flight,Business,Bahamas,Central America,2,1,1,1,1,2,0,Technical Failure
1999-09-21 00:00:00,Baltimore Air Transport,Landing (descent or approach),Operational,United States of America,North America,2,1,1,1,1,2,0,Human Factor
1999-10-05 00:00:00,Shoreline Aviation,Takeoff (climb),Operational,United States of America,North America,2,2,2,0,0,2,0,Human Factor
1999-10-31 00:00:00,Helibérica,Takeoff (climb),Specialised Services,Spain,Europe,2,1,1,1,1,2,0,Technical Failure
1999-12-22 00:00:00,Private Mexican,Landing (descent or approach),Business,Mexico,Central America,2,1,1,1,1,2,0,Unknown
1999-12-22 00:00:00,Thomas H. Hoffman,Takeoff (climb),Business,United States of America,North America,2,1,1,1,1,2,0,Human Factor
1999-12-26 00:00:00,Giovanni Beretta,Flight,Humanitarian,Italy,Europe,4,1,1,3,1,2,2,Weather
2000-01-10 00:00:00,N3193X Bonanza Corporation,Landing (descent or approach),Operational,United States of America,North America,2,1,1,1,1,2,0,Human Factor
2000-01-22 00:00:00,BTC Saratoga,Takeoff (climb),Business,United States of America,North America,2,2,2,0,0,2,0,Technical Failure
2000-03-17 00:00:00,Points North Air,Landing (descent or approach),Operational,Canada,North America,2,2,2,0,0,2,0,Other
2000-04-02 00:00:00,Lufttaxi Flug,Flight,Operational,Germany,Europe,2,2,2,0,0,2,0,Unknown
2000-04-02 00:00:00,Foster Webb Air Charter,Takeoff (climb),Operational,Swaziland,Africa,3,2,1,1,1,2,1,Human Factor
2000-04-05 00:00:00,Biodata,Landing (descent or approach),Operational,Germany,Europe,2,2,2,0,0,2,0,Unknown
2000-04-08 00:00:00,Imaginair,Landing (descent or approach),Humanitarian,Germany,Europe,2,2,2,0,0,2,0,Other
2000-04-19 00:00:00,Kivu Air,Flight,Commercial,Democratic Republic of Congo,Africa,2,1,1,1,1,2,0,Unknown
2000-04-30 00:00:00,Robert C. Donoho,Flight,Business,United States of America,North America,2,1,1,1,1,2,0,Human Factor
2000-05-02 00:00:00,Northern Executive Aviation,Landing (descent or approach),Commercial,France,Europe,5,2,2,3,0,2,3,Technical Failure
2000-05-09 00:00:00,Servicio Aéreo Ejecutivo,Flight,Operational,World,World,2,2,2,0,0,2,0,Unknown
2000-06-05 00:00:00,Key Lime Air,Flight,Operational,United States of America,North America,2,2,2,0,0,2,0,Human Factor
2000-07-15 00:00:00,Hellenic Air Force - Elleniki Polemiki Aeroporia,Flight,Humanitarian,Greece,Europe,2,2,2,0,0,2,0,Human Factor
2000-07-19 00:00:00,Airwave Transport,Flight,Operational,United States of America,North America,2,2,2,0,0,2,0,Human Factor
2000-07-20 00:00:00,Allied Air Freight,Takeoff (climb),Operational,Bahamas,Central America,2,2,2,0,0,2,0,Technical Failure
2000-08-14 00:00:00,RCMP - GRC Air Services,Takeoff (climb),Operational,Canada,North America,2,2,2,0,0,2,0,Human Factor
2000-08-14 00:00:00,Colonel's,Landing (descent or approach),Business,United States of America,North America,4,2,2,2,0,2,2,Weather
2000-09-06 00:00:00,T %26 G Aviation,Flight,Humanitarian,France,Europe,4,4,2,0,0,2,2,Human Factor
2000-10-06 00:00:00,Mexican Air Force - Fuerza Aérea Mexicana,Flight,Military / Government,Mexico,Central America,3,2,2,1,0,2,1,Unknown
2000-10-26 00:00:00,Marko Foam Products,Flight,Business,United States of America,North America,2,2,2,0,0,2,0,Weather
2000-11-10 00:00:00,Aerohawk Aviation,Landing (descent or approach),Operational,United States of America,North America,2,2,2,0,0,2,0,Human Factor
2000-11-13 00:00:00,Champagne Airlines,Landing (descent or approach),Operational,France,Europe,2,2,2,0,0,2,0,Human Factor
2000-12-10 00:00:00,Four Twenty One,Landing (descent or approach),Business,United States of America,North America,2,1,1,1,1,2,0,Human Factor
2000-12-20 00:00:00,Everts Air Cargo,Flight,Operational,United States of America,North America,2,2,2,0,0,2,0,Human Factor
2000-12-22 00:00:00,Mountain Air Service,Landing (descent or approach),Business,United States of America,North America,2,1,1,1,1,2,0,Human Factor
2001-01-11 00:00:00,Bahia Táxi Aéreo - BATA,Landing (descent or approach),Operational,Brazil,South America,2,2,2,0,0,2,0,Human Factor
2001-01-23 00:00:00,Majestic Air Cargo,Takeoff (climb),Operational,United States of America,North America,2,2,2,0,0,2,0,Human Factor
2001-02-07 00:00:00,Argentinian Air Force - Fuerza Aérea Argentina,Flight,Operational,Argentina,South America,2,2,2,0,0,2,0,Unknown
2001-02-08 00:00:00,Northern Illinois Flight Center,Landing (descent or approach),Commercial,United States of America,North America,6,2,2,4,0,2,4,Human Factor
2001-02-27 00:00:00,Loganair,Takeoff (climb),Operational,United Kingdom,Europe,2,2,2,0,0,2,0,Technical Failure
2001-03-06 00:00:00,Gwen Bloomingdale,Flight,Business,Iceland,Europe,2,2,2,0,0,2,0,Weather
2001-03-26 00:00:00,United States Army,Landing (descent or approach),Military / Government,Germany,Europe,2,2,2,0,0,2,0,Unknown
2001-04-09 00:00:00,LK Aero Corporation,Takeoff (climb),Business,United States of America,North America,2,2,2,0,0,2,0,Human Factor
2001-05-01 00:00:00,Jerry L. Fambrough,Flight,Business,United States of America,North America,2,1,1,1,1,2,0,Technical Failure
2001-06-10 00:00:00,John M. White,Flight,Business,United States of America,North America,2,1,1,1,1,2,0,Human Factor
2001-06-16 00:00:00,Network Aviation Services,Flight,Commercial,Nigeria,Africa,3,1,1,2,1,2,1,Technical Failure
2001-08-24 00:00:00,Ameristar Jet Charter,Takeoff (climb),Operational,United States of America,North America,2,2,2,0,0,2,0,Human Factor
2001-09-24 00:00:00,Key Lime Air,Flight,Operational,United States of America,North America,2,2,2,0,0,2,0,Human Factor
2001-10-11 00:00:00,Perimeter Aviation,Landing (descent or approach),Humanitarian,Canada,North America,3,2,2,1,0,2,1,Human Factor
2001-11-13 00:00:00,Richard C. Runyon,Takeoff (climb),Business,United States of America,North America,2,1,1,1,1,2,0,Human Factor
2001-11-22 00:00:00,Universal Jet Aviation,Takeoff (climb),Operational,United States of America,North America,2,2,2,0,0,2,0,Human Factor
2001-11-23 00:00:00,Enimex,Landing (descent or approach),Commercial,Estonia,Europe,17,3,0,14,2,2,15,Human Factor
2001-12-01 00:00:00,Air Carriers - USA,Landing (descent or approach),Operational,United States of America,North America,2,2,2,0,0,2,0,Human Factor
2001-12-10 00:00:00,Air Cargo Express,Flight,Operational,United States of America,North America,2,2,2,0,0,2,0,Unknown
2001-12-20 00:00:00,Eagle Air - Switzerland,Takeoff (climb),Operational,Switzerland,Europe,2,2,2,0,0,2,0,Human Factor
2002-01-25 00:00:00,Timothy A. Patrick,Flight,Business,United States of America,North America,2,1,1,1,1,2,0,Human Factor
2002-01-30 00:00:00,Chrysalis 1,Flight,Business,United States of America,North America,2,1,1,1,1,2,0,Human Factor
2002-02-02 00:00:00,United States Air Force - USAF,Takeoff (climb),Operational,United States of America,North America,2,2,2,0,0,2,0,Human Factor
2002-02-14 00:00:00,Kronospan,Flight,Business,Switzerland,Europe,2,1,1,1,1,2,0,Human Factor
2002-03-17 00:00:00,Floopie Flight Corporation,Landing (descent or approach),Business,United States of America,North America,2,1,1,1,1,2,0,Human Factor
2002-04-12 00:00:00,Tadair,Landing (descent or approach),Operational,Spain,Europe,2,2,2,0,0,2,0,Human Factor
2002-05-31 00:00:00,Bevins Air Service,Flight,Commercial,Dominica,Central America,2,1,1,1,1,2,0,Technical Failure
2002-07-01 00:00:00,DHL Worldwide Express - DHL Airways,Flight,Operational,Germany,Europe,2,2,2,0,0,2,0,Human Factor
2002-07-18 00:00:00,Hawkins %26 Powers Aviation,Flight,Humanitarian,United States of America,North America,2,2,2,0,0,2,0,Human Factor
2002-07-21 00:00:00,Image Air,Takeoff (climb),Business,United States of America,North America,2,2,2,0,0,2,0,Unknown
2002-08-08 00:00:00,Eysk Avia,Takeoff (climb),Business,Russia,Asia,2,2,2,0,0,2,0,Human Factor
2002-09-14 00:00:00,Pilatus Partners,Flight,Business,United States of America,North America,2,1,1,1,1,2,0,Human Factor
2002-09-14 00:00:00,Total Linhas Aéreas,Flight,Operational,Brazil,South America,2,2,2,0,0,2,0,Human Factor
2002-10-23 00:00:00,Duke Aircraft Corporation,Landing (descent or approach),Business,United States of America,North America,2,1,1,1,1,2,0,Human Factor
2002-11-08 00:00:00,Richmor Aviation,Landing (descent or approach),Operational,United States of America,North America,2,2,2,0,0,2,0,Weather
2002-12-17 00:00:00,FMU - Flieg mit Uns Luftfahrtunternehmen,Landing (descent or approach),Commercial,Germany,Europe,2,1,1,1,1,2,0,Human Factor
2002-12-21 00:00:00,TransAsia Airways,Flight,Operational,Taiwan,Asia,2,2,2,0,0,2,0,Weather
2002-12-25 00:00:00,Robert A. Rumachik,Landing (descent or approach),Business,United States of America,North America,2,1,1,1,1,2,0,Technical Failure
2003-01-24 00:00:00,Lee Larson Aircraft Sales,Flight,Business,United States of America,North America,2,2,2,0,0,2,0,Human Factor
2003-01-26 00:00:00,NDB Equipment Finance,Takeoff (climb),Business,United States of America,North America,2,1,1,1,1,2,0,Human Factor
2003-02-10 00:00:00,Enimex,Takeoff (climb),Operational,Estonia,Europe,3,3,2,0,0,2,1,Technical Failure
2003-02-13 00:00:00,One Leasing,Flight,Military / Government,Colombia,South America,5,2,2,3,0,2,3,Technical Failure
2003-03-24 00:00:00,Asia Air Survey,Flight,Specialised Services,Japan,Asia,2,2,2,0,0,2,0,Human Factor
2003-03-25 00:00:00,Spanish Air Force - Ejército del Aire,Flight,Operational,Spain,Europe,4,4,2,0,0,2,2,Unknown
2003-03-27 00:00:00,Haulers Insurance Company,Flight,Operational,United States of America,North America,2,1,1,1,1,2,0,Weather
2003-04-04 00:00:00,Private New Zealand,Flight,Operational,New Zealand,Oceania,2,1,1,1,1,2,0,Unknown
2003-04-09 00:00:00,Richard E. Crow,Landing (descent or approach),Business,United States of America,North America,2,1,1,1,1,2,0,Human Factor
2003-05-18 00:00:00,Ian Gordon Fletcher,Flight,Business,Barbados,Central America,2,1,1,1,1,2,0,Human Factor
2003-06-01 00:00:00,Eurojet Italia,Takeoff (climb),Operational,Italy,Europe,2,2,2,0,0,2,0,Other
2003-06-16 00:00:00,Gold Wing Transportation,Takeoff (climb),Business,United States of America,North America,2,1,1,1,1,2,0,Technical Failure
2003-06-26 00:00:00,Osprey Air Services,Flight,Business,United States of America,North America,4,1,0,3,2,2,2,Human Factor
2003-07-10 00:00:00,American Airpower Heritage Museum,Landing (descent or approach),Business,United States of America,North America,2,2,2,0,0,2,0,Technical Failure
2003-07-13 00:00:00,Air Sunshine,Landing (descent or approach),Commercial,Bahamas,Central America,10,1,0,9,2,2,8,Technical Failure
2003-07-16 00:00:00,Air Spray,Flight,Humanitarian,Canada,North America,2,2,2,0,0,2,0,Unknown
2003-08-04 00:00:00,Air East Management,Landing (descent or approach),Operational,United States of America,North America,2,2,2,0,0,2,0,Human Factor
2003-08-11 00:00:00,Fugro Spatial Solutions,Takeoff (climb),Military / Government,Australia,Oceania,6,1,0,5,2,2,4,Technical Failure
2003-08-12 00:00:00,United States Army,Flight,Specialised Services,South Korea,Asia,2,2,2,0,0,2,0,Human Factor
2003-08-17 00:00:00,Hageland Aviation Services,Flight,Commercial,United States of America,North America,2,1,1,1,1,2,0,Unknown
2003-08-21 00:00:00,Clearwater Aircraft,Landing (descent or approach),Operational,United States of America,North America,3,3,2,0,0,2,1,Human Factor
2003-08-26 00:00:00,USAir Express - US Airways Express,Takeoff (climb),Operational,United States of America,North America,2,2,2,0,0,2,0,Human Factor
2003-08-31 00:00:00,Hickory Travel,Takeoff (climb),Business,United States of America,North America,2,1,1,1,1,2,0,Human Factor
2003-09-12 00:00:00,Private Mexican,Flight,Business,Colombia,South America,2,1,1,1,1,2,0,Human Factor
2003-09-25 00:00:00,Corsair Aviation,Landing (descent or approach),Operational,United States of America,North America,3,2,1,1,1,2,1,Human Factor
2003-10-03 00:00:00,Air Freight NZ,Flight,Operational,New Zealand,Oceania,2,2,2,0,0,2,0,Weather
2003-10-03 00:00:00,Minden Air,Landing (descent or approach),Operational,United States of America,North America,2,2,2,0,0,2,0,Human Factor
2003-10-10 00:00:00,Jicarilla Game %26 Fish Commission,Flight,Operational,Venezuela,South America,2,2,2,0,0,2,0,Unknown
2003-10-18 00:00:00,James T. Gillespie,Landing (descent or approach),Business,United States of America,North America,2,1,1,1,1,2,0,Human Factor
2003-11-08 00:00:00,Trans Guyana Airways,Takeoff (climb),Commercial,Guyana,South America,7,3,1,4,1,2,5,Technical Failure
2003-12-04 00:00:00,Southeastern Air Charter,Landing (descent or approach),Operational,United States of America,North America,2,2,2,0,0,2,0,Human Factor
2003-12-10 00:00:00,Warrington Development Corporation,Takeoff (climb),Business,United States of America,North America,2,1,1,1,1,2,0,Human Factor
2003-12-13 00:00:00,T %26 M Pipeline Construction,Landing (descent or approach),Business,Mexico,Central America,2,1,1,1,1,2,0,Unknown
2003-12-16 00:00:00,Huron Air,Takeoff (climb),Commercial,Canada,North America,3,1,1,2,1,2,1,Human Factor
2003-12-17 00:00:00,BME Air Ranch,Takeoff (climb),Business,United States of America,North America,2,1,1,1,1,2,0,Human Factor
2003-12-23 00:00:00,Pavair,Flight,Business,United States of America,North America,2,2,2,0,0,2,0,Unknown
2004-01-27 00:00:00,Private Australian,Flight,Operational,Australia,Oceania,2,2,2,0,0,2,0,Unknown
2004-01-31 00:00:00,Global Aerofleet,Flight,Business,United States of America,North America,2,1,1,1,1,2,0,Human Factor
2004-02-18 00:00:00,Spanish Air Force - Ejército del Aire,Flight,Operational,Spain,Europe,2,2,2,0,0,2,0,Unknown
2004-02-23 00:00:00,Bem-Te-Vi Táxi Aéreo,Flight,Operational,Brazil,South America,2,2,2,0,0,2,0,Technical Failure
2004-02-23 00:00:00,Robert M. Compton,Flight,Business,United States of America,North America,2,1,1,1,1,2,0,Human Factor
2004-03-08 00:00:00,Sécurité civile française,Landing (descent or approach),Operational,France,Europe,3,3,2,0,0,2,1,Human Factor
2004-03-11 00:00:00,Ronald S. Scott,Landing (descent or approach),Business,United States of America,North America,2,1,1,1,1,2,0,Human Factor
2004-04-05 00:00:00,Aero Dreams,Takeoff (climb),Business,United States of America,North America,2,1,1,1,1,2,0,Human Factor
2004-04-20 00:00:00,Fugro Airborne Surveys,Takeoff (climb),Specialised Services,Mozambique,Africa,2,2,2,0,0,2,0,Unknown
2004-05-05 00:00:00,Consejo de Recursos Minerales,Flight,Specialised Services,Mexico,Central America,2,2,2,0,0,2,0,Unknown
2004-05-23 00:00:00,Bluebird Aviation,Flight,Operational,Kenya,Africa,2,2,2,0,0,2,0,Unknown
2004-06-13 00:00:00,Rader Aviaton,Landing (descent or approach),Operational,United States of America,North America,2,2,2,0,0,2,0,Human Factor
2004-06-28 00:00:00,Ngangeni Air Charters,Takeoff (climb),Operational,Mozambique,Africa,2,2,2,0,0,2,0,Human Factor
2004-07-10 00:00:00,Capital Airlines - Valley Airways,Landing (descent or approach),Commercial,United States of America,North America,2,1,1,1,1,2,0,Unknown
2004-07-29 00:00:00,Airlines PNG,Flight,Operational,Papua New Guinea,Oceania,3,2,2,1,0,2,1,Human Factor
2004-08-03 00:00:00,Air Antilles,Flight,Business,Honduras,Central America,2,2,2,0,0,2,0,Unknown
2004-08-17 00:00:00,Alpine Air,Flight,Operational,United States of America,North America,2,2,2,0,0,2,0,Human Factor
2004-08-30 00:00:00,Peter Quilliam,Takeoff (climb),Operational,Australia,Oceania,2,1,1,1,1,2,0,Unknown
2004-09-09 00:00:00,Jett Paquetería,Landing (descent or approach),Operational,Mexico,Central America,2,2,2,0,0,2,0,Human Factor
2004-09-23 00:00:00,N729DM LLC,Landing (descent or approach),Business,United States of America,North America,3,1,1,2,1,2,1,Human Factor
2004-10-14 00:00:00,Northwest Airlink,Flight,Operational,United States of America,North America,2,2,2,0,0,2,0,Human Factor
2004-10-16 00:00:00,PacificAir - Pacific Airways,Takeoff (climb),Operational,Philippines,Asia,2,2,2,0,0,2,0,Weather
2004-11-25 00:00:00,M3 Services,Takeoff (climb),Business,United States of America,North America,2,1,1,1,1,2,0,Technical Failure
2004-11-28 00:00:00,Otmaro Henrique,Flight,Business,Venezuela,South America,2,1,1,1,1,2,0,Human Factor
2004-11-30 00:00:00,Grand Aire Express - Executive Aire Express,Takeoff (climb),Operational,United States of America,North America,2,2,2,0,0,2,0,Human Factor
2004-12-06 00:00:00,Salmon Air,Landing (descent or approach),Commercial,United States of America,North America,2,1,1,1,1,2,0,Weather
2004-12-10 00:00:00,Flight Line - USA,Landing (descent or approach),Operational,United States of America,North America,2,2,2,0,0,2,0,Human Factor
2004-12-11 00:00:00,NHR Táxi Aéreo,Landing (descent or approach),Operational,Brazil,South America,2,2,2,0,0,2,0,Human Factor
2004-12-21 00:00:00,Arica,Landing (descent or approach),Commercial,Ecuador,South America,2,1,1,1,1,2,0,Unknown
2004-12-22 00:00:00,Private Brazilian,Flight,Humanitarian,Paraguay,South America,2,1,1,1,1,2,0,Unknown
2005-01-27 00:00:00,Farnair Hungary,Landing (descent or approach),Operational,Romania,Europe,2,2,2,0,0,2,0,Human Factor
2005-02-07 00:00:00,Ward County Irrigation District N°1,Flight,Other,Argentina,South America,2,2,2,0,0,2,0,Unknown
2005-02-11 00:00:00,Private Mexican,Landing (descent or approach),Commercial,Mexico,Central America,3,1,0,2,2,2,1,Human Factor
2005-02-22 00:00:00,Missionary Aviation Fellowship - MAF,Landing (descent or approach),Commercial,Papua New Guinea,Oceania,13,3,2,10,0,2,11,Weather
2005-02-24 00:00:00,Air Force of Zimbabwe,Takeoff (climb),Operational,Zimbabwe,Africa,2,2,2,0,0,2,0,Unknown
2005-02-28 00:00:00,Private Mexican,Landing (descent or approach),Business,Mexico,Central America,2,2,2,0,0,2,0,Unknown
2005-03-08 00:00:00,Transmandu - Transportes Aéreos Manduca,Landing (descent or approach),Operational,Venezuela,South America,2,2,2,0,0,2,0,Unknown
2005-03-08 00:00:00,Transportes Inland,Landing (descent or approach),Operational,Venezuela,South America,2,2,2,0,0,2,0,Human Factor
2005-03-15 00:00:00,Loganair,Landing (descent or approach),Humanitarian,United Kingdom,Europe,2,1,1,1,1,2,0,Human Factor
2005-03-18 00:00:00,SOREM - Società Ricerche Esperienze Meteorologiche,Flight,Humanitarian,Italy,Europe,2,2,2,0,0,2,0,Human Factor
2005-04-22 00:00:00,Nav Air Charter,Landing (descent or approach),Operational,Canada,North America,2,2,2,0,0,2,0,Technical Failure
2005-05-03 00:00:00,Airwork - New Zealand,Flight,Operational,New Zealand,Oceania,2,2,2,0,0,2,0,Human Factor
2005-05-11 00:00:00,Bosfor,Flight,Military / Government,Ukraine,Europe,2,1,1,1,1,2,0,Technical Failure
2005-05-24 00:00:00,Empresa Agroservicios Polar,Flight,Operational,Venezuela,South America,2,2,2,0,0,2,0,Human Factor
2005-07-26 00:00:00,Aéreo Ruta Maya,Flight,Military / Government,Guatemala,Central America,2,2,2,0,0,2,0,Unknown
2005-07-28 00:00:00,Northern Thunderbird Air - NT Air,Flight,Operational,Canada,North America,2,2,2,0,0,2,0,Human Factor
2005-08-01 00:00:00,Sécurité civile française,Flight,Humanitarian,France,Europe,2,2,2,0,0,2,0,Other
2005-08-20 00:00:00,Sécurité civile française,Flight,Humanitarian,France,Europe,2,2,2,0,0,2,0,Unknown
2005-09-16 00:00:00,Viaçao Cometa,Flight,Operational,Brazil,South America,2,2,2,0,0,2,0,Human Factor
2005-09-17 00:00:00,Reacin,Takeoff (climb),Business,United States of America,North America,2,1,1,1,1,2,0,Technical Failure
2005-09-21 00:00:00,Panafrican Airways,Flight,Operational,Democratic Republic of Congo,Africa,3,2,2,1,0,2,1,Unknown
2005-10-04 00:00:00,Wimbi Dira Airways,Landing (descent or approach),Commercial,Democratic Republic of Congo,Africa,100,4,0,96,2,2,98,Technical Failure
2005-11-05 00:00:00,Houston Cardiac Electrophysiology Associates - HCEA,Takeoff (climb),Business,United States of America,North America,2,1,1,1,1,2,0,Human Factor
2005-11-08 00:00:00,Exec 1 Aviation,Takeoff (climb),Commercial,United States of America,North America,2,1,1,1,1,2,0,Human Factor
2005-11-22 00:00:00,Super Air,Landing (descent or approach),Operational,New Zealand,Oceania,2,1,1,1,1,2,0,Human Factor
2005-11-28 00:00:00,Oriental Energy Resources,Takeoff (climb),Operational,Nigeria,Africa,2,1,1,1,1,2,0,Technical Failure
2005-12-20 00:00:00,Nav Air Charter,Takeoff (climb),Operational,Canada,North America,2,2,2,0,0,2,0,Technical Failure
2005-12-24 00:00:00,Tepavia Trans,Takeoff (climb),Operational,Sudan,Africa,2,2,2,0,0,2,0,Unknown
2005-12-28 00:00:00,Skyward Aviation - USA,Landing (descent or approach),Operational,United States of America,North America,2,2,2,0,0,2,0,Human Factor
2006-01-12 00:00:00,Euroflug Frenzel,Landing (descent or approach),Operational,Germany,Europe,2,2,2,0,0,2,0,Human Factor
2006-02-12 00:00:00,Maria de Jesus Morano,Flight,Humanitarian,Guatemala,Central America,2,2,2,0,0,2,0,Human Factor
2006-03-07 00:00:00,Aerovalles - Aerotaxi Los Valles,Landing (descent or approach),Commercial,Spain,Europe,6,2,1,4,1,2,4,Human Factor
2006-03-18 00:00:00,Ameriflight,Landing (descent or approach),Operational,United States of America,North America,2,2,2,0,0,2,0,Human Factor
2006-03-28 00:00:00,Cessna Aircraft Company,Flight,Operational,United States of America,North America,2,2,2,0,0,2,0,Human Factor
2006-04-11 00:00:00,Kapoli Air,Flight,Military / Government,Bulgaria,Europe,3,1,1,2,1,2,1,Human Factor
2006-04-24 00:00:00,Air Million Cargo,Landing (descent or approach),Military / Government,Afghanistan,Asia,16,4,2,12,0,2,14,Human Factor
2006-05-10 00:00:00,John R. Martin,Flight,Business,United States of America,North America,2,1,1,1,1,2,0,Weather
2006-06-02 00:00:00,International Jet Charter,Landing (descent or approach),Commercial,United States of America,North America,5,2,2,3,0,2,3,Human Factor
2006-06-24 00:00:00,JMH Capital,Takeoff (climb),Operational,United States of America,North America,2,2,2,0,0,2,0,Human Factor
2006-07-19 00:00:00,Tomco II,Landing (descent or approach),Business,United States of America,North America,4,2,2,2,0,2,2,Human Factor
2006-07-19 00:00:00,Indonesian Air Force - TNI-AU Tentara Nasional Indonesia - Angkatan Udara,Landing (descent or approach),Operational,Indonesia,Asia,2,2,2,0,0,2,0,Unknown
2006-07-25 00:00:00,Spectrum Aeronautical,Flight,Specialised Services,United States of America,North America,2,2,2,0,0,2,0,Human Factor
2006-08-11 00:00:00,Aerovias Guayana - Aguaysa,Takeoff (climb),Commercial,Venezuela,South America,2,1,1,1,1,2,0,Unknown
2006-08-11 00:00:00,Línea de Aeroservicios - LASSA,Flight,Specialised Services,Chile,South America,2,1,1,1,1,2,0,Human Factor
2006-08-25 00:00:00,Drug %26 Laboratory Disposal Inc.,Flight,Business,United States of America,North America,2,1,1,1,1,2,0,Weather
2006-09-15 00:00:00,Alex T. Stack,Flight,Business,United States of America,North America,2,1,1,1,1,2,0,Human Factor
2006-09-15 00:00:00,Private Mexican,Landing (descent or approach),Business,Mexico,Central America,7,1,0,6,2,2,5,Technical Failure
2006-10-19 00:00:00,Chinese Air Force - AFPLA - Chung-Kuo Shan Min Taie Fang Tsun Pu-Tai,Flight,Operational,China,Asia,6,6,2,0,0,2,4,Human Factor
2006-11-06 00:00:00,Air Loop,Flight,Business,Italy,Europe,2,1,1,1,1,2,0,Unknown
2006-11-19 00:00:00,SVG Air - Saint Vincent %26 Grenadines Air,Landing (descent or approach),Commercial,Saint Vincent and Grenadines,Central America,2,1,1,1,1,2,0,Unknown
2006-12-26 00:00:00,Flight Source,Landing (descent or approach),Business,United States of America,North America,2,2,2,0,0,2,0,Human Factor
2006-12-30 00:00:00,Jett Paquetería,Landing (descent or approach),Operational,Mexico,Central America,2,2,2,0,0,2,0,Human Factor
2007-01-09 00:00:00,Ameristar Jet Charter,Landing (descent or approach),Operational,Mexico,Central America,2,2,2,0,0,2,0,Human Factor
2007-01-12 00:00:00,Sun Quest Executive Air Charter,Takeoff (climb),Operational,United States of America,North America,2,2,2,0,0,2,0,Human Factor
2007-01-15 00:00:00,Larry L. Galloway,Flight,Business,Puerto Rico,Central America,2,1,1,1,1,2,0,Human Factor
2007-02-09 00:00:00,Drilling Structures International,Landing (descent or approach),Business,United States of America,North America,2,1,1,1,1,2,0,Human Factor
2007-03-30 00:00:00,Airlink Papua New Guinea,Flight,Operational,Papua New Guinea,Oceania,2,2,2,0,0,2,0,Technical Failure
2007-04-10 00:00:00,Ernest M. Kollmann,Flight,Business,Bahamas,Central America,2,1,1,1,1,2,0,Weather
2007-05-03 00:00:00,Hamilton Ranches,Landing (descent or approach),Business,United States of America,North America,2,1,1,1,1,2,0,Unknown
2007-07-03 00:00:00,Southwest Consulting Group,Takeoff (climb),Business,United States of America,North America,2,1,1,1,1,2,0,Human Factor
2007-07-05 00:00:00,Lancton Taverns,Landing (descent or approach),Operational,Ireland,Europe,9,1,1,8,1,2,7,Human Factor
2007-07-23 00:00:00,Hellenic Air Force - Elleniki Polemiki Aeroporia,Flight,Humanitarian,Greece,Europe,2,2,2,0,0,2,0,Unknown
2007-07-31 00:00:00,Private Australian,Flight,Business,Australia,Oceania,2,1,1,1,1,2,0,Weather
2007-08-22 00:00:00,Two Taxi Aéreo,Takeoff (climb),Operational,Brazil,South America,2,2,2,0,0,2,0,Human Factor
2007-09-17 00:00:00,Nacional Mercantil Corretora e Representações de Algodão,Flight,Business,Brazil,South America,2,1,1,1,1,2,0,Human Factor
2007-09-26 00:00:00,Fugro Airborne Surveys,Takeoff (climb),Specialised Services,Uganda,Africa,2,2,2,0,0,2,0,Human Factor
2007-10-07 00:00:00,Private Mexican,Landing (descent or approach),Business,Venezuela,South America,2,2,2,0,0,2,0,Human Factor
2007-10-25 00:00:00,Air Creebec,Landing (descent or approach),Operational,Canada,North America,2,2,2,0,0,2,0,Human Factor
2007-11-04 00:00:00,Reali Taxi Aéreo,Takeoff (climb),Operational,Brazil,South America,2,2,2,0,0,2,0,Human Factor
2007-11-04 00:00:00,Private Mexican,Landing (descent or approach),Humanitarian,Guatemala,Central America,2,2,2,0,0,2,0,Technical Failure
2007-11-06 00:00:00,RHB-JMJ,Takeoff (climb),Business,United States of America,North America,2,1,1,1,1,2,0,Human Factor
2007-11-15 00:00:00,Showa Aviation,Flight,Specialised Services,Japan,Asia,3,2,1,1,1,2,1,Human Factor
2007-12-05 00:00:00,Castle Aviation,Takeoff (climb),Operational,United States of America,North America,2,1,1,1,1,2,0,Human Factor
2007-12-10 00:00:00,QB Corporation,Landing (descent or approach),Business,United States of America,North America,4,1,1,3,1,2,2,Human Factor
2008-01-15 00:00:00,Nuclear Materials Authority,Landing (descent or approach),Operational,Egypt,Africa,2,2,2,0,0,2,0,Technical Failure
2008-02-01 00:00:00,Jeanette A. Symons,Takeoff (climb),Business,United States of America,North America,2,1,1,1,1,2,0,Human Factor
2008-02-16 00:00:00,Bajaj Holdings,Takeoff (climb),Business,United States of America,North America,2,1,1,1,1,2,0,Human Factor
2008-03-15 00:00:00,Wings Aviation,Flight,Operational,Nigeria,Africa,3,2,2,1,0,2,1,Human Factor
2008-03-31 00:00:00,Abaeté Aerotáxi,Landing (descent or approach),Operational,Brazil,South America,2,2,2,0,0,2,0,Human Factor
2008-04-03 00:00:00,Auric Air,Takeoff (climb),Operational,Tanzania,Africa,2,2,2,0,0,2,0,Human Factor
2008-05-17 00:00:00,Chelan Airways,Landing (descent or approach),Commercial,United States of America,North America,5,1,0,4,2,2,3,Unknown
2008-05-30 00:00:00,Skydive Lillo - Air Compluto,Flight,Humanitarian,Spain,Europe,11,1,1,10,1,2,9,Weather
2008-06-07 00:00:00,Vassili Sklyar,Flight,Humanitarian,Russia,Asia,2,2,2,0,0,2,0,Human Factor
2008-06-24 00:00:00,Central Air Southwest,Flight,Operational,United States of America,North America,2,2,2,0,0,2,0,Human Factor
2008-09-18 00:00:00,BDW Equipment Leasing,Landing (descent or approach),Business,United States of America,North America,2,1,1,1,1,2,0,Human Factor
2008-09-21 00:00:00,Paravia,Flight,Humanitarian,Switzerland,Europe,2,1,1,1,1,2,0,Human Factor
2008-10-06 00:00:00,Private Mexican,Takeoff (climb),Business,Mexico,Central America,2,1,1,1,1,2,0,Technical Failure
2008-10-29 00:00:00,Government of Punjab,Landing (descent or approach),Operational,India,Asia,2,2,2,0,0,2,0,Human Factor
2008-11-23 00:00:00,JC Shows,Landing (descent or approach),Commercial,Brazil,South America,10,2,1,8,1,2,8,Human Factor
2008-12-03 00:00:00,Taxi Aéreo Caribeño,Flight,Operational,Colombia,South America,2,2,2,0,0,2,0,Human Factor
2008-12-07 00:00:00,Government of the State of Tlaxcala,Landing (descent or approach),Operational,Mexico,Central America,2,2,2,0,0,2,0,Human Factor
2008-12-18 00:00:00,Avia Center,Takeoff (climb),Business,Argentina,South America,2,1,1,1,1,2,0,Technical Failure
2008-12-22 00:00:00,Joseph F. Brumleve,Landing (descent or approach),Business,United States of America,North America,2,2,2,0,0,2,0,Human Factor
2009-01-11 00:00:00,Rooney Consulting %26 Aviation,Takeoff (climb),Business,United States of America,North America,2,1,1,1,1,2,0,Human Factor
2009-02-07 00:00:00,Air One Executive,Takeoff (climb),Operational,Italy,Europe,2,2,2,0,0,2,0,Human Factor
2009-02-12 00:00:00,Laret Aviation,Landing (descent or approach),Business,Switzerland,Europe,3,2,2,1,0,2,1,Human Factor
2009-03-23 00:00:00,Federal Express - FedEx,Landing (descent or approach),Operational,Japan,Asia,2,2,2,0,0,2,0,Human Factor
2009-06-23 00:00:00,Gavina,Flight,Operational,Spain,Europe,2,2,2,0,0,2,0,Human Factor
2009-07-09 00:00:00,Canadian Air Charters,Landing (descent or approach),Operational,Canada,North America,2,2,2,0,0,2,0,Other
2009-07-19 00:00:00,Underhill Aviation,Takeoff (climb),Business,Canada,North America,4,1,1,3,1,2,2,Unknown
2009-08-12 00:00:00,Wayne R. Monson,Takeoff (climb),Business,United States of America,North America,2,1,1,1,1,2,0,Technical Failure
2009-08-14 00:00:00,Skydive Portugal,Landing (descent or approach),Humanitarian,Portugal,Europe,2,1,1,1,1,2,0,Human Factor
2009-10-09 00:00:00,Compagnia Generale Ripreseaeree,Flight,Operational,Italy,Europe,2,2,2,0,0,2,0,Unknown
2009-10-16 00:00:00,E. S. Management,Takeoff (climb),Business,Netherlands,Europe,2,1,1,1,1,2,0,Human Factor
2009-10-29 00:00:00,Brazilian Air Force - Força Aérea Brasileira,Flight,Military / Government,Brazil,South America,11,4,0,7,2,2,9,Technical Failure
2009-11-09 00:00:00,Bluebird Aviation,Landing (descent or approach),Operational,Kenya,Africa,2,2,2,0,0,2,0,Human Factor
2009-12-07 00:00:00,Riley W. Kent,Landing (descent or approach),Business,United States of America,North America,2,1,1,1,1,2,0,Human Factor
2009-12-09 00:00:00,Exact Air,Landing (descent or approach),Commercial,Canada,North America,4,2,2,2,0,2,2,Human Factor
2009-12-17 00:00:00,FL Aviation Group,Landing (descent or approach),Operational,Bahamas,Central America,2,2,2,0,0,2,0,Unknown
2009-12-31 00:00:00,Sinarmas,Takeoff (climb),Operational,Indonesia,Asia,2,1,1,1,1,2,0,Technical Failure
2010-01-05 00:00:00,Royal Air Freight - Royal Air Charter,Landing (descent or approach),Operational,United States of America,North America,2,2,2,0,0,2,0,Unknown
2010-01-15 00:00:00,Southern Aircraft Consultancy,Takeoff (climb),Specialised Services,United Kingdom,Europe,2,1,1,1,1,2,0,Human Factor
2010-01-18 00:00:00,Everett R. Arinwine,Flight,Business,United States of America,North America,2,1,1,1,1,2,0,Human Factor
2010-01-18 00:00:00,John M. White,Landing (descent or approach),Business,United States of America,North America,2,1,1,1,1,2,0,Technical Failure
2010-01-21 00:00:00,ACE Air Cargo,Takeoff (climb),Operational,United States of America,North America,2,2,2,0,0,2,0,Unknown
2010-01-23 00:00:00,ENS Corporation,Takeoff (climb),Business,United States of America,North America,2,1,1,1,1,2,0,Human Factor
2010-01-25 00:00:00,Piquiatuba Taxi Aéreo,Landing (descent or approach),Commercial,Brazil,South America,10,2,1,8,1,2,8,Technical Failure
2010-02-14 00:00:00,Time Air,Flight,Operational,Germany,Europe,2,2,2,0,0,2,0,Human Factor
2010-02-21 00:00:00,Bingham Capital Markets St Louis,Landing (descent or approach),Business,United States of America,North America,2,1,1,1,1,2,0,Human Factor
2010-03-22 00:00:00,Airnorth Regional - RegionalLink,Takeoff (climb),Operational,Australia,Oceania,2,2,2,0,0,2,0,Human Factor
2010-05-02 00:00:00,Deems Holdings,Landing (descent or approach),Business,United States of America,North America,2,1,1,1,1,2,0,Human Factor
2010-05-26 00:00:00,North Wind Aviation,Flight,Commercial,Canada,North America,2,1,1,1,1,2,0,Human Factor
2010-06-15 00:00:00,Skymaster Air Services,Takeoff (climb),Humanitarian,Australia,Oceania,2,1,1,1,1,2,0,Human Factor
2010-06-23 00:00:00,New Life Research %26 Development,Takeoff (climb),Operational,Guatemala,Central America,2,2,2,0,0,2,0,Human Factor
2010-06-24 00:00:00,Air Flamingo,Takeoff (climb),Operational,Kazakhstan,Asia,3,3,2,0,0,2,1,Human Factor
2010-07-24 00:00:00,Nordair Québec 2000,Takeoff (climb),Commercial,Canada,North America,5,1,1,4,1,2,3,Other
2010-07-31 00:00:00,Conair Aviation,Flight,Humanitarian,Canada,North America,2,2,2,0,0,2,0,Human Factor
2010-08-05 00:00:00,Forent Energy,Landing (descent or approach),Business,Canada,North America,2,1,1,1,1,2,0,Human Factor
2010-08-11 00:00:00,Frank N. Vessels,Flight,Business,United States of America,North America,2,1,1,1,1,2,0,Human Factor
2010-08-16 00:00:00,Aires Colombia - Aerovias de Integracion Regional,Landing (descent or approach),Commercial,Colombia,South America,131,6,0,125,2,2,129,Human Factor
2010-09-03 00:00:00,United Parcel Service - UPS,Landing (descent or approach),Operational,United Arab Emirates,Asia,2,2,2,0,0,2,0,Other
2010-10-21 00:00:00,Tracep,Takeoff (climb),Operational,Democratic Republic of Congo,Africa,2,2,2,0,0,2,0,Technical Failure
2010-11-02 00:00:00,Private German,Landing (descent or approach),Business,Poland,Europe,2,1,1,1,1,2,0,Human Factor
2010-11-04 00:00:00,Aéro Pyrénées,Flight,Operational,France,Europe,2,2,2,0,0,2,0,Human Factor
2010-11-11 00:00:00,Tarco Air,Landing (descent or approach),Commercial,Sudan,Africa,44,6,0,38,2,2,42,Human Factor
2010-12-04 00:00:00,Daghestan Airlines - Avialinii Dagestana,Landing (descent or approach),Commercial,Russia,Asia,169,9,0,160,2,2,167,Human Factor
2010-12-14 00:00:00,Monarch Air Group,Landing (descent or approach),Operational,Bahamas,Central America,2,2,2,0,0,2,0,Unknown
2010-12-15 00:00:00,William B. Harris,Landing (descent or approach),Business,United States of America,North America,2,1,1,1,1,2,0,Human Factor
2010-12-19 00:00:00,Windrose Air Jet Charter,Landing (descent or approach),Operational,Switzerland,Europe,2,2,2,0,0,2,0,Human Factor
2010-12-30 00:00:00,TeeMark Corporation,Flight,Business,United States of America,North America,2,1,1,1,1,2,0,Technical Failure
2011-01-03 00:00:00,Private Japanese,Takeoff (climb),Business,Japan,Asia,2,1,1,1,1,2,0,Human Factor
2011-01-09 00:00:00,Michael O. Welton,Flight,Business,United States of America,North America,2,1,1,1,1,2,0,Weather
2011-02-14 00:00:00,African Air Services,Takeoff (climb),Operational,Democratic Republic of Congo,Africa,2,2,2,0,0,2,0,Unknown
2011-02-18 00:00:00,Escuela de Aviación Rutas Aéreas Mayas,Landing (descent or approach),Operational,Mexico,Central America,2,2,2,0,0,2,0,Unknown
2011-03-08 00:00:00,Desert Sand Aircraft Leasing,Landing (descent or approach),Specialised Services,United States of America,North America,2,2,2,0,0,2,0,Human Factor
2011-05-24 00:00:00,Shoreline Energy International Ltd,Takeoff (climb),Specialised Services,Nigeria,Africa,2,2,2,0,0,2,0,Human Factor
2011-07-28 00:00:00,Asiana Airlines Cargo,Flight,Operational,World,World,2,2,2,0,0,2,0,Other
2011-08-13 00:00:00,Inland Aviation Services,Flight,Commercial,United States of America,North America,6,1,1,5,1,2,4,Human Factor
2011-09-09 00:00:00,Susi Air,Flight,Operational,Indonesia,Asia,2,2,2,0,0,2,0,Other
2011-09-12 00:00:00,Private American,Takeoff (climb),Specialised Services,Mexico,Central America,2,1,1,1,1,2,0,Unknown
2011-09-22 00:00:00,Arctic Sunwest Charters,Landing (descent or approach),Commercial,Canada,North America,9,2,2,7,0,2,7,Human Factor
2011-10-04 00:00:00,Air Tindi,Flight,Commercial,Canada,North America,4,1,1,3,1,2,2,Human Factor
2011-10-21 00:00:00,Cezanne Air Express,Landing (descent or approach),Commercial,Kenya,Africa,3,1,1,2,1,2,1,Unknown
2011-10-27 00:00:00,Northern Thunderbird Air - NT Air,Landing (descent or approach),Commercial,Canada,North America,9,2,2,7,0,2,7,Human Factor
2011-10-31 00:00:00,Francisco Zermeño,Takeoff (climb),Business,Mexico,Central America,2,1,1,1,1,2,0,Unknown
2011-12-17 00:00:00,Associated Mission Aviation - AMA,Landing (descent or approach),Commercial,Indonesia,Asia,5,1,1,4,1,2,3,Unknown
2011-12-20 00:00:00,Private Argentinian,Flight,Business,Argentina,South America,2,2,2,0,0,2,0,Weather
2012-01-18 00:00:00,Awyr Cymru Cyf,Landing (descent or approach),Operational,United Kingdom,Europe,2,2,2,0,0,2,0,Human Factor
2012-02-19 00:00:00,Scott A. Humpal,Landing (descent or approach),Business,United States of America,North America,6,1,1,5,1,2,4,Human Factor
2012-03-08 00:00:00,CM Airlines,Flight,Commercial,Honduras,Central America,2,1,1,1,1,2,0,Unknown
2012-03-15 00:00:00,Fresh Air,Takeoff (climb),Operational,Puerto Rico,Central America,2,2,2,0,0,2,0,Human Factor
2012-04-25 00:00:00,Susi Air,Flight,Specialised Services,Indonesia,Asia,2,1,1,1,1,2,0,Human Factor
2012-05-18 00:00:00,Línea Aérea Costa Norte,Flight,Military / Government,Chile,South America,2,2,2,0,0,2,0,Unknown
2012-05-25 00:00:00,Air Cochrane,Landing (descent or approach),Commercial,Canada,North America,3,1,1,2,1,2,1,Weather
2012-06-03 00:00:00,Neptune Aviation Charter,Flight,Humanitarian,United States of America,North America,2,2,2,0,0,2,0,Human Factor
2012-06-06 00:00:00,Air Class Lineas Aéreas,Takeoff (climb),Operational,Uruguay,South America,2,2,2,0,0,2,0,Weather
2012-08-02 00:00:00,Airnor - Aeronaves del Noroeste,Landing (descent or approach),Operational,Spain,Europe,2,2,2,0,0,2,0,Human Factor
2012-08-21 00:00:00,Private Brazilian,Takeoff (climb),Business,Brazil,South America,2,2,2,0,0,2,0,Unknown
2012-08-22 00:00:00,Intertransavia,Takeoff (climb),Operational,Russia,Asia,2,2,2,0,0,2,0,Technical Failure
2012-09-07 00:00:00,Rossi Aerofotogrammetria Brescia,Takeoff (climb),Operational,Italy,Europe,2,2,2,0,0,2,0,Unknown
2012-09-27 00:00:00,Premier Aviation,Takeoff (climb),Humanitarian,Dominican Republic,Central America,2,2,2,0,0,2,0,Unknown
2012-10-03 00:00:00,Tariku Aviation,Flight,Operational,Indonesia,Asia,2,1,1,1,1,2,0,Human Factor
2012-11-10 00:00:00,Scott H. Clarke,Flight,Business,United States of America,North America,2,1,1,1,1,2,0,Human Factor
2012-12-14 00:00:00,Oneal Aviation,Flight,Business,United States of America,North America,2,1,1,1,1,2,0,Weather
2012-12-15 00:00:00,Nothman Jerry Company Trustee,Flight,Business,United States of America,North America,2,1,1,1,1,2,0,Human Factor
2012-12-19 00:00:00,Stinger Welding Inc.,Landing (descent or approach),Business,United States of America,North America,2,1,1,1,1,2,0,Human Factor
2013-02-06 00:00:00,Sauo Aero Services,Landing (descent or approach),Operational,United States of America,North America,2,2,2,0,0,2,0,Human Factor
2013-02-21 00:00:00,Mexican Air Force - Fuerza Aérea Mexicana,Flight,Operational,Mexico,Central America,2,2,2,0,0,2,0,Unknown
2013-03-04 00:00:00,Global Jet Luxembourg,Takeoff (climb),Operational,France,Europe,3,1,1,2,1,2,1,Human Factor
2013-03-06 00:00:00,BioFlight,Landing (descent or approach),Military / Government,Denmark,Europe,2,1,1,1,1,2,0,Human Factor
2013-03-08 00:00:00,ACE Air Cargo,Landing (descent or approach),Operational,United States of America,North America,2,2,2,0,0,2,0,Human Factor
2013-03-17 00:00:00,Digicut Systems,Landing (descent or approach),Business,United States of America,North America,4,1,1,3,1,2,2,Human Factor
2013-05-05 00:00:00,Franklin Duran,Landing (descent or approach),Business,Venezuela,South America,2,2,2,0,0,2,0,Unknown
2013-05-29 00:00:00,Private Brazilian,Takeoff (climb),Business,Brazil,South America,2,1,1,1,1,2,0,Unknown
2013-05-30 00:00:00,First Air Service,Takeoff (climb),Business,Canada,North America,2,1,1,1,1,2,0,Unknown
2013-06-20 00:00:00,Nighthawk Air,Flight,Operational,United States of America,North America,2,2,2,0,0,2,0,Human Factor
2013-06-25 00:00:00,Private Dominican,Flight,Humanitarian,Haiti,Central America,2,2,2,0,0,2,0,Human Factor
2013-06-29 00:00:00,Batair Cargo,Landing (descent or approach),Operational,Botswana,Africa,2,2,2,0,0,2,0,Unknown
2013-08-05 00:00:00,Myflug Air,Landing (descent or approach),Operational,Iceland,Europe,3,2,1,1,1,2,1,Human Factor
2013-08-09 00:00:00,Ellumax Leasing,Landing (descent or approach),Business,United States of America,North America,2,1,1,1,1,2,0,Human Factor
2013-08-14 00:00:00,United Parcel Service - UPS,Landing (descent or approach),Operational,United States of America,North America,2,2,2,0,0,2,0,Human Factor
2013-08-16 00:00:00,Air Nootka,Takeoff (climb),Commercial,Canada,North America,6,1,0,5,2,2,4,Human Factor
2013-09-04 00:00:00,Carl Whiteley,Landing (descent or approach),Business,United Kingdom,Europe,2,1,1,1,1,2,0,Human Factor
2013-09-09 00:00:00,CorpFlite - Transportes Aéreos Corporativos,Landing (descent or approach),Operational,Chile,South America,2,2,2,0,0,2,0,Human Factor
2013-10-10 00:00:00,MASwings,Landing (descent or approach),Commercial,Malaysia,Asia,16,2,1,14,1,2,14,Human Factor
2013-10-10 00:00:00,Private Ukrainian,Landing (descent or approach),Humanitarian,Ukraine,Europe,2,2,2,0,0,2,0,Human Factor
2013-10-18 00:00:00,Ed Dufresne Ministries,Flight,Business,United States of America,North America,2,1,1,1,1,2,0,Weather
2013-10-26 00:00:00,Private Russian,Landing (descent or approach),Humanitarian,Russia,Asia,4,2,2,2,0,2,2,Human Factor
2013-11-01 00:00:00,J %26 G Aviation,Landing (descent or approach),Business,United States of America,North America,2,1,1,1,1,2,0,Human Factor
2013-11-18 00:00:00,Private Mexican,Flight,Business,Mexico,Central America,2,1,1,1,1,2,0,Unknown
2013-12-02 00:00:00,IBC Airways,Flight,Operational,Puerto Rico,Central America,2,2,2,0,0,2,0,Human Factor
2013-12-14 00:00:00,Hutch Air,Landing (descent or approach),Business,Canada,North America,2,1,1,1,1,2,0,Unknown
2013-12-17 00:00:00,Mallen Industries,Takeoff (climb),Business,United States of America,North America,2,1,1,1,1,2,0,Human Factor
2014-01-18 00:00:00,Trans Guyana Airways,Takeoff (climb),Operational,Guyana,South America,2,1,1,1,1,2,0,Technical Failure
2014-01-20 00:00:00,Şcoala Superioară de Aviaţie Civilă,Flight,Humanitarian,Romania,Europe,7,2,1,5,1,2,5,Weather
2014-04-08 00:00:00,ERA Alaska,Flight,Operational,United States of America,North America,2,2,2,0,0,2,0,Human Factor
2014-04-09 00:00:00,Adventist Aviation Services,Takeoff (climb),Commercial,Indonesia,Asia,7,1,1,6,1,2,5,Human Factor
2014-04-22 00:00:00,L. Botha,Flight,Business,South Africa,Africa,2,1,1,1,1,2,0,Technical Failure
2014-05-03 00:00:00,Oracle Geoscience International,Flight,Specialised Services,Colombia,South America,2,1,1,1,1,2,0,Human Factor
2014-06-07 00:00:00,Private Russian,Takeoff (climb),Business,Russia,Asia,2,1,1,1,1,2,0,Unknown
2014-06-23 00:00:00,GFD - Gesellschaft Für Flugzieldarstellung,Flight,Military / Government,Germany,Europe,2,2,2,0,0,2,0,Human Factor
2014-07-14 00:00:00,Ukrainian Air Force - Povitryani Syly Ukrayini,Flight,Military / Government,Ukraine,Europe,8,8,2,0,0,2,6,Terrorism
2014-08-06 00:00:00,AG Plastics,Flight,Business,France,Europe,5,1,1,4,1,2,3,Unknown
2014-08-15 00:00:00,Lawrence R. Liptack,Landing (descent or approach),Business,United States of America,North America,2,1,1,1,1,2,0,Human Factor
2014-08-16 00:00:00,Atlantic Charters,Landing (descent or approach),Humanitarian,Canada,North America,4,2,1,2,1,2,2,Human Factor
2014-09-05 00:00:00,New 51LG,Flight,Business,Jamaica,Central America,2,1,1,1,1,2,0,Technical Failure
2014-09-14 00:00:00,Tango Jet,Landing (descent or approach),Business,Argentina,South America,2,1,1,1,1,2,0,Human Factor
2014-10-29 00:00:00,SkyWay Enterprises,Takeoff (climb),Operational,Netherlands,Central America,2,2,2,0,0,2,0,Human Factor
2014-11-14 00:00:00,Global Airlift,Landing (descent or approach),Humanitarian,South Sudan,Africa,3,3,2,0,0,2,1,Technical Failure
2014-12-19 00:00:00,T-Air - USA,Landing (descent or approach),Business,Mexico,Central America,2,2,2,0,0,2,0,Unknown
2014-12-28 00:00:00,Air Services - Guyana,Flight,Operational,Guyana,South America,2,1,1,1,1,2,0,Unknown
2015-03-24 00:00:00,Indian Navy - Bharatiya Nau Sena,Flight,Operational,India,Asia,3,3,2,0,0,2,1,Unknown
2015-03-25 00:00:00,Agrotekhservice,Landing (descent or approach),Humanitarian,Ukraine,Europe,2,2,2,0,0,2,0,Human Factor
2015-04-13 00:00:00,Carson Air,Flight,Operational,Canada,North America,2,2,2,0,0,2,0,Human Factor
2015-05-07 00:00:00,Rocket Engineering,Takeoff (climb),Specialised Services,United States of America,North America,2,1,1,1,1,2,0,Human Factor
2015-05-16 00:00:00,Klaipedos Avialinijos,Flight,Operational,World,World,2,2,2,0,0,2,0,Unknown
2015-05-24 00:00:00,Private Brazilian,Flight,Humanitarian,Venezuela,South America,2,2,2,0,0,2,0,Terrorism
2015-06-08 00:00:00,Russian Air Force - Voyenno-vozdushnye sily Rossii,Takeoff (climb),Operational,Russia,Asia,9,9,2,0,0,2,7,Technical Failure
2015-07-14 00:00:00,Russian Air Force - Voyenno-vozdushnye sily Rossii,Flight,Military / Government,Russia,Asia,7,7,2,0,0,2,5,Technical Failure
2015-07-26 00:00:00,Private Japanese,Takeoff (climb),Business,Japan,Asia,5,1,1,4,1,2,3,Human Factor
2015-07-29 00:00:00,Trustey Management Corporation,Landing (descent or approach),Business,United States of America,North America,2,1,1,1,1,2,0,Human Factor
2015-09-11 00:00:00,Heliblack,Flight,Specialised Services,Colombia,South America,3,2,1,1,1,2,1,Human Factor
2015-10-03 00:00:00,El Caminente Air,Takeoff (climb),Business,Colombia,South America,3,1,1,2,1,2,1,Technical Failure
2015-10-03 00:00:00,London Executive Aviation,Takeoff (climb),Operational,United Kingdom,Europe,2,1,1,1,1,2,0,Human Factor
2015-10-05 00:00:00,Private American,Flight,Humanitarian,Venezuela,South America,2,2,2,0,0,2,0,Unknown
2015-10-12 00:00:00,Afghan Republican Air Force - Afghan Hanai Qurah,Takeoff (climb),Military / Government,Afghanistan,Asia,7,2,2,5,0,2,5,Unknown
2015-10-14 00:00:00,Aero One,Takeoff (climb),Business,United States of America,North America,2,1,1,1,1,2,0,Human Factor
2015-10-16 00:00:00,Chapman Corporate Air Services,Takeoff (climb),Business,Canada,North America,2,1,1,1,1,2,0,Unknown
2015-10-28 00:00:00,National Argentinian Police,Flight,Military / Government,Argentina,South America,2,2,2,0,0,2,0,Unknown
2015-11-09 00:00:00,Legal Airways,Flight,Commercial,United States of America,North America,2,1,1,1,1,2,0,Human Factor
2015-11-17 00:00:00,Private Colombian,Takeoff (climb),Commercial,Colombia,South America,10,1,1,9,1,2,8,Human Factor
2016-01-03 00:00:00,Supermercados Shibata,Landing (descent or approach),Operational,Brazil,South America,2,2,2,0,0,2,0,Human Factor
2016-01-08 00:00:00,West Air Sweden,Flight,Operational,Sweden,Europe,2,2,2,0,0,2,0,Technical Failure
2016-01-18 00:00:00,Donald L. Baker,Flight,Business,United States of America,North America,2,1,1,1,1,2,0,Human Factor
2016-02-01 00:00:00,Private Brazilian,Takeoff (climb),Business,Brazil,South America,2,1,1,1,1,2,0,Human Factor
2016-02-26 00:00:00,Air Kasthamandap,Flight,Commercial,Nepal,Asia,11,2,2,9,0,2,9,Unknown
2016-03-02 00:00:00,Daniel J. Murray,Flight,Business,United States of America,North America,2,1,1,1,1,2,0,Human Factor
2016-03-18 00:00:00,Ninerxray Inc.,Takeoff (climb),Business,United States of America,North America,2,1,1,1,1,2,0,Human Factor
2016-04-09 00:00:00,Mickey L. Brethower,Flight,Operational,United States of America,North America,2,2,2,0,0,2,0,Unknown
2016-04-19 00:00:00,St Tammany Parish Mosquito Abatement District,Landing (descent or approach),Military / Government,United States of America,North America,2,2,2,0,0,2,0,Human Factor
2016-06-11 00:00:00,Skydive Kalifornia,Flight,Humanitarian,Italy,Europe,9,2,2,7,0,2,7,Human Factor
2016-06-16 00:00:00,Aero National,Landing (descent or approach),Humanitarian,United States of America,North America,2,1,1,1,1,2,0,Human Factor
2016-06-30 00:00:00,Krasny Kut Civil Aviation Flight School,Flight,Military / Government,Russia,Asia,2,1,1,1,1,2,0,Human Factor
2016-08-01 00:00:00,Tiuna Tours,Flight,Operational,Venezuela,South America,2,2,2,0,0,2,0,Unknown
2016-08-16 00:00:00,Private Venezuelan,Takeoff (climb),Operational,Venezuela,South America,2,2,2,0,0,2,0,Unknown
2016-12-12 00:00:00,Farmers Air,Flight,Operational,New Zealand,Oceania,2,1,1,1,1,2,0,Human Factor
2016-12-27 00:00:00,Independent Technologies,Landing (descent or approach),Business,United States of America,North America,2,1,1,1,1,2,0,Human Factor
2017-01-23 00:00:00,KAAZ LLC,Takeoff (climb),Business,United States of America,North America,2,1,1,1,1,2,0,Human Factor
2017-01-26 00:00:00,Private Australian,Flight,Operational,Australia,Oceania,2,1,1,1,1,2,0,Human Factor
2017-03-04 00:00:00,David B. Mutchler,Flight,Operational,United States of America,North America,2,2,2,0,0,2,0,Human Factor
2017-03-31 00:00:00,Itapara Sport Fishing,Landing (descent or approach),Operational,Brazil,South America,2,1,1,1,1,2,0,Human Factor
2017-04-30 00:00:00,Exact Air,Landing (descent or approach),Specialised Services,Canada,North America,2,2,2,0,0,2,0,Human Factor
2017-05-05 00:00:00,Air Cargo Carriers,Landing (descent or approach),Operational,United States of America,North America,2,2,2,0,0,2,0,Human Factor
2017-05-15 00:00:00,Trans-Pacific Air Charter,Landing (descent or approach),Operational,United States of America,North America,2,2,2,0,0,2,0,Human Factor
2017-05-17 00:00:00,Aerotransportes Huitzilin,Takeoff (climb),Operational,Mexico,Central America,2,2,2,0,0,2,0,Human Factor
2017-05-27 00:00:00,Summit Air,Landing (descent or approach),Operational,Nepal,Asia,3,3,2,0,0,2,1,Human Factor
2017-06-13 00:00:00,King Industries,Takeoff (climb),Business,United States of America,North America,2,1,1,1,1,2,0,Human Factor
2017-07-13 00:00:00,T-210 Holdings,Takeoff (climb),Business,United States of America,North America,2,1,1,1,1,2,0,Unknown
2017-08-08 00:00:00,Malibair,Flight,Business,Germany,Europe,2,1,1,1,1,2,0,Weather
2017-08-14 00:00:00,Sky West Aviation,Flight,Business,Japan,Asia,2,1,1,1,1,2,0,Human Factor
2017-09-02 00:00:00,Yevgeni Sologubov,Flight,Operational,Russia,Asia,2,2,2,0,0,2,0,Human Factor
2017-09-04 00:00:00,Private Venezuelan,Flight,Humanitarian,Venezuela,South America,2,2,2,0,0,2,0,Human Factor
2017-09-13 00:00:00,Private Mexican,Flight,Business,Mexico,Central America,2,1,1,1,1,2,0,Human Factor
2017-09-26 00:00:00,Valnetis Air,Flight,Commercial,Czech Republic,Europe,2,1,1,1,1,2,0,Technical Failure
2017-10-04 00:00:00,Haddock Flying Service,Flight,Business,United States of America,North America,2,1,1,1,1,2,0,Human Factor
2018-02-18 00:00:00,William E. Patterson,Landing (descent or approach),Business,United States of America,North America,2,1,1,1,1,2,0,Human Factor
2018-02-27 00:00:00,Pegasus of Montana,Landing (descent or approach),Business,United States of America,North America,2,1,1,1,1,2,0,Human Factor
2018-03-08 00:00:00,Robert R. Marshall,Takeoff (climb),Business,United States of America,North America,2,2,2,0,0,2,0,Technical Failure
2018-05-13 00:00:00,Irish Parachute Club,Landing (descent or approach),Humanitarian,Ireland,Europe,2,1,1,1,1,2,0,Human Factor
2018-05-16 00:00:00,Makalu Air,Flight,Operational,Nepal,Asia,2,2,2,0,0,2,0,Human Factor
2018-05-27 00:00:00,Private American,Flight,Humanitarian,Guatemala,Central America,2,2,2,0,0,2,0,Unknown
2018-06-27 00:00:00,Marcelo Oliveira Silva,Flight,Humanitarian,Brazil,South America,3,1,0,2,2,2,1,Unknown
2018-08-01 00:00:00,Aries Aviation International,Flight,Specialised Services,Canada,North America,2,1,1,1,1,2,0,Human Factor
2018-09-27 00:00:00,Air America Flight Services,Landing (descent or approach),Commercial,United States of America,North America,4,2,2,2,0,2,2,Technical Failure
2018-12-20 00:00:00,Kenneth L. Reed,Flight,Business,United States of America,North America,2,1,1,1,1,2,0,Unknown
2019-01-12 00:00:00,Aerotours,Flight,Business,Germany,Europe,2,2,2,0,0,2,0,Unknown
2019-01-21 00:00:00,Southern Aircraft Consultancy,Flight,Commercial,United Kingdom,Europe,2,1,1,1,1,2,0,Unknown
2019-01-21 00:00:00,Priority Air Charter,Takeoff (climb),Operational,United States of America,North America,2,2,2,0,0,2,0,Technical Failure
2019-01-30 00:00:00,Air Tindi,Flight,Operational,Canada,North America,2,2,2,0,0,2,0,Technical Failure
2019-02-15 00:00:00,Charles S. Azzopardi,Flight,Business,United States of America,North America,2,1,1,1,1,2,0,Human Factor
2019-02-28 00:00:00,Lennard Properties,Takeoff (climb),Business,United States of America,North America,2,1,1,1,1,2,0,Human Factor
2019-03-18 00:00:00,Sundance Airport FBO,Landing (descent or approach),Business,United States of America,North America,2,2,2,0,0,2,0,Technical Failure
2019-04-13 00:00:00,Private American,Flight,Humanitarian,Guatemala,Central America,2,2,2,0,0,2,0,Human Factor
2019-05-05 00:00:00,Roberto Decena,Landing (descent or approach),Business,United States of America,North America,2,1,1,1,1,2,0,Human Factor
2019-05-20 00:00:00,Taquan Air,Landing (descent or approach),Commercial,United States of America,North America,2,1,1,1,1,2,0,Human Factor
2019-05-22 00:00:00,Private American,Takeoff (climb),Business,United States of America,North America,2,1,1,1,1,2,0,Human Factor
2019-06-20 00:00:00,Navigator,Takeoff (climb),Military / Government,Kazakhstan,Asia,3,3,2,0,0,2,1,Human Factor
2019-06-27 00:00:00,Angara Airlines,Landing (descent or approach),Commercial,Russia,Asia,47,4,2,43,0,2,45,Technical Failure
2019-07-11 00:00:00,Hawk Air,Takeoff (climb),Operational,Canada,North America,2,1,1,1,1,2,0,Human Factor
2019-08-06 00:00:00,Alkan Air,Flight,Commercial,Canada,North America,2,1,1,1,1,2,0,Human Factor
2019-08-30 00:00:00,Private Russian,Flight,Business,Russia,Asia,7,2,0,5,2,2,5,Human Factor
2019-09-02 00:00:00,Private Mexican,Flight,Humanitarian,Guatemala,Central America,2,2,2,0,0,2,0,Unknown
2019-09-11 00:00:00,Douglas R. Taylor,Landing (descent or approach),Operational,United States of America,North America,2,2,2,0,0,2,0,Unknown
2019-09-23 00:00:00,Auric Air,Takeoff (climb),Commercial,Tanzania,Africa,2,1,1,1,1,2,0,Unknown
2019-09-24 00:00:00,KASET - Bureau of Royal Rainmaking and Agricultural Aviation,Flight,Operational,Thailand,Asia,2,2,2,0,0,2,0,Unknown
2019-12-14 00:00:00,Anju Azul Aviation,Takeoff (climb),Operational,Australia,Oceania,2,1,1,1,1,2,0,Human Factor
2019-12-24 00:00:00,Calafia Airlines,Flight,Commercial,Mexico,Central America,2,1,1,1,1,2,0,Unknown
2020-01-12 00:00:00,Pakistani Government,Flight,Military / Government,Pakistan,Asia,2,2,2,0,0,2,0,Technical Failure
2020-01-24 00:00:00,Anthony L. Wright,Flight,Business,United States of America,North America,3,1,1,2,1,2,1,Technical Failure
2020-01-27 00:00:00,United States Air Force - USAF,Flight,Operational,Afghanistan,Asia,2,2,2,0,0,2,0,Human Factor
2020-03-12 00:00:00,Private Colombian,Flight,Humanitarian,Honduras,Central America,2,2,2,0,0,2,0,Unknown
2020-04-19 00:00:00,Private American,Flight,Humanitarian,Guatemala,Central America,2,2,2,0,0,2,0,Human Factor
2020-06-14 00:00:00,Oeste Veículos,Takeoff (climb),Business,Brazil,South America,2,2,2,0,0,2,0,Unknown
2020-07-13 00:00:00,Zeus-Avia,Flight,Military / Government,Russia,Asia,2,2,2,0,0,2,0,Human Factor
2020-08-10 00:00:00,Private American,Flight,Humanitarian,Venezuela,South America,2,2,2,0,0,2,0,Human Factor
2020-08-28 00:00:00,Conquest Air Cargo,Flight,Business,United States of America,North America,2,1,1,1,1,2,0,Unknown
2020-09-20 00:00:00,Sky Team Cremona,Flight,Humanitarian,Italy,Europe,9,1,1,8,1,2,7,Unknown
2020-10-02 00:00:00,N965DM LLC,Flight,Business,United States of America,North America,2,1,1,1,1,2,0,Unknown
2020-10-29 00:00:00,Private American,Flight,Humanitarian,Guatemala,Central America,2,2,2,0,0,2,0,Human Factor
2020-10-31 00:00:00,Iraqi Air Force - Al Quwwat al Jawwiya al Iraqiya,Flight,Military / Government,Iraq,Asia,2,2,2,0,0,2,0,Unknown
2021-01-09 00:00:00,SX Transport,Flight,Business,United States of America,North America,2,1,1,1,1,2,0,Unknown
2021-03-11 00:00:00,Private Mexican,Flight,Humanitarian,Dominican Republic,Central America,2,2,2,0,0,2,0,Human Factor
2021-03-20 00:00:00,Aeronav Air Services,Flight,Operational,Kenya,Africa,2,2,2,0,0,2,0,Unknown
2021-04-23 00:00:00,Mark Andregg,Flight,Business,United States of America,North America,2,1,1,1,1,2,0,Unknown
2021-04-23 00:00:00,Global Air,Flight,Operational,United States of America,North America,2,2,2,0,0,2,0,Unknown
2021-05-14 00:00:00,Skydive Pull Out Ravenna,Flight,Operational,Italy,Europe,2,2,2,0,0,2,0,Unknown
2021-07-05 00:00:00,Transenergie,Takeoff (climb),Business,Bahamas,Central America,2,2,2,0,0,2,0,Human Factor
2021-07-10 00:00:00,Falcon Executive Aviation,Flight,Humanitarian,United States of America,North America,2,1,1,1,1,2,0,Unknown
2021-10-05 00:00:00,Career Aviation,Landing (descent or approach),Operational,United States of America,North America,2,2,2,0,0,2,0,Unknown
2021-11-15 00:00:00,N290KA LLC,Landing (descent or approach),Business,United States of America,North America,2,1,1,1,1,2,0,Unknown
2022-02-11 00:00:00,Kamchatsky Krechet,Takeoff (climb),Operational,Russia,Asia,2,2,2,0,0,2,0,Unknown
2022-04-21 00:00:00,Nixon Enterprises,Takeoff (climb),Business,United States of America,North America,2,1,1,1,1,2,0,Unknown
2022-05-08 00:00:00,Bronco Aviation,Flight,Business,United States of America,North America,2,1,1,1,1,2,0,Unknown
2022-05-11 00:00:00,Skydive4fun,Takeoff (climb),Humanitarian,Brazil,South America,15,1,0,14,2,2,13,Technical Failure
2022-05-23 00:00:00,Raul Ignacion Posada,Flight,Business,Mexico,Central America,2,1,1,1,1,2,0,Unknown
1918-06-11 00:00:00,Royal Air Force - RAF,Flight,Operational,Egypt,Africa,2,2,1,0,0,1,1,Unknown
1918-06-19 00:00:00,United States Signal Corps - USSC,Flight,Military / Government,United States of America,North America,1,1,1,0,0,1,0,Technical Failure
1918-07-14 00:00:00,Marine Aeroplane Depot,Landing (descent or approach),Operational,United Kingdom,Europe,1,1,1,0,0,1,0,Unknown
1918-11-12 00:00:00,United States Signal Corps - USSC,Flight,Operational,United States of America,North America,2,2,1,0,0,1,1,Unknown
1918-11-14 00:00:00,Royal Air Force - RAF,Flight,Operational,United Kingdom,Europe,2,2,1,0,0,1,1,Unknown
1918-12-16 00:00:00,U.S. Air Mail Service,Takeoff (climb),Operational,United States of America,North America,1,1,1,0,0,1,0,Human Factor
1918-12-22 00:00:00,French Air Force - Armée de l'Air,Flight,Military / Government,Greece,Europe,1,1,1,0,0,1,0,Weather
1919-02-20 00:00:00,French Air Force - Armée de l'Air,Flight,Military / Government,France,Europe,1,1,1,0,0,1,0,Unknown
1919-05-01 00:00:00,Aircraft Transport %26 Travel - AT%26T,Flight,Operational,United Kingdom,Europe,1,1,1,0,0,1,0,Unknown
1919-05-24 00:00:00,Royal Air Force - RAF,Flight,Operational,United Kingdom,Europe,2,2,1,0,0,1,1,Unknown
1919-05-25 00:00:00,U.S. Air Mail Service,Takeoff (climb),Operational,United States of America,North America,1,1,1,0,0,1,0,Technical Failure
1919-07-19 00:00:00,U.S. Air Mail Service,Flight,Operational,United States of America,North America,1,1,1,0,0,1,0,Weather
1919-08-06 00:00:00,Avro Air Transport,Landing (descent or approach),Commercial,United Kingdom,Europe,4,1,1,3,0,1,3,Unknown
1919-08-11 00:00:00,Royal Air Force - RAF,Takeoff (climb),Military / Government,United Kingdom,Europe,7,7,1,0,0,1,6,Unknown
1919-10-02 00:00:00,Aircraft Transport %26 Travel - AT%26T,Landing (descent or approach),Commercial,United Kingdom,Europe,2,1,1,1,0,1,1,Technical Failure
1919-10-05 00:00:00,Avro Air Transport,Flight,Operational,United Kingdom,Europe,1,1,1,0,0,1,0,Weather
1919-10-14 00:00:00,U.S. Air Mail Service,Flight,Operational,United States of America,North America,1,1,1,0,0,1,0,Human Factor
1919-10-30 00:00:00,U.S. Air Mail Service,Flight,Operational,United States of America,North America,1,1,1,0,0,1,0,Weather
1919-12-18 00:00:00,Vickers-Armstrongs Ltd,Flight,Operational,France,Europe,1,1,1,0,0,1,0,Unknown
1920-02-26 00:00:00,T. K. Wong Ltd,Takeoff (climb),Business,Malaysia,Asia,2,2,1,0,0,1,1,Unknown
1920-03-10 00:00:00,U.S. Air Mail Service,Flight,Operational,United States of America,North America,1,1,1,0,0,1,0,Human Factor
1920-03-30 00:00:00,U.S. Air Mail Service,Landing (descent or approach),Operational,United States of America,North America,1,1,1,0,0,1,0,Human Factor
1920-04-10 00:00:00,U.S. Air Mail Service,Flight,Operational,United States of America,North America,2,1,0,1,1,1,1,Technical Failure
1920-04-11 00:00:00,U.S. Air Mail Service,Takeoff (climb),Operational,United States of America,North America,2,1,0,1,1,1,1,Unknown
1920-04-27 00:00:00,Compagnie Générale Transaérienne - CGT,Flight,Operational,World,World,1,1,1,0,0,1,0,Unknown
1920-04-29 00:00:00,Compañia Colombiana de Navegación Aérea,Takeoff (climb),Commercial,Colombia,South America,4,1,1,3,0,1,3,Weather
1920-05-12 00:00:00,U.S. Air Mail Service,Flight,Operational,United States of America,North America,2,1,0,1,1,1,1,Human Factor
1920-06-02 00:00:00,Junkers Flugzeug %26 Motorenwerke,Flight,Specialised Services,Germany,Europe,1,1,1,0,0,1,0,Unknown
1920-06-06 00:00:00,U.S. Air Mail Service,Takeoff (climb),Operational,United States of America,North America,3,2,1,1,0,1,2,Technical Failure
1920-08-16 00:00:00,By Air,Flight,Operational,United Kingdom,Europe,2,1,1,1,0,1,1,Unknown
1920-08-16 00:00:00,U.S. Air Mail Service,Takeoff (climb),Operational,United States of America,North America,1,1,1,0,0,1,0,Human Factor
1920-08-31 00:00:00,Ad Astra Aero,Flight,Operational,Switzerland,Europe,1,1,1,0,0,1,0,Unknown
1920-09-05 00:00:00,U.S. Air Mail Service,Takeoff (climb),Operational,United States of America,North America,1,1,1,0,0,1,0,Technical Failure
1920-09-15 00:00:00,United States Army Air Service - USAAS,Landing (descent or approach),Military / Government,United States of America,North America,2,1,1,1,0,1,1,Unknown
1920-09-27 00:00:00,U.S. Air Mail Service,Flight,Operational,United States of America,North America,1,1,1,0,0,1,0,Human Factor
1920-10-16 00:00:00,U.S. Air Mail Service,Flight,Operational,United States of America,North America,1,1,1,0,0,1,0,Human Factor
1920-11-06 00:00:00,U.S. Air Mail Service,Flight,Operational,United States of America,North America,1,1,1,0,0,1,0,Human Factor
1920-11-29 00:00:00,Brazilian Navy - Aviação Naval Brasileira,Flight,Operational,Brazil,South America,1,1,1,0,0,1,0,Unknown
1920-12-24 00:00:00,Lignes Aériennes Latécoère,Takeoff (climb),Operational,Spain,Europe,1,1,1,0,0,1,0,Technical Failure
1921-01-25 00:00:00,Syndicat National pour l'Etude du Transport Aérien - SNETA,Flight,Operational,United Kingdom,Europe,1,1,1,0,0,1,0,Human Factor
1921-02-03 00:00:00,U.S. Air Mail Service,Takeoff (climb),Operational,United States of America,North America,2,2,1,0,0,1,1,Technical Failure
1921-02-08 00:00:00,Royal Netherlands East Indies Air Force - ML-KNIL,Flight,Operational,Indonesia,Asia,2,2,1,0,0,1,1,Human Factor
1921-02-18 00:00:00,Brazilian Navy - Aviação Naval Brasileira,Flight,Operational,Brazil,South America,2,2,1,0,0,1,1,Unknown
1921-02-22 00:00:00,U.S. Air Mail Service,Takeoff (climb),Operational,United States of America,North America,1,1,1,0,0,1,0,Human Factor
1921-02-23 00:00:00,French Air Force - Armée de l'Air,Flight,Operational,France,Europe,2,2,1,0,0,1,1,Unknown
1921-02-24 00:00:00,Royal Air Force - RAF,Landing (descent or approach),Operational,United Kingdom,Europe,2,2,1,0,0,1,1,Unknown
1921-03-10 00:00:00,Aeroplane %26 Armament Experimental Establishment - A%26AEE,Flight,Specialised Services,United Kingdom,Europe,1,1,1,0,0,1,0,Human Factor
1921-04-21 00:00:00,U.S. Air Mail Service,Takeoff (climb),Operational,United States of America,North America,1,1,1,0,0,1,0,Unknown
1921-04-29 00:00:00,U.S. Air Mail Service,Landing (descent or approach),Operational,United States of America,North America,1,1,1,0,0,1,0,Weather
1921-05-05 00:00:00,U.S. Air Mail Service,Takeoff (climb),Operational,United States of America,North America,1,1,1,0,0,1,0,Unknown
1921-05-08 00:00:00,Compagnie Générale d'Entreprises Aéronautiques - CGEA,Landing (descent or approach),Operational,Spain,Europe,1,1,1,0,0,1,0,Weather
1921-05-11 00:00:00,United States Army Air Service - USAAS,Flight,Operational,United States of America,North America,1,1,1,0,0,1,0,Unknown
1921-06-12 00:00:00,McCall-Hanrahan Air Service,Flight,Business,Canada,North America,2,1,0,1,1,1,1,Unknown
1921-07-06 00:00:00,U.S. Air Mail Service,Takeoff (climb),Operational,United States of America,North America,1,1,1,0,0,1,0,Weather
1921-09-09 00:00:00,Surrey Flying Services,Landing (descent or approach),Operational,United Kingdom,Europe,1,1,1,0,0,1,0,Unknown
1921-10-27 00:00:00,Royal Netherlands East Indies Air Force - ML-KNIL,Takeoff (climb),Military / Government,Indonesia,Asia,1,1,1,0,0,1,0,Unknown
1921-12-30 00:00:00,Canterbury Aviation,Flight,Operational,New Zealand,Oceania,1,1,1,0,0,1,0,Technical Failure
1922-01-13 00:00:00,Royal Air Force - RAF,Flight,Operational,Iraq,Asia,2,2,1,0,0,1,1,Human Factor
1922-01-16 00:00:00,Chilean Air Force - Fuerza Aérea de Chile,Flight,Operational,Chile,South America,1,1,1,0,0,1,0,Unknown
1922-02-08 00:00:00,Royal Air Force - RAF,Takeoff (climb),Operational,United Kingdom,Europe,2,2,1,0,0,1,1,Unknown
1922-03-01 00:00:00,Royal Air Force - RAF,Landing (descent or approach),Operational,United Kingdom,Europe,1,1,1,0,0,1,0,Unknown
1922-03-06 00:00:00,Royal Air Force - RAF,Flight,Operational,United Kingdom,Europe,1,1,1,0,0,1,0,Unknown
1922-03-23 00:00:00,Royal Air Force - RAF,Takeoff (climb),Operational,United Kingdom,Europe,2,2,1,0,0,1,1,Unknown
1922-04-28 00:00:00,S. Summerfield Company,Flight,Operational,United Kingdom,Europe,1,1,1,0,0,1,0,Unknown
1922-05-06 00:00:00,Grahame-White Aviation,Takeoff (climb),Operational,United Kingdom,Europe,1,1,1,0,0,1,0,Unknown
1922-06-04 00:00:00,Chilean Air Force - Fuerza Aérea de Chile,Flight,Operational,Chile,South America,1,1,1,0,0,1,0,Unknown
1922-06-10 00:00:00,W. L. Woodward,Takeoff (climb),Business,United Kingdom,Europe,3,1,0,2,1,1,2,Unknown
1922-06-17 00:00:00,Belgian Air Force - Force Aérienne Belge - Belgische Luchtmacht,Landing (descent or approach),Operational,Belgium,Europe,1,1,1,0,0,1,0,Unknown
1922-07-07 00:00:00,Royal Air Force - RAF,Landing (descent or approach),Operational,United Kingdom,Europe,1,1,1,0,0,1,0,Human Factor
1922-09-07 00:00:00,U.S. Air Mail Service,Takeoff (climb),Operational,United States of America,North America,1,1,1,0,0,1,0,Unknown
1922-09-16 00:00:00,Royal Air Force - RAF,Landing (descent or approach),Military / Government,Iraq,Asia,2,2,1,0,0,1,1,Unknown
1922-09-20 00:00:00,Belgian Air Force - Force Aérienne Belge - Belgische Luchtmacht,Landing (descent or approach),Operational,Belgium,Europe,1,1,1,0,0,1,0,Unknown
1922-12-03 00:00:00,Compagnie Générale d'Entreprises Aéronautiques - CGEA,Flight,Operational,Morocco,Africa,1,1,1,0,0,1,0,Human Factor
1923-01-17 00:00:00,Compagnie Générale d'Entreprises Aéronautiques - CGEA,Landing (descent or approach),Operational,Spain,Europe,2,1,1,1,0,1,1,Weather
1923-01-25 00:00:00,Royal Netherlands East Indies Air Force - ML-KNIL,Landing (descent or approach),Military / Government,Indonesia,Asia,2,2,1,0,0,1,1,Unknown
1923-02-06 00:00:00,SCADTA - Sociedad Colombo-Alemana de Transportes Aéreos,Takeoff (climb),Commercial,Colombia,South America,6,2,1,4,0,1,5,Other
1923-02-26 00:00:00,U.S. Air Mail Service,Flight,Operational,United States of America,North America,1,1,1,0,0,1,0,Human Factor
1923-03-17 00:00:00,Junkers Flugzeug %26 Motorenwerke,Flight,Operational,Brazil,South America,2,2,1,0,0,1,1,Weather
1923-03-20 00:00:00,Belgian Air Force - Force Aérienne Belge - Belgische Luchtmacht,Flight,Operational,Belgium,Europe,1,1,1,0,0,1,0,Unknown
1923-05-06 00:00:00,Aeroexpress,Flight,Commercial,Hungary,Europe,6,2,0,4,1,1,5,Unknown
1923-06-23 00:00:00,Blériot,Flight,Operational,France,Europe,2,2,1,0,0,1,1,Technical Failure
1923-06-25 00:00:00,Irish Air Corps - Aer Chór na hÉireann,Flight,Operational,Ireland,Europe,2,2,1,0,0,1,1,Unknown
1923-07-16 00:00:00,Dobrolet,Landing (descent or approach),Commercial,Russia,Asia,5,1,1,4,0,1,4,Technical Failure
1923-08-27 00:00:00,Air Union France,Flight,Commercial,United Kingdom,Europe,11,2,0,9,1,1,10,Technical Failure
1923-09-07 00:00:00,U.S. Air Mail Service,Flight,Operational,United States of America,North America,1,1,1,0,0,1,0,Technical Failure
1923-10-30 00:00:00,French Air Force - Armée de l'Air,Landing (descent or approach),Operational,France,Europe,2,2,1,0,0,1,1,Human Factor
1923-11-19 00:00:00,Turkish Air Force - Türk Hava Kuvvetleri,Flight,Operational,Turkey,Asia,2,2,1,0,0,1,1,Unknown
1923-12-06 00:00:00,U.S. Air Mail Service,Flight,Operational,United States of America,North America,1,1,1,0,0,1,0,Technical Failure
1923-12-24 00:00:00,U.S. Air Mail Service,Flight,Operational,United States of America,North America,1,1,1,0,0,1,0,Weather
1924-02-11 00:00:00,Cuban Air Force - Cuerpo de Aviación del Ejército de Cuba,Flight,Operational,Cuba,Central America,1,1,1,0,0,1,0,Unknown
1924-03-07 00:00:00,U.S. Air Mail Service,Flight,Operational,United States of America,North America,1,1,1,0,0,1,0,Weather
1924-05-05 00:00:00,Syndicat National pour l'Etude du Transport Aérien - SNETA,Landing (descent or approach),Operational,France,Europe,1,1,1,0,0,1,0,Unknown
1924-08-01 00:00:00,U.S. Air Mail Service,Flight,Business,United States of America,North America,1,1,1,0,0,1,0,Human Factor
1924-08-12 00:00:00,United States Army Air Service - USAAS,Flight,Operational,United States of America,North America,1,1,1,0,0,1,0,Unknown
1924-11-06 00:00:00,Compagnie Générale d'Entreprises Aéronautiques - CGEA,Flight,Operational,France,Europe,1,1,1,0,0,1,0,Weather
1924-12-03 00:00:00,Royal Air Force - RAF,Flight,Operational,United Kingdom,Europe,2,2,1,0,0,1,1,Unknown
1924-12-21 00:00:00,U.S. Air Mail Service,Flight,Operational,United States of America,North America,1,1,1,0,0,1,0,Weather
1924-12-29 00:00:00,U.S. Air Mail Service,Flight,Operational,United States of America,North America,1,1,1,0,0,1,0,Human Factor
1925-02-07 00:00:00,Blériot,Takeoff (climb),Business,Niger,Africa,4,4,1,0,0,1,3,Unknown
1925-02-27 00:00:00,Royal Air Force - RAF,Landing (descent or approach),Operational,United Kingdom,Europe,2,2,1,0,0,1,1,Unknown
1925-03-25 00:00:00,Royal Australian Air Force - RAAF,Landing (descent or approach),Operational,Australia,Oceania,2,2,1,0,0,1,1,Unknown
1925-05-05 00:00:00,North Sea Aerial %26 General Transport,Landing (descent or approach),Commercial,United Kingdom,Europe,3,1,1,2,0,1,2,Unknown
1925-05-15 00:00:00,Royal Air Force - RAF,Flight,Operational,United Kingdom,Europe,1,1,1,0,0,1,0,Technical Failure
1925-06-15 00:00:00,Belgian Air Force - Force Aérienne Belge - Belgische Luchtmacht,Flight,Operational,Belgium,Europe,1,1,1,0,0,1,0,Technical Failure
1925-07-02 00:00:00,Royal Air Force - RAF,Landing (descent or approach),Operational,United Kingdom,Europe,1,1,1,0,0,1,0,Unknown
1925-07-14 00:00:00,Royal Air Force - RAF,Flight,Operational,United Kingdom,Europe,1,1,1,0,0,1,0,Unknown
1925-07-22 00:00:00,Lloyd-Luftverkehr Sablatnig,Flight,Commercial,Switzerland,Europe,5,1,0,4,1,1,4,Unknown
1925-07-24 00:00:00,Compagnie Internationale de Navigation Aérienne - CIDNA,Landing (descent or approach),Operational,Hungary,Europe,1,1,1,0,0,1,0,Unknown
1925-08-16 00:00:00,Royal Air Force - RAF,Landing (descent or approach),Operational,United Kingdom,Europe,4,4,1,0,0,1,3,Human Factor
1925-09-13 00:00:00,Breguet Industries,Flight,Business,Germany,Europe,2,2,1,0,0,1,1,Unknown
1925-09-15 00:00:00,Goteborgs Luftdroskor,Flight,Commercial,Sweden,Europe,2,1,0,1,1,1,1,Unknown
1925-09-21 00:00:00,Royal Air Force - RAF,Flight,Operational,United Kingdom,Europe,2,2,1,0,0,1,1,Human Factor
1925-10-01 00:00:00,U.S. Air Mail Service,Flight,Operational,United States of America,North America,1,1,1,0,0,1,0,Weather
1925-10-14 00:00:00,United States Army Air Service - USAAS,Flight,Operational,United States of America,North America,1,1,1,0,0,1,0,Unknown
1925-10-16 00:00:00,Air Union France,Flight,Commercial,United Kingdom,Europe,9,2,0,7,1,1,8,Unknown
1925-10-17 00:00:00,Lignes Aériennes Latécoère,Flight,Operational,Mauritania,Africa,1,1,1,0,0,1,0,Human Factor
1925-12-04 00:00:00,Junkers Flugzeug %26 Motorenwerke,Flight,Specialised Services,Germany,Europe,1,1,1,0,0,1,0,Unknown
1925-12-10 00:00:00,Deutsche Verkehrsfliegerschule - DVS,Flight,Operational,Germany,Europe,1,1,1,0,0,1,0,Technical Failure
1925-12-16 00:00:00,Royal Air Force - RAF,Takeoff (climb),Operational,United Kingdom,Europe,1,1,1,0,0,1,0,Unknown
1926-01-22 00:00:00,Royal Australian Air Force - RAAF,Flight,Operational,Australia,Oceania,1,1,1,0,0,1,0,Unknown
1926-01-24 00:00:00,Aeronaut,Takeoff (climb),Commercial,Estonia,Europe,5,1,0,4,1,1,4,Technical Failure
1926-01-27 00:00:00,Royal Australian Air Force - RAAF,Flight,Operational,Australia,Oceania,1,1,1,0,0,1,0,Technical Failure
1926-02-02 00:00:00,Royal Australian Air Force - RAAF,Flight,Operational,Australia,Oceania,1,1,1,0,0,1,0,Unknown
1926-02-12 00:00:00,U.S. Air Mail Service,Flight,Operational,United States of America,North America,1,1,1,0,0,1,0,Unknown
1926-02-12 00:00:00,Royal Engineers Experimental Station,Flight,Specialised Services,United Kingdom,Europe,3,3,1,0,0,1,2,Human Factor
1926-02-24 00:00:00,Albert Collet,Flight,Business,France,Europe,1,1,1,0,0,1,0,Human Factor
1926-02-26 00:00:00,Spanish Air Force - Aeronáutica Militar,Flight,Operational,Spain,Europe,1,1,1,0,0,1,0,Unknown
1926-03-08 00:00:00,Deutsche Lufthansa,Landing (descent or approach),Operational,Germany,Europe,1,1,1,0,0,1,0,Unknown
1926-04-10 00:00:00,Inland Area Aircraft Depot,Flight,Operational,United Kingdom,Europe,1,1,1,0,0,1,0,Human Factor
1926-05-02 00:00:00,Southern Counties Aviation,Flight,Commercial,United Kingdom,Europe,3,1,1,2,0,1,2,Unknown
1926-05-18 00:00:00,Ford Air Freight Lines,Takeoff (climb),Operational,United States of America,North America,1,1,1,0,0,1,0,Technical Failure
1926-05-31 00:00:00,Air Union France,Flight,Operational,World,World,1,1,1,0,0,1,0,Unknown
1926-06-01 00:00:00,Deutsche Verkehrsfliegerschule - DVS,Flight,Operational,Germany,Europe,2,2,1,0,0,1,1,Unknown
1926-06-03 00:00:00,Royal Australian Air Force - RAAF,Flight,Operational,Australia,Oceania,1,1,1,0,0,1,0,Human Factor
1926-06-07 00:00:00,Charles Dickinson,Takeoff (climb),Operational,United States of America,North America,1,1,1,0,0,1,0,Unknown
1926-07-20 00:00:00,Costruzioni Meccaniche Aeronautiche SA,Takeoff (climb),Specialised Services,Italy,Europe,6,6,1,0,0,1,5,Unknown
1926-07-24 00:00:00,Turkish Air Force - Türk Hava Kuvvetleri,Flight,Operational,Turkey,Asia,1,1,1,0,0,1,0,Unknown
1926-08-20 00:00:00,Swiss Air Force,Flight,Operational,Switzerland,Europe,1,1,1,0,0,1,0,Human Factor
1926-09-05 00:00:00,Royal Australian Air Force - RAAF,Flight,Operational,Australia,Oceania,1,1,1,0,0,1,0,Human Factor
1926-09-06 00:00:00,Royal Air Force - RAF,Landing (descent or approach),Military / Government,United Kingdom,Europe,3,3,1,0,0,1,2,Unknown
1926-09-21 00:00:00,United States Army Air Corps - USAAC,Takeoff (climb),Military / Government,United Kingdom,Europe,2,1,0,1,1,1,1,Technical Failure
1926-11-12 00:00:00,Pacific Air Transport,Flight,Operational,United States of America,North America,2,1,0,1,1,1,1,Weather
1926-11-12 00:00:00,Royal Air Force - RAF,Flight,Operational,United Kingdom,Europe,1,1,1,0,0,1,0,Unknown
1926-11-22 00:00:00,London Aeroplane Club,Flight,Operational,United Kingdom,Europe,2,1,0,1,1,1,1,Unknown
1926-12-16 00:00:00,Pacific Air Transport,Flight,Operational,United States of America,North America,1,1,1,0,0,1,0,Weather
1927-01-07 00:00:00,United States Army Air Corps - USAAC,Flight,Operational,United States of America,North America,1,1,1,0,0,1,0,Human Factor
1927-01-07 00:00:00,United States Army Air Corps - USAAC,Flight,Operational,United States of America,North America,1,1,1,0,0,1,0,Human Factor
1927-03-19 00:00:00,Turkish Air Force - Türk Hava Kuvvetleri,Flight,Operational,Turkey,Asia,1,1,1,0,0,1,0,Unknown
1927-03-20 00:00:00,Compagnie Générale d'Entreprises Aéronautiques - CGEA,Flight,Operational,Morocco,Africa,1,1,1,0,0,1,0,Technical Failure
1927-04-15 00:00:00,United States Army Air Corps - USAAC,Flight,Operational,United States of America,North America,2,2,1,0,0,1,1,Unknown
1927-04-22 00:00:00,U.S. Air Mail Service,Flight,Operational,United States of America,North America,1,1,1,0,0,1,0,Weather
1927-05-02 00:00:00,Air Union France,Takeoff (climb),Commercial,Algeria,Africa,3,3,1,0,0,1,2,Technical Failure
1927-05-12 00:00:00,De Havilland School of Flying,Landing (descent or approach),Operational,United Kingdom,Europe,1,1,1,0,0,1,0,Unknown
1927-05-16 00:00:00,Royal Air Force - RAF,Takeoff (climb),Operational,United Kingdom,Europe,1,1,1,0,0,1,0,Unknown
1927-05-28 00:00:00,United States Army Air Corps - USAAC,Flight,Specialised Services,United States of America,North America,5,5,1,0,0,1,4,Technical Failure
1927-05-30 00:00:00,Royal Air Force - RAF,Landing (descent or approach),Operational,United Kingdom,Europe,2,2,1,0,0,1,1,Unknown
1927-06-06 00:00:00,Deutsche Sportflieger Klub,Takeoff (climb),Specialised Services,Germany,Europe,1,1,1,0,0,1,0,Unknown
1927-06-09 00:00:00,Canadian Vickers,Landing (descent or approach),Specialised Services,Canada,North America,2,2,1,0,0,1,1,Unknown
1927-06-22 00:00:00,Royal Air Force - RAF,Takeoff (climb),Operational,United Kingdom,Europe,1,1,1,0,0,1,0,Technical Failure
1927-06-29 00:00:00,Irish Air Corps - Aer Chór na hÉireann,Takeoff (climb),Operational,Ireland,Europe,1,1,1,0,0,1,0,Unknown
1927-07-13 00:00:00,French Air Force - Armée de l'Air,Landing (descent or approach),Military / Government,France,Europe,5,5,1,0,0,1,4,Unknown
1927-07-18 00:00:00,West Australian Airways,Flight,Operational,Australia,Oceania,1,1,1,0,0,1,0,Unknown
1927-08-22 00:00:00,KLM Royal Dutch Airlines - Koninklijke Luchtvaart Maatschappij,Flight,Commercial,United Kingdom,Europe,11,2,1,9,0,1,10,Technical Failure
1927-08-23 00:00:00,Deutsche Verkehrsfliegerschule - DVS,Flight,Operational,Poland,Europe,1,1,1,0,0,1,0,Unknown
1927-08-26 00:00:00,Paul Rinaldo Redfern,Flight,Business,Guyana,South America,1,1,1,0,0,1,0,Unknown
1927-09-03 00:00:00,Colonial Air Transport,Flight,Operational,United States of America,North America,1,1,1,0,0,1,0,Weather
1927-09-22 00:00:00,L'Aéropostale,Flight,Operational,Spain,Europe,1,1,1,0,0,1,0,Unknown
1927-09-23 00:00:00,Anthony Milburn,Takeoff (climb),Business,United Kingdom,Europe,2,1,0,1,1,1,1,Unknown
1927-09-29 00:00:00,Focke-Wulf Flugzeuge,Flight,Specialised Services,Germany,Europe,1,1,1,0,0,1,0,Technical Failure
1927-10-09 00:00:00,London Aeroplane Club,Landing (descent or approach),Operational,United Kingdom,Europe,1,1,1,0,0,1,0,Unknown
1927-10-19 00:00:00,Department of Lands %26 Forestry,Flight,Military / Government,Canada,North America,2,1,1,1,0,1,1,Human Factor
1927-10-27 00:00:00,Royal Australian Air Force - RAAF,Flight,Operational,Australia,Oceania,1,1,1,0,0,1,0,Technical Failure
1927-11-08 00:00:00,Compagnie Internationale de Navigation Aérienne - CIDNA,Takeoff (climb),Commercial,France,Europe,4,2,1,2,0,1,3,Human Factor
1927-11-17 00:00:00,Swedish Air Force - Flygvapnet,Flight,Operational,Sweden,Europe,2,2,1,0,0,1,1,Technical Failure
1927-11-26 00:00:00,Royal Netherlands East Indies Air Force - ML-KNIL,Takeoff (climb),Operational,Indonesia,Asia,1,1,1,0,0,1,0,Unknown
1927-11-29 00:00:00,National Air Transport - USA,Flight,Operational,United States of America,North America,1,1,1,0,0,1,0,Weather
1927-12-28 00:00:00,L'Aéropostale,Flight,Operational,Spain,Europe,1,1,1,0,0,1,0,Technical Failure
1928-01-14 00:00:00,Stearman Aircraft,Flight,Specialised Services,United States of America,North America,1,1,1,0,0,1,0,Weather
1928-01-20 00:00:00,Société Générale des Transports Aériens - SGTA,Flight,Commercial,Germany,Europe,3,1,1,2,0,1,2,Human Factor
1928-01-22 00:00:00,L'Aéropostale,Flight,Commercial,Spain,Europe,2,1,0,1,1,1,1,Technical Failure
1928-02-26 00:00:00,Bayerische Flugzeugwerke,Flight,Specialised Services,Germany,Europe,1,1,1,0,0,1,0,Technical Failure
1928-02-26 00:00:00,Boeing Air Transport,Flight,Commercial,United States of America,North America,2,1,1,1,0,1,1,Technical Failure
1928-03-11 00:00:00,Australian Aero Club,Flight,Operational,Australia,Oceania,1,1,1,0,0,1,0,Unknown
1928-03-19 00:00:00,Dominion Airways - Canada,Flight,Operational,Canada,North America,1,1,1,0,0,1,0,Human Factor
1928-03-22 00:00:00,Royal Air Force - RAF,Flight,Operational,United Kingdom,Europe,2,2,1,0,0,1,1,Human Factor
1928-04-17 00:00:00,Boeing Air Transport,Flight,Commercial,United States of America,North America,2,1,0,1,1,1,1,Weather
1928-05-07 00:00:00,L'Aéropostale,Flight,Commercial,Brazil,South America,5,2,0,3,1,1,4,Technical Failure
1928-05-10 00:00:00,Royal Air Force - RAF,Landing (descent or approach),Military / Government,United Kingdom,Europe,4,4,1,0,0,1,3,Unknown
1928-05-12 00:00:00,Belgian Air Force - Force Aérienne Belge - Belgische Luchtmacht,Flight,Operational,Belgium,Europe,1,1,1,0,0,1,0,Unknown
1928-05-26 00:00:00,Pitcairn Aviation,Landing (descent or approach),Operational,United States of America,North America,1,1,1,0,0,1,0,Unknown
1928-05-29 00:00:00,Arthur Gabbetis Cooper,Flight,Business,United Kingdom,Europe,2,1,1,1,0,1,1,Unknown
1928-05-30 00:00:00,United States Army Air Corps - USAAC,Flight,Military / Government,United States of America,North America,1,1,1,0,0,1,0,Unknown
1928-06-05 00:00:00,Compagnie Internationale de Navigation Aérienne - CIDNA,Flight,Operational,Czech Republic,Europe,2,2,1,0,0,1,1,Technical Failure
1928-06-15 00:00:00,Belgian Air Force - Force Aérienne Belge - Belgische Luchtmacht,Flight,Operational,Belgium,Europe,2,2,1,0,0,1,1,Unknown
1928-06-16 00:00:00,Western Canada Airways,Landing (descent or approach),Operational,Canada,North America,2,2,1,0,0,1,1,Unknown
1928-06-22 00:00:00,National Air Transport - USA,Flight,Operational,United States of America,North America,1,1,1,0,0,1,0,Weather
1928-06-28 00:00:00,Robertson Aircraft Corporation,Flight,Operational,United States of America,North America,1,1,1,0,0,1,0,Human Factor
1928-07-07 00:00:00,Royal Air Force - RAF,Flight,Operational,United Kingdom,Europe,1,1,1,0,0,1,0,Unknown
1928-07-12 00:00:00,Excelsior,Flight,Operational,United States of America,North America,1,1,1,0,0,1,0,Unknown
1928-07-24 00:00:00,KLM Royal Dutch Airlines - Koninklijke Luchtvaart Maatschappij,Takeoff (climb),Commercial,Netherlands,Europe,6,1,0,5,1,1,5,Human Factor
1928-07-24 00:00:00,Belgian Air Force - Force Aérienne Belge - Belgische Luchtmacht,Flight,Operational,Belgium,Europe,1,1,1,0,0,1,0,Unknown
1928-07-27 00:00:00,Provincial Air Service of Lands %26 Forests,Flight,Military / Government,Canada,North America,1,1,1,0,0,1,0,Technical Failure
1928-07-31 00:00:00,Polish Government,Landing (descent or approach),Military / Government,Iraq,Asia,3,3,1,0,0,1,2,Human Factor
1928-08-17 00:00:00,Royal Air Force - RAF,Flight,Operational,United Kingdom,Europe,1,1,1,0,0,1,0,Human Factor
1928-08-25 00:00:00,Belgian Air Force - Force Aérienne Belge - Belgische Luchtmacht,Flight,Operational,Belgium,Europe,1,1,1,0,0,1,0,Unknown
1928-08-29 00:00:00,Granby Aero Club,Takeoff (climb),Operational,Canada,North America,1,1,1,0,0,1,0,Unknown
1928-08-30 00:00:00,Royal Air Force - RAF,Flight,Operational,United Kingdom,Europe,1,1,1,0,0,1,0,Unknown
1928-08-31 00:00:00,Royal Air Force - RAF,Flight,Operational,United Kingdom,Europe,1,1,1,0,0,1,0,Unknown
1928-09-02 00:00:00,Royal Air Force - RAF,Flight,Operational,United Kingdom,Europe,1,1,1,0,0,1,0,Human Factor
1928-09-04 00:00:00,Qantas Airways - Queensland and Northern Territory Aerial Services,Takeoff (climb),Commercial,Australia,Oceania,2,2,1,0,0,1,1,Human Factor
1928-09-20 00:00:00,Henderson Flying School,Takeoff (climb),Operational,United Kingdom,Europe,1,1,1,0,0,1,0,Human Factor
1928-09-21 00:00:00,Aircraft Ltd,Flight,Specialised Services,Canada,North America,1,1,1,0,0,1,0,Unknown
1928-10-02 00:00:00,Pacific Air Transport,Flight,Commercial,United States of America,North America,2,1,0,1,1,1,1,Human Factor
1928-10-18 00:00:00,De Havilland Aircraft UK,Flight,Business,World,World,1,1,1,0,0,1,0,Unknown
1928-10-18 00:00:00,National Air Transport - USA,Flight,Operational,United States of America,North America,1,1,1,0,0,1,0,Weather
1928-10-31 00:00:00,Air Union France,Flight,Commercial,France,Europe,2,1,1,1,0,1,1,Weather
1928-11-01 00:00:00,Royal Canadian Air Force - RCAF,Landing (descent or approach),Operational,Canada,North America,2,2,1,0,0,1,1,Unknown
1928-11-07 00:00:00,Royal Air Force - RAF,Flight,Operational,United Kingdom,Europe,1,1,1,0,0,1,0,Human Factor
1928-11-15 00:00:00,L'Aéropostale,Landing (descent or approach),Operational,Spain,Europe,3,3,1,0,0,1,2,Human Factor
1928-11-25 00:00:00,National Air Transport - USA,Flight,Operational,United States of America,North America,1,1,1,0,0,1,0,Weather
1928-11-25 00:00:00,Continental Air Lines,Flight,Operational,United States of America,North America,1,1,1,0,0,1,0,Weather
1928-12-20 00:00:00,National Air Transport - USA,Flight,Operational,United States of America,North America,1,1,1,0,0,1,0,Weather
1928-12-26 00:00:00,Hamilton Aero Club,Flight,Business,Canada,North America,2,1,0,1,1,1,1,Unknown
1929-01-05 00:00:00,Colonial Air Transport,Flight,Operational,United States of America,North America,1,1,1,0,0,1,0,Unknown
1929-01-18 00:00:00,Varney Air Lines - VAL,Flight,Operational,United States of America,North America,1,1,1,0,0,1,0,Weather
1929-01-20 00:00:00,Philip Aubrey Wills,Takeoff (climb),Business,United Kingdom,Europe,2,1,1,1,0,1,1,Unknown
1929-01-31 00:00:00,Skyline Transportation Company,Landing (descent or approach),Operational,United States of America,North America,1,1,1,0,0,1,0,Unknown
1929-02-25 00:00:00,Royal Australian Air Force - RAAF,Takeoff (climb),Operational,Australia,Oceania,2,2,1,0,0,1,1,Unknown
1929-03-07 00:00:00,Royal Australian Air Force - RAAF,Takeoff (climb),Military / Government,Australia,Oceania,2,2,1,0,0,1,1,Unknown
1929-03-07 00:00:00,Belgian Air Force - Force Aérienne Belge - Belgische Luchtmacht,Flight,Operational,Belgium,Europe,1,1,1,0,0,1,0,Human Factor
1929-03-08 00:00:00,Nottingham Aero Club,Flight,Operational,World,World,1,1,1,0,0,1,0,Human Factor
1929-03-19 00:00:00,Alf Gunnestad,Flight,Operational,France,Europe,1,1,1,0,0,1,0,Weather
1929-03-22 00:00:00,Caddo Company,Flight,Specialised Services,United States of America,North America,2,2,1,0,0,1,1,Technical Failure
1929-05-02 00:00:00,L'Aéropostale,Flight,Operational,Western Sahara,Africa,1,1,1,0,0,1,0,Unknown
1929-05-02 00:00:00,Royal Netherlands Navy - Marineluchtvaartdienst,Flight,Operational,Iraq,Asia,3,3,1,0,0,1,2,Unknown
1929-05-10 00:00:00,Royal Air Force - RAF,Flight,Operational,United Kingdom,Europe,1,1,1,0,0,1,0,Unknown
1929-05-16 00:00:00,SCADTA - Sociedad Colombo-Alemana de Transportes Aéreos,Takeoff (climb),Commercial,Colombia,South America,7,2,0,5,1,1,6,Other
1929-05-21 00:00:00,Belgian Air Force - Force Aérienne Belge - Belgische Luchtmacht,Flight,Operational,Belgium,Europe,1,1,1,0,0,1,0,Terrorism
1929-06-14 00:00:00,L'Aéropostale,Takeoff (climb),Operational,Spain,Europe,2,2,1,0,0,1,1,Technical Failure
1929-06-24 00:00:00,Northwest Airways,Takeoff (climb),Commercial,United States of America,North America,8,2,0,6,1,1,7,Technical Failure
1929-06-28 00:00:00,Yarrow Aircraft Corporation,Flight,Business,Canada,North America,1,1,1,0,0,1,0,Human Factor
1929-06-30 00:00:00,Continental Air Lines,Flight,Operational,United States of America,North America,1,1,1,0,0,1,0,Weather
1929-07-07 00:00:00,Louis Coudouret,Flight,Business,France,Europe,3,1,1,2,0,1,2,Technical Failure
1929-07-08 00:00:00,Pitcairn Aviation,Flight,Specialised Services,United States of America,North America,1,1,1,0,0,1,0,Technical Failure
1929-07-09 00:00:00,Armstrong-Whitworth Aircraft,Landing (descent or approach),Operational,United Kingdom,Europe,1,1,1,0,0,1,0,Unknown
1929-07-11 00:00:00,Royal Air Force - RAF,Flight,Operational,United Kingdom,Europe,1,1,1,0,0,1,0,Unknown
1929-07-13 00:00:00,Polish Government,Landing (descent or approach),Business,Portugal,Europe,2,2,1,0,0,1,1,Technical Failure
1929-07-14 00:00:00,Australian Aero Club,Landing (descent or approach),Operational,Australia,Oceania,1,1,1,0,0,1,0,Unknown
1929-07-17 00:00:00,French Air Force - Armée de l'Air,Landing (descent or approach),Military / Government,France,Europe,4,4,1,0,0,1,3,Unknown
1929-07-18 00:00:00,De Havilland Aircraft UK,Flight,Operational,United Kingdom,Europe,1,1,1,0,0,1,0,Unknown
1929-07-22 00:00:00,Deutsche Lufthansa,Takeoff (climb),Operational,Germany,Europe,1,1,1,0,0,1,0,Technical Failure
1929-07-22 00:00:00,Aero Club of British Columbia,Landing (descent or approach),Operational,Canada,North America,2,2,1,0,0,1,1,Unknown
1929-07-28 00:00:00,National Flying Services,Flight,Operational,United Kingdom,Europe,1,1,1,0,0,1,0,Human Factor
1929-07-29 00:00:00,George Frederick Boyle,Flight,Business,United Kingdom,Europe,1,1,1,0,0,1,0,Human Factor
1929-07-30 00:00:00,Pitcairn Aviation,Flight,Operational,United States of America,North America,1,1,1,0,0,1,0,Human Factor
1929-08-01 00:00:00,Brazilian Navy - Aviação Naval Brasileira,Flight,Operational,Brazil,South America,9,9,1,0,0,1,8,Unknown
1929-08-04 00:00:00,General Tire %26 Rubber Company,Flight,Operational,United States of America,North America,1,1,1,0,0,1,0,Weather
1929-08-12 00:00:00,Middle States Airlines - MSA,Flight,Operational,United States of America,North America,1,1,1,0,0,1,0,Weather
1929-08-13 00:00:00,Thompson Aeronautical Corporation,Landing (descent or approach),Commercial,United States of America,North America,4,1,0,3,1,1,3,Weather
1929-08-16 00:00:00,Aeroposta Argentina,Flight,Commercial,Paraguay,South America,3,2,1,1,0,1,2,Human Factor
1929-08-26 00:00:00,Warren Packard,Flight,Operational,United States of America,North America,2,2,1,0,0,1,1,Human Factor
1929-08-30 00:00:00,United States Army Air Corps - USAAC,Takeoff (climb),Military / Government,Nicaragua,Central America,3,3,1,0,0,1,2,Technical Failure
1929-08-31 00:00:00,Montreal Light Aeroplane Club,Takeoff (climb),Business,Canada,North America,2,1,0,1,1,1,1,Unknown
1929-09-02 00:00:00,Associated Aviators,Flight,Commercial,United States of America,North America,2,2,1,0,0,1,1,Weather
1929-09-04 00:00:00,Andrew Paton Holt,Flight,Business,United Kingdom,Europe,1,1,1,0,0,1,0,Unknown
1929-09-13 00:00:00,Pitcairn Aviation,Landing (descent or approach),Operational,United States of America,North America,1,1,1,0,0,1,0,Human Factor
1929-09-17 00:00:00,Colonial Air Transport,Flight,Operational,United States of America,North America,1,1,1,0,0,1,0,Weather
1929-09-17 00:00:00,Pickwick Airways,Flight,Commercial,United States of America,North America,2,1,0,1,1,1,1,Weather
1929-09-19 00:00:00,Surrey Flying Services,Flight,Commercial,United Kingdom,Europe,2,1,1,1,0,1,1,Unknown
1929-09-28 00:00:00,Swiss Air Force,Landing (descent or approach),Operational,Switzerland,Europe,2,2,1,0,0,1,1,Unknown
1929-10-08 00:00:00,Saskatoon Aero Club,Flight,Operational,Canada,North America,1,1,1,0,0,1,0,Technical Failure
1929-10-29 00:00:00,Dobrolet,Flight,Operational,Russia,Asia,1,1,1,0,0,1,0,Human Factor
1929-10-29 00:00:00,Continental Air Lines,Flight,Operational,United States of America,North America,1,1,1,0,0,1,0,Human Factor
1929-10-30 00:00:00,Brazilian Air Force - Aviação Militar,Flight,Operational,Brazil,South America,2,2,1,0,0,1,1,Unknown
1929-11-02 00:00:00,Yukon Airways %26 Exploration Company,Takeoff (climb),Commercial,Canada,North America,1,1,1,0,0,1,0,Unknown
1929-11-20 00:00:00,Società Aerea Mediterranea - SAM,Landing (descent or approach),Commercial,Italy,Europe,12,3,0,9,1,1,11,Human Factor
1929-11-30 00:00:00,Varney Air Lines - VAL,Flight,Operational,United States of America,North America,1,1,1,0,0,1,0,Human Factor
1929-12-02 00:00:00,National Air Transport - USA,Flight,Operational,United States of America,North America,1,1,1,0,0,1,0,Unknown
1929-12-15 00:00:00,Aircraft Ltd,Landing (descent or approach),Operational,Canada,North America,1,1,1,0,0,1,0,Human Factor
1930-01-05 00:00:00,Royal Australian Air Force - RAAF,Flight,Operational,Australia,Oceania,1,1,1,0,0,1,0,Human Factor
1930-01-09 00:00:00,Curtiss Flying Service,Flight,Operational,United States of America,North America,1,1,1,0,0,1,0,Unknown
1930-01-10 00:00:00,Boeing Air Transport,Flight,Operational,United States of America,North America,1,1,1,0,0,1,0,Weather
1930-01-11 00:00:00,Western Air Express,Flight,Operational,United States of America,North America,1,1,1,0,0,1,0,Weather
1930-01-18 00:00:00,Marjorie Hazeldene Stevens,Takeoff (climb),Business,United Kingdom,Europe,2,1,0,1,1,1,1,Unknown
1930-02-03 00:00:00,Colonial Air Transport,Landing (descent or approach),Operational,United States of America,North America,1,1,1,0,0,1,0,Human Factor
1930-03-07 00:00:00,Royal Netherlands East Indies Air Force - ML-KNIL,Landing (descent or approach),Military / Government,Indonesia,Asia,2,2,1,0,0,1,1,Unknown
1930-04-01 00:00:00,Royal Air Force - RAF,Flight,Operational,United Kingdom,Europe,1,1,1,0,0,1,0,Human Factor
1930-04-08 00:00:00,Hellenic Air Force - Elleniki Polemiki Aeroporia,Landing (descent or approach),Operational,Greece,Europe,1,1,1,0,0,1,0,Human Factor
1930-04-13 00:00:00,Swedish Air Force - Flygvapnet,Flight,Humanitarian,Sweden,Europe,5,2,0,3,1,1,4,Technical Failure
1930-04-25 00:00:00,Lockheed Aircraft Corporation,Takeoff (climb),Operational,United States of America,North America,2,1,1,1,0,1,1,Other
1930-04-27 00:00:00,Commercial Aviation Company - Australia,Flight,Humanitarian,Australia,Oceania,1,1,1,0,0,1,0,Human Factor
1930-05-06 00:00:00,National Flying Services,Flight,Specialised Services,United Kingdom,Europe,1,1,1,0,0,1,0,Unknown
1930-05-26 00:00:00,Royal Air Force - RAF,Flight,Operational,United Kingdom,Europe,2,2,1,0,0,1,1,Unknown
1930-05-26 00:00:00,Lockheed Aircraft Corporation,Flight,Specialised Services,United States of America,North America,1,1,1,0,0,1,0,Unknown
1930-05-27 00:00:00,Brazilian Navy - Aviação Naval Brasileira,Flight,Operational,Brazil,South America,2,2,1,0,0,1,1,Unknown
1930-06-02 00:00:00,Canadian Airways,Landing (descent or approach),Operational,Canada,North America,1,1,1,0,0,1,0,Weather
1930-06-05 00:00:00,Colonial Air Transport,Takeoff (climb),Commercial,United States of America,North America,15,2,0,13,1,1,14,Technical Failure
1930-06-06 00:00:00,Royal Air Force - RAF,Landing (descent or approach),Operational,United Kingdom,Europe,2,2,1,0,0,1,1,Human Factor
1930-06-13 00:00:00,Royal Air Force - RAF,Flight,Operational,United Kingdom,Europe,1,1,1,0,0,1,0,Human Factor
1930-06-17 00:00:00,Royal Air Force - RAF,Takeoff (climb),Operational,United Kingdom,Europe,2,2,1,0,0,1,1,Unknown
1930-06-29 00:00:00,Ontario Provincial Air Service,Flight,Operational,Canada,North America,1,1,1,0,0,1,0,Human Factor
1930-07-03 00:00:00,Eric L. Hook,Flight,Business,Myanmar,Asia,2,2,1,0,0,1,1,Weather
1930-07-06 00:00:00,H. J. Barryman,Flight,Business,Australia,Oceania,2,1,0,1,1,1,1,Unknown
1930-07-07 00:00:00,Royal Canadian Air Force - RCAF,Takeoff (climb),Operational,Canada,North America,1,1,1,0,0,1,0,Unknown
1930-07-09 00:00:00,Société Générale des Transports Aériens - SGTA,Takeoff (climb),Operational,Netherlands,Europe,3,3,1,0,0,1,2,Technical Failure
1930-07-22 00:00:00,Thompson Aeronautical Corporation,Flight,Operational,United States of America,North America,1,1,1,0,0,1,0,Weather
1930-08-14 00:00:00,Ölag - Österreichische Luftverkehrs AG,Flight,Commercial,Germany,Europe,3,1,1,2,0,1,2,Weather
1930-08-15 00:00:00,Royal Air Force - RAF,Takeoff (climb),Operational,Egypt,Africa,1,1,1,0,0,1,0,Unknown
1930-08-18 00:00:00,Johannes La Cour,Flight,Business,Denmark,Europe,2,1,1,1,0,1,1,Unknown
1930-08-19 00:00:00,Australian Aero Club,Takeoff (climb),Operational,Australia,Oceania,2,2,1,0,0,1,1,Unknown
1930-09-02 00:00:00,Ölag - Österreichische Luftverkehrs AG,Flight,Operational,Germany,Europe,1,1,1,0,0,1,0,Human Factor
1930-09-09 00:00:00,Royal Air Force - RAF,Flight,Operational,United Kingdom,Europe,1,1,1,0,0,1,0,Unknown
1930-09-11 00:00:00,Deutsche Verkehrsfliegerschule - DVS,Flight,Operational,Germany,Europe,1,1,1,0,0,1,0,Unknown
1930-09-19 00:00:00,Deutsche Verkehrsfliegerschule - DVS,Takeoff (climb),Operational,Germany,Europe,2,2,1,0,0,1,1,Unknown
1930-09-27 00:00:00,Finnish Air Force - Suomen Ilmavoimat,Flight,Operational,Finland,Europe,1,1,1,0,0,1,0,Unknown
1930-10-10 00:00:00,Canadian Aerial Explorations,Flight,Specialised Services,Canada,North America,3,2,1,1,0,1,2,Human Factor
1930-10-14 00:00:00,Transadriatica,Takeoff (climb),Specialised Services,Italy,Europe,3,3,1,0,0,1,2,Unknown
1930-10-18 00:00:00,Paul Ebener,Flight,Business,Germany,Europe,1,1,1,0,0,1,0,Technical Failure
1930-10-23 00:00:00,Polish Air Force - Polska Wojska Lotnicze i Obrony Powietrznej,Flight,Operational,Poland,Europe,1,1,1,0,0,1,0,Unknown
1930-10-30 00:00:00,Embry Riddle Company,Flight,Operational,United States of America,North America,1,1,1,0,0,1,0,Weather
1930-11-01 00:00:00,Douglas Henry Corsellis,Landing (descent or approach),Business,United Kingdom,Europe,1,1,1,0,0,1,0,Human Factor
1930-11-07 00:00:00,Syndicato Condor,Flight,Commercial,Brazil,South America,10,3,0,7,1,1,9,Unknown
1930-11-08 00:00:00,Brazilian Air Force - Aviação Militar,Landing (descent or approach),Military / Government,Brazil,South America,1,1,1,0,0,1,0,Unknown
1930-11-09 00:00:00,Nottingham Aero Club,Flight,Operational,United Kingdom,Europe,1,1,1,0,0,1,0,Unknown
1930-11-22 00:00:00,Texas Pipe Line Company,Flight,Business,United States of America,North America,1,1,1,0,0,1,0,Unknown
1930-11-30 00:00:00,Royal Air Force - RAF,Flight,Military / Government,United Kingdom,Europe,1,1,1,0,0,1,0,Unknown
1930-12-22 00:00:00,Auckland Aero Club,Flight,Operational,New Zealand,Oceania,1,1,1,0,0,1,0,Unknown
1931-01-06 00:00:00,Regia Aeronautica,Takeoff (climb),Military / Government,Guinea Bissau,Africa,4,4,1,0,0,1,3,Unknown
1931-01-22 00:00:00,Varney Air Lines - VAL,Flight,Operational,United States of America,North America,1,1,1,0,0,1,0,Weather
1931-01-26 00:00:00,Turkish Air Force - Türk Hava Kuvvetleri,Flight,Operational,Turkey,Asia,1,1,1,0,0,1,0,Unknown
1931-02-02 00:00:00,Venezuelan Air Force - Fuerza Aérea Venezolana,Landing (descent or approach),Military / Government,Venezuela,South America,4,1,1,3,0,1,3,Weather
1931-02-24 00:00:00,L'Aéropostale,Flight,Operational,France,Europe,3,3,1,0,0,1,2,Technical Failure
1931-02-25 00:00:00,SABENA - Société Anonyme Belge d'Exploitation de la Navigation Aérienne,Takeoff (climb),Commercial,Democratic Republic of Congo,Africa,7,2,1,5,0,1,6,Other
1931-03-01 00:00:00,George D. Mallinson,Flight,Operational,World,World,1,1,1,0,0,1,0,Weather
1931-03-07 00:00:00,Royal Air Force - RAF,Flight,Operational,United Kingdom,Europe,1,1,1,0,0,1,0,Human Factor
1931-03-23 00:00:00,Royal Air Force - RAF,Flight,Operational,United Kingdom,Europe,1,1,1,0,0,1,0,Unknown
1931-04-04 00:00:00,Royal Air Force - RAF,Landing (descent or approach),Military / Government,Egypt,Africa,3,1,1,2,0,1,2,Unknown
1931-04-05 00:00:00,National Air Transport - Canada,Flight,Operational,Canada,North America,2,2,1,0,0,1,1,Human Factor
1931-04-08 00:00:00,Hellenic Air Force - Elleniki Polemiki Aeroporia,Flight,Military / Government,Greece,Europe,1,1,1,0,0,1,0,Human Factor
1931-04-25 00:00:00,VARIG - Viação Aérea Rio Grandense,Takeoff (climb),Operational,Brazil,South America,2,2,1,0,0,1,1,Weather
1931-05-01 00:00:00,Prince Jean Ghica,Landing (descent or approach),Business,Romania,Europe,2,1,0,1,1,1,1,Unknown
1931-05-02 00:00:00,Royal Air Force - RAF,Flight,Operational,United Kingdom,Europe,2,2,1,0,0,1,1,Unknown
1931-05-12 00:00:00,Royal Air Force - RAF,Flight,Operational,United Kingdom,Europe,1,1,1,0,0,1,0,Human Factor
1931-05-24 00:00:00,National Air Transport - USA,Flight,Operational,United States of America,North America,1,1,1,0,0,1,0,Weather
1931-06-08 00:00:00,Australian Government - Department of Defence,Flight,Operational,Australia,Oceania,1,1,1,0,0,1,0,Unknown
1931-06-09 00:00:00,H. Hindriks,Flight,Business,Netherlands,Europe,1,1,1,0,0,1,0,Unknown
1931-06-13 00:00:00,ADC Aircraft,Flight,Business,United Kingdom,Europe,1,1,1,0,0,1,0,Technical Failure
1931-07-03 00:00:00,Breguet Industries,Flight,Specialised Services,France,Europe,1,1,1,0,0,1,0,Technical Failure
1931-07-07 00:00:00,Royal Air Force - RAF,Landing (descent or approach),Military / Government,Egypt,Africa,7,7,1,0,0,1,6,Unknown
1931-07-12 00:00:00,Charles Edward Ansell Flewitt,Flight,Business,United Kingdom,Europe,2,2,1,0,0,1,1,Unknown
1931-07-21 00:00:00,American Airways,Flight,Operational,United States of America,North America,1,1,1,0,0,1,0,Weather
1931-07-31 00:00:00,Spanish Air Force - Aeronáutica Militar,Flight,Military / Government,Spain,Europe,1,1,1,0,0,1,0,Unknown
1931-09-01 00:00:00,Swedish Air Force - Flygvapnet,Flight,Operational,Sweden,Europe,1,1,1,0,0,1,0,Human Factor
1931-09-14 00:00:00,Chicago-Detroit Airways,Landing (descent or approach),Operational,United States of America,North America,1,1,1,0,0,1,0,Weather
1931-09-18 00:00:00,Nigel B. Cohen,Flight,Operational,United Kingdom,Europe,1,1,1,0,0,1,0,Human Factor
1931-09-20 00:00:00,Hampshire Aeroplane Club,Flight,Business,United Kingdom,Europe,1,1,1,0,0,1,0,Unknown
1931-09-27 00:00:00,Dr. Naner,Flight,Business,Switzerland,Europe,1,1,1,0,0,1,0,Human Factor
1931-09-28 00:00:00,Royal Canadian Air Force - RCAF,Flight,Operational,Canada,North America,1,1,1,0,0,1,0,Human Factor
1931-10-03 00:00:00,Charles Richard Vernon Pugh,Landing (descent or approach),Business,United Kingdom,Europe,2,1,0,1,1,1,1,Technical Failure
1931-11-08 00:00:00,Brooklands School of Flying,Landing (descent or approach),Operational,United Kingdom,Europe,2,2,1,0,0,1,1,Unknown
1931-11-23 00:00:00,Boeing Air Transport,Landing (descent or approach),Operational,United States of America,North America,1,1,1,0,0,1,0,Weather
1931-11-26 00:00:00,Varney Air Lines - VAL,Landing (descent or approach),Operational,United States of America,North America,1,1,1,0,0,1,0,Weather
1931-12-13 00:00:00,Herts %26 Essex Aero Club,Landing (descent or approach),Operational,United Kingdom,Europe,1,1,1,0,0,1,0,Unknown
1931-12-13 00:00:00,Vera Brailey,Flight,Business,United Kingdom,Europe,2,1,1,1,0,1,1,Unknown
1931-12-19 00:00:00,Transcontinental %26 Western Air - TWA,Takeoff (climb),Operational,United States of America,North America,2,2,1,0,0,1,1,Technical Failure
1932-01-04 00:00:00,CAMS,Landing (descent or approach),Specialised Services,France,Europe,1,1,1,0,0,1,0,Unknown
1932-01-21 00:00:00,Northwest Airways,Flight,Commercial,United States of America,North America,1,1,1,0,0,1,0,Weather
1932-01-25 00:00:00,Stinson Aircraft Company,Flight,Operational,United States of America,North America,5,1,1,4,0,1,4,Human Factor
1932-02-02 00:00:00,Transamerican Airlines,Flight,Operational,United States of America,North America,1,1,1,0,0,1,0,Weather
1932-02-02 00:00:00,Boeing Air Transport,Flight,Operational,United States of America,North America,1,1,1,0,0,1,0,Weather
1932-02-07 00:00:00,Boeing Air Transport,Flight,Operational,United States of America,North America,1,1,1,0,0,1,0,Weather
1932-02-08 00:00:00,Nederlands-Indische Vliegclub,Takeoff (climb),Operational,Indonesia,Asia,1,1,1,0,0,1,0,Unknown
1932-02-17 00:00:00,Royal Air Force - RAF,Flight,Military / Government,Malta,Europe,2,2,1,0,0,1,1,Unknown
1932-03-12 00:00:00,Canadian Airways,Landing (descent or approach),Operational,Canada,North America,1,1,1,0,0,1,0,Weather
1932-03-20 00:00:00,Flugdienst Breslau - Wilhelm Przibilla,Takeoff (climb),Commercial,Poland,Europe,4,1,1,3,0,1,3,Human Factor
1932-03-21 00:00:00,Royal Canadian Air Force - RCAF,Flight,Specialised Services,Canada,North America,2,2,1,0,0,1,1,Technical Failure
1932-03-25 00:00:00,Finnish Air Force - Suomen Ilmavoimat,Flight,Operational,Finland,Europe,2,2,1,0,0,1,1,Unknown
1932-03-31 00:00:00,National Air Transport - USA,Flight,Operational,United States of America,North America,1,1,1,0,0,1,0,Weather
1932-04-04 00:00:00,Luftsport-verband Niedersachsen,Flight,Commercial,Germany,Europe,1924,1924,1,0,0,1,1923,Technical Failure
1932-04-08 00:00:00,Short Brothers,Landing (descent or approach),Specialised Services,United Kingdom,Europe,1,1,1,0,0,1,0,Unknown
1932-04-14 00:00:00,Royal Air Force - RAF,Landing (descent or approach),Military / Government,United Kingdom,Europe,1,1,1,0,0,1,0,Unknown
1932-04-21 00:00:00,Transamerican Airlines,Landing (descent or approach),Operational,United States of America,North America,1,1,1,0,0,1,0,Unknown
1932-04-28 00:00:00,De Havilland Aircraft UK,Takeoff (climb),Specialised Services,United Kingdom,Europe,1,1,1,0,0,1,0,Technical Failure
1932-04-29 00:00:00,Royal Air Force - RAF,Flight,Operational,United Kingdom,Europe,1,1,1,0,0,1,0,Human Factor
1932-05-02 00:00:00,Ferdinand Fluckiger,Flight,Business,France,Europe,1,1,1,0,0,1,0,Unknown
1932-05-04 00:00:00,Brazilian Air Force - Aviação Militar,Flight,Operational,Brazil,South America,2,2,1,0,0,1,1,Unknown
1932-05-06 00:00:00,Royal Air Force - RAF,Flight,Operational,United Kingdom,Europe,1,1,1,0,0,1,0,Human Factor
1932-05-06 00:00:00,Royal Air Force - RAF,Flight,Operational,United Kingdom,Europe,1,1,1,0,0,1,0,Human Factor
1932-05-16 00:00:00,Akademische Fliegergruppe,Flight,Operational,Germany,Europe,2,2,1,0,0,1,1,Unknown
1932-05-19 00:00:00,Norfolk %26 Norwich Aero Club,Flight,Business,United Kingdom,Europe,1,1,1,0,0,1,0,Unknown
1932-05-21 00:00:00,Spartan Aircraft,Flight,Business,United Kingdom,Europe,1,1,1,0,0,1,0,Human Factor
1932-05-30 00:00:00,Varney Air Transport - VAT,Takeoff (climb),Commercial,United States of America,North America,2,1,0,1,1,1,1,Technical Failure
1932-06-09 00:00:00,Royal Air Force - RAF,Flight,Operational,United Kingdom,Europe,1,1,1,0,0,1,0,Human Factor
1932-06-23 00:00:00,Finnish Air Force - Suomen Ilmavoimat,Flight,Operational,Finland,Europe,2,2,1,0,0,1,1,Unknown
1932-07-29 00:00:00,Deutsche Verkehrsfliegerschule - DVS,Flight,Operational,Germany,Europe,2,2,1,0,0,1,1,Human Factor
1932-08-07 00:00:00,T. F. Carr,Landing (descent or approach),Business,Canada,North America,2,1,0,1,1,1,1,Unknown
1932-08-27 00:00:00,Etienne Michelin,Flight,Business,France,Europe,1,1,1,0,0,1,0,Weather
1932-09-14 00:00:00,Turkish Air Force - Türk Hava Kuvvetleri,Flight,Operational,Turkey,Asia,1,1,1,0,0,1,0,Unknown
1932-09-16 00:00:00,Royal Air Force - RAF,Landing (descent or approach),Military / Government,South Sudan,Africa,3,3,1,0,0,1,2,Unknown
1932-09-17 00:00:00,Air Union France,Landing (descent or approach),Operational,United Kingdom,Europe,2,2,1,0,0,1,1,Human Factor
1932-09-27 00:00:00,Brazilian Air Force - Aviação Militar,Flight,Military / Government,Brazil,South America,2,2,1,0,0,1,1,Unknown
1932-10-05 00:00:00,Cornwall Aviation,Flight,Operational,United Kingdom,Europe,3,1,0,2,1,1,2,Human Factor
1932-10-09 00:00:00,Northern Air Transport,Takeoff (climb),Business,United Kingdom,Europe,2,1,0,1,1,1,1,Unknown
1932-10-12 00:00:00,L'Aéropostale,Takeoff (climb),Operational,Mauritania,Africa,1,1,1,0,0,1,0,Unknown
1932-11-17 00:00:00,Hal Roach Studios,Takeoff (climb),Specialised Services,Zimbabwe,Africa,3,1,1,2,0,1,2,Other
1932-12-06 00:00:00,Royal Australian Air Force - RAAF,Landing (descent or approach),Operational,Australia,Oceania,2,1,1,1,0,1,1,Human Factor
1932-12-10 00:00:00,L'Aéropostale,Flight,Commercial,France,Europe,2,1,1,1,0,1,1,Human Factor
1932-12-14 00:00:00,Boeing Air Transport,Flight,Operational,United States of America,North America,1,1,1,0,0,1,0,Human Factor
1932-12-15 00:00:00,Royal Air Force - RAF,Flight,Operational,Egypt,Africa,1,1,1,0,0,1,0,Unknown
1933-01-07 00:00:00,Herbert John Louis Hinkler,Flight,Business,Italy,Europe,1,1,1,0,0,1,0,Technical Failure
1933-01-11 00:00:00,L'Aéropostale,Takeoff (climb),Operational,Algeria,Africa,3,3,1,0,0,1,2,Unknown
1933-01-12 00:00:00,Royal Air Force - RAF,Landing (descent or approach),Operational,United Kingdom,Europe,9,9,1,0,0,1,8,Other
1933-01-12 00:00:00,Putilov,Flight,Specialised Services,Russia,Asia,2,2,1,0,0,1,1,Weather
1933-01-13 00:00:00,Spencer-McDonough Air Transport,Flight,Commercial,Canada,North America,5,2,1,3,0,1,4,Weather
1933-01-18 00:00:00,Belgian Air Force - Force Aérienne Belge - Belgische Luchtmacht,Flight,Operational,Belgium,Europe,1,1,1,0,0,1,0,Unknown
1933-01-20 00:00:00,American Airways,Landing (descent or approach),Operational,United States of America,North America,1,1,1,0,0,1,0,Human Factor
1933-01-20 00:00:00,American Airways,Flight,Operational,United States of America,North America,1,1,1,0,0,1,0,Human Factor
1933-01-25 00:00:00,Royal Air Force - RAF,Flight,Specialised Services,Egypt,Africa,1,1,1,0,0,1,0,Unknown
1933-01-31 00:00:00,Patrick Geoffrey T. Rodd,Takeoff (climb),Business,Switzerland,Europe,2,1,1,1,0,1,1,Unknown
1933-02-11 00:00:00,French Air Force - Armée de l'Air,Flight,Operational,Madagascar,Africa,1,1,1,0,0,1,0,Unknown
1933-02-27 00:00:00,Flugdienst Breslau - Wilhelm Przibilla,Flight,Business,Poland,Europe,1,1,1,0,0,1,0,Technical Failure
1933-03-20 00:00:00,Hellenic Air Force - Elleniki Polemiki Aeroporia,Landing (descent or approach),Operational,Greece,Europe,2,2,1,0,0,1,1,Unknown
1933-04-03 00:00:00,Deutsche Lufthansa,Flight,Operational,Germany,Europe,2,2,1,0,0,1,1,Unknown
1933-04-12 00:00:00,Edward William Lancaster,Flight,Business,Algeria,Africa,1,1,1,0,0,1,0,Technical Failure
1933-04-15 00:00:00,Selkhozaviatsiya,Flight,Specialised Services,Russia,Asia,2,2,1,0,0,1,1,Human Factor
1933-04-23 00:00:00,Eric C. Peacock,Flight,Business,United Kingdom,Europe,2,1,0,1,1,1,1,Unknown
1933-04-30 00:00:00,Devonshire Aviation Tours,Takeoff (climb),Business,United Kingdom,Europe,3,1,0,2,1,1,2,Human Factor
1933-05-02 00:00:00,Det Danske Luftfartselskab - DDL,Landing (descent or approach),Operational,Germany,Europe,2,2,1,0,0,1,1,Weather
1933-05-11 00:00:00,Aeroflot - Russian International Airlines,Flight,Commercial,Russia,Asia,4,2,1,2,0,1,3,Human Factor
1933-05-19 00:00:00,Royal Air Force - RAF,Landing (descent or approach),Operational,United Kingdom,Europe,2,2,1,0,0,1,1,Human Factor
1933-05-19 00:00:00,Royal Air Force - RAF,Landing (descent or approach),Operational,United Kingdom,Europe,1,1,1,0,0,1,0,Human Factor
1933-06-01 00:00:00,Gravesend School of Flying,Flight,Business,United Kingdom,Europe,1,1,1,0,0,1,0,Unknown
1933-06-03 00:00:00,Paraguay Air Force - Fuerza Aérea Paraguaya,Flight,Military / Government,Paraguay,South America,1,1,1,0,0,1,0,Terrorism
1933-06-04 00:00:00,Eastern Air Transport,Flight,Operational,United States of America,North America,1,1,1,0,0,1,0,Technical Failure
1933-06-22 00:00:00,Aerial Transport Company,Flight,Operational,Thailand,Asia,1,1,1,0,0,1,0,Technical Failure
1933-06-27 00:00:00,Aeroflot - Russian International Airlines,Flight,Operational,Russia,Asia,1,1,1,0,0,1,0,Human Factor
1933-07-01 00:00:00,Regia Aeronautica,Landing (descent or approach),Military / Government,Netherlands,Europe,5,5,1,0,0,1,4,Human Factor
1933-07-11 00:00:00,Cardiff %26 Peacock Airlines,Flight,Commercial,United States of America,North America,1,1,1,0,0,1,0,Technical Failure
1933-07-25 00:00:00,Royal Air Force - RAF,Flight,Operational,Yemen,Asia,1,1,1,0,0,1,0,Unknown
1933-07-28 00:00:00,Transcontinental %26 Western Air - TWA,Takeoff (climb),Operational,United States of America,North America,1,1,1,0,0,1,0,Technical Failure
1933-08-06 00:00:00,Carl Nauer,Flight,Business,Democratic Republic of Congo,Africa,1,1,1,0,0,1,0,Unknown
1933-08-08 00:00:00,Regia Aeronautica,Takeoff (climb),Military / Government,Portugal,Europe,4,4,1,0,0,1,3,Unknown
1933-08-19 00:00:00,Skyloft,Flight,Business,United States of America,North America,1,1,1,0,0,1,0,Weather
1933-08-25 00:00:00,Selkhozaviatsiya,Landing (descent or approach),Military / Government,Russia,Asia,2,1,1,1,0,1,1,Human Factor
1933-09-16 00:00:00,United Airlines,Flight,Operational,United States of America,North America,1,1,1,0,0,1,0,Weather
1933-09-16 00:00:00,Royal Air Force - RAF,Takeoff (climb),Military / Government,United Kingdom,Europe,5,5,1,0,0,1,4,Unknown
1933-09-24 00:00:00,Winnipeg Flying Club,Flight,Operational,Canada,North America,2,1,0,1,1,1,1,Unknown
1933-09-28 00:00:00,Rollason Aviation,Flight,Operational,United Kingdom,Europe,1,1,1,0,0,1,0,Human Factor
1933-10-15 00:00:00,Rabaul Airways,Flight,Commercial,Papua New Guinea,Oceania,3,1,0,2,1,1,2,Human Factor
1933-10-21 00:00:00,Boulton %26 Paul Industry,Takeoff (climb),Specialised Services,United Kingdom,Europe,1,1,1,0,0,1,0,Unknown
1933-10-25 00:00:00,Dr. R. Schien,Flight,Business,Switzerland,Europe,1,1,1,0,0,1,0,Unknown
1933-11-28 00:00:00,Mexican Air Force - Fuerza Aérea Mexicana,Flight,Operational,Mexico,Central America,1,1,1,0,0,1,0,Human Factor
1933-11-28 00:00:00,Mexican Air Force - Fuerza Aérea Mexicana,Flight,Operational,Mexico,Central America,1,1,1,0,0,1,0,Human Factor
1933-12-04 00:00:00,Brazilian Air Force - Aviação Militar,Flight,Operational,Brazil,South America,2,2,1,0,0,1,1,Unknown
1933-12-05 00:00:00,Mary du Caurroy,Flight,Business,United Kingdom,Europe,2,1,1,1,0,1,1,Human Factor
1933-12-24 00:00:00,Hawkes Bay %26 East Coast Aero Club,Takeoff (climb),Business,New Zealand,Oceania,1,1,1,0,0,1,0,Unknown
1933-12-31 00:00:00,Yugoslav Navy - Jugoslavenska Ratna Mornarica,Flight,Operational,Montenegro,Europe,1,1,1,0,0,1,0,Human Factor
1934-01-05 00:00:00,Evelyn Frost,Flight,Business,France,Europe,2,1,0,1,1,1,1,Human Factor
1934-01-14 00:00:00,Toronto Flying Club,Takeoff (climb),Operational,Canada,North America,2,2,1,0,0,1,1,Human Factor
1934-02-05 00:00:00,Selkhozaviatsiya,Flight,Commercial,Kazakhstan,Asia,3,1,1,2,0,1,2,Human Factor
1934-02-12 00:00:00,American Airlines,Takeoff (climb),Commercial,United States of America,North America,4,1,1,3,0,1,3,Human Factor
1934-02-22 00:00:00,Portuguese Air Force - Aeronáutica Militar,Flight,Operational,Portugal,Europe,1,1,1,0,0,1,0,Human Factor
1934-02-23 00:00:00,United States Army Air Corps - USAAC,Flight,Military / Government,United States of America,North America,3,3,1,0,0,1,2,Unknown
1934-02-26 00:00:00,Air France,Flight,Commercial,Western Sahara,Africa,7,2,1,5,0,1,6,Technical Failure
1934-03-05 00:00:00,Morgan Air Lines,Takeoff (climb),Commercial,Honduras,Central America,12,2,0,10,1,1,11,Unknown
1934-03-09 00:00:00,United States Army Air Corps - USAAC,Takeoff (climb),Military / Government,United States of America,North America,3,3,1,0,0,1,2,Unknown
1934-03-24 00:00:00,Herts %26 Essex Aero Club,Takeoff (climb),Business,United Kingdom,Europe,2,1,0,1,1,1,1,Human Factor
1934-05-18 00:00:00,Aeroflot - Russian International Airlines,Flight,Operational,Russia,Asia,1,1,1,0,0,1,0,Human Factor
1934-05-24 00:00:00,Mackenzie Air Service,Takeoff (climb),Commercial,Canada,North America,3,1,0,2,1,1,2,Unknown
1934-05-29 00:00:00,Austrian Air Force - Österreichische Luftstreitkräfte,Flight,Operational,Austria,Europe,1,1,1,0,0,1,0,Unknown
1934-06-06 00:00:00,Aeroflot - Russian International Airlines,Flight,Operational,Russia,Asia,1,1,1,0,0,1,0,Human Factor
1934-06-10 00:00:00,Selkhozaviatsiya,Flight,Commercial,Russia,Asia,2,1,1,1,0,1,1,Human Factor
1934-06-10 00:00:00,Aeroflot - Russian International Airlines,Flight,Operational,Russia,Asia,1,1,1,0,0,1,0,Human Factor
1934-06-16 00:00:00,Norman Edgar,Landing (descent or approach),Business,United Kingdom,Europe,3,1,0,2,1,1,2,Human Factor
1934-06-22 00:00:00,Deutsche Lufthansa,Flight,Commercial,Germany,Europe,6,2,0,4,1,1,5,Weather
1934-06-23 00:00:00,Aerovias Centrales,Landing (descent or approach),Operational,United States of America,North America,1,1,1,0,0,1,0,Weather
1934-06-23 00:00:00,Herts %26 Essex Aero Club,Flight,Business,United Kingdom,Europe,2,1,0,1,1,1,1,Unknown
1934-06-23 00:00:00,I. J. Bishop,Flight,Operational,Australia,Oceania,1,1,1,0,0,1,0,Human Factor
1934-06-23 00:00:00,Royal Aero Club of South Australia,Flight,Operational,Australia,Oceania,1,1,1,0,0,1,0,Human Factor
1934-06-24 00:00:00,Scarborough Aero Club,Flight,Business,United Kingdom,Europe,1,1,1,0,0,1,0,Unknown
1934-06-30 00:00:00,National Aviation Day,Flight,Operational,United Kingdom,Europe,1,1,1,0,0,1,0,Technical Failure
1934-07-04 00:00:00,Turkish Air Force - Türk Hava Kuvvetleri,Flight,Operational,Turkey,Asia,1,1,1,0,0,1,0,Unknown
1934-07-06 00:00:00,Royal Air Force - RAF,Landing (descent or approach),Operational,United Kingdom,Europe,5,5,1,0,0,1,4,Human Factor
1934-07-13 00:00:00,Private Hungarian,Flight,Operational,Hungary,Europe,1,1,1,0,0,1,0,Unknown
1934-07-17 00:00:00,Royal Air Force - RAF,Landing (descent or approach),Operational,Malta,Europe,2,2,1,0,0,1,1,Human Factor
1934-07-17 00:00:00,Spanish Air Force - Aeronáutica Militar,Flight,Operational,Spain,Europe,1,1,1,0,0,1,0,Unknown
1934-07-21 00:00:00,Australian Aero Club,Flight,Operational,Australia,Oceania,1,1,1,0,0,1,0,Unknown
1934-07-24 00:00:00,Argentinian Navy - Armada Argentina,Flight,Operational,Argentina,South America,3,3,1,0,0,1,2,Unknown
1934-08-10 00:00:00,China National Aviation Corporation - CNAC,Flight,Commercial,China,Asia,0,0,1,0,0,1,-1,Unknown
1934-08-20 00:00:00,Escuela de Aviación Militar,Landing (descent or approach),Operational,Argentina,South America,2,2,1,0,0,1,1,Unknown
1934-08-23 00:00:00,David Dear,Flight,Business,Tanzania,Africa,1,1,1,0,0,1,0,Unknown
1934-08-30 00:00:00,Royal Netherlands East Indies Air Force - ML-KNIL,Flight,Operational,Indonesia,Asia,1,1,1,0,0,1,0,Unknown
1934-09-16 00:00:00,United States Army Air Corps - USAAC,Takeoff (climb),Operational,United States of America,North America,5,5,1,0,0,1,4,Unknown
1934-10-10 00:00:00,Alaska Southern Airways,Flight,Commercial,United States of America,North America,4,1,0,3,1,1,3,Unknown
1934-10-15 00:00:00,Hansa Luftbild,Flight,Specialised Services,Germany,Europe,2,1,1,1,0,1,1,Unknown
1934-10-18 00:00:00,Belgian Air Force - Force Aérienne Belge - Belgische Luchtmacht,Flight,Operational,Belgium,Europe,8,2,1,6,0,1,7,Human Factor
1934-10-31 00:00:00,SCADTA - Sociedad Colombo-Alemana de Transportes Aéreos,Flight,Operational,Colombia,South America,1,1,1,0,0,1,0,Technical Failure
1934-11-04 00:00:00,MacRobertson Miller Airlines,Landing (descent or approach),Commercial,Australia,Oceania,2,1,0,1,1,1,1,Unknown
1934-11-15 00:00:00,Aeroflot - Russian International Airlines,Flight,Operational,Russia,Asia,1,1,1,0,0,1,0,Human Factor
1934-11-18 00:00:00,Bombay Flying Club,Landing (descent or approach),Operational,India,Asia,2,2,1,0,0,1,1,Unknown
1934-11-23 00:00:00,Geoffrey H. Turner,Flight,Business,United Kingdom,Europe,1,1,1,0,0,1,0,Human Factor
1934-11-24 00:00:00,Otago Aero Club,Flight,Commercial,New Zealand,Oceania,2,1,0,1,1,1,1,Unknown
1934-11-28 00:00:00,M. A. Scott,Flight,Operational,New Zealand,Oceania,1,1,1,0,0,1,0,Human Factor
1934-12-03 00:00:00,Benigno Serrato García,Flight,Military / Government,Mexico,Central America,4,2,0,2,1,1,3,Technical Failure
1934-12-03 00:00:00,Bengal Flying Club,Takeoff (climb),Operational,India,Asia,1,1,1,0,0,1,0,Unknown
1934-12-08 00:00:00,Braniff Airways,Flight,Operational,United States of America,North America,1,1,1,0,0,1,0,Weather
1934-12-09 00:00:00,Midland Aero Club,Landing (descent or approach),Business,United Kingdom,Europe,1,1,1,0,0,1,0,Human Factor
1934-12-22 00:00:00,American Airlines,Flight,Operational,United States of America,North America,1,1,1,0,0,1,0,Technical Failure
1935-01-19 00:00:00,Canterbury Aero Club,Flight,Business,New Zealand,Oceania,2,1,1,1,0,1,1,Human Factor
1935-01-26 00:00:00,Transcontinental %26 Western Air - TWA,Takeoff (climb),Operational,United States of America,North America,1,1,1,0,0,1,0,Weather
1935-03-28 00:00:00,Private British,Takeoff (climb),Business,India,Asia,2,1,0,1,1,1,1,Unknown
1935-04-01 00:00:00,Air France,Flight,Operational,France,Europe,3,2,1,1,0,1,2,Other
1935-04-24 00:00:00,Newcastle upon Tyne Light Aeroplane Club,Flight,Business,United Kingdom,Europe,2,1,0,1,1,1,1,Human Factor
1935-04-25 00:00:00,Deutsche Lufthansa,,Commercial,Germany,Europe,1,1,1,0,0,1,0,Unknown
1935-05-01 00:00:00,Varney Air Transport - VAT,Flight,Operational,United States of America,North America,1,1,1,0,0,1,0,Human Factor
1935-05-07 00:00:00,Private Guatemalan,Flight,Operational,Guatemala,Central America,2,2,1,0,0,1,1,Unknown
1935-05-27 00:00:00,Wyoming Air Service,Flight,Operational,United States of America,North America,1,1,1,0,0,1,0,Human Factor
1935-06-13 00:00:00,French Air Force - Armée de l'Air,Landing (descent or approach),Military / Government,France,Europe,5,5,1,0,0,1,4,Human Factor
1935-07-03 00:00:00,Cobham Air Routes,Flight,Commercial,United Kingdom,Europe,2,1,1,1,0,1,1,Technical Failure
1935-07-10 00:00:00,Hellenic Air Force - Elleniki Polemiki Aeroporia,Flight,Operational,Greece,Europe,1,1,1,0,0,1,0,Unknown
1935-07-20 00:00:00,Australian Aero Club,Landing (descent or approach),Operational,Australia,Oceania,1,1,1,0,0,1,0,Human Factor
1935-07-20 00:00:00,Air Transport %26 Sales,Flight,Operational,United Kingdom,Europe,1,1,1,0,0,1,0,Human Factor
1935-07-21 00:00:00,Private New Zealand,Flight,Business,New Zealand,Oceania,1,1,1,0,0,1,0,Human Factor
1935-09-08 00:00:00,National Air Transport - Canada,Flight,Commercial,Canada,North America,1,1,1,0,0,1,0,Technical Failure
1935-09-30 00:00:00,WR Carpenter %26 Company,Flight,Operational,Papua New Guinea,Oceania,1,1,1,0,0,1,0,Unknown
1935-10-21 00:00:00,Chamberlin Flying Service,Landing (descent or approach),Commercial,United States of America,North America,6,2,1,4,0,1,5,Human Factor
1935-11-09 00:00:00,Braniff Airways,Takeoff (climb),Operational,United States of America,North America,1,1,1,0,0,1,0,Unknown
1935-12-04 00:00:00,Air Bleu,Landing (descent or approach),Operational,France,Europe,2,2,1,0,0,1,1,Human Factor
1935-12-18 00:00:00,KLM Royal Dutch Airlines - Koninklijke Luchtvaart Maatschappij,Landing (descent or approach),Operational,Netherlands,Europe,1,1,1,0,0,1,0,Human Factor
1936-01-29 00:00:00,American Airlines,Landing (descent or approach),Commercial,United States of America,North America,6,1,0,5,1,1,5,Weather
1936-02-19 00:00:00,Union Airways,Landing (descent or approach),Commercial,New Zealand,Oceania,2,1,0,1,1,1,1,Human Factor
1936-04-21 00:00:00,Private British,Flight,Business,United Kingdom,Europe,1,1,1,0,0,1,0,Human Factor
1936-04-26 00:00:00,Nederlands-Indische Vliegclub,Takeoff (climb),Operational,Indonesia,Asia,2,2,1,0,0,1,1,Human Factor
1936-05-08 00:00:00,Air France,Flight,Commercial,World,World,8,4,0,4,1,1,7,Human Factor
1936-05-16 00:00:00,Holyman's Airways,Flight,Operational,Australia,Oceania,1,1,1,0,0,1,0,Human Factor
1936-06-09 00:00:00,Aktiebolaget Aerotransport - ABA,Takeoff (climb),Commercial,Sweden,Europe,13,3,0,10,1,1,12,Human Factor
1936-06-13 00:00:00,Deutsche Lufthansa,Flight,Commercial,Germany,Europe,6,2,0,4,1,1,5,Technical Failure
1936-07-03 00:00:00,Erprobungstelle,Flight,Business,Netherlands,Europe,4,4,1,0,0,1,3,Unknown
1936-07-19 00:00:00,Spanish Nationalist Air Force,Takeoff (climb),Military / Government,Portugal,Europe,2,1,0,1,1,1,1,Unknown
1936-08-03 00:00:00,Mexicana de Aviación,Flight,Operational,Mexico,Central America,1,1,1,0,0,1,0,Unknown
1936-08-04 00:00:00,Austrian Air Force - Österreichische Luftstreitkräfte,Landing (descent or approach),Operational,Austria,Europe,1,1,1,0,0,1,0,Unknown
1936-08-07 00:00:00,Private British,Takeoff (climb),Operational,United Kingdom,Europe,1,1,1,0,0,1,0,Unknown
1936-08-20 00:00:00,Airspeed Ltd,Takeoff (climb),Operational,United Kingdom,Europe,2,2,1,0,0,1,1,Human Factor
1936-08-29 00:00:00,Private South African,Flight,Operational,South Africa,Africa,2,2,1,0,0,1,1,Human Factor
1936-09-03 00:00:00,Austrian Air Force - Österreichische Luftstreitkräfte,Flight,Operational,Austria,Europe,1,1,1,0,0,1,0,Unknown
1936-10-06 00:00:00,Mexicana de Aviación,Flight,Operational,Mexico,Central America,1,1,1,0,0,1,0,Unknown
1936-10-09 00:00:00,North Sea Aerial %26 General Transport,Flight,Operational,United Kingdom,Europe,1,1,1,0,0,1,0,Unknown
1936-10-19 00:00:00,Spanish Air Force - Ejército del Aire,Flight,Other,Spain,Europe,1,1,1,0,0,1,0,Terrorism
1936-11-03 00:00:00,Harita,Flight,Commercial,Turkey,Asia,2,2,1,0,0,1,1,Unknown
1936-11-09 00:00:00,Royal Air Force - RAF,Takeoff (climb),Operational,United Kingdom,Europe,3,3,1,0,0,1,2,Human Factor
1936-12-01 00:00:00,LOT Polish Airlines - Polskie Linie Lotnicze,Landing (descent or approach),Commercial,Greece,Europe,7,2,1,5,0,1,6,Human Factor
1936-12-03 00:00:00,Private Dutch,Landing (descent or approach),Business,Netherlands,Europe,1,1,1,0,0,1,0,Human Factor
1936-12-05 00:00:00,United States Coast Guard - USCG,Takeoff (climb),Humanitarian,United States of America,North America,3,2,1,1,0,1,2,Unknown
1936-12-09 00:00:00,Royal Australian Air Force - RAAF,Landing (descent or approach),Operational,Australia,Oceania,1,1,1,0,0,1,0,Human Factor
1936-12-30 00:00:00,Southland Airways,Landing (descent or approach),Commercial,New Zealand,Oceania,5,1,0,4,1,1,4,Unknown
1937-01-13 00:00:00,Nicaragua Atlantic Coast Airways,Flight,Operational,Nicaragua,Central America,1,1,1,0,0,1,0,Unknown
1937-01-19 00:00:00,North Queensland Airways,Flight,Commercial,Australia,Oceania,3,1,0,2,1,1,2,Human Factor
1937-01-21 00:00:00,Plane Advertising,Flight,Operational,United Kingdom,Europe,2,2,1,0,0,1,1,Technical Failure
1937-03-23 00:00:00,Mary du Caurroy,Flight,Business,World,World,1,1,1,0,0,1,0,Unknown
1937-04-19 00:00:00,Royal Air Force - RAF,Takeoff (climb),Specialised Services,United Kingdom,Europe,2,2,1,0,0,1,1,Technical Failure
1937-05-27 00:00:00,Royal Norwegian Air Force - Kongelige Norske Luftforsvaret,Flight,Operational,Norway,Europe,1,1,1,0,0,1,0,Weather
1937-05-29 00:00:00,Irish Aero Club,Flight,Business,Ireland,Europe,1,1,1,0,0,1,0,Unknown
1937-06-04 00:00:00,Private German,Flight,Business,Germany,Europe,1,1,1,0,0,1,0,Unknown
1937-06-06 00:00:00,Wideroe - Wideroe's Flyveselskap,Flight,Commercial,Norway,Europe,2,1,0,1,1,1,1,Unknown
1937-06-16 00:00:00,South African Airways -SAA - Suid Afrikaanse Lugdiens - SAL,Takeoff (climb),Commercial,South Africa,Africa,0,0,0,0,1,1,-1,Technical Failure
1937-06-18 00:00:00,Royal Air Force - RAF,Flight,Operational,United Kingdom,Europe,2,2,1,0,0,1,1,Unknown
1937-06-19 00:00:00,Royal Queensland Aero Club,Flight,Operational,Australia,Oceania,1,1,1,0,0,1,0,Human Factor
1937-06-19 00:00:00,Royal Queensland Aero Club,Flight,Operational,Australia,Oceania,1,1,1,0,0,1,0,Human Factor
1937-08-01 00:00:00,Nederlands-Indische Vliegclub,Landing (descent or approach),Operational,Indonesia,Asia,2,2,1,0,0,1,1,Unknown
1937-08-05 00:00:00,Japan Air Transport,Takeoff (climb),Operational,Japan,Asia,0,0,1,0,0,1,-1,Unknown
1937-09-11 00:00:00,German Air Force - Deutsche Luftwaffe,Flight,Military / Government,Czech Republic,Europe,4,1,1,3,0,1,3,Human Factor
1937-12-03 00:00:00,Manawatu Aero Club,Takeoff (climb),Business,New Zealand,Oceania,2,2,1,0,0,1,1,Human Factor
1937-12-23 00:00:00,Redhill Flying Club,Flight,Operational,United Kingdom,Europe,1,1,1,0,0,1,0,Unknown
1938-01-12 00:00:00,General Airways,Flight,Commercial,Canada,North America,1,1,1,0,0,1,0,Technical Failure
1938-01-16 00:00:00,Private French,Flight,Business,Iran,Asia,1,1,1,0,0,1,0,Unknown
1938-01-24 00:00:00,Royal Air Force - RAF,Landing (descent or approach),Operational,United Kingdom,Europe,4,4,1,0,0,1,3,Human Factor
1938-02-06 00:00:00,Junkers Flugzeug %26 Motorenwerke,Flight,Specialised Services,Germany,Europe,3,3,1,0,0,1,2,Technical Failure
1938-03-04 00:00:00,Sociedad Ecuatoriana de Transportes Aéreos - SEDTA,Flight,Operational,Ecuador,South America,1,1,1,0,0,1,0,Unknown
1938-03-08 00:00:00,Australian National Airways - ANA,Flight,Operational,Australia,Oceania,1,1,1,0,0,1,0,Human Factor
1938-05-05 00:00:00,Lineas Aéreas Mineras - LAMSA,Takeoff (climb),Business,Mexico,Central America,6,1,1,5,0,1,5,Human Factor
1938-06-02 00:00:00,Royal Canadian Air Force - RCAF,Flight,Operational,Canada,North America,2,2,1,0,0,1,1,Unknown
1938-06-25 00:00:00,Blackpool %26 West Coast Air Service,Landing (descent or approach),Commercial,United Kingdom,Europe,7,1,1,6,0,1,6,Unknown
1938-07-08 00:00:00,Northwest Airlines,Takeoff (climb),Commercial,United States of America,North America,10,2,0,8,1,1,9,Human Factor
1938-08-07 00:00:00,Hellenic Air Force - Elleniki Polemiki Aeroporia,Flight,Operational,Greece,Europe,2,2,1,0,0,1,1,Unknown
1938-09-13 00:00:00,Royal Air Force - RAF,Flight,Operational,United Kingdom,Europe,1,1,1,0,0,1,0,Unknown
1938-10-16 00:00:00,Royal Australian Air Force - RAAF,Flight,Operational,Australia,Oceania,1,1,1,0,0,1,0,Human Factor
1938-10-20 00:00:00,Private American,Flight,Business,United States of America,North America,1,1,1,0,0,1,0,Unknown
1938-12-13 00:00:00,United Air Services - USA,Landing (descent or approach),Specialised Services,United States of America,North America,3,1,0,2,1,1,2,Unknown
1939-02-21 00:00:00,Royal Air Force - RAF,Takeoff (climb),Operational,United Kingdom,Europe,3,3,1,0,0,1,2,Unknown
1939-02-23 00:00:00,Indian National Airways - INA,Flight,Operational,Pakistan,Asia,1,1,1,0,0,1,0,Unknown
1939-04-03 00:00:00,French Government,Takeoff (climb),Operational,Madagascar,Africa,2,2,1,0,0,1,1,Technical Failure
1939-04-25 00:00:00,Isle of Man Air Services,Landing (descent or approach),Military / Government,United Kingdom,Europe,5,2,0,3,1,1,4,Human Factor
1939-05-12 00:00:00,Private Australian,Flight,Operational,Australia,Oceania,2,2,1,0,0,1,1,Human Factor
1939-06-11 00:00:00,Royal Victorian Aero Club,Takeoff (climb),Business,Australia,Oceania,2,1,1,1,0,1,1,Human Factor
1939-06-15 00:00:00,United Air Transport,Landing (descent or approach),Commercial,United States of America,North America,1,1,1,0,0,1,0,Human Factor
1939-07-26 00:00:00,Royal Air Force - RAF,Flight,Military / Government,United Kingdom,Europe,4,4,1,0,0,1,3,Human Factor
1939-08-01 00:00:00,Royal Air Force - RAF,Flight,Operational,United Kingdom,Europe,1,1,1,0,0,1,0,Human Factor
1939-08-21 00:00:00,Isle of Wight Flying Club,Takeoff (climb),Business,United Kingdom,Europe,2,1,1,1,0,1,1,Unknown
1939-08-29 00:00:00,Royal Air Force - RAF,Takeoff (climb),Operational,United Kingdom,Europe,6,6,1,0,0,1,5,Technical Failure
1939-09-09 00:00:00,Royal Air Force - RAF,Flight,Military / Government,France,Europe,3,3,1,0,0,1,2,Technical Failure
1939-09-12 00:00:00,Royal Air Force - RAF,Landing (descent or approach),Operational,United Kingdom,Europe,1,1,1,0,0,1,0,Human Factor
1939-09-18 00:00:00,Royal Air Force - RAF,Flight,Operational,United Kingdom,Europe,1,1,1,0,0,1,0,Unknown
1939-09-19 00:00:00,Royal Air Force - RAF,Landing (descent or approach),Operational,United Kingdom,Europe,2,2,1,0,0,1,1,Human Factor
1939-10-11 00:00:00,Royal Air Force - RAF,Landing (descent or approach),Operational,United Kingdom,Europe,1,1,1,0,0,1,0,Human Factor
1939-10-15 00:00:00,Royal Air Force - RAF,Flight,Operational,United Kingdom,Europe,5,5,1,0,0,1,4,Technical Failure
1939-10-16 00:00:00,Royal Air Force - RAF,Flight,Military / Government,Germany,Europe,5,5,1,0,0,1,4,Terrorism
1939-10-31 00:00:00,Royal Air Force - RAF,Flight,Operational,United Kingdom,Europe,1,1,1,0,0,1,0,Human Factor
1939-12-18 00:00:00,Royal Air Force - RAF,Flight,Military / Government,World,World,5,5,1,0,0,1,4,Terrorism
1940-01-25 00:00:00,Canadian Airways,Takeoff (climb),Operational,Canada,North America,1,1,1,0,0,1,0,Technical Failure
1940-03-02 00:00:00,Royal Air Force - RAF,Flight,Military / Government,United Kingdom,Europe,4,4,1,0,0,1,3,Weather
1940-03-28 00:00:00,Royal Air Force - RAF,Flight,Military / Government,Netherlands,Europe,5,5,1,0,0,1,4,Terrorism
1940-03-28 00:00:00,Royal Air Force - RAF,Flight,Military / Government,Germany,Europe,5,5,1,0,0,1,4,Terrorism
1940-04-09 00:00:00,German Air Force - Deutsche Luftwaffe,Landing (descent or approach),Military / Government,Norway,Europe,5,5,1,0,0,1,4,Terrorism
1940-04-14 00:00:00,German Air Force - Deutsche Luftwaffe,Flight,Military / Government,Norway,Europe,15,3,0,12,1,1,14,Terrorism
1940-04-18 00:00:00,Royal Air Force - RAF,Flight,Military / Government,World,World,5,5,1,0,0,1,4,Unknown
1940-04-30 00:00:00,Royal Air Force - RAF,Flight,Military / Government,Norway,Europe,5,5,1,0,0,1,4,Terrorism
1940-04-30 00:00:00,Royal Air Force - RAF,Flight,Military / Government,United Kingdom,Europe,5,5,1,0,0,1,4,Technical Failure
1940-05-03 00:00:00,Royal Air Force - RAF,Flight,Military / Government,United Kingdom,Europe,5,5,1,0,0,1,4,Technical Failure
1940-05-20 00:00:00,Royal Air Force - RAF,Flight,Military / Government,Netherlands,Europe,5,5,1,0,0,1,4,Unknown
1940-05-23 00:00:00,SABENA - Société Anonyme Belge d'Exploitation de la Navigation Aérienne,Flight,Operational,France,Europe,3,3,1,0,0,1,2,Terrorism
1940-06-01 00:00:00,German Air Force - Deutsche Luftwaffe,Flight,Military / Government,France,Europe,5,5,1,0,0,1,4,Terrorism
1940-06-16 00:00:00,Royal Air Force - RAF,Flight,Military / Government,United Kingdom,Europe,4,4,1,0,0,1,3,Human Factor
1940-06-20 00:00:00,Air France,Flight,Military / Government,France,Europe,3,3,1,0,0,1,2,Terrorism
1940-06-21 00:00:00,Royal New Zealand Air Force - RNZAF,Takeoff (climb),Operational,New Zealand,Oceania,3,3,1,0,0,1,2,Unknown
1940-06-26 00:00:00,German Air Force - Deutsche Luftwaffe,Flight,Military / Government,United Kingdom,Europe,4,4,1,0,0,1,3,Terrorism
1940-07-06 00:00:00,Royal Air Force - RAF,Flight,Military / Government,Netherlands,Europe,5,5,1,0,0,1,4,Terrorism
1940-07-08 00:00:00,Royal Air Force - RAF,Flight,Specialised Services,United Kingdom,Europe,1,1,1,0,0,1,0,Unknown
1940-07-14 00:00:00,Royal Air Force - RAF,Landing (descent or approach),Military / Government,Egypt,Africa,0,0,1,0,0,1,-1,Unknown
1940-08-07 00:00:00,Royal New Zealand Air Force - RNZAF,Takeoff (climb),Operational,New Zealand,Oceania,1,1,1,0,0,1,0,Unknown
1940-08-15 00:00:00,Royal Air Force - RAF,Takeoff (climb),Military / Government,United Kingdom,Europe,2,2,1,0,0,1,1,Technical Failure
1940-08-15 00:00:00,German Air Force - Deutsche Luftwaffe,Flight,Military / Government,United Kingdom,Europe,4,4,1,0,0,1,3,Terrorism
1940-08-17 00:00:00,Royal Air Force - RAF,Takeoff (climb),Operational,United Kingdom,Europe,1,1,1,0,0,1,0,Unknown
1940-08-23 00:00:00,Royal Air Force - RAF,Flight,Military / Government,United Kingdom,Europe,6,6,1,0,0,1,5,Human Factor
1940-08-31 00:00:00,Royal Air Force - RAF,Flight,Military / Government,United Kingdom,Europe,5,5,1,0,0,1,4,Technical Failure
1940-09-15 00:00:00,Royal Air Force - RAF,Takeoff (climb),Military / Government,United Kingdom,Europe,4,4,1,0,0,1,3,Unknown
1940-10-15 00:00:00,Royal Air Force - RAF,Landing (descent or approach),Military / Government,United Kingdom,Europe,5,5,1,0,0,1,4,Human Factor
1940-10-16 00:00:00,Royal Air Force - RAF,Flight,Operational,United Kingdom,Europe,1,1,1,0,0,1,0,Human Factor
1940-10-17 00:00:00,Royal Air Force - RAF,Flight,Military / Government,Germany,Europe,6,6,1,0,0,1,5,Terrorism
1940-10-30 00:00:00,Royal Air Force - RAF,Landing (descent or approach),Military / Government,United Kingdom,Europe,5,5,1,0,0,1,4,Weather
1940-11-04 00:00:00,Royal Air Force - RAF,Flight,Operational,United Kingdom,Europe,1,1,1,0,0,1,0,Human Factor
1940-11-08 00:00:00,Shell-Mex Argentina,Landing (descent or approach),Business,Brazil,South America,1,1,1,0,0,1,0,Human Factor
1940-11-14 00:00:00,Royal Air Force - RAF,Flight,Operational,United Kingdom,Europe,1,1,1,0,0,1,0,Human Factor
1940-11-14 00:00:00,Royal New Zealand Air Force - RNZAF,Flight,Operational,New Zealand,Oceania,1,1,1,0,0,1,0,Human Factor
1940-11-29 00:00:00,Royal Air Force - RAF,Takeoff (climb),Operational,United Kingdom,Europe,1,1,1,0,0,1,0,Unknown
1940-12-16 00:00:00,Royal Air Force - RAF,Landing (descent or approach),Military / Government,United Kingdom,Europe,5,5,1,0,0,1,4,Technical Failure
1940-12-22 00:00:00,Royal Air Force - RAF,Takeoff (climb),Operational,United Kingdom,Europe,5,5,1,0,0,1,4,Unknown
1940-12-23 00:00:00,Royal Air Force - RAF,Landing (descent or approach),Military / Government,United Kingdom,Europe,5,5,1,0,0,1,4,Technical Failure
1941-01-05 00:00:00,Air Transport Auxiliary,Flight,Operational,United Kingdom,Europe,1,1,1,0,0,1,0,Weather
1941-01-07 00:00:00,Starratt Airways %26 Transportation,Flight,Operational,Canada,North America,1,1,1,0,0,1,0,Other
1941-01-23 00:00:00,Royal Air Force - RAF,Flight,Operational,United Kingdom,Europe,1,1,1,0,0,1,0,Technical Failure
1941-01-31 00:00:00,Royal New Zealand Air Force - RNZAF,Takeoff (climb),Operational,New Zealand,Oceania,1,1,1,0,0,1,0,Unknown
1941-02-06 00:00:00,Stephens Aviation,Flight,Operational,Papua New Guinea,Oceania,1,1,1,0,0,1,0,Unknown
1941-02-09 00:00:00,United States Navy - USN,Landing (descent or approach),Operational,United States of America,North America,0,0,1,0,0,1,-1,Unknown
1941-02-10 00:00:00,Royal Air Force - RAF,Flight,Military / Government,Netherlands,Europe,6,6,1,0,0,1,5,Terrorism
1941-02-17 00:00:00,Royal Air Force - RAF,Flight,Operational,United Kingdom,Europe,3,3,1,0,0,1,2,Unknown
1941-03-28 00:00:00,Royal Air Force - RAF,Flight,Military / Government,Netherlands,Europe,6,6,1,0,0,1,5,Unknown
1941-04-22 00:00:00,Colombian Air Force - Fuerza Aérea Colombiana,Landing (descent or approach),Military / Government,Colombia,South America,14,5,1,9,0,1,13,Technical Failure
1941-05-15 00:00:00,Royal New Zealand Air Force - RNZAF,Flight,Operational,New Zealand,Oceania,1,1,1,0,0,1,0,Human Factor
1941-05-26 00:00:00,Avro Aircraft,Landing (descent or approach),Specialised Services,United Kingdom,Europe,4,4,1,0,0,1,3,Unknown
1941-05-29 00:00:00,Royal New Zealand Air Force - RNZAF,Flight,Operational,New Zealand,Oceania,1,1,1,0,0,1,0,Unknown
1941-06-10 00:00:00,Swedish Air Force - Flygvapnet,Takeoff (climb),Military / Government,Sweden,Europe,3,3,1,0,0,1,2,Technical Failure
1941-06-20 00:00:00,Royal Australian Air Force - RAAF,Takeoff (climb),Military / Government,Australia,Oceania,5,1,1,4,0,1,4,Technical Failure
1941-06-21 00:00:00,Royal New Zealand Air Force - RNZAF,Takeoff (climb),Operational,New Zealand,Oceania,1,1,1,0,0,1,0,Technical Failure
1941-06-29 00:00:00,Royal Air Force - RAF,Flight,Operational,United Kingdom,Europe,2,2,1,0,0,1,1,Technical Failure
1941-07-22 00:00:00,Royal Air Force - RAF,Taxiing,Operational,United Kingdom,Europe,1,1,1,0,0,1,0,Unknown
1941-08-15 00:00:00,Colombian Air Force - Fuerza Aérea Colombiana,Takeoff (climb),Military / Government,Colombia,South America,15,2,1,13,0,1,14,Unknown
1941-09-07 00:00:00,Royal Air Force - RAF,Flight,Operational,United Kingdom,Europe,5,5,1,0,0,1,4,Human Factor
1941-09-08 00:00:00,Royal Air Force - RAF,Landing (descent or approach),Military / Government,United Kingdom,Europe,7,7,1,0,0,1,6,Terrorism
1941-09-14 00:00:00,Royal Air Force - RAF,Landing (descent or approach),Operational,United Kingdom,Europe,6,6,1,0,0,1,5,Technical Failure
1941-10-03 00:00:00,Aeroflot - Russian International Airlines,Takeoff (climb),Commercial,Russia,Asia,8,6,0,2,1,1,7,Other
1941-10-10 00:00:00,Northern Territory Medical Services,Takeoff (climb),Humanitarian,Australia,Oceania,3,1,0,2,1,1,2,Human Factor
1941-11-02 00:00:00,United States Army Air Forces - USAAF,Flight,Operational,United States of America,North America,9,9,1,0,0,1,8,Technical Failure
1941-11-02 00:00:00,German Air Force - Deutsche Luftwaffe,Flight,Military / Government,Norway,Europe,17,4,0,13,1,1,16,Unknown
1941-11-16 00:00:00,Royal Air Force - RAF,Flight,Operational,United Kingdom,Europe,1,1,1,0,0,1,0,Human Factor
1941-11-20 00:00:00,Royal New Zealand Air Force - RNZAF,Takeoff (climb),Operational,New Zealand,Oceania,1,1,1,0,0,1,0,Unknown
1941-11-29 00:00:00,Aeroflot - Russian International Airlines,Takeoff (climb),Specialised Services,Russia,Asia,4,4,1,0,0,1,3,Human Factor
1941-12-07 00:00:00,United States Army Air Forces - USAAF,Landing (descent or approach),Military / Government,United States of America,North America,8,8,1,0,0,1,7,Terrorism
1941-12-08 00:00:00,Royal Air Force - RAF,Flight,Military / Government,Egypt,Africa,2,2,0,0,1,1,1,Terrorism
1941-12-10 00:00:00,Royal Air Force - RAF,Flight,Military / Government,United Kingdom,Europe,1,1,1,0,0,1,0,Unknown
1941-12-11 00:00:00,Royal Air Force - RAF,Flight,Operational,United Kingdom,Europe,1,1,1,0,0,1,0,Unknown
1941-12-14 00:00:00,Royal Air Force - RAF,Landing (descent or approach),Military / Government,United Kingdom,Europe,1,1,1,0,0,1,0,Unknown
1941-12-27 00:00:00,United States Army Air Forces - USAAF,Flight,Military / Government,United States of America,North America,5,5,1,0,0,1,4,Unknown
1942-01-09 00:00:00,United States Army Air Forces - USAAF,Flight,Operational,United States of America,North America,1,1,1,0,0,1,0,Human Factor
1942-01-15 00:00:00,Royal Air Force - RAF,Flight,Military / Government,Germany,Europe,6,6,1,0,0,1,5,Terrorism
1942-01-29 00:00:00,Royal Air Force - RAF,Flight,Operational,United Kingdom,Europe,7,7,1,0,0,1,6,Weather
1942-02-06 00:00:00,United States Army Air Forces - USAAF,Flight,Operational,United States of America,North America,1,1,1,0,0,1,0,Unknown
1942-02-08 00:00:00,Air Transport Auxiliary,Flight,Operational,United Kingdom,Europe,1,1,1,0,0,1,0,Human Factor
1942-02-19 00:00:00,China National Aviation Corporation - CNAC,Flight,Commercial,China,Asia,0,0,0,0,1,1,-1,Unknown
1942-02-22 00:00:00,Aeroflot - Russian International Airlines,Takeoff (climb),Humanitarian,Russia,Asia,4,4,1,0,0,1,3,Human Factor
1942-02-22 00:00:00,Canadian Pacific Airlines - CP Air,Flight,Commercial,Canada,North America,3,1,0,2,1,1,2,Technical Failure
1942-03-14 00:00:00,United States Army Air Forces - USAAF,Flight,Military / Government,Australia,Oceania,8,8,1,0,0,1,7,Technical Failure
1942-04-06 00:00:00,United States Army Air Forces - USAAF,Flight,Military / Government,Papua New Guinea,Oceania,8,8,1,0,0,1,7,Terrorism
1942-04-20 00:00:00,Royal Air Force - RAF,Flight,Operational,United Kingdom,Europe,4,4,1,0,0,1,3,Human Factor
1942-04-24 00:00:00,Royal Air Force - RAF,Flight,Military / Government,Denmark,Europe,7,7,1,0,0,1,6,Technical Failure
1942-04-27 00:00:00,Royal Air Force - RAF,Flight,Military / Government,Belgium,Europe,3,3,1,0,0,1,2,Terrorism
1942-05-09 00:00:00,Royal Air Force - RAF,Flight,Military / Government,Denmark,Europe,7,7,1,0,0,1,6,Unknown
1942-05-13 00:00:00,United States Army Air Forces - USAAF,Landing (descent or approach),Military / Government,Papua New Guinea,Oceania,8,8,1,0,0,1,7,Terrorism
1942-05-17 00:00:00,Royal Air Force - RAF,Landing (descent or approach),Operational,United Kingdom,Europe,1,1,1,0,0,1,0,Unknown
1942-05-17 00:00:00,Royal Air Force - RAF,Landing (descent or approach),Operational,United Kingdom,Europe,1,1,1,0,0,1,0,Unknown
1942-05-24 00:00:00,Royal Australian Air Force - RAAF,Flight,Operational,Australia,Oceania,4,4,1,0,0,1,3,Human Factor
1942-05-31 00:00:00,Royal Air Force - RAF,Flight,Military / Government,Belgium,Europe,7,7,1,0,0,1,6,Terrorism
1942-06-10 00:00:00,Atlantic Airmotive,Takeoff (climb),Operational,United States of America,North America,1,1,1,0,0,1,0,Unknown
1942-06-19 00:00:00,Royal Air Force - RAF,Flight,Military / Government,United Kingdom,Europe,4,4,1,0,0,1,3,Technical Failure
1942-06-19 00:00:00,Aeroflot - Russian International Airlines,Takeoff (climb),Operational,Russia,Asia,4,4,1,0,0,1,3,Human Factor
1942-07-21 00:00:00,Royal Air Force - RAF,Flight,Operational,United Kingdom,Europe,1,1,1,0,0,1,0,Human Factor
1942-08-03 00:00:00,Royal Canadian Air Force - RCAF,Flight,Operational,Canada,North America,1,1,1,0,0,1,0,Weather
1942-08-13 00:00:00,United States Army Air Forces - USAAF,Flight,Military / Government,Papua New Guinea,Oceania,7,7,1,0,0,1,6,Terrorism
1942-09-03 00:00:00,Royal Air Force - RAF,Flight,Operational,United Kingdom,Europe,2,2,1,0,0,1,1,Human Factor
1942-09-13 00:00:00,United States Army Air Forces - USAAF,Landing (descent or approach),Military / Government,Australia,Oceania,8,8,1,0,0,1,7,Technical Failure
1942-09-18 00:00:00,United States Army Air Forces - USAAF,Flight,Military / Government,Australia,Oceania,9,9,1,0,0,1,8,Weather
1942-10-01 00:00:00,Royal Air Force - RAF,Flight,Operational,United Kingdom,Europe,5,5,1,0,0,1,4,Human Factor
1942-10-14 00:00:00,Royal Australian Air Force - RAAF,Flight,Military / Government,Australia,Oceania,3,3,1,0,0,1,2,Human Factor
1942-10-26 00:00:00,Royal Netherlands Navy - Marineluchtvaartdienst,Flight,Operational,United Kingdom,Europe,1,1,1,0,0,1,0,Unknown
1942-10-27 00:00:00,Royal Air Force - RAF,Flight,Operational,United Kingdom,Europe,4,4,1,0,0,1,3,Technical Failure
1942-11-04 00:00:00,United States Army Air Forces - USAAF,Flight,Military / Government,Australia,Oceania,7,7,1,0,0,1,6,Terrorism
1942-11-13 00:00:00,United States Navy - USN,Landing (descent or approach),Operational,United States of America,North America,8,8,1,0,0,1,7,Unknown
1942-11-15 00:00:00,Royal Air Force - RAF,Flight,Military / Government,United Kingdom,Europe,3,3,1,0,0,1,2,Human Factor
1942-11-26 00:00:00,United States Navy - USN,Landing (descent or approach),Military / Government,Australia,Oceania,9,9,1,0,0,1,8,Unknown
1942-11-28 00:00:00,Royal Air Force - RAF,Takeoff (climb),Operational,United Kingdom,Europe,1,1,1,0,0,1,0,Human Factor
1942-12-04 00:00:00,Royal Australian Air Force - RAAF,Landing (descent or approach),Military / Government,Australia,Oceania,5,5,1,0,0,1,4,Terrorism
1942-12-12 00:00:00,United States Army Air Forces - USAAF,Flight,Military / Government,United States of America,North America,0,0,1,0,0,1,-1,Unknown
1943-01-01 00:00:00,Royal Air Force - RAF,Flight,Operational,United Kingdom,Europe,5,5,1,0,0,1,4,Human Factor
1943-01-02 00:00:00,Royal Air Force - RAF,Flight,Operational,United Kingdom,Europe,6,6,1,0,0,1,5,Unknown
1943-01-03 00:00:00,Royal Air Force - RAF,Takeoff (climb),Operational,United Kingdom,Europe,1,1,1,0,0,1,0,Technical Failure
1943-01-16 00:00:00,United States Army Air Forces - USAAF,Flight,Military / Government,Trinidad and Tobago,Central America,0,0,1,0,0,1,-1,Unknown
1943-02-13 00:00:00,Aerovias Brasil,Flight,Commercial,Brazil,South America,2,2,1,0,0,1,1,Unknown
1943-03-03 00:00:00,Royal Air Force - RAF,Flight,Operational,United Kingdom,Europe,1,1,1,0,0,1,0,Human Factor
1943-03-09 00:00:00,United States Army Air Forces - USAAF,Flight,Military / Government,Australia,Oceania,8,8,1,0,0,1,7,Technical Failure
1943-03-18 00:00:00,Royal New Zealand Air Force - RNZAF,Takeoff (climb),Operational,New Zealand,Oceania,3,3,1,0,0,1,2,Technical Failure
1943-04-07 00:00:00,China National Aviation Corporation - CNAC,Flight,Operational,India,Asia,3,3,1,0,0,1,2,Human Factor
1943-04-16 00:00:00,United States Army Air Forces - USAAF,Flight,Operational,United States of America,North America,0,0,1,0,0,1,-1,Unknown
1943-04-22 00:00:00,Royal Canadian Air Force - RCAF,Landing (descent or approach),Operational,Canada,North America,1,1,1,0,0,1,0,Human Factor
1943-04-22 00:00:00,Royal Canadian Air Force - RCAF,Landing (descent or approach),Operational,Canada,North America,1,1,1,0,0,1,0,Human Factor
1943-04-24 00:00:00,Royal Air Force - RAF,Takeoff (climb),Military / Government,Algeria,Africa,6,6,1,0,0,1,5,Technical Failure
1943-04-27 00:00:00,United States Navy - USN,Flight,Military / Government,New Caledonia,Oceania,0,0,1,0,0,1,-1,Unknown
1943-05-01 00:00:00,United States Navy - USN,Landing (descent or approach),Operational,United States of America,North America,5,5,1,0,0,1,4,Unknown
1943-05-11 00:00:00,Aeroflot - Russian International Airlines,Takeoff (climb),Specialised Services,Russia,Asia,5,4,1,1,0,1,4,Human Factor
1943-05-12 00:00:00,United States Navy - USN,Flight,Operational,United States of America,North America,8,8,1,0,0,1,7,Unknown
1943-05-12 00:00:00,Royal Air Force - RAF,Flight,Operational,United Kingdom,Europe,1,1,1,0,0,1,0,Human Factor
1943-05-17 00:00:00,United States Army Air Forces - USAAF,Flight,Military / Government,Netherlands,Europe,6,6,1,0,0,1,5,Terrorism
1943-05-24 00:00:00,Aeroflot - Russian International Airlines,Takeoff (climb),Commercial,Russia,Asia,20,4,1,16,0,1,19,Human Factor
1943-06-02 00:00:00,Royal Air Force - RAF,Flight,Military / Government,United Kingdom,Europe,11,11,1,0,0,1,10,Terrorism
1943-07-01 00:00:00,United States Navy - USN,Landing (descent or approach),Operational,United States of America,North America,9,9,1,0,0,1,8,Unknown
1943-07-23 00:00:00,United States Army Air Forces - USAAF,Flight,Military / Government,Papua New Guinea,Oceania,8,8,1,0,0,1,7,Terrorism
1943-07-24 00:00:00,United States Army Air Forces - USAAF,Landing (descent or approach),Military / Government,Canada,North America,1,1,1,0,0,1,0,Unknown
1943-07-30 00:00:00,Royal Canadian Air Force - RCAF,Takeoff (climb),Operational,Canada,North America,8,8,1,0,0,1,7,Human Factor
1943-07-30 00:00:00,Aeroflot - Russian International Airlines,Flight,Military / Government,Belarus,Europe,6,6,1,0,0,1,5,Terrorism
1943-08-02 00:00:00,United States Army Air Forces - USAAF,Flight,Military / Government,Myanmar,Asia,24,4,1,20,0,1,23,Technical Failure
1943-08-09 00:00:00,Royal Air Force - RAF,Flight,Operational,United Kingdom,Europe,5,5,1,0,0,1,4,Human Factor
1943-08-22 00:00:00,United States Army Air Forces - USAAF,Landing (descent or approach),Military / Government,Tunisia,Africa,0,0,1,0,0,1,-1,Unknown
1943-08-27 00:00:00,United States Navy - USN,Takeoff (climb),Military / Government,Solomon Islands,Oceania,0,0,1,0,0,1,-1,Unknown
1943-09-15 00:00:00,United States Army Air Forces - USAAF,Takeoff (climb),Military / Government,Sudan,Africa,0,0,1,0,0,1,-1,Technical Failure
1943-09-16 00:00:00,Royal Air Force - RAF,Flight,Military / Government,Netherlands,Europe,8,8,1,0,0,1,7,Human Factor
1943-09-24 00:00:00,Pan American World Airways - PAA,Flight,Specialised Services,United States of America,North America,3,3,1,0,0,1,2,Unknown
1943-09-28 00:00:00,United States Army Air Forces - USAAF,Flight,Military / Government,United States of America,North America,15,5,1,10,0,1,14,Technical Failure
1943-09-29 00:00:00,Royal New Zealand Air Force - RNZAF,Flight,Operational,New Zealand,Oceania,3,3,1,0,0,1,2,Human Factor
1943-09-29 00:00:00,United States Army Air Forces - USAAF,Flight,Military / Government,India,Asia,0,0,1,0,0,1,-1,Unknown
1943-10-10 00:00:00,United States Army Air Forces - USAAF,Flight,Military / Government,Netherlands,Europe,10,10,1,0,0,1,9,Terrorism
1943-10-10 00:00:00,Aeroflot - Russian International Airlines,Flight,Military / Government,Russia,Asia,16,9,1,7,0,1,15,Human Factor
1943-10-10 00:00:00,United States Army Air Forces - USAAF,,Military / Government,India,Asia,0,0,1,0,0,1,-1,Unknown
1943-10-20 00:00:00,United States Army Air Forces - USAAF,Flight,Operational,China,Asia,4,4,1,0,0,1,3,Technical Failure
1943-10-23 00:00:00,Royal Air Force - RAF,Flight,Operational,United Kingdom,Europe,1,1,1,0,0,1,0,Human Factor
1943-10-24 00:00:00,Aeroflot - Russian International Airlines,Flight,Operational,Russia,Asia,5,5,1,0,0,1,4,Weather
1943-10-25 00:00:00,Royal Netherlands Navy - Marineluchtvaartdienst,Flight,Military / Government,France,Europe,4,4,1,0,0,1,3,Terrorism
1943-11-05 00:00:00,United States Army Air Forces - USAAF,Flight,Military / Government,United Kingdom,Europe,0,0,1,0,0,1,-1,Unknown
1943-11-23 00:00:00,Royal Air Force - RAF,Flight,Military / Government,United Kingdom,Europe,19,19,1,0,0,1,18,Human Factor
1943-11-24 00:00:00,United States Army Air Forces - USAAF,Landing (descent or approach),Operational,Canada,North America,3,3,1,0,0,1,2,Human Factor
1943-11-24 00:00:00,United States Army Air Forces - USAAF,Flight,Military / Government,Vietnam,Asia,0,0,1,0,0,1,-1,Unknown
1943-12-04 00:00:00,United States Army Air Forces - USAAF,Landing (descent or approach),Specialised Services,United States of America,North America,3,3,1,0,0,1,2,Technical Failure
1943-12-04 00:00:00,United States Navy - USN,Landing (descent or approach),Operational,United States of America,North America,7,7,1,0,0,1,6,Unknown
1943-12-14 00:00:00,United States Army Air Forces - USAAF,Flight,Military / Government,India,Asia,3,3,1,0,0,1,2,Unknown
1943-12-23 00:00:00,United States Army Air Forces - USAAF,Takeoff (climb),Operational,India,Asia,3,3,1,0,0,1,2,Unknown
1943-12-26 00:00:00,United States Army Air Forces - USAAF,Takeoff (climb),Military / Government,India,Asia,0,0,1,0,0,1,-1,Unknown
1944-01-12 00:00:00,Syndicato Condor,Takeoff (climb),Operational,Brazil,South America,2,2,1,0,0,1,1,Unknown
1944-01-13 00:00:00,United States Army Air Forces - USAAF,Takeoff (climb),Military / Government,United States of America,North America,2,2,1,0,0,1,1,Human Factor
1944-01-14 00:00:00,United States Army Air Forces - USAAF,Flight,Operational,Bahamas,Central America,5,5,1,0,0,1,4,Unknown
1944-01-14 00:00:00,German Air Force - Deutsche Luftwaffe,Flight,Military / Government,Austria,Europe,1,1,1,0,0,1,0,Unknown
1944-01-19 00:00:00,United States Army Air Forces - USAAF,Takeoff (climb),Operational,India,Asia,4,4,1,0,0,1,3,Unknown
1944-01-22 00:00:00,United States Army Air Forces - USAAF,Landing (descent or approach),Military / Government,United States of America,North America,4,4,1,0,0,1,3,Human Factor
1944-01-22 00:00:00,United States Army Air Forces - USAAF,Landing (descent or approach),Military / Government,United States of America,North America,4,4,1,0,0,1,3,Human Factor
1944-01-27 00:00:00,United States Navy - USN,Landing (descent or approach),Operational,United States of America,North America,7,7,1,0,0,1,6,Unknown
1944-01-30 00:00:00,Royal Air Force - RAF,Flight,Operational,United Kingdom,Europe,1,1,1,0,0,1,0,Human Factor
1944-02-20 00:00:00,Royal Air Force - RAF,Flight,Military / Government,United Kingdom,Europe,4,4,1,0,0,1,3,Weather
1944-02-22 00:00:00,United States Army Air Forces - USAAF,Flight,Military / Government,Netherlands,Europe,5,5,1,0,0,1,4,Terrorism
1944-02-28 00:00:00,United States Army Air Forces - USAAF,Takeoff (climb),Operational,United States of America,North America,3,3,1,0,0,1,2,Technical Failure
1944-03-02 00:00:00,United States Army Air Forces - USAAF,Flight,Operational,United Kingdom,Europe,11,11,1,0,0,1,10,Unknown
1944-03-06 00:00:00,United States Army Air Forces - USAAF,Flight,Military / Government,Netherlands,Europe,10,10,1,0,0,1,9,Terrorism
1944-03-14 00:00:00,Marine Aircraft Experimental Establishment,Takeoff (climb),Specialised Services,United Kingdom,Europe,3,3,1,0,0,1,2,Weather
1944-03-18 00:00:00,United States Army Air Forces - USAAF,Landing (descent or approach),Military / Government,Switzerland,Europe,10,10,1,0,0,1,9,Terrorism
1944-03-27 00:00:00,Royal Air Force - RAF,Flight,Operational,United Kingdom,Europe,5,5,1,0,0,1,4,Technical Failure
1944-03-27 00:00:00,United States Army Air Forces - USAAF,Flight,Military / Government,Egypt,Africa,0,0,1,0,0,1,-1,Technical Failure
1944-03-29 00:00:00,United States Army Air Forces - USAAF,Takeoff (climb),Military / Government,India,Asia,0,0,1,0,0,1,-1,Unknown
1944-03-31 00:00:00,Royal Air Force - RAF,Flight,Military / Government,United Kingdom,Europe,7,7,1,0,0,1,6,Terrorism
1944-04-01 00:00:00,United States Army Air Forces - USAAF,Flight,Military / Government,France,Europe,10,10,1,0,0,1,9,Terrorism
1944-04-13 00:00:00,United States Navy - USN,Flight,Specialised Services,United States of America,North America,8,8,1,0,0,1,7,Unknown
1944-04-18 00:00:00,United States Army Air Forces - USAAF,Flight,Military / Government,Bangladesh,Asia,0,0,1,0,0,1,-1,Unknown
1944-04-28 00:00:00,Royal Air Force - RAF,Flight,Military / Government,Switzerland,Europe,7,7,1,0,0,1,6,Terrorism
1944-05-11 00:00:00,United States Army Air Forces - USAAF,Takeoff (climb),Operational,United States of America,North America,11,3,1,8,0,1,10,Human Factor
1944-05-14 00:00:00,Swedish Air Force - Flygvapnet,Flight,Military / Government,Latvia,Europe,4,4,1,0,0,1,3,Terrorism
1944-05-14 00:00:00,United States Army Air Forces - USAAF,Flight,Military / Government,Italy,Europe,0,0,1,0,0,1,-1,Unknown
1944-05-28 00:00:00,Royal Air Force - RAF,Landing (descent or approach),Military / Government,United Kingdom,Europe,7,7,1,0,0,1,6,Terrorism
1944-06-06 00:00:00,Royal Air Force - RAF,Flight,Military / Government,France,Europe,4,4,1,0,0,1,3,Terrorism
1944-06-11 00:00:00,United States Army Air Forces - USAAF,Flight,Military / Government,United Kingdom,Europe,1,1,1,0,0,1,0,Human Factor
1944-06-13 00:00:00,Royal Canadian Air Force - RCAF,Flight,Military / Government,World,World,5,5,1,0,0,1,4,Terrorism
1944-06-16 00:00:00,United States Army Air Forces - USAAF,Landing (descent or approach),Military / Government,India,Asia,4,4,1,0,0,1,3,Unknown
1944-06-18 00:00:00,China National Aviation Corporation - CNAC,Flight,Commercial,China,Asia,14,3,0,11,1,1,13,Human Factor
1944-07-02 00:00:00,United States Army Air Forces - USAAF,Flight,Military / Government,India,Asia,0,0,1,0,0,1,-1,Unknown
1944-07-03 00:00:00,TACA International Airlines - Transportes Aéreos Centro Americanos,Flight,Commercial,Nicaragua,Central America,1,1,1,0,0,1,0,Unknown
1944-07-10 00:00:00,United States Army Air Forces - USAAF,Takeoff (climb),Military / Government,India,Asia,0,0,1,0,0,1,-1,Unknown
1944-07-12 00:00:00,Royal Air Force - RAF,Flight,Operational,United Kingdom,Europe,5,5,1,0,0,1,4,Human Factor
1944-07-24 00:00:00,United States Army Air Forces - USAAF,Flight,Military / Government,United States of America,North America,1,1,1,0,0,1,0,Unknown
1944-08-02 00:00:00,United States Army Air Forces - USAAF,Flight,Military / Government,France,Europe,10,10,1,0,0,1,9,Terrorism
1944-08-10 00:00:00,United States Navy - USN,Landing (descent or approach),Military / Government,Papua New Guinea,Oceania,6,6,1,0,0,1,5,Unknown
1944-08-12 00:00:00,United States Army Air Forces - USAAF,Takeoff (climb),Military / Government,United States of America,North America,27,3,1,24,0,1,26,Human Factor
1944-08-14 00:00:00,Royal New Zealand Air Force - RNZAF,Flight,Operational,New Zealand,Oceania,1,1,1,0,0,1,0,Human Factor
1944-08-14 00:00:00,Royal New Zealand Air Force - RNZAF,Flight,Operational,New Zealand,Oceania,1,1,1,0,0,1,0,Human Factor
1944-08-15 00:00:00,Royal Air Force - RAF,Landing (descent or approach),Military / Government,United Kingdom,Europe,1,1,1,0,0,1,0,Technical Failure
1944-08-28 00:00:00,United States Army Air Forces - USAAF,Takeoff (climb),Military / Government,France,Europe,1,1,1,0,0,1,0,Unknown
1944-08-29 00:00:00,United States Army Air Forces - USAAF,Flight,Military / Government,United States of America,North America,1,1,1,0,0,1,0,Technical Failure
1944-09-01 00:00:00,Royal Netherlands East Indies Air Force - ML-KNIL,Flight,Military / Government,Indonesia,Asia,0,0,1,0,0,1,-1,Terrorism
1944-09-04 00:00:00,United States Navy - USN,Flight,Operational,United States of America,North America,5,5,1,0,0,1,4,Unknown
1944-09-04 00:00:00,Federal Office of Topography,Flight,Specialised Services,Switzerland,Europe,2,1,0,1,1,1,1,Unknown
1944-09-07 00:00:00,United States Army Air Forces - USAAF,Flight,Military / Government,United Kingdom,Europe,1,1,1,0,0,1,0,Unknown
1944-09-13 00:00:00,United States Army Air Forces - USAAF,Takeoff (climb),Military / Government,Eritrea,Africa,0,0,1,0,0,1,-1,Unknown
1944-09-15 00:00:00,United States Army Air Forces - USAAF,Flight,Military / Government,France,Europe,7,4,0,3,1,1,6,Technical Failure
1944-09-15 00:00:00,United States Army Air Forces - USAAF,Landing (descent or approach),Military / Government,France,Europe,1,1,1,0,0,1,0,Unknown
1944-09-16 00:00:00,United States Army Air Forces - USAAF,Flight,Military / Government,Egypt,Africa,0,0,1,0,0,1,-1,Unknown
1944-09-19 00:00:00,Royal Air Force - RAF,Flight,Military / Government,Netherlands,Europe,8,4,0,4,1,1,7,Terrorism
1944-09-19 00:00:00,Royal Air Force - RAF,Flight,Military / Government,Netherlands,Europe,0,0,1,0,0,1,-1,Terrorism
1944-10-09 00:00:00,United States Army Air Forces - USAAF,Takeoff (climb),Military / Government,Ghana,Africa,0,0,1,0,0,1,-1,Unknown
1944-10-09 00:00:00,United States Army Air Forces - USAAF,Landing (descent or approach),Specialised Services,United Kingdom,Europe,5,5,1,0,0,1,4,Technical Failure
1944-10-11 00:00:00,Qantas Airways - Queensland and Northern Territory Aerial Services,Landing (descent or approach),Commercial,Australia,Oceania,29,7,0,22,1,1,28,Human Factor
1944-10-17 00:00:00,Deutsche Lufthansa,Flight,Commercial,Hungary,Europe,9,3,0,6,1,1,8,Terrorism
1944-10-22 00:00:00,United States Army Air Forces - USAAF,Flight,Military / Government,Iceland,Europe,1,1,1,0,0,1,0,Unknown
1944-10-23 00:00:00,German Air Force - Deutsche Luftwaffe,Flight,Military / Government,Finland,Europe,9,2,0,7,1,1,8,Terrorism
1944-10-27 00:00:00,United States Navy - USN,Flight,Operational,United States of America,North America,3,3,1,0,0,1,2,Unknown
1944-11-10 00:00:00,United States Army Air Forces - USAAF,Takeoff (climb),Military / Government,China,Asia,18,4,0,14,1,1,17,Technical Failure
1944-11-11 00:00:00,Aeroflot - Russian International Airlines,Landing (descent or approach),Commercial,Belarus,Europe,15,5,0,10,1,1,14,Human Factor
1944-12-06 00:00:00,Royal Air Force - RAF,Flight,Military / Government,United Kingdom,Europe,1,1,1,0,0,1,0,Human Factor
1944-12-19 00:00:00,Royal Netherlands Navy - Marineluchtvaartdienst,Flight,Military / Government,Belgium,Europe,4,4,1,0,0,1,3,Terrorism
1944-12-27 00:00:00,United States Army Air Forces - USAAF,Flight,Military / Government,Belgium,Europe,4,4,1,0,0,1,3,Terrorism
1944-12-27 00:00:00,United States Army Air Forces - USAAF,Flight,Military / Government,Belgium,Europe,4,4,1,0,0,1,3,Terrorism
1945-01-04 00:00:00,United States Army Air Forces - USAAF,Landing (descent or approach),Military / Government,Portugal,Europe,0,0,1,0,0,1,-1,Unknown
1945-01-05 00:00:00,United States Navy - USN,Landing (descent or approach),Military / Government,United States of America,North America,0,0,1,0,0,1,-1,Unknown
1945-01-08 00:00:00,Royal Air Force - RAF,Flight,Operational,United Kingdom,Europe,4,4,1,0,0,1,3,Human Factor
1945-01-12 00:00:00,Royal Air Force - RAF,Flight,Military / Government,Myanmar,Asia,0,0,1,0,0,1,-1,Terrorism
1945-01-19 00:00:00,Royal Air Force - RAF,Flight,Operational,United Kingdom,Europe,3,3,1,0,0,1,2,Technical Failure
1945-01-20 00:00:00,Royal Air Force - RAF,Flight,Operational,United Kingdom,Europe,2,2,1,0,0,1,1,Weather
1945-01-21 00:00:00,United States Army Air Forces - USAAF,Flight,Military / Government,France,Europe,9,9,1,0,0,1,8,Terrorism
1945-01-22 00:00:00,United States Army Air Forces - USAAF,Flight,Military / Government,China,Asia,4,4,1,0,0,1,3,Unknown
1945-02-03 00:00:00,Royal Air Force - RAF,Flight,Military / Government,Netherlands,Europe,7,7,1,0,0,1,6,Terrorism
1945-02-11 00:00:00,United States Army Air Forces - USAAF,Flight,Military / Government,China,Asia,0,0,1,0,0,1,-1,Unknown
1945-02-11 00:00:00,United States Army Air Forces - USAAF,Flight,Military / Government,China,Asia,0,0,1,0,0,1,-1,Unknown
1945-02-24 00:00:00,Royal Australian Air Force - RAAF,Flight,Operational,Australia,Oceania,4,4,1,0,0,1,3,Technical Failure
1945-02-24 00:00:00,Royal Australian Air Force - RAAF,Landing (descent or approach),Operational,Australia,Oceania,4,4,1,0,0,1,3,Unknown
1945-03-04 00:00:00,United States Army Air Forces - USAAF,Flight,Military / Government,United Kingdom,Europe,0,0,1,0,0,1,-1,Unknown
1945-03-09 00:00:00,United States Army Air Forces - USAAF,Takeoff (climb),Military / Government,China,Asia,0,0,1,0,0,1,-1,Unknown
1945-03-21 00:00:00,Royal New Zealand Air Force - RNZAF,Flight,Operational,New Zealand,Oceania,5,5,1,0,0,1,4,Human Factor
1945-03-23 00:00:00,United States Army Air Forces - USAAF,Takeoff (climb),Military / Government,Bangladesh,Asia,0,0,1,0,0,1,-1,Unknown
1945-03-31 00:00:00,United States Army Air Forces - USAAF,Flight,Military / Government,India,Asia,0,0,1,0,0,1,-1,Unknown
1945-04-06 00:00:00,Royal Air Force - RAF,Flight,Operational,United Kingdom,Europe,1,1,1,0,0,1,0,Human Factor
1945-04-12 00:00:00,Royal Air Force - RAF,Flight,Operational,United Kingdom,Europe,1,1,1,0,0,1,0,Unknown
1945-04-23 00:00:00,United States Army Air Forces - USAAF,Flight,Military / Government,Bangladesh,Asia,3,3,1,0,0,1,2,Unknown
1945-05-11 00:00:00,South African Air Force,Takeoff (climb),Operational,Kenya,Africa,3,2,0,1,1,1,2,Weather
1945-06-09 00:00:00,Private American,Flight,Business,United States of America,North America,4,1,1,3,0,1,3,Unknown
1945-06-10 00:00:00,United States Army Air Forces - USAAF,Landing (descent or approach),Military / Government,India,Asia,1,1,1,0,0,1,0,Unknown
1945-07-08 00:00:00,South African Air Force,Flight,Operational,South Africa,Africa,4,4,1,0,0,1,3,Unknown
1945-07-12 00:00:00,Eastern Airlines,Flight,Commercial,United States of America,North America,24,4,0,20,1,1,23,Human Factor
1945-07-21 00:00:00,United States Army Air Forces - USAAF,Takeoff (climb),Operational,Taiwan,Asia,4,4,1,0,0,1,3,Unknown
1945-07-24 00:00:00,Royal Air Force - RAF,Landing (descent or approach),Military / Government,Philippines,Asia,4,4,1,0,0,1,3,Unknown
1945-08-02 00:00:00,United States Army Air Forces - USAAF,Flight,Military / Government,China,Asia,1,1,1,0,0,1,0,Unknown
1945-08-23 00:00:00,Soviet Air Force - Voyenno-vozdushnye sily CCCP,Flight,Military / Government,China,Asia,0,0,1,0,0,1,-1,Unknown
1945-09-06 00:00:00,Royal Australian Air Force - RAAF,Flight,Operational,Australia,Oceania,5,5,1,0,0,1,4,Unknown
1945-09-21 00:00:00,United States Army Air Forces - USAAF,Flight,Military / Government,Bangladesh,Asia,1,1,1,0,0,1,0,Technical Failure
1945-10-01 00:00:00,United States Army Air Forces - USAAF,Flight,Military / Government,Germany,Europe,1,1,1,0,0,1,0,Unknown
1945-10-19 00:00:00,Royal Air Force - RAF,Takeoff (climb),Military / Government,Bangladesh,Asia,0,0,1,0,0,1,-1,Unknown
1945-10-20 00:00:00,Polyarnaya Aviatsiya,Landing (descent or approach),Operational,Russia,Asia,3,2,1,1,0,1,2,Technical Failure
1945-10-26 00:00:00,Misrair,Parking,Commercial,Palestine,Asia,1,1,1,0,0,1,0,Unknown
1945-11-03 00:00:00,Turkish Air Force - Türk Hava Kuvvetleri,Flight,Operational,Turkey,Asia,1,1,1,0,0,1,0,Unknown
1945-11-03 00:00:00,Turkish Air Force - Türk Hava Kuvvetleri,Flight,Operational,Turkey,Asia,1,1,1,0,0,1,0,Unknown
1945-11-22 00:00:00,Private Swiss,Takeoff (climb),Business,Switzerland,Europe,3,1,0,2,1,1,2,Unknown
1945-11-23 00:00:00,Royal Air Force - RAF,Flight,Operational,United Kingdom,Europe,1,1,1,0,0,1,0,Unknown
1945-12-16 00:00:00,Royal Aero Club of New South Wales,Flight,Business,Australia,Oceania,1,1,1,0,0,1,0,Unknown
1945-12-22 00:00:00,United States Army Air Forces - USAAF,Landing (descent or approach),Military / Government,United States of America,North America,2,2,1,0,0,1,1,Human Factor
1945-12-22 00:00:00,Colombian Air Force - Fuerza Aérea Colombiana,Flight,Military / Government,Colombia,South America,3,3,1,0,0,1,2,Technical Failure
1945-12-29 00:00:00,Royal Air Force - RAF,Landing (descent or approach),Operational,United Kingdom,Europe,4,4,1,0,0,1,3,Human Factor
1945-12-30 00:00:00,Eastern Airlines,Landing (descent or approach),Commercial,United States of America,North America,14,3,0,11,1,1,13,Human Factor
1946-01-07 00:00:00,Royal Air Force - RAF,Flight,Operational,United Kingdom,Europe,3,3,1,0,0,1,2,Human Factor
1946-02-21 00:00:00,British Overseas Airways Corporation - BOAC,Landing (descent or approach),Commercial,Canada,North America,14,6,1,8,0,1,13,Weather
1946-02-22 00:00:00,Royal Air Force - RAF,Flight,Military / Government,Germany,Europe,7,2,0,5,1,1,6,Weather
1946-03-19 00:00:00,Royal Air Force - RAF,Flight,Operational,United Kingdom,Europe,1,1,1,0,0,1,0,Unknown
1946-03-28 00:00:00,MVD - Ministerstvo Vnutrennikh Del,Takeoff (climb),Operational,Russia,Asia,7,4,1,3,0,1,6,Other
1946-04-09 00:00:00,Royal Air Force - RAF,Takeoff (climb),Military / Government,United Kingdom,Europe,7,3,0,4,1,1,6,Technical Failure
1946-04-11 00:00:00,Royal Air Force - RAF,Landing (descent or approach),Operational,United Kingdom,Europe,6,6,1,0,0,1,5,Human Factor
1946-04-18 00:00:00,United States Army Air Forces - USAAF,Flight,Military / Government,United Kingdom,Europe,0,0,1,0,0,1,-1,Unknown
1946-04-24 00:00:00,United States Army Air Forces - USAAF,Flight,Military / Government,Kiribati,Oceania,0,0,1,0,0,1,-1,Unknown
1946-05-01 00:00:00,Connellan Airways,Flight,Operational,Australia,Oceania,1,1,1,0,0,1,0,Human Factor
1946-05-08 00:00:00,Royal Air Force - RAF,Landing (descent or approach),Operational,United Kingdom,Europe,1,1,1,0,0,1,0,Human Factor
1946-06-04 00:00:00,United States Army Air Forces - USAAF,Takeoff (climb),Military / Government,Puerto Rico,Central America,0,0,1,0,0,1,-1,Unknown
1946-06-07 00:00:00,United States Army Air Forces - USAAF,Flight,Military / Government,Morocco,Africa,0,0,1,0,0,1,-1,Unknown
1946-08-01 00:00:00,Royal Air Force - RAF,Flight,Operational,United Kingdom,Europe,1,1,1,0,0,1,0,Technical Failure
1946-08-14 00:00:00,British Overseas Airways Corporation - BOAC,Landing (descent or approach),Operational,Malta,Europe,5,5,1,0,0,1,4,Technical Failure
1946-09-02 00:00:00,Royal Air Force - RAF,Takeoff (climb),Operational,United Kingdom,Europe,2,2,1,0,0,1,1,Human Factor
1946-09-11 00:00:00,Royal Air Force - RAF,Flight,Operational,United Kingdom,Europe,1,1,1,0,0,1,0,Other
1946-09-17 00:00:00,SABENA - Société Anonyme Belge d'Exploitation de la Navigation Aérienne,Takeoff (climb),Commercial,Belgium,Europe,7,3,1,4,0,1,6,Technical Failure
1946-09-25 00:00:00,Private Mexican,Landing (descent or approach),Business,Mexico,Central America,10,2,0,8,1,1,9,Unknown
1946-09-26 00:00:00,London Aero %26 Motor Services - LAMS,Flight,Operational,Belgium,Europe,4,3,0,1,1,1,3,Human Factor
1946-10-17 00:00:00,Royal Air Force - RAF,Flight,Operational,United Kingdom,Europe,1,1,1,0,0,1,0,Human Factor
1946-10-22 00:00:00,United States Army Air Forces - USAAF,Flight,Military / Government,Germany,Europe,3,3,1,0,0,1,2,Unknown
1946-10-23 00:00:00,SOCOTRA - Société Coopérative de Tramping Aérien,Flight,Commercial,Egypt,Africa,24,2,0,22,1,1,23,Technical Failure
1946-10-31 00:00:00,Royal Air Force - RAF,Landing (descent or approach),Operational,United Kingdom,Europe,1,1,1,0,0,1,0,Technical Failure
1946-11-01 00:00:00,United States Army Air Forces - USAAF,Flight,Military / Government,South Korea,Asia,0,0,1,0,0,1,-1,Unknown
1946-11-05 00:00:00,Aeroflot - Russian International Airlines,Landing (descent or approach),Commercial,Russia,Asia,26,4,0,22,1,1,25,Technical Failure
1946-11-15 00:00:00,Shell Company of Ecuador,Landing (descent or approach),Business,Ecuador,South America,4,1,1,3,0,1,3,Technical Failure
1946-12-07 00:00:00,Nederlandsche Maatschappij voor de Walvischvaart,Flight,Specialised Services,South Africa,Africa,4,4,1,0,0,1,3,Unknown
1946-12-20 00:00:00,VIARCO - Vias Aéreas Colombianas,Landing (descent or approach),Commercial,Colombia,South America,0,0,1,0,0,1,-1,Other
1947-01-20 00:00:00,United States Navy - USN,Landing (descent or approach),Military / Government,United States of America,North America,21,7,0,14,1,1,20,Human Factor
1947-01-22 00:00:00,United States Navy - USN,Landing (descent or approach),Operational,United States of America,North America,5,5,1,0,0,1,4,Unknown
1947-01-26 00:00:00,Royal Netherlands Navy - Marineluchtvaartdienst,Landing (descent or approach),Military / Government,Indonesia,Asia,5,5,1,0,0,1,4,Unknown
1947-01-29 00:00:00,Mandated Airlines,Flight,Operational,Papua New Guinea,Oceania,1,1,1,0,0,1,0,Human Factor
1947-02-05 00:00:00,International Air Freight,Landing (descent or approach),Operational,United States of America,North America,3,3,1,0,0,1,2,Human Factor
1947-02-19 00:00:00,United States Army Air Forces - USAAF,Landing (descent or approach),Military / Government,Germany,Europe,4,3,0,1,1,1,3,Unknown
1947-03-16 00:00:00,Polyarnaya Aviatsiya,Takeoff (climb),Commercial,Russia,Asia,4,3,1,1,0,1,3,Human Factor
1947-04-09 00:00:00,United States Army Air Forces - USAAF,Takeoff (climb),Military / Government,United States of America,North America,21,2,0,19,1,1,20,Technical Failure
1947-04-13 00:00:00,Royal Air Force - RAF,Landing (descent or approach),Operational,United Kingdom,Europe,6,6,1,0,0,1,5,Human Factor
1947-06-14 00:00:00,North Sea Air Transport,Takeoff (climb),Operational,United Kingdom,Europe,3,2,1,1,0,1,2,Other
1947-07-02 00:00:00,French Navy,Flight,Operational,Algeria,Africa,1,1,1,0,0,1,0,Unknown
1947-07-07 00:00:00,Royal Air Force - RAF,Flight,Operational,United Kingdom,Europe,5,2,1,3,0,1,4,Human Factor
1947-07-15 00:00:00,Aéro Cargo,Landing (descent or approach),Commercial,France,Europe,19,3,0,16,1,1,18,Unknown
1947-07-17 00:00:00,Turkish Air Force - Türk Hava Kuvvetleri,Flight,Operational,Turkey,Asia,1,1,1,0,0,1,0,Unknown
1947-08-09 00:00:00,Aktiebolaget Aerotransport - ABA,Landing (descent or approach),Operational,Sweden,Europe,5,5,1,0,0,1,4,Human Factor
1947-08-30 00:00:00,Air Atlas,Flight,Commercial,Morocco,Africa,0,0,1,0,0,1,-1,Unknown
1947-11-10 00:00:00,Royal Air Force - RAF,Landing (descent or approach),Specialised Services,United Kingdom,Europe,3,3,1,0,0,1,2,Technical Failure
1947-11-13 00:00:00,Société Auxiliaire de Navigation Aérienne - SANA,Flight,Operational,France,Europe,3,3,1,0,0,1,2,Human Factor
1947-11-19 00:00:00,British Overseas Airways Corporation - BOAC,Flight,Operational,United Kingdom,Europe,4,4,1,0,0,1,3,Human Factor
1947-11-20 00:00:00,Royal Air Force - RAF,Flight,Operational,United Kingdom,Europe,4,4,1,0,0,1,3,Technical Failure
1947-12-01 00:00:00,Royal Air Force - RAF,Flight,Operational,United Kingdom,Europe,1,1,1,0,0,1,0,Human Factor
1948-01-06 00:00:00,British European Airways - BEA,Landing (descent or approach),Commercial,United Kingdom,Europe,18,4,0,14,1,1,17,Human Factor
1948-01-10 00:00:00,United States Navy - USN,Takeoff (climb),Military / Government,China,Asia,0,0,1,0,0,1,-1,Other
1948-01-18 00:00:00,United States Air Force - USAF,Landing (descent or approach),Military / Government,United States of America,North America,4,4,1,0,0,1,3,Unknown
1948-02-02 00:00:00,Northrop Aircraft,Flight,Specialised Services,United States of America,North America,3,3,1,0,0,1,2,Technical Failure
1948-02-10 00:00:00,Gulf Transportation Company,Flight,Operational,Mexico,Central America,2,2,1,0,0,1,1,Technical Failure
1948-02-25 00:00:00,Bruning Aviation,Landing (descent or approach),Operational,United States of America,North America,2,2,1,0,0,1,1,Human Factor
1948-04-10 00:00:00,Air France,Takeoff (climb),Operational,Nigeria,Africa,6,6,1,0,0,1,5,Human Factor
1948-04-10 00:00:00,United States Air Force - USAF,Flight,Operational,United States of America,North America,3,3,1,0,0,1,2,Unknown
1948-04-23 00:00:00,Aeroflot - Russian International Airlines,Takeoff (climb),Commercial,Russia,Asia,16,4,1,12,0,1,15,Human Factor
1948-04-25 00:00:00,United States Navy - USN,Landing (descent or approach),Operational,United States of America,North America,0,0,1,0,0,1,-1,Human Factor
1948-05-18 00:00:00,Italian Air Force - Aeronautica Militare Italiana,Takeoff (climb),Military / Government,Italy,Europe,5,5,1,0,0,1,4,Unknown
1948-05-23 00:00:00,Israeli Air Force - Heyl Ha'avir,Flight,Military / Government,Israel,Asia,3,3,1,0,0,1,2,Human Factor
1948-05-28 00:00:00,Turkish Air Force - Türk Hava Kuvvetleri,Flight,Operational,Turkey,Europe,1,1,1,0,0,1,0,Unknown
1948-06-23 00:00:00,Italian Air Force - Aeronautica Militare Italiana,Flight,Specialised Services,Italy,Europe,3,3,1,0,0,1,2,Unknown
1948-06-26 00:00:00,Linea Aeropostal Venezolana - LAV,Landing (descent or approach),Commercial,Venezuela,South America,17,3,1,14,0,1,16,Unknown
1948-07-07 00:00:00,United States Air Force - USAF,Landing (descent or approach),Military / Government,United States of America,North America,0,0,1,0,0,1,-1,Unknown
1948-08-25 00:00:00,Private New Zealand,Flight,Business,New Zealand,Oceania,1,1,1,0,0,1,0,Weather
1948-09-02 00:00:00,Aeroflot - Russian International Airlines,Takeoff (climb),Commercial,Russia,Asia,20,5,0,15,1,1,19,Human Factor
1948-11-10 00:00:00,Royal Canadian Air Force - RCAF,Flight,Operational,Canada,North America,5,5,1,0,0,1,4,Technical Failure
1948-11-23 00:00:00,Air France,Takeoff (climb),Specialised Services,France,Europe,5,5,1,0,0,1,4,Human Factor
1948-12-11 00:00:00,United States Navy - USN,Landing (descent or approach),Operational,Germany,Europe,6,6,1,0,0,1,5,Human Factor
1948-12-31 00:00:00,Catholic Mission of the Holy Ghost,Landing (descent or approach),Operational,Papua New Guinea,Oceania,1,1,1,0,0,1,0,Unknown
1949-01-17 00:00:00,Beech Aircraft Corporation,Takeoff (climb),Specialised Services,United States of America,North America,4,2,1,2,0,1,3,Human Factor
1949-01-17 00:00:00,Beech Aircraft Corporation,Takeoff (climb),Specialised Services,United States of America,North America,4,2,1,2,0,1,3,Human Factor
1949-01-18 00:00:00,United States Air Force - USAF,Landing (descent or approach),Operational,Germany,Europe,3,3,1,0,0,1,2,Unknown
1949-01-18 00:00:00,Royal Navy,Flight,Military / Government,United Kingdom,Europe,1,1,1,0,0,1,0,Unknown
1949-02-04 00:00:00,Skyways of London,Landing (descent or approach),Commercial,Libya,Africa,53,9,1,44,0,1,52,Human Factor
1949-02-07 00:00:00,MAP - Ministerstvo Aviatsionnoi Promyshlennosti - Minaviaprom,Flight,Operational,Russia,Asia,5,5,1,0,0,1,4,Technical Failure
1949-03-01 00:00:00,Royal Air Force - RAF,Flight,Operational,United Kingdom,Europe,1,1,1,0,0,1,0,Human Factor
1949-03-01 00:00:00,Royal Air Force - RAF,Flight,Operational,United Kingdom,Europe,1,1,1,0,0,1,0,Human Factor
1949-03-04 00:00:00,United States Air Force - USAF,Flight,Military / Government,Germany,Europe,5,3,1,2,0,1,4,Technical Failure
1949-07-01 00:00:00,Czech Air Force - Ceské Vojenské Letectvo,Flight,Military / Government,Czech Republic,Europe,4,4,1,0,0,1,3,Human Factor
1949-07-30 00:00:00,North Sea Air Transport,Landing (descent or approach),Commercial,United Kingdom,Europe,5,1,1,4,0,1,4,Unknown
1949-08-22 00:00:00,Société de Transports Aériens Alpes Provence - STAAP,Flight,Operational,Algeria,Africa,4,4,1,0,0,1,3,Technical Failure
1949-08-28 00:00:00,Brazilian Air Force - Força Aérea Brasileira,Takeoff (climb),Operational,Brazil,South America,1,1,1,0,0,1,0,Unknown
1949-08-30 00:00:00,United States Air Force - USAF,Flight,Operational,United States of America,North America,14,14,1,0,0,1,13,Technical Failure
1949-09-01 00:00:00,Transportes Aéreos de Jalisco,Takeoff (climb),Commercial,Mexico,Central America,16,3,0,13,1,1,15,Unknown
1949-10-21 00:00:00,Connellan Airways,Takeoff (climb),Commercial,Australia,Oceania,1,1,1,0,0,1,0,Weather
1949-11-09 00:00:00,United States Navy - USN,Flight,Military / Government,United States of America,North America,7,7,1,0,0,1,6,Technical Failure
1949-11-11 00:00:00,Italian Air Force - Aeronautica Militare Italiana,Parking,Military / Government,Italy,Europe,0,0,1,0,0,1,-1,Technical Failure
1950-01-31 00:00:00,United States Air Force - USAF,Flight,Military / Government,Guatemala,Central America,0,0,1,0,0,1,-1,Unknown
1950-02-20 00:00:00,Indian Government,Takeoff (climb),Military / Government,Pakistan,Asia,1,1,1,0,0,1,0,Unknown
1950-03-07 00:00:00,Royal Danish Air Force - Flyvevåbnet,Takeoff (climb),Operational,Denmark,Europe,1,1,1,0,0,1,0,Human Factor
1950-03-11 00:00:00,United States Air Force - USAF,Flight,Operational,United States of America,North America,4,4,1,0,0,1,3,Technical Failure
1950-03-25 00:00:00,Mandated Airlines,Landing (descent or approach),Specialised Services,Papua New Guinea,Oceania,3,3,1,0,0,1,2,Technical Failure
1950-05-17 00:00:00,Turkish Air Force - Türk Hava Kuvvetleri,Flight,Operational,Turkey,Asia,1,1,1,0,0,1,0,Unknown
1950-05-17 00:00:00,United States Air Force - USAF,Landing (descent or approach),Military / Government,United States of America,North America,0,0,1,0,0,1,-1,Unknown
1950-05-24 00:00:00,Ford Motor Company,Takeoff (climb),Business,United States of America,North America,6,4,1,2,0,1,5,Unknown
1950-05-27 00:00:00,Regina Cargo Airlines,Takeoff (climb),Operational,United States of America,North America,2,2,1,0,0,1,1,Other
1950-06-16 00:00:00,Brazilian Air Force - Força Aérea Brasileira,Flight,Operational,Brazil,South America,3,3,1,0,0,1,2,Unknown
1950-06-19 00:00:00,United States Air Force - USAF,Takeoff (climb),Military / Government,United States of America,North America,2,2,1,0,0,1,1,Unknown
1950-07-12 00:00:00,Turkish Air Force - Türk Hava Kuvvetleri,Takeoff (climb),Operational,Turkey,Asia,2,2,1,0,0,1,1,Technical Failure
1950-08-11 00:00:00,United States Air Force - USAF,Flight,Operational,United States of America,North America,2,2,1,0,0,1,1,Unknown
1950-08-23 00:00:00,United States Air Force - USAF,Flight,Operational,United States of America,North America,2,2,1,0,0,1,1,Human Factor
1950-09-15 00:00:00,United States Air Force - USAF,Takeoff (climb),Military / Government,Japan,Asia,11,11,1,0,0,1,10,Unknown
1950-09-15 00:00:00,Royal Air Force - RAF,Flight,Operational,United Kingdom,Europe,1,1,1,0,0,1,0,Human Factor
1950-09-27 00:00:00,United States Air Force - USAF,Takeoff (climb),Military / Government,Japan,Asia,11,11,1,0,0,1,10,Unknown
1950-09-27 00:00:00,United States Air Force - USAF,Takeoff (climb),Military / Government,Japan,Asia,4,4,1,0,0,1,3,Technical Failure
1950-09-30 00:00:00,Private American,Takeoff (climb),Business,United States of America,North America,4,1,1,3,0,1,3,Unknown
1950-10-11 00:00:00,Directorate of Geodesy and Cartography,Flight,Specialised Services,Russia,Asia,0,0,1,0,0,1,-1,Human Factor
1950-10-13 00:00:00,Servicios Aéreos de Chiapas,Takeoff (climb),Commercial,Mexico,Central America,3,2,1,1,0,1,2,Unknown
1950-10-19 00:00:00,United States Air Force - USAF,Takeoff (climb),Military / Government,Saudi Arabia,Asia,0,0,1,0,0,1,-1,Unknown
1950-11-28 00:00:00,United States Air Force - USAF,Flight,Military / Government,South Korea,Asia,2,2,1,0,0,1,1,Terrorism
1950-12-08 00:00:00,Civil Air Transport,Landing (descent or approach),Humanitarian,North Korea,Asia,9,3,0,6,1,1,8,Weather
1950-12-11 00:00:00,Brazilian Air Force - Força Aérea Brasileira,Flight,Operational,Brazil,South America,1,1,1,0,0,1,0,Unknown
1950-12-14 00:00:00,VASP - Viação Aérea de São Paulo,Takeoff (climb),Commercial,Brazil,South America,20,4,0,16,1,1,19,Technical Failure
1951-01-18 00:00:00,Royal Air Force - RAF,Landing (descent or approach),Operational,United Kingdom,Europe,6,6,1,0,0,1,5,Human Factor
1951-01-28 00:00:00,Trans Oceanic Airways - TOA,Takeoff (climb),Operational,Malta,Europe,39,6,0,33,1,1,38,Unknown
1951-02-13 00:00:00,United States Air Force - USAF,Flight,Operational,United States of America,North America,0,0,1,0,0,1,-1,Unknown
1951-02-18 00:00:00,Royal Air Force - RAF,Landing (descent or approach),Military / Government,Sweden,Europe,21,4,1,17,0,1,20,Technical Failure
1951-03-05 00:00:00,United States Air Force - USAF,Landing (descent or approach),Military / Government,Japan,Asia,3,3,1,0,0,1,2,Technical Failure
1951-03-10 00:00:00,United States Air Force - USAF,Takeoff (climb),Military / Government,United States of America,Central America,8,8,1,0,0,1,7,Unknown
1951-03-10 00:00:00,Royal Air Force - RAF,Flight,Military / Government,World,World,6,3,0,3,1,1,5,Technical Failure
1951-03-19 00:00:00,Italian Air Force - Aeronautica Militare Italiana,Landing (descent or approach),Military / Government,Italy,Europe,3,3,1,0,0,1,2,Unknown
1951-03-24 00:00:00,United States Air Force - USAF,Flight,Military / Government,North Korea,Asia,3,3,1,0,0,1,2,Terrorism
1951-03-29 00:00:00,United States Air Force - USAF,Flight,Military / Government,South Korea,Asia,5,5,1,0,0,1,4,Technical Failure
1951-04-18 00:00:00,United States Air Force - USAF,Takeoff (climb),Operational,United States of America,North America,0,0,1,0,0,1,-1,Technical Failure
1951-05-07 00:00:00,United States Air Force - USAF,Flight,Military / Government,North Korea,Asia,3,3,1,0,0,1,2,Terrorism
1951-06-15 00:00:00,United States Navy - USN,Landing (descent or approach),Military / Government,United States of America,North America,8,8,1,0,0,1,7,Unknown
1951-07-10 00:00:00,Air Navigation %26 Trading Company,Flight,Operational,United Kingdom,Europe,1,1,1,0,0,1,0,Human Factor
1951-07-13 00:00:00,Private Mexican,Flight,Operational,Mexico,Central America,1,1,1,0,0,1,0,Unknown
1951-07-19 00:00:00,United States Air Force - USAF,Taxiing,Military / Government,South Korea,Asia,5,2,1,3,0,1,4,Unknown
1951-07-20 00:00:00,Airwork East Africa,Flight,Operational,Tanzania,Africa,1,1,1,0,0,1,0,Human Factor
1951-07-26 00:00:00,Compagnie Autrex-Lopez-Loreta-Le Breton,Flight,Operational,Vietnam,Asia,3,3,1,0,0,1,2,Unknown
1951-08-05 00:00:00,United States Air Force - USAF,Flight,Military / Government,South Korea,Asia,3,3,1,0,0,1,2,Technical Failure
1951-08-15 00:00:00,Royal Air Force - RAF,Flight,Military / Government,Libya,Africa,6,6,1,0,0,1,5,Human Factor
1951-08-20 00:00:00,Polyarnaya Aviatsiya,Takeoff (climb),Operational,Russia,Asia,4,4,1,0,0,1,3,Human Factor
1951-08-23 00:00:00,United States Air Force - USAF,Flight,Military / Government,North Korea,Asia,11,11,1,0,0,1,10,Terrorism
1951-08-26 00:00:00,United States Air Force - USAF,Takeoff (climb),Military / Government,South Korea,Asia,4,4,1,0,0,1,3,Technical Failure
1951-08-31 00:00:00,United States Air Force - USAF,Flight,Military / Government,United States of America,North America,0,0,1,0,0,1,-1,Unknown
1951-09-02 00:00:00,United States Air Force - USAF,Flight,Military / Government,North Korea,Asia,3,3,1,0,0,1,2,Unknown
1951-09-10 00:00:00,United States Air Force - USAF,Flight,Military / Government,United States of America,North America,7,7,1,0,0,1,6,Unknown
1951-09-11 00:00:00,Colombian Air Force - Fuerza Aérea Colombiana,Takeoff (climb),Military / Government,Colombia,South America,3,3,1,0,0,1,2,Unknown
1951-09-15 00:00:00,Air India,Takeoff (climb),Commercial,India,Asia,27,4,1,23,0,1,26,Human Factor
1951-09-20 00:00:00,Andrau Airpark Inc.,Flight,Business,United States of America,North America,1,1,1,0,0,1,0,Unknown
1951-09-21 00:00:00,Qantas Airways - Queensland and Northern Territory Aerial Services,Flight,Operational,Papua New Guinea,Oceania,1,1,1,0,0,1,0,Human Factor
1951-10-01 00:00:00,United States Air Force - USAF,Landing (descent or approach),Operational,South Korea,Asia,3,3,1,0,0,1,2,Human Factor
1951-10-08 00:00:00,United States Air Force - USAF,Landing (descent or approach),Military / Government,South Korea,Asia,3,3,1,0,0,1,2,Human Factor
1951-10-09 00:00:00,Colombian Air Force - Fuerza Aérea Colombiana,Takeoff (climb),Military / Government,Colombia,South America,10,2,1,8,0,1,9,Other
1951-10-11 00:00:00,Aeroflot - Russian International Airlines,Flight,Commercial,Russia,Asia,10,4,1,6,0,1,9,Human Factor
1951-10-22 00:00:00,Ontario Central Airlines,Landing (descent or approach),Commercial,Canada,North America,1,1,1,0,0,1,0,Human Factor
1951-11-05 00:00:00,Transocean Air Lines - TOA,Landing (descent or approach),Commercial,United States of America,North America,29,3,0,26,1,1,28,Human Factor
1951-11-05 00:00:00,Royal Air Force - RAF,Flight,Operational,United Kingdom,Europe,5,5,1,0,0,1,4,Technical Failure
1951-11-27 00:00:00,Queensland Ambulance Transport Brigade,Flight,Humanitarian,Australia,Oceania,4,1,0,3,1,1,3,Technical Failure
1951-11-29 00:00:00,Royal Air Force - RAF,Flight,Operational,United Kingdom,Europe,1,1,1,0,0,1,0,Human Factor
1951-12-06 00:00:00,Royal Air Force - RAF,Landing (descent or approach),Military / Government,United Kingdom,Europe,1,1,1,0,0,1,0,Unknown
1951-12-08 00:00:00,United States Air Force - USAF,Flight,Military / Government,North Korea,Asia,3,3,1,0,0,1,2,Unknown
1951-12-20 00:00:00,French Navy,Landing (descent or approach),Military / Government,Vietnam,Asia,0,0,1,0,0,1,-1,Technical Failure
1951-12-21 00:00:00,United States Air Force - USAF,Flight,Operational,Germany,Europe,3,3,1,0,0,1,2,Unknown
1951-12-22 00:00:00,United States Air Force - USAF,Flight,Operational,United States of America,North America,8,8,1,0,0,1,7,Technical Failure
1952-01-05 00:00:00,United States Navy - USN,Landing (descent or approach),Operational,United Kingdom,Europe,12,12,1,0,0,1,11,Unknown
1952-02-19 00:00:00,United States Air Force - USAF,Flight,Military / Government,North Korea,Asia,4,4,1,0,0,1,3,Terrorism
1952-04-01 00:00:00,Royal Air Force - RAF,Takeoff (climb),Operational,United Kingdom,Europe,1,1,1,0,0,1,0,Human Factor
1952-04-07 00:00:00,United States Air Force - USAF,Takeoff (climb),Military / Government,Lebanon,Asia,0,0,1,0,0,1,-1,Unknown
1952-05-03 00:00:00,Société de Transports Aériens en Extrême-Orient - STAEO,Takeoff (climb),Commercial,Vietnam,Asia,14,2,0,12,1,1,13,Terrorism
1952-05-16 00:00:00,Royal Air Force - RAF,Flight,Operational,United Kingdom,Europe,1,1,1,0,0,1,0,Unknown
1952-05-26 00:00:00,British Overseas Airways Corporation - BOAC,Flight,Commercial,Mauritania,Africa,18,8,1,10,0,1,17,Human Factor
1952-06-04 00:00:00,Royal Air Force - RAF,Landing (descent or approach),Operational,United Kingdom,Europe,1,1,1,0,0,1,0,Human Factor
1952-06-20 00:00:00,Royal Air Force - RAF,Landing (descent or approach),Operational,United Kingdom,Europe,1,1,1,0,0,1,0,Human Factor
1952-06-23 00:00:00,United States Air Force - USAF,Takeoff (climb),Operational,South Korea,Asia,2,2,1,0,0,1,1,Technical Failure
1952-07-16 00:00:00,United States Navy - USN,Landing (descent or approach),Military / Government,United States of America,North America,7,7,1,0,0,1,6,Human Factor
1952-07-31 00:00:00,Royal Air Force - RAF,Landing (descent or approach),Operational,United Kingdom,Europe,1,1,1,0,0,1,0,Human Factor
1952-08-19 00:00:00,Royal Air Force - RAF,Landing (descent or approach),Operational,United Kingdom,Europe,1,1,1,0,0,1,0,Other
1952-08-24 00:00:00,Eagle Aviation - UK,Flight,Operational,Germany,Europe,3,3,1,0,0,1,2,Technical Failure
1952-09-02 00:00:00,United States Air Force - USAF,Flight,Military / Government,South Korea,Asia,1,1,1,0,0,1,0,Unknown
1952-09-12 00:00:00,Royal Air Force - RAF,Flight,Operational,United Kingdom,Europe,1,1,1,0,0,1,0,Human Factor
1952-09-14 00:00:00,Private British,Takeoff (climb),Business,United Kingdom,Europe,1,1,1,0,0,1,0,Technical Failure
1952-09-15 00:00:00,Royal Air Force - RAF,Flight,Operational,United Kingdom,Europe,1,1,1,0,0,1,0,Human Factor
1952-09-15 00:00:00,Royal Air Force - RAF,Flight,Operational,United Kingdom,Europe,1,1,1,0,0,1,0,Human Factor
1952-10-13 00:00:00,Royal Air Force - RAF,Landing (descent or approach),Operational,United Kingdom,Europe,3,3,1,0,0,1,2,Human Factor
1952-10-14 00:00:00,Royal Air Force - RAF,Flight,Operational,Germany,Europe,1,1,1,0,0,1,0,Technical Failure
1952-12-02 00:00:00,Royal Air Force - RAF,Landing (descent or approach),Operational,United Kingdom,Europe,4,4,1,0,0,1,3,Technical Failure
1952-12-05 00:00:00,Queen Charlotte Airlines,Flight,Operational,Canada,North America,1,1,1,0,0,1,0,Human Factor
1952-12-13 00:00:00,United States Air Force - USAF,Takeoff (climb),Operational,South Korea,Asia,2,2,1,0,0,1,1,Unknown
1952-12-19 00:00:00,Royal Netherlands Navy - Marineluchtvaartdienst,Flight,Military / Government,Lebanon,Asia,9,9,1,0,0,1,8,Human Factor
1952-12-31 00:00:00,Royal Air Force - RAF,Flight,Operational,United Kingdom,Europe,1,1,1,0,0,1,0,Weather
1953-01-09 00:00:00,Swedish Air Force - Flygvapnet,Takeoff (climb),Humanitarian,Sweden,Europe,4,1,1,3,0,1,3,Human Factor
1953-01-10 00:00:00,United States Air Force - USAF,Flight,Military / Government,North Korea,Asia,13,13,1,0,0,1,12,Terrorism
1953-03-30 00:00:00,Royal Air Force - RAF,Flight,Operational,United Kingdom,Europe,1,1,1,0,0,1,0,Human Factor
1953-04-01 00:00:00,Czech Air Force - Ceské Vojenské Letectvo,Landing (descent or approach),Operational,Czech Republic,Europe,3,3,1,0,0,1,2,Human Factor
1953-04-23 00:00:00,United States Navy - USN,Flight,Military / Government,United States of America,North America,11,11,1,0,0,1,10,Unknown
1953-04-30 00:00:00,Aeroflot - Russian International Airlines,Landing (descent or approach),Commercial,Russia,Asia,23,5,0,18,1,1,22,Other
1953-04-30 00:00:00,United States Air Force - USAF,Landing (descent or approach),Operational,United States of America,North America,3,3,1,0,0,1,2,Unknown
1953-05-19 00:00:00,United States Air Force - USAF,Takeoff (climb),Operational,Guam Island,Asia,7,7,1,0,0,1,6,Technical Failure
1953-05-29 00:00:00,United States Air Force - USAF,Takeoff (climb),Military / Government,Japan,Asia,1,1,1,0,0,1,0,Unknown
1953-06-19 00:00:00,Royal Air Force - RAF,Landing (descent or approach),Operational,United Kingdom,Europe,1,1,1,0,0,1,0,Human Factor
1953-06-29 00:00:00,Western Airlines,Takeoff (climb),Specialised Services,United States of America,North America,3,3,1,0,0,1,2,Human Factor
1953-07-01 00:00:00,United States Air Force - USAF,Flight,Military / Government,North Korea,Asia,4,4,1,0,0,1,3,Terrorism
1953-08-04 00:00:00,Orient Airways,Takeoff (climb),Commercial,United Arab Emirates,Asia,25,4,0,21,1,1,24,Human Factor
1953-08-24 00:00:00,United States Air Force - USAF,Flight,Military / Government,United States of America,North America,1,1,1,0,0,1,0,Unknown
1953-09-14 00:00:00,Transportes Aéreos Mexicanos - TAMSA,Landing (descent or approach),Operational,Mexico,Central America,2,2,1,0,0,1,1,Human Factor
1953-09-15 00:00:00,Royal Navy,Flight,Military / Government,United Kingdom,Europe,2,2,1,0,0,1,1,Unknown
1953-09-19 00:00:00,Avianca,Landing (descent or approach),Operational,Colombia,South America,4,3,1,1,0,1,3,Unknown
1953-09-30 00:00:00,United States Air Force - USAF,Flight,Military / Government,United States of America,North America,1,1,1,0,0,1,0,Unknown
1953-10-13 00:00:00,Royal Air Maroc - RAM,Takeoff (climb),Commercial,Morocco,Africa,0,0,0,0,1,1,-1,Technical Failure
1953-10-21 00:00:00,Aeroflot - Russian International Airlines,Landing (descent or approach),Commercial,Russia,Asia,8,5,1,3,0,1,7,Human Factor
1953-10-27 00:00:00,United States Navy - USN,Flight,Military / Government,World,World,9,9,1,0,0,1,8,Technical Failure
1953-12-16 00:00:00,Royal Air Force - RAF,Landing (descent or approach),Operational,Malta,Europe,5,5,1,0,0,1,4,Technical Failure
1953-12-18 00:00:00,United States Air Force - USAF,Landing (descent or approach),Military / Government,United States of America,North America,7,7,1,0,0,1,6,Human Factor
1953-12-19 00:00:00,SABENA - Société Anonyme Belge d'Exploitation de la Navigation Aérienne,Landing (descent or approach),Commercial,Switzerland,Europe,44,5,0,39,1,1,43,Human Factor
1954-01-20 00:00:00,Royal Air Force - RAF,Takeoff (climb),Military / Government,United Kingdom,Europe,13,5,1,8,0,1,12,Technical Failure
1954-03-19 00:00:00,LOT Polish Airlines - Polskie Linie Lotnicze,Flight,Commercial,Poland,Europe,23,3,0,20,1,1,22,Other
1954-03-25 00:00:00,Royal Air Force - RAF,Landing (descent or approach),Operational,United Kingdom,Europe,2,2,1,0,0,1,1,Human Factor
1954-04-20 00:00:00,Rural Aviation,Flight,Military / Government,New Zealand,Oceania,1,1,1,0,0,1,0,Unknown
1954-05-11 00:00:00,Compañía Auxiliar de Navegación Aérea,Landing (descent or approach),Specialised Services,Spain,Europe,4,2,0,2,1,1,3,Technical Failure
1954-06-11 00:00:00,AREA Ecuador - Aerovias Ecuatorianas,Flight,Operational,Ecuador,South America,1,1,1,0,0,1,0,Unknown
1954-08-17 00:00:00,Brazilian Air Force - Força Aérea Brasileira,Landing (descent or approach),Operational,Brazil,South America,2,2,1,0,0,1,1,Unknown
1954-08-24 00:00:00,Royal Australian Air Force - RAAF,Flight,Military / Government,Australia,Oceania,4,4,1,0,0,1,3,Technical Failure
1954-08-28 00:00:00,United States Air Force - USAF,Landing (descent or approach),Operational,United States of America,North America,0,0,1,0,0,1,-1,Technical Failure
1954-09-04 00:00:00,United States Navy - USN,Flight,Military / Government,World,World,10,10,1,0,0,1,9,Terrorism
1954-09-21 00:00:00,United States Air Force - USAF,Flight,Military / Government,United States of America,North America,9,9,1,0,0,1,8,Technical Failure
1954-10-20 00:00:00,United States Air Force - USAF,Takeoff (climb),Military / Government,South Korea,Asia,0,0,1,0,0,1,-1,Technical Failure
1954-11-04 00:00:00,Alaska Coastal Airlines,Takeoff (climb),Commercial,United States of America,North America,3,1,1,2,0,1,2,Weather
1954-11-05 00:00:00,Private American,Landing (descent or approach),Business,United States of America,North America,2,2,1,0,0,1,1,Technical Failure
1954-11-24 00:00:00,Aero-Nord Sweden,Takeoff (climb),Operational,Sweden,Europe,2,2,1,0,0,1,1,Technical Failure
1954-12-01 00:00:00,De Havilland Aircraft UK,Takeoff (climb),Operational,Australia,Oceania,3,3,1,0,0,1,2,Unknown
1954-12-05 00:00:00,Aeroflot - Russian International Airlines,Landing (descent or approach),Commercial,Kazakhstan,Asia,19,5,1,14,0,1,18,Technical Failure
1955-02-23 00:00:00,Central African Airways - CAA,Takeoff (climb),Commercial,Zimbabwe,Africa,26,5,1,21,0,1,25,Technical Failure
1955-03-10 00:00:00,Spanish Air Force - Ejército del Aire,Takeoff (climb),Military / Government,Spain,Europe,8,8,1,0,0,1,7,Unknown
1955-04-15 00:00:00,Brazilian Air Force - Força Aérea Brasileira,Flight,Operational,Brazil,South America,1,1,1,0,0,1,0,Unknown
1955-04-16 00:00:00,United States Air Force - USAF,Takeoff (climb),Military / Government,Japan,Asia,0,0,1,0,0,1,-1,Technical Failure
1955-04-26 00:00:00,Royal Air Force - RAF,Flight,Military / Government,France,Europe,1,1,1,0,0,1,0,Human Factor
1955-04-28 00:00:00,The Christian %26 Missionary Alliance,Flight,Operational,Indonesia,Asia,1,1,1,0,0,1,0,Human Factor
1955-05-05 00:00:00,Hollinger Ungava Transport,Takeoff (climb),Commercial,Canada,North America,2,1,1,1,0,1,1,Unknown
1955-05-08 00:00:00,United States Air Force - USAF,Flight,Military / Government,United States of America,North America,14,4,0,10,1,1,13,Technical Failure
1955-05-28 00:00:00,Intercontinental Aviation,Flight,Operational,Switzerland,Europe,1,1,1,0,0,1,0,Unknown
1955-06-07 00:00:00,United States Air Force - USAF,Flight,Operational,United States of America,North America,9,9,1,0,0,1,8,Technical Failure
1955-07-23 00:00:00,Cambrian Airways,Flight,Commercial,United Kingdom,Europe,7,1,1,6,0,1,6,Technical Failure
1955-07-26 00:00:00,Brazilian Air Force - Força Aérea Brasileira,Landing (descent or approach),Operational,Brazil,South America,4,4,1,0,0,1,3,Unknown
1955-08-21 00:00:00,United States Air Force - USAF,Flight,Military / Government,Germany,Europe,1,1,1,0,0,1,0,Unknown
1955-08-25 00:00:00,United States Air Force - USAF,Flight,Military / Government,United States of America,North America,1,1,1,0,0,1,0,Unknown
1955-09-06 00:00:00,United States Air Force - USAF,Takeoff (climb),Military / Government,United States of America,North America,69,9,0,60,1,1,68,Weather
1955-09-29 00:00:00,Associated Airways,Flight,Operational,Canada,North America,2,2,1,0,0,1,1,Human Factor
1955-10-23 00:00:00,Lineas Aéreas de Transporte Nacional - LATN,Flight,Operational,Argentina,South America,1,1,1,0,0,1,0,Human Factor
1955-11-09 00:00:00,United States Air Force - USAF,Flight,Military / Government,World,World,5,5,1,0,0,1,4,Technical Failure
1955-12-22 00:00:00,Spartan Air Services,Flight,Operational,United Kingdom,Europe,6,6,1,0,0,1,5,Technical Failure
1956-01-12 00:00:00,Ansett Airways Pty. Ltd.,Landing (descent or approach),Operational,Australia,Oceania,2,2,1,0,0,1,1,Human Factor
1956-03-23 00:00:00,Aeroflot - Russian International Airlines,Flight,Commercial,Russia,Asia,5,2,0,3,1,1,4,Human Factor
1956-03-28 00:00:00,Starways,Landing (descent or approach),Operational,United Kingdom,Europe,3,3,1,0,0,1,2,Human Factor
1956-04-03 00:00:00,United States Air Force - USAF,Flight,Operational,United States of America,North America,6,6,1,0,0,1,5,Unknown
1956-07-02 00:00:00,Munz Airways,Flight,Commercial,United States of America,North America,1,1,1,0,0,1,0,Unknown
1956-07-12 00:00:00,TICAL,Landing (descent or approach),Commercial,Brazil,South America,5,3,1,2,0,1,4,Technical Failure
1956-07-30 00:00:00,Brazilian Air Force - Força Aérea Brasileira,Takeoff (climb),Military / Government,Brazil,South America,3,3,1,0,0,1,2,Unknown
1956-08-12 00:00:00,Argentinian Air Force - Fuerza Aérea Argentina,Takeoff (climb),Operational,Argentina,South America,1,1,1,0,0,1,0,Unknown
1956-08-16 00:00:00,United States Air Force - USAF,Landing (descent or approach),Humanitarian,Bahamas,Central America,13,13,1,0,0,1,12,Human Factor
1956-09-09 00:00:00,Jordan International Airlines,Landing (descent or approach),Commercial,Jordan,Asia,57,4,0,53,1,1,56,Technical Failure
1956-09-16 00:00:00,Aeroflot - Russian International Airlines,Landing (descent or approach),Operational,Russia,Asia,3,3,1,0,0,1,2,Human Factor
1956-09-18 00:00:00,Transports Aériens du Gabon,Flight,Operational,Cameroon,Africa,1,1,1,0,0,1,0,Human Factor
1956-10-04 00:00:00,French Navy,Flight,Military / Government,Algeria,Africa,4,4,1,0,0,1,3,Weather
1956-10-19 00:00:00,Aviation Enterprises,Flight,Military / Government,New Zealand,Oceania,1,1,1,0,0,1,0,Other
1956-10-30 00:00:00,Direction Générale de l'Aviation Civile - DGAC,Flight,Operational,Brazil,South America,7,3,0,4,1,1,6,Unknown
1956-11-18 00:00:00,Aeroflot - Russian International Airlines,Landing (descent or approach),Operational,Russia,Asia,5,4,1,1,0,1,4,Human Factor
1957-01-06 00:00:00,American Airlines,Landing (descent or approach),Commercial,United States of America,North America,10,3,0,7,1,1,9,Human Factor
1957-01-19 00:00:00,Pan American World Airways - PAA,Takeoff (climb),Other,United States of America,North America,1,1,1,0,0,1,0,Human Factor
1957-01-22 00:00:00,United States Navy - USN,Landing (descent or approach),Military / Government,United States of America,North America,7,7,1,0,0,1,6,Weather
1957-01-30 00:00:00,United States Air Force - USAF,Landing (descent or approach),Operational,United States of America,North America,2,2,1,0,0,1,1,Human Factor
1957-02-12 00:00:00,Aeroflot - Russian International Airlines,Landing (descent or approach),Operational,Russia,Asia,2,2,1,0,0,1,1,Human Factor
1957-02-27 00:00:00,Wanganui Aero Work,Flight,Military / Government,New Zealand,Oceania,1,1,1,0,0,1,0,Technical Failure
1957-04-13 00:00:00,Advance Aviation,Flight,Military / Government,New Zealand,Oceania,1,1,1,0,0,1,0,Unknown
1957-05-05 00:00:00,Indian Airlines,Takeoff (climb),Operational,India,Asia,3,3,1,0,0,1,2,Weather
1957-05-08 00:00:00,Indian Air Force - Bharatiya Vayu Sena,Flight,Military / Government,India,Asia,3,3,1,0,0,1,2,Unknown
1957-06-04 00:00:00,Mexican Navy - Armada de México,Flight,Military / Government,Mexico,Central America,8,8,1,0,0,1,7,Unknown
1957-06-09 00:00:00,Belgian Air Force - Force Aérienne Belge - Belgische Luchtmacht,Takeoff (climb),Military / Government,Democratic Republic of Congo,Africa,6,6,1,0,0,1,5,Technical Failure
1957-07-03 00:00:00,Spanish Air Force - Ejército del Aire,Takeoff (climb),Military / Government,Morocco,Africa,4,4,1,0,0,1,3,Unknown
1957-07-13 00:00:00,Nordair,Flight,Commercial,Canada,North America,4,1,0,3,1,1,3,Human Factor
1957-07-24 00:00:00,Swiss Government,Landing (descent or approach),Specialised Services,Switzerland,Europe,3,3,1,0,0,1,2,Technical Failure
1957-08-07 00:00:00,Aeroflot - Russian International Airlines,Landing (descent or approach),Commercial,Russia,Asia,17,5,1,12,0,1,16,Human Factor
1957-08-16 00:00:00,VARIG - Viação Aérea Rio Grandense,Flight,Operational,Dominican Republic,Central America,11,11,1,0,0,1,10,Technical Failure
1957-08-30 00:00:00,Northern Wings,Takeoff (climb),Operational,Canada,North America,1,1,1,0,0,1,0,Unknown
1957-09-18 00:00:00,Real Aerovias,Landing (descent or approach),Commercial,Uruguay,South America,35,5,1,30,0,1,34,Human Factor
1957-09-29 00:00:00,Northland Districts Aero Club,Takeoff (climb),Commercial,New Zealand,Oceania,5,1,0,4,1,1,4,Technical Failure
1957-10-27 00:00:00,Polyarnaya Aviatsiya,Landing (descent or approach),Operational,Russia,Asia,6,6,1,0,0,1,5,Human Factor
1957-12-17 00:00:00,Meridian Air Maps,Flight,Operational,United Kingdom,Europe,1,1,1,0,0,1,0,Unknown
1958-01-15 00:00:00,Alaska Coastal Airlines,Landing (descent or approach),Commercial,United States of America,North America,3,1,1,2,0,1,2,Technical Failure
1958-02-04 00:00:00,Royal Air Force - RAF,Landing (descent or approach),Military / Government,Yemen,Asia,10,3,1,7,0,1,9,Technical Failure
1958-03-12 00:00:00,Brazilian Air Force - Força Aérea Brasileira,Flight,Operational,Brazil,South America,4,4,1,0,0,1,3,Unknown
1958-04-29 00:00:00,Antonov Industries,Takeoff (climb),Specialised Services,Russia,Asia,5,5,1,0,0,1,4,Technical Failure
1958-06-02 00:00:00,Pan American World Airways - PAA,Landing (descent or approach),Commercial,Philippines,Asia,57,8,0,49,1,1,56,Weather
1958-06-04 00:00:00,Capital Airlines,Landing (descent or approach),Operational,United States of America,North America,3,3,1,0,0,1,2,Human Factor
1958-07-08 00:00:00,Gibbes Sepik Airways,Landing (descent or approach),Operational,Papua New Guinea,Oceania,1,1,1,0,0,1,0,Weather
1958-07-29 00:00:00,United States Air Force - USAF,Landing (descent or approach),Operational,United States of America,North America,9,9,1,0,0,1,8,Human Factor
1958-08-09 00:00:00,Aklavik Import %26 Export Company,Flight,Operational,United States of America,North America,2,2,1,0,0,1,1,Unknown
1958-08-20 00:00:00,Alaska Coastal Airlines,Flight,Commercial,United States of America,North America,9,1,0,8,1,1,8,Human Factor
1958-09-05 00:00:00,Aeroflot - Russian International Airlines,Flight,Commercial,Estonia,Europe,17,6,0,11,1,1,16,Terrorism
1958-09-15 00:00:00,Austin Airways,Landing (descent or approach),Operational,Canada,North America,1,1,1,0,0,1,0,Technical Failure
1958-09-17 00:00:00,United States Air Force - USAF,Landing (descent or approach),Military / Government,United States of America,North America,8,8,1,0,0,1,7,Technical Failure
1958-10-19 00:00:00,Bohman Airways,Flight,Operational,Canada,North America,1,1,1,0,0,1,0,Unknown
1958-11-29 00:00:00,Royal Australian Air Force - RAAF,Takeoff (climb),Military / Government,Australia,Oceania,1,1,1,0,0,1,0,Human Factor
1958-12-07 00:00:00,Aeroflot - Russian International Airlines,Landing (descent or approach),Commercial,Russia,Asia,25,6,1,19,0,1,24,Human Factor
1959-01-20 00:00:00,Wien Alaska Airlines,Takeoff (climb),Operational,United States of America,North America,1,1,1,0,0,1,0,Technical Failure
1959-03-13 00:00:00,Aviaco - Aviacion y Comercio,Landing (descent or approach),Commercial,Spain,Europe,18,3,0,15,1,1,17,Weather
1959-03-14 00:00:00,Gold Belt Air Service,Takeoff (climb),Operational,Canada,North America,1,1,1,0,0,1,0,Human Factor
1959-04-02 00:00:00,United States Navy - USN,Landing (descent or approach),Military / Government,Canada,North America,29,4,0,25,1,1,28,Technical Failure
1959-05-20 00:00:00,United States Air Force - USAF,Landing (descent or approach),Military / Government,Japan,Asia,9,9,1,0,0,1,8,Unknown
1959-06-07 00:00:00,United States Air Force - USAF,Flight,Military / Government,World,World,7,7,1,0,0,1,6,Technical Failure
1959-06-19 00:00:00,ASPA - Aspersiones Antes,Flight,Commercial,Colombia,South America,8,1,1,7,0,1,7,Technical Failure
1959-06-30 00:00:00,Royal Canadian Air Force - RCAF,Landing (descent or approach),Military / Government,Canada,North America,9,9,1,0,0,1,8,Other
1959-08-02 00:00:00,Cuban Air Force - Fuerza Aérea del Ejército de Cuba,Takeoff (climb),Operational,Cuba,Central America,3,3,1,0,0,1,2,Technical Failure
1959-09-12 00:00:00,Adastra Aviation,Flight,Military / Government,New Zealand,Oceania,1,1,1,0,0,1,0,Human Factor
1959-10-26 00:00:00,Pacific Air Lines,Takeoff (climb),Commercial,United States of America,North America,20,3,1,17,0,1,19,Technical Failure
1959-10-27 00:00:00,Aeroflot - Russian International Airlines,Landing (descent or approach),Commercial,Kazakhstan,Asia,29,3,0,26,1,1,28,Human Factor
1959-11-01 00:00:00,Adastra Aviation,Flight,Military / Government,New Zealand,Oceania,1,1,1,0,0,1,0,Human Factor
1959-11-09 00:00:00,Argentinian Air Force - Fuerza Aérea Argentina,Landing (descent or approach),Military / Government,Argentina,South America,1,1,1,0,0,1,0,Unknown
1959-11-13 00:00:00,Brazilian Air Force - Força Aérea Brasileira,Landing (descent or approach),Military / Government,Brazil,South America,6,6,1,0,0,1,5,Unknown
1959-11-19 00:00:00,Robby's Aerial Services,Flight,Military / Government,Australia,Oceania,1,1,1,0,0,1,0,Unknown
1959-12-17 00:00:00,Aeroflot - Russian International Airlines,Takeoff (climb),Commercial,Lithuania,Europe,9,5,1,4,0,1,8,Human Factor
1959-12-21 00:00:00,Aerial Farming,Flight,Military / Government,New Zealand,Oceania,1,1,1,0,0,1,0,Unknown
1959-12-24 00:00:00,Garuda Indonesian Airways,Landing (descent or approach),Operational,Indonesia,Asia,2,2,1,0,0,1,1,Technical Failure
1960-01-15 00:00:00,Aeroflot - Russian International Airlines,Flight,Operational,Russia,Asia,4,4,1,0,0,1,3,Technical Failure
1960-04-27 00:00:00,Aeroflot - Russian International Airlines,Landing (descent or approach),Operational,Russia,Asia,5,5,1,0,0,1,4,Human Factor
1960-06-25 00:00:00,Lineas Aéreas Costarricenses - LACSA,Takeoff (climb),Commercial,Costa Rica,Central America,13,3,0,10,1,1,12,Unknown
1960-07-14 00:00:00,Northwest Airlines,Flight,Commercial,World,World,58,7,0,51,1,1,57,Technical Failure
1960-07-15 00:00:00,Sherwood Aviation,Takeoff (climb),Military / Government,New Zealand,Oceania,1,1,1,0,0,1,0,Other
1960-07-15 00:00:00,Ethiopian Airlines,Landing (descent or approach),Commercial,Ethiopia,Africa,11,3,1,8,0,1,10,Human Factor
1960-07-31 00:00:00,Deutsche Flugdienst,Landing (descent or approach),Commercial,Italy,Europe,34,4,0,30,1,1,33,Technical Failure
1960-09-26 00:00:00,Aeroflot - Russian International Airlines,Landing (descent or approach),Commercial,Belarus,Europe,27,6,1,21,0,1,26,Human Factor
1960-11-18 00:00:00,United States Air Force - USAF,Landing (descent or approach),Operational,United States of America,North America,17,5,0,12,1,1,16,Human Factor
1960-12-09 00:00:00,United States Air Force - USAF,Flight,Operational,United States of America,North America,9,9,1,0,0,1,8,Human Factor
1960-12-21 00:00:00,Private American,Landing (descent or approach),Business,Spain,Europe,1,1,1,0,0,1,0,Technical Failure
1960-12-27 00:00:00,United States Air Force - USAF,Flight,Military / Government,United States of America,North America,1,1,1,0,0,1,0,Human Factor
1961-01-19 00:00:00,United States Air Force - USAF,Flight,Operational,United States of America,North America,7,7,1,0,0,1,6,Weather
1961-01-30 00:00:00,Aeroflot - Russian International Airlines,Takeoff (climb),Operational,Russia,Asia,4,4,1,0,0,1,3,Human Factor
1961-02-05 00:00:00,Aircraft Service,Flight,Military / Government,New Zealand,Oceania,1,1,1,0,0,1,0,Technical Failure
1961-03-02 00:00:00,Royal Air Force - RAF,Flight,Military / Government,Tanzania,Africa,1,1,1,0,0,1,0,Unknown
1961-03-08 00:00:00,Papuan Air Transport - Patair,Flight,Operational,Papua New Guinea,Oceania,1,1,1,0,0,1,0,Human Factor
1961-03-29 00:00:00,Aerotaxi Servicios Aéreos,Flight,Operational,Colombia,South America,1,1,1,0,0,1,0,Unknown
1961-04-17 00:00:00,Cuban Air Force - Fuerza Aérea del Ejército de Cuba,Flight,Military / Government,Cuba,Central America,2,2,1,0,0,1,1,Terrorism
1961-04-18 00:00:00,Aeroflot - Russian International Airlines,Flight,Military / Government,Russia,Asia,2,2,1,0,0,1,1,Human Factor
1961-06-17 00:00:00,Continentale Deutsche Luftreederei,Landing (descent or approach),Operational,Nigeria,Africa,7,5,0,2,1,1,6,Human Factor
1961-07-10 00:00:00,Aeroflot - Russian International Airlines,Landing (descent or approach),Commercial,Ukraine,Europe,94,9,1,85,0,1,93,Human Factor
1961-08-29 00:00:00,Eastern Provincial Airways - EPA,Takeoff (climb),Commercial,Greenland,Europe,6,2,1,4,0,1,5,Technical Failure
1961-09-12 00:00:00,CAMBA Transportes Aéreos - Comercializadora Aérea Mixta Boliviana,Landing (descent or approach),Operational,Bolivia,South America,3,3,1,0,0,1,2,Human Factor
1961-09-20 00:00:00,James Aviation,Flight,Military / Government,New Zealand,Oceania,1,1,1,0,0,1,0,Other
1961-10-12 00:00:00,Indian Air Force - Bharatiya Vayu Sena,Takeoff (climb),Military / Government,India,Asia,4,4,1,0,0,1,3,Technical Failure
1961-12-24 00:00:00,Kodiak Airways,Takeoff (climb),Commercial,United States of America,North America,5,1,0,4,1,1,4,Human Factor
1962-01-06 00:00:00,TAN Airlines - Transportes Aéreos Nacionales de Honduras,Takeoff (climb),Operational,Belize,Central America,2,2,1,0,0,1,1,Technical Failure
1962-01-24 00:00:00,British Army Air Corps,Flight,Military / Government,Belgium,Europe,1,1,1,0,0,1,0,Unknown
1962-01-27 00:00:00,Aeroflot - Russian International Airlines,Takeoff (climb),Operational,Russia,Asia,3,3,1,0,0,1,2,Human Factor
1962-03-15 00:00:00,Flying Tiger Line,Landing (descent or approach),Operational,United States of America,North America,7,7,1,0,0,1,6,Human Factor
1962-03-20 00:00:00,Aeroflot - Russian International Airlines,Landing (descent or approach),Commercial,Russia,Asia,7,2,0,5,1,1,6,Human Factor
1962-06-03 00:00:00,Aeroflot - Russian International Airlines,Flight,Operational,Turkmenistan,Asia,2,2,1,0,0,1,1,Technical Failure
1962-07-04 00:00:00,Spanish Air Force - Ejército del Aire,Landing (descent or approach),Military / Government,Spain,Europe,44,4,0,40,1,1,43,Weather
1962-10-07 00:00:00,Caspair,Landing (descent or approach),Commercial,Uganda,Africa,5,1,1,4,0,1,4,Human Factor
1962-12-19 00:00:00,Aeroflot - Russian International Airlines,Landing (descent or approach),Commercial,Russia,Asia,14,2,1,12,0,1,13,Human Factor
1962-12-22 00:00:00,VARIG - Viação Aérea Rio Grandense,Landing (descent or approach),Commercial,Brazil,South America,40,5,1,35,0,1,39,Human Factor
1962-12-28 00:00:00,Channel Air Bridge,Landing (descent or approach),Commercial,Netherlands,Europe,18,4,1,14,0,1,17,Human Factor
1963-01-19 00:00:00,James Aviation,Flight,Military / Government,New Zealand,Oceania,1,1,1,0,0,1,0,Unknown
1963-01-22 00:00:00,Transair Canada,Flight,Operational,Canada,North America,1,1,1,0,0,1,0,Technical Failure
1963-01-26 00:00:00,Skyvan Airways,Landing (descent or approach),Operational,United States of America,North America,2,2,1,0,0,1,1,Weather
1963-02-04 00:00:00,United States Air Force - USAF,Takeoff (climb),Military / Government,United States of America,North America,20,2,0,18,1,1,19,Technical Failure
1963-04-01 00:00:00,Aeroflot - Russian International Airlines,Landing (descent or approach),Operational,Ukraine,Europe,5,5,1,0,0,1,4,Human Factor
1963-04-07 00:00:00,Syrianair - Syrian Arab Airlines,Takeoff (climb),Commercial,Syria,Asia,30,4,0,26,1,1,29,Unknown
1963-04-27 00:00:00,Private New Zealand,Flight,Business,New Zealand,Oceania,2,1,0,1,1,1,1,Human Factor
1963-06-09 00:00:00,Aeroflot - Russian International Airlines,Flight,Military / Government,Uzbekistan,Asia,2,2,1,0,0,1,1,Human Factor
1963-06-21 00:00:00,United States Air Force - USAF,Landing (descent or approach),Operational,United States of America,North America,4,4,1,0,0,1,3,Unknown
1963-07-01 00:00:00,United States Army,Takeoff (climb),Military / Government,Vietnam,Asia,1,1,1,0,0,1,0,Weather
1963-07-24 00:00:00,Aeroflot - Russian International Airlines,Takeoff (climb),Business,Kazakhstan,Asia,1,1,1,0,0,1,0,Human Factor
1963-08-14 00:00:00,Aaxico Airlines - American Air Export %26 Import Company,Flight,Operational,United States of America,North America,2,2,1,0,0,1,1,Technical Failure
1963-08-31 00:00:00,Aeroflot - Russian International Airlines,Takeoff (climb),Commercial,Armenia,Asia,16,2,0,14,1,1,15,Human Factor
1963-08-31 00:00:00,Aeroflot - Russian International Airlines,Flight,Specialised Services,Russia,Asia,8,7,1,1,0,1,7,Technical Failure
1963-09-10 00:00:00,Aerial Agriculture,Flight,Military / Government,Australia,Oceania,1,1,1,0,0,1,0,Technical Failure
1963-10-21 00:00:00,Adastra Aviation,Takeoff (climb),Military / Government,New Zealand,Oceania,1,1,1,0,0,1,0,Human Factor
1963-11-29 00:00:00,Purdue University Airlines,Landing (descent or approach),Operational,United States of America,North America,3,3,1,0,0,1,2,Human Factor
1964-01-03 00:00:00,Private American,Flight,Business,United States of America,North America,1,1,1,0,0,1,0,Human Factor
1964-01-29 00:00:00,Aeroflot - Russian International Airlines,Takeoff (climb),Commercial,Azerbaijan,Asia,22,3,1,19,0,1,21,Human Factor
1964-01-29 00:00:00,Brazilian Air Force - Força Aérea Brasileira,Flight,Operational,Brazil,South America,6,6,1,0,0,1,5,Unknown
1964-02-08 00:00:00,Argentinian Air Force - Fuerza Aérea Argentina,Flight,Operational,Argentina,South America,2,2,1,0,0,1,1,Unknown
1964-03-02 00:00:00,Aerotaxi Servicios Aéreos,Flight,Commercial,Colombia,South America,2,1,1,1,0,1,1,Terrorism
1964-03-05 00:00:00,Private American,Flight,Business,United States of America,North America,4,1,1,3,0,1,3,Weather
1964-03-08 00:00:00,Hansen Air Activities,Landing (descent or approach),Commercial,United States of America,North America,30,2,1,28,0,1,29,Weather
1964-05-13 00:00:00,Aeroflot - Russian International Airlines,Landing (descent or approach),Military / Government,Ukraine,Europe,3,2,1,1,0,1,2,Human Factor
1964-05-15 00:00:00,United States Navy - USN,Flight,Military / Government,Ecuador,South America,11,4,1,7,0,1,10,Unknown
1964-06-03 00:00:00,Private American,Landing (descent or approach),Business,United States of America,North America,1,1,1,0,0,1,0,Human Factor
1964-06-09 00:00:00,Private American,Takeoff (climb),Business,Mexico,Central America,1,1,1,0,0,1,0,Unknown
1964-06-21 00:00:00,TASSA Transportes Aéreos,Takeoff (climb),Commercial,Spain,Europe,28,3,0,25,1,1,27,Technical Failure
1964-06-28 00:00:00,Moseley Aviation,Flight,Humanitarian,United States of America,North America,1,1,1,0,0,1,0,Unknown
1964-07-03 00:00:00,Aeroflot - Russian International Airlines,Flight,Military / Government,Russia,Asia,2,2,1,0,0,1,1,Human Factor
1964-07-04 00:00:00,Saskatchewan Government Airways,Takeoff (climb),Operational,Canada,North America,1,1,1,0,0,1,0,Human Factor
1964-07-07 00:00:00,Wanganui Aero Work,Flight,Operational,New Zealand,Oceania,1,1,1,0,0,1,0,Human Factor
1964-07-09 00:00:00,Aerial Agriculture,Flight,Military / Government,Australia,Oceania,1,1,1,0,0,1,0,Unknown
1964-07-14 00:00:00,Brazilian Air Force - Força Aérea Brasileira,Landing (descent or approach),Military / Government,Brazil,South America,5,2,0,3,1,1,4,Unknown
1964-08-16 00:00:00,VASP - Viação Aérea de São Paulo,Flight,Operational,Brazil,South America,4,4,1,0,0,1,3,Technical Failure
1964-08-24 00:00:00,Spartan Air Services,Flight,Business,Canada,North America,1,1,1,0,0,1,0,Human Factor
1964-09-08 00:00:00,Private American,Landing (descent or approach),Business,United States of America,North America,1,1,1,0,0,1,0,Human Factor
1964-09-09 00:00:00,Houston Beech Airlines,Flight,Operational,United States of America,North America,1,1,1,0,0,1,0,Human Factor
1964-10-02 00:00:00,Alaska Coastal-Ellis Airlines,Landing (descent or approach),Operational,United States of America,North America,3,3,1,0,0,1,2,Human Factor
1964-10-02 00:00:00,Interocean Airways,Landing (descent or approach),Operational,Ethiopia,Africa,7,7,1,0,0,1,6,Human Factor
1964-10-04 00:00:00,Southeast Airmotive,Landing (descent or approach),Operational,United States of America,North America,1,1,1,0,0,1,0,Human Factor
1964-11-18 00:00:00,Aeroflot - Russian International Airlines,Flight,Operational,Russia,Asia,2,2,1,0,0,1,1,Human Factor
1964-12-21 00:00:00,Fleming Airways System Transport,Flight,Commercial,Philippines,Asia,39,3,1,36,0,1,38,Human Factor
1964-12-24 00:00:00,Servicio Aéreo de Transportes Comerciales - SATCO,Takeoff (climb),Commercial,Peru,South America,23,3,1,20,0,1,22,Unknown
1964-12-28 00:00:00,British Antarctic Survey - BAS,Landing (descent or approach),Operational,Antarctica,Antarctica,1,1,1,0,0,1,0,Unknown
1965-01-14 00:00:00,Turkish Air Force - Türk Hava Kuvvetleri,Takeoff (climb),Military / Government,Turkey,Asia,0,0,1,0,0,1,-1,Unknown
1965-01-24 00:00:00,Private American,Flight,Business,United States of America,North America,1,1,1,0,0,1,0,Human Factor
1965-02-02 00:00:00,Aeroflot - Russian International Airlines,Flight,Military / Government,Belarus,Europe,3,2,0,1,1,1,2,Human Factor
1965-02-02 00:00:00,Private American,Landing (descent or approach),Operational,Bahamas,Central America,1,1,1,0,0,1,0,Technical Failure
1965-05-12 00:00:00,Hamburger Flugzeugbau,Flight,Operational,Spain,Europe,3,3,1,0,0,1,2,Human Factor
1965-05-26 00:00:00,Air Contracts,Takeoff (climb),Military / Government,New Zealand,Oceania,1,1,1,0,0,1,0,Human Factor
1965-05-30 00:00:00,Economy Leasing Company,Flight,Business,United States of America,North America,1,1,1,0,0,1,0,Human Factor
1965-06-02 00:00:00,Air Lloyd,Flight,Operational,Germany,Europe,1,1,1,0,0,1,0,Human Factor
1965-06-04 00:00:00,TAM Paraguay - Transporte Aéreo Militar,Landing (descent or approach),Military / Government,Paraguay,South America,31,4,1,27,0,1,30,Technical Failure
1965-06-15 00:00:00,French Air Force - Armée de l'Air,,Military / Government,Mauritania,Africa,0,0,1,0,0,1,-1,Unknown
1965-06-23 00:00:00,Newfoundland %26 Labrador Forestry Service,Landing (descent or approach),Humanitarian,Canada,North America,2,2,1,0,0,1,1,Unknown
1965-07-21 00:00:00,Aeroflot - Russian International Airlines,Flight,Commercial,Russia,Asia,12,2,1,10,0,1,11,Human Factor
1965-07-22 00:00:00,Mid-Valley Dusters,Flight,Military / Government,United States of America,North America,1,1,1,0,0,1,0,Weather
1965-08-16 00:00:00,Argentinian Air Force - Fuerza Aérea Argentina,Flight,Operational,Argentina,South America,2,2,1,0,0,1,1,Unknown
1965-08-25 00:00:00,Aeroflot - Russian International Airlines,Flight,Military / Government,Lithuania,Europe,1,1,1,0,0,1,0,Human Factor
1965-09-05 00:00:00,Aeroflot - Russian International Airlines,Landing (descent or approach),Operational,Russia,Asia,2,2,1,0,0,1,1,Human Factor
1965-09-12 00:00:00,United States Navy - USN,Takeoff (climb),Military / Government,World,World,10,10,1,0,0,1,9,Unknown
1965-09-18 00:00:00,Brazilian Air Force - Força Aérea Brasileira,Flight,Operational,Brazil,South America,4,4,1,0,0,1,3,Unknown
1965-10-03 00:00:00,Air America,Landing (descent or approach),Operational,Laos,Asia,3,3,1,0,0,1,2,Unknown
1965-10-11 00:00:00,Northland Air Manitoba,Flight,Operational,Canada,North America,1,1,1,0,0,1,0,Unknown
1965-10-20 00:00:00,Philippine Airlines - PAL,Takeoff (climb),Commercial,Philippines,Asia,37,3,0,34,1,1,36,Human Factor
1965-12-10 00:00:00,United States Army,Flight,Operational,United States of America,North America,1,1,1,0,0,1,0,Unknown
1965-12-10 00:00:00,United States Navy - USN,Flight,Operational,United States of America,North America,10,10,1,0,0,1,9,Other
1965-12-12 00:00:00,Private German,Takeoff (climb),Business,Switzerland,Europe,9,2,1,7,0,1,8,Human Factor
1966-01-15 00:00:00,Skyway Air Cargo,Landing (descent or approach),Operational,United States of America,North America,1,1,1,0,0,1,0,Human Factor
1966-01-30 00:00:00,Aeroflot - Russian International Airlines,Flight,Operational,Ukraine,Europe,6,6,1,0,0,1,5,Human Factor
1966-02-06 00:00:00,Dart Aero,Flight,Business,United States of America,North America,1,1,1,0,0,1,0,Unknown
1966-03-04 00:00:00,Philip L. Taylor,Flight,Business,United States of America,North America,1,1,1,0,0,1,0,Human Factor
1966-04-14 00:00:00,Renkenberger,Flight,Operational,United States of America,North America,1,1,1,0,0,1,0,Human Factor
1966-05-21 00:00:00,Skyway Air Cargo,Takeoff (climb),Operational,United States of America,North America,1,1,1,0,0,1,0,Unknown
1966-05-29 00:00:00,Continental Air Services,Flight,Commercial,Laos,Asia,1,1,1,0,0,1,0,Unknown
1966-06-10 00:00:00,Jack Adams Air,Flight,Operational,United States of America,North America,1,1,1,0,0,1,0,Human Factor
1966-06-14 00:00:00,Royal Air Force - RAF,Flight,Operational,United Kingdom,Europe,7,7,1,0,0,1,6,Human Factor
1966-06-24 00:00:00,Aeroflot - Russian International Airlines,Flight,Military / Government,Armenia,Asia,3,2,0,1,1,1,2,Human Factor
1966-08-18 00:00:00,Aerovias Halcón,Flight,Operational,Argentina,South America,16,4,1,12,0,1,15,Technical Failure
1966-09-09 00:00:00,Aeroflot - Russian International Airlines,Flight,Commercial,Georgia,Asia,12,2,0,10,1,1,11,Technical Failure
1966-09-16 00:00:00,Iberia - Lineas Aéreas de Espana,Takeoff (climb),Commercial,Spain,Europe,27,3,0,24,1,1,26,Technical Failure
1966-09-18 00:00:00,Alamo Airways,Takeoff (climb),Commercial,United States of America,North America,6,1,1,5,0,1,5,Technical Failure
1966-10-13 00:00:00,BBR Drilling,Takeoff (climb),Business,United States of America,North America,5,1,0,4,1,1,4,Technical Failure
1966-10-28 00:00:00,United States Air Force - USAF,Flight,Military / Government,Vietnam,Asia,3,3,1,0,0,1,2,Human Factor
1966-11-22 00:00:00,Kellogg Company,Landing (descent or approach),Business,Bahamas,Central America,2,1,0,1,1,1,1,Human Factor
1966-11-28 00:00:00,Robertson Air Service,Flight,Military / Government,New Zealand,Oceania,1,1,1,0,0,1,0,Human Factor
1966-12-02 00:00:00,Parkway Corp.,Flight,Business,United States of America,North America,1,1,1,0,0,1,0,Human Factor
1966-12-09 00:00:00,R.D. Marcotte %26 Associates,Takeoff (climb),Business,United States of America,North America,1,1,1,0,0,1,0,Technical Failure
1967-01-01 00:00:00,Indian Air Force - Bharatiya Vayu Sena,Landing (descent or approach),Operational,India,Asia,3,3,1,0,0,1,2,Unknown
1967-01-12 00:00:00,Royal Malaysian Air Force - Tentera Udara Diraja Malaysia,Landing (descent or approach),Military / Government,Malaysia,Asia,9,9,1,0,0,1,8,Unknown
1967-01-18 00:00:00,World Wide Helicopters,Flight,Operational,United Kingdom,Europe,1,1,1,0,0,1,0,Human Factor
1967-02-08 00:00:00,United States Coast Guard - USCG,Landing (descent or approach),Military / Government,United States of America,North America,8,8,1,0,0,1,7,Unknown
1967-02-21 00:00:00,Rosendin Electric,Landing (descent or approach),Business,United States of America,North America,5,1,1,4,0,1,4,Technical Failure
1967-02-21 00:00:00,Barr Bros,Flight,Military / Government,New Zealand,Oceania,1,1,1,0,0,1,0,Human Factor
1967-02-22 00:00:00,Cannon Aircraft,Flight,Operational,United States of America,North America,1,1,1,0,0,1,0,Human Factor
1967-03-13 00:00:00,Aeroflot - Russian International Airlines,Flight,Business,World,World,1,1,1,0,0,1,0,Terrorism
1967-04-24 00:00:00,United States Forest Service - USFS,Flight,Operational,United States of America,North America,3,3,1,0,0,1,2,Human Factor
1967-04-27 00:00:00,Vicksburg Air,Flight,Operational,United States of America,North America,1,1,1,0,0,1,0,Technical Failure
1967-04-28 00:00:00,Private American,Flight,Business,United States of America,North America,1,1,1,0,0,1,0,Technical Failure
1967-05-02 00:00:00,Mikal Corporation,Takeoff (climb),Operational,United States of America,North America,2,1,1,1,0,1,1,Human Factor
1967-05-27 00:00:00,Catalina-Vegas Airlines,Takeoff (climb),Commercial,United States of America,North America,4,2,1,2,0,1,3,Human Factor
1967-06-11 00:00:00,Aeroflot - Russian International Airlines,Flight,Military / Government,Russia,Asia,2,2,1,0,0,1,1,Unknown
1967-06-12 00:00:00,Private American,Flight,Business,World,World,1,1,1,0,0,1,0,Unknown
1967-06-23 00:00:00,Northland Air Manitoba,Landing (descent or approach),Commercial,Canada,North America,2,1,1,1,0,1,1,Human Factor
1967-07-17 00:00:00,United States Air Force - USAF,Takeoff (climb),Operational,United States of America,North America,5,5,1,0,0,1,4,Human Factor
1967-07-28 00:00:00,Aeroflot - Russian International Airlines,Flight,Operational,Russia,Asia,3,3,1,0,0,1,2,Human Factor
1967-08-01 00:00:00,Aerovias Darienitas SA,Flight,Commercial,Panama,Central America,7,1,1,6,0,1,6,Technical Failure
1967-08-14 00:00:00,Aviation Communications,Flight,Military / Government,Greenland,Europe,3,2,1,1,0,1,2,Human Factor
1967-09-22 00:00:00,United States Army,Landing (descent or approach),Operational,Vietnam,Asia,2,2,1,0,0,1,1,Human Factor
1967-10-21 00:00:00,Marian Air Service,Flight,Military / Government,United States of America,North America,1,1,1,0,0,1,0,Human Factor
1967-10-25 00:00:00,United States Air Force - USAF,Takeoff (climb),Military / Government,Vietnam,Asia,5,5,1,0,0,1,4,Human Factor
1967-10-29 00:00:00,Mid-Continent Airlines,Landing (descent or approach),Business,United States of America,North America,1,1,1,0,0,1,0,Human Factor
1967-11-05 00:00:00,Cathay Pacific Airways,Takeoff (climb),Commercial,China,Asia,127,11,0,116,1,1,126,Technical Failure
1967-11-06 00:00:00,Trans World Airlines - TWA,Takeoff (climb),Commercial,United States of America,North America,36,7,0,29,1,1,35,Human Factor
1967-11-08 00:00:00,Sécurité civile française,Landing (descent or approach),Operational,France,Europe,4,4,1,0,0,1,3,Unknown
1967-11-17 00:00:00,Air America,Takeoff (climb),Military / Government,Vietnam,Asia,6,1,1,5,0,1,5,Unknown
1967-11-26 00:00:00,Executive Aviation,Flight,Business,United States of America,North America,1,1,1,0,0,1,0,Human Factor
1968-01-09 00:00:00,United States Air Force - USAF,Landing (descent or approach),Military / Government,Italy,Europe,7,2,0,5,1,1,6,Technical Failure
1968-01-12 00:00:00,Ohio Valley Aviation,Flight,Operational,United States of America,North America,1,1,1,0,0,1,0,Human Factor
1968-01-21 00:00:00,United States Air Force - USAF,Flight,Military / Government,Greenland,Europe,7,7,1,0,0,1,6,Technical Failure
1968-02-07 00:00:00,Canadian Pacific Airlines - CP Air,Landing (descent or approach),Commercial,Canada,North America,61,9,1,52,0,1,60,Human Factor
1968-03-02 00:00:00,Miller Aviation,Landing (descent or approach),Operational,United States of America,North America,3,2,1,1,0,1,2,Technical Failure
1968-03-07 00:00:00,Rexall Drug and Chemical Corporation,Flight,Business,United States of America,North America,1,1,1,0,0,1,0,Weather
1968-03-07 00:00:00,Aeroflot - Russian International Airlines,Takeoff (climb),Commercial,Russia,Asia,49,5,1,44,0,1,48,Human Factor
1968-03-26 00:00:00,Airland,Flight,Military / Government,New Zealand,Oceania,1,1,1,0,0,1,0,Weather
1968-03-31 00:00:00,United States Army,Flight,Military / Government,Taiwan,Asia,1,1,1,0,0,1,0,Unknown
1968-04-13 00:00:00,United States Air Force - USAF,Landing (descent or approach),Military / Government,Vietnam,Asia,8,7,0,1,1,1,7,Technical Failure
1968-04-20 00:00:00,ABC-PRS Airways,Flight,Operational,Puerto Rico,Central America,1,1,1,0,0,1,0,Unknown
1968-05-15 00:00:00,Midstate Air Commuter,Takeoff (climb),Operational,United States of America,North America,1,1,1,0,0,1,0,Technical Failure
1968-05-16 00:00:00,Aeroflot - Russian International Airlines,Flight,Military / Government,Russia,Asia,1,1,1,0,0,1,0,Technical Failure
1968-05-24 00:00:00,Private American,Takeoff (climb),Business,United States of America,North America,1,1,1,0,0,1,0,Weather
1968-05-29 00:00:00,The First Electric,Flight,Business,United States of America,North America,1,1,1,0,0,1,0,Human Factor
1968-05-30 00:00:00,Aeroflot - Russian International Airlines,Flight,Military / Government,Russia,Asia,2,1,0,1,1,1,1,Human Factor
1968-07-01 00:00:00,Kansas City Life Insurance Company,Landing (descent or approach),Business,United States of America,North America,8,2,0,6,1,1,7,Human Factor
1968-07-19 00:00:00,Continental Services,Flight,Business,United States of America,North America,1,1,1,0,0,1,0,Weather
1968-08-04 00:00:00,Private Canadian,Takeoff (climb),Business,Canada,North America,4,1,1,3,0,1,3,Human Factor
1968-08-13 00:00:00,Robertson Air Service,Flight,Military / Government,New Zealand,Oceania,1,1,1,0,0,1,0,Human Factor
1968-09-18 00:00:00,ANDES Ecuador - Aerolineas Nacionales del Ecuador,Takeoff (climb),Operational,Nicaragua,Central America,2,2,1,0,0,1,1,Unknown
1968-09-19 00:00:00,Bulair,Flight,Military / Government,Bulgaria,Europe,1,1,1,0,0,1,0,Unknown
1968-09-29 00:00:00,Catalina Seaplanes,Flight,Operational,United States of America,North America,1,1,1,0,0,1,0,Unknown
1968-11-07 00:00:00,Flo Air,Takeoff (climb),Specialised Services,United States of America,North America,1,1,1,0,0,1,0,Human Factor
1968-11-07 00:00:00,Jet Set Aviation,Landing (descent or approach),Operational,United States of America,North America,1,1,1,0,0,1,0,Other
1968-12-06 00:00:00,Butler Aviation,Landing (descent or approach),Operational,Denmark,Europe,1,1,1,0,0,1,0,Unknown
1968-12-07 00:00:00,Private American,Takeoff (climb),Business,United States of America,North America,1,1,1,0,0,1,0,Human Factor
1968-12-13 00:00:00,Harbour Air,Takeoff (climb),Commercial,Canada,North America,2,1,1,1,0,1,1,Human Factor
1968-12-18 00:00:00,Combs FreightAir,Takeoff (climb),Commercial,United States of America,North America,7,1,0,6,1,1,6,Human Factor
1968-12-18 00:00:00,Combs FreightAir,Flight,Operational,United States of America,North America,1,1,1,0,0,1,0,Technical Failure
1968-12-27 00:00:00,Brazilian Air Force - Força Aérea Brasileira,Landing (descent or approach),Military / Government,Brazil,South America,2,2,1,0,0,1,1,Human Factor
1969-01-18 00:00:00,L. Chesterfield,Flight,Business,United States of America,North America,1,1,1,0,0,1,0,Weather
1969-03-13 00:00:00,Wien Consolidated Airlines,Landing (descent or approach),Commercial,United States of America,North America,5,1,0,4,1,1,4,Human Factor
1969-03-22 00:00:00,Meeco Marinas Inc.,Takeoff (climb),Business,United States of America,North America,4,1,1,3,0,1,3,Human Factor
1969-04-07 00:00:00,Air Canada,Landing (descent or approach),Commercial,Canada,North America,20,4,0,16,1,1,19,Technical Failure
1969-04-24 00:00:00,Ghana Airways,Landing (descent or approach),Commercial,Ghana,Africa,33,3,0,30,1,1,32,Technical Failure
1969-05-23 00:00:00,United States Air Force - USAF,Flight,Military / Government,World,World,1,1,1,0,0,1,0,Human Factor
1969-05-23 00:00:00,Kimex,Landing (descent or approach),Operational,Venezuela,South America,4,2,1,2,0,1,3,Technical Failure
1969-05-24 00:00:00,Private American,Flight,Military / Government,United States of America,North America,1,1,1,0,0,1,0,Human Factor
1969-05-25 00:00:00,Aero Trasporti Italiani - ATI,Landing (descent or approach),Commercial,Italy,Europe,36,5,0,31,1,1,35,Human Factor
1969-05-28 00:00:00,Midstate Aviation,Flight,Operational,United States of America,North America,1,1,1,0,0,1,0,Human Factor
1969-06-06 00:00:00,Air West BC,Flight,Operational,Canada,North America,1,1,1,0,0,1,0,Unknown
1969-07-23 00:00:00,Airwest Airlines,Landing (descent or approach),Commercial,United States of America,North America,2,1,0,1,1,1,1,Human Factor
1969-07-25 00:00:00,Trans Isle Air,Flight,Commercial,United States of America,North America,13,2,0,11,1,1,12,Technical Failure
1969-07-26 00:00:00,United States Air Force - USAF,Flight,Military / Government,Vietnam,Asia,5,5,1,0,0,1,4,Technical Failure
1969-08-22 00:00:00,Queen City Flying Service,Landing (descent or approach),Operational,United States of America,North America,1,1,1,0,0,1,0,Human Factor
1969-08-25 00:00:00,Transportes Aéreos Orientales - TAO,Takeoff (climb),Operational,Ecuador,South America,4,4,1,0,0,1,3,Unknown
1969-09-11 00:00:00,Eureka Aero Industries,Landing (descent or approach),Operational,United States of America,North America,2,2,1,0,0,1,1,Unknown
1969-10-11 00:00:00,Air Indies,Flight,Commercial,Puerto Rico,Central America,12,1,0,11,1,1,11,Technical Failure
1969-11-01 00:00:00,Central Air Freight,Takeoff (climb),Operational,United States of America,North America,1,1,1,0,0,1,0,Technical Failure
1969-12-11 00:00:00,Royal Danish Air Force - Flyvevåbnet,Landing (descent or approach),Operational,Denmark,Europe,8,5,1,3,0,1,7,Human Factor
1969-12-17 00:00:00,United States Air Force - USAF,Landing (descent or approach),Military / Government,Vietnam,Asia,5,5,1,0,0,1,4,Unknown
1969-12-21 00:00:00,Springfield Flight Services,Landing (descent or approach),Operational,United States of America,North America,1,1,1,0,0,1,0,Weather
1970-01-13 00:00:00,Royal Thai Air Force - Kong Thap Akat Thai,Landing (descent or approach),Military / Government,Thailand,Asia,6,2,0,4,1,1,5,Unknown
1970-01-25 00:00:00,Royal Nepal Airlines,Landing (descent or approach),Commercial,India,Asia,23,5,0,18,1,1,22,Weather
1970-01-29 00:00:00,Private American,Landing (descent or approach),Business,United States of America,North America,4,2,1,2,0,1,3,Human Factor
1970-02-14 00:00:00,Central Flying Service,Landing (descent or approach),Operational,United States of America,North America,1,1,1,0,0,1,0,Weather
1970-02-17 00:00:00,Aviant - Kievskii Aviatsionnye Zavod,Takeoff (climb),Operational,Russia,Asia,6,5,1,1,0,1,5,Other
1970-02-27 00:00:00,Nepalese Army,Takeoff (climb),Military / Government,Nepal,Asia,5,1,0,4,1,1,4,Unknown
1970-02-28 00:00:00,United States Air Force - USAF,Flight,Operational,Spain,Europe,1,1,1,0,0,1,0,Human Factor
1970-03-07 00:00:00,Lyle Cameron,Flight,Humanitarian,United States of America,North America,6,1,0,5,1,1,5,Human Factor
1970-03-25 00:00:00,Ingersoll Steel %26 Disc Company,Takeoff (climb),Business,United States of America,North America,2,2,1,0,0,1,1,Human Factor
1970-03-26 00:00:00,Hazair Agricultural Services,Flight,Military / Government,Australia,Oceania,1,1,1,0,0,1,0,Unknown
1970-04-10 00:00:00,Cessna Aircraft Company,Flight,Specialised Services,United States of America,North America,1,1,1,0,0,1,0,Human Factor
1970-05-09 00:00:00,Philippine Airlines - PAL,Takeoff (climb),Commercial,Philippines,Asia,33,4,1,29,0,1,32,Unknown
1970-05-27 00:00:00,Thompson Street,Flight,Business,United States of America,North America,1,1,1,0,0,1,0,Technical Failure
1970-05-30 00:00:00,Lehigh Acres Development Company,Takeoff (climb),Commercial,United States of America,North America,33,4,0,29,1,1,32,Human Factor
1970-06-06 00:00:00,United States Air Force - USAF,Flight,Military / Government,World,World,10,10,1,0,0,1,9,Technical Failure
1970-06-24 00:00:00,Pilatus,Takeoff (climb),Operational,Libya,Africa,1,1,1,0,0,1,0,Unknown
1970-07-17 00:00:00,United States Air Force - USAF,Flight,Operational,Vietnam,Asia,4,4,1,0,0,1,3,Technical Failure
1970-07-19 00:00:00,Aeroflot - Russian International Airlines,Flight,Military / Government,Russia,Asia,2,2,1,0,0,1,1,Human Factor
1970-07-20 00:00:00,Imperial Tobacco,Takeoff (climb),Operational,United Kingdom,Europe,2,2,1,0,0,1,1,Human Factor
1970-07-21 00:00:00,Western Skyways,Flight,Operational,United States of America,North America,1,1,1,0,0,1,0,Human Factor
1970-07-30 00:00:00,United States Navy - USN,Landing (descent or approach),Military / Government,United States of America,North America,5,5,1,0,0,1,4,Unknown
1970-08-08 00:00:00,Aeroflot - Russian International Airlines,Flight,Commercial,Moldova,Europe,114,107,0,7,1,1,113,Human Factor
1970-08-09 00:00:00,Yankee Air Club,Landing (descent or approach),Operational,United States of America,North America,1,1,1,0,0,1,0,Human Factor
1970-09-09 00:00:00,San Juan Air,Flight,Commercial,Puerto Rico,Central America,1,1,1,0,0,1,0,Human Factor
1970-09-21 00:00:00,Aeroflot - Russian International Airlines,Flight,Operational,Russia,Asia,3,2,0,1,1,1,2,Human Factor
1970-10-20 00:00:00,Gerald R. Hamm,Landing (descent or approach),Operational,United States of America,North America,1,1,1,0,0,1,0,Human Factor
1970-11-19 00:00:00,Village Clubs,Flight,Business,United States of America,North America,1,1,1,0,0,1,0,Human Factor
1970-11-25 00:00:00,Leake Industries,Flight,Business,United States of America,North America,1,1,1,0,0,1,0,Technical Failure
1970-12-05 00:00:00,Aircraft Facilities,Flight,Operational,World,World,1,1,1,0,0,1,0,Technical Failure
1970-12-10 00:00:00,Great Lakes Aviation,Landing (descent or approach),Operational,United States of America,North America,1,1,1,0,0,1,0,Human Factor
1970-12-16 00:00:00,William J. Whitehurst II,Flight,Business,United States of America,North America,1,1,1,0,0,1,0,Weather
1970-12-17 00:00:00,Results,Flight,Business,United States of America,North America,1,1,1,0,0,1,0,Technical Failure
1970-12-19 00:00:00,Ben K. Odell,Landing (descent or approach),Business,United States of America,North America,1,1,1,0,0,1,0,Human Factor
1970-12-23 00:00:00,French Navy,Takeoff (climb),Operational,France,Europe,2,2,1,0,0,1,1,Technical Failure
1971-01-09 00:00:00,Mission Drywall Company,Flight,Business,United States of America,North America,1,1,1,0,0,1,0,Weather
1971-01-19 00:00:00,Madsen International,Takeoff (climb),Operational,United States of America,North America,1,1,1,0,0,1,0,Technical Failure
1971-01-23 00:00:00,Líder Taxi Aéreo,Landing (descent or approach),Commercial,Brazil,South America,7,1,0,6,1,1,6,Unknown
1971-02-26 00:00:00,Peck Meat Packing,Landing (descent or approach),Business,United States of America,North America,4,1,0,3,1,1,3,Human Factor
1971-04-08 00:00:00,Bulair,Flight,Military / Government,Bulgaria,Europe,1,1,1,0,0,1,0,Unknown
1971-05-02 00:00:00,Royal Canadian Air Force - RCAF,Takeoff (climb),Military / Government,Canada,North America,6,2,0,4,1,1,5,Unknown
1971-05-04 00:00:00,Aero Union,Flight,Humanitarian,United States of America,North America,1,1,1,0,0,1,0,Human Factor
1971-05-13 00:00:00,Frank E. Birch,Landing (descent or approach),Business,United States of America,North America,1,1,1,0,0,1,0,Human Factor
1971-07-01 00:00:00,ASTRO - Aero Servicio Transportes Regionales del Oeste,Landing (descent or approach),Commercial,Argentina,South America,3,2,1,1,0,1,2,Unknown
1971-07-03 00:00:00,Soviet Navy - Voyenno-morskoy flot CCCP,Taxiing,Operational,Russia,Asia,4,4,1,0,0,1,3,Human Factor
1971-07-09 00:00:00,Cessnyca,Landing (descent or approach),Operational,Colombia,South America,1,1,1,0,0,1,0,Technical Failure
1971-07-16 00:00:00,Aeroflot - Russian International Airlines,Flight,Military / Government,Russia,Asia,2,2,1,0,0,1,1,Technical Failure
1971-07-16 00:00:00,Private German,Flight,Business,Germany,Europe,1,1,1,0,0,1,0,Unknown
1971-07-30 00:00:00,Private American,Flight,Operational,United States of America,North America,2,1,0,1,1,1,1,Technical Failure
1971-08-01 00:00:00,Air Lease,Flight,Business,United States of America,North America,1,1,1,0,0,1,0,Human Factor
1971-08-03 00:00:00,Memphis Air Charter,Takeoff (climb),Operational,United States of America,North America,2,2,1,0,0,1,1,Human Factor
1971-08-11 00:00:00,Italian Air Force - Aeronautica Militare Italiana,Flight,Operational,Italy,Europe,3,3,1,0,0,1,2,Technical Failure
1971-08-27 00:00:00,Chicago %26 Southern Airlines,Takeoff (climb),Operational,United States of America,North America,2,2,1,0,0,1,1,Technical Failure
1971-11-15 00:00:00,Super Spread Aviation,Flight,Military / Government,Australia,Oceania,1,1,1,0,0,1,0,Human Factor
1971-11-22 00:00:00,Garden State Airlines,Landing (descent or approach),Commercial,United States of America,North America,6,2,0,4,1,1,5,Human Factor
1971-11-29 00:00:00,Aeroflot - Russian International Airlines,Landing (descent or approach),Military / Government,Latvia,Europe,3,2,1,1,0,1,2,Human Factor
1971-12-05 00:00:00,United States Navy - USN,Takeoff (climb),Military / Government,Philippines,Asia,16,4,0,12,1,1,15,Human Factor
1971-12-08 00:00:00,Aeroflot - Russian International Airlines,Flight,Operational,Russia,Asia,2,2,1,0,0,1,1,Human Factor
1972-01-20 00:00:00,Turkish Airlines - THY Türk Hava Yollari,Landing (descent or approach),Operational,Turkey,Asia,5,5,1,0,0,1,4,Human Factor
1972-02-01 00:00:00,Vereinigte Flugtechnische Werke GmbH - VFW,Flight,Specialised Services,Germany,Europe,3,3,1,0,0,1,2,Human Factor
1972-02-04 00:00:00,Air America,Landing (descent or approach),Commercial,Laos,Asia,38,4,1,34,0,1,37,Human Factor
1972-02-23 00:00:00,Bulair,Flight,Military / Government,Bulgaria,Europe,2,2,1,0,0,1,1,Unknown
1972-03-03 00:00:00,Combs FreightAir,Takeoff (climb),Operational,United States of America,North America,1,1,1,0,0,1,0,Human Factor
1972-03-27 00:00:00,Aeroflot - Russian International Airlines,Flight,Business,Ukraine,Europe,1,1,1,0,0,1,0,Human Factor
1972-04-08 00:00:00,Air America,Flight,Commercial,Laos,Asia,3,3,1,0,0,1,2,Human Factor
1972-04-11 00:00:00,Aeroflot - Russian International Airlines,Takeoff (climb),Commercial,Russia,Asia,4,2,0,2,1,1,3,Human Factor
1972-04-14 00:00:00,Viking International Air Freight,Landing (descent or approach),Operational,United States of America,North America,1,1,1,0,0,1,0,Technical Failure
1972-05-15 00:00:00,P. J. Goodwin,Landing (descent or approach),Business,United States of America,North America,1,1,1,0,0,1,0,Human Factor
1972-06-02 00:00:00,Air Taxi Operation,Flight,Operational,United States of America,North America,1,1,1,0,0,1,0,Human Factor
1972-06-05 00:00:00,United States Air Force - USAF,Landing (descent or approach),Military / Government,Greenland,Europe,8,8,1,0,0,1,7,Human Factor
1972-06-10 00:00:00,Sierra West Air,Landing (descent or approach),Operational,United States of America,North America,2,2,1,0,0,1,1,Human Factor
1972-06-10 00:00:00,Cross Lake Air Service,Landing (descent or approach),Commercial,Canada,North America,1,1,1,0,0,1,0,Unknown
1972-06-22 00:00:00,Quaker City Airways,Takeoff (climb),Operational,United States of America,North America,1,1,1,0,0,1,0,Technical Failure
1972-06-29 00:00:00,Aeroflot - Russian International Airlines,Flight,Military / Government,Kazakhstan,Asia,2,2,1,0,0,1,1,Technical Failure
1972-07-03 00:00:00,Private American,Landing (descent or approach),Business,United States of America,North America,1,1,1,0,0,1,0,Human Factor
1972-07-08 00:00:00,United States Air Force - USAF,Takeoff (climb),Military / Government,Guam Island,Asia,6,6,1,0,0,1,5,Technical Failure
1972-07-19 00:00:00,Aeroflot - Russian International Airlines,Takeoff (climb),Business,Russia,Asia,1,1,1,0,0,1,0,Human Factor
1972-07-21 00:00:00,Equitable Engineering Company,Flight,Business,United States of America,North America,1,1,1,0,0,1,0,Unknown
1972-08-30 00:00:00,Mount Cook Air Services,Flight,Military / Government,New Zealand,Oceania,1,1,1,0,0,1,0,Human Factor
1972-09-11 00:00:00,Private American,Takeoff (climb),Humanitarian,Jamaica,Central America,3,1,0,2,1,1,2,Human Factor
1972-09-30 00:00:00,Spantax,Takeoff (climb),Operational,Spain,Europe,6,6,1,0,0,1,5,Human Factor
1972-10-23 00:00:00,Air Melanesiæ,Flight,Commercial,Vanuatu,Oceania,8,1,0,7,1,1,7,Human Factor
1972-11-18 00:00:00,Miami Aircraft Ventures,Landing (descent or approach),Humanitarian,United States of America,North America,1,1,1,0,0,1,0,Human Factor
1972-11-20 00:00:00,Safelite Industries,Flight,Business,United States of America,North America,1,1,1,0,0,1,0,Technical Failure
1972-11-21 00:00:00,United States Air Force - USAF,Landing (descent or approach),Military / Government,Thailand,Asia,10,3,0,7,1,1,9,Technical Failure
1972-12-06 00:00:00,Fieldair,Flight,Operational,New Zealand,Oceania,1,1,1,0,0,1,0,Unknown
1972-12-09 00:00:00,Ivy Steele %26 Partners,Landing (descent or approach),Business,United States of America,North America,1,1,1,0,0,1,0,Human Factor
1972-12-11 00:00:00,KBC Inc.,Landing (descent or approach),Commercial,United States of America,North America,2,1,1,1,0,1,1,Human Factor
1972-12-12 00:00:00,Unnamed operator,Flight,Operational,Paraguay,South America,2,2,1,0,0,1,1,Unknown
1972-12-20 00:00:00,United States Air Force - USAF,Flight,Military / Government,Laos,Asia,6,6,1,0,0,1,5,Terrorism
1973-01-26 00:00:00,Gene Damschroeder,Landing (descent or approach),Operational,United States of America,North America,2,1,0,1,1,1,1,Human Factor
1973-02-06 00:00:00,Robertson Air Service,Flight,Military / Government,New Zealand,Oceania,1,1,1,0,0,1,0,Human Factor
1973-02-13 00:00:00,United States Air Force - USAF,Flight,Operational,United States of America,North America,1,1,1,0,0,1,0,Unknown
1973-02-16 00:00:00,Farmers Aerial,Flight,Military / Government,New Zealand,Oceania,1,1,1,0,0,1,0,Unknown
1973-02-23 00:00:00,Southern Air Super,Flight,Military / Government,New Zealand,Oceania,1,1,1,0,0,1,0,Technical Failure
1973-03-01 00:00:00,Vietnam People's Air Force,Flight,Military / Government,Vietnam,Asia,16,2,0,14,1,1,15,Unknown
1973-03-03 00:00:00,Norcanair - North Canada Air,Flight,Military / Government,Canada,North America,4,1,0,3,1,1,3,Weather
1973-03-20 00:00:00,Buckeye Air Services,Flight,Commercial,United States of America,North America,1,1,1,0,0,1,0,Unknown
1973-03-26 00:00:00,Goldways,Landing (descent or approach),Business,Bahamas,Central America,1,1,1,0,0,1,0,Technical Failure
1973-03-26 00:00:00,Air Central,Takeoff (climb),Business,United States of America,North America,1,1,1,0,0,1,0,Human Factor
1973-03-31 00:00:00,Cessna Aircraft Company,Landing (descent or approach),Operational,Canada,North America,1,1,1,0,0,1,0,Human Factor
1973-04-14 00:00:00,Aeroflot - Russian International Airlines,Flight,Operational,Kazakhstan,Asia,6,2,1,4,0,1,5,Human Factor
1973-05-19 00:00:00,David M. Hume,Takeoff (climb),Business,United States of America,North America,1,1,1,0,0,1,0,Human Factor
1973-05-20 00:00:00,Aeroflot - Russian International Airlines,Flight,Military / Government,Ukraine,Europe,2,2,1,0,0,1,1,Human Factor
1973-05-31 00:00:00,SMB Stage Line,Landing (descent or approach),Operational,United States of America,North America,1,1,1,0,0,1,0,Human Factor
1973-06-09 00:00:00,Lineas Aéreas Interiores de Catalina,Landing (descent or approach),Specialised Services,Colombia,South America,3,3,1,0,0,1,2,Technical Failure
1973-06-15 00:00:00,Refrigerated Transport Company,Takeoff (climb),Business,United States of America,North America,1,1,1,0,0,1,0,Technical Failure
1973-07-04 00:00:00,Bulair,Flight,Military / Government,Bulgaria,Europe,1,1,1,0,0,1,0,Unknown
1973-07-11 00:00:00,Italian Air Force - Aeronautica Militare Italiana,Landing (descent or approach),Humanitarian,Italy,Europe,2,2,1,0,0,1,1,Unknown
1973-07-13 00:00:00,Private American,Landing (descent or approach),Business,United States of America,North America,3,1,0,2,1,1,2,Human Factor
1973-07-20 00:00:00,Aeroflot - Russian International Airlines,Flight,Military / Government,Azerbaijan,Asia,2,2,1,0,0,1,1,Other
1973-09-15 00:00:00,Aeroflot - Russian International Airlines,Flight,Military / Government,Turkmenistan,Asia,2,2,1,0,0,1,1,Human Factor
1973-09-29 00:00:00,Czech Air Force - Ceské Vojenské Letectvo,Landing (descent or approach),Military / Government,Hungary,Europe,23,5,1,18,0,1,22,Human Factor
1973-10-03 00:00:00,Midwest Air Charter,Landing (descent or approach),Operational,United States of America,North America,1,1,1,0,0,1,0,Human Factor
1973-10-12 00:00:00,Western Commander Aviation,Landing (descent or approach),Business,United States of America,North America,1,1,1,0,0,1,0,Human Factor
1973-11-22 00:00:00,Private American,Landing (descent or approach),Business,United States of America,North America,1,1,1,0,0,1,0,Human Factor
1973-11-23 00:00:00,Fort Wainwright Air,Landing (descent or approach),Business,United States of America,North America,6,1,1,5,0,1,5,Human Factor
1973-11-27 00:00:00,SMB Stage Line,Landing (descent or approach),Operational,United States of America,North America,1,1,1,0,0,1,0,Weather
1973-11-28 00:00:00,Europair,Landing (descent or approach),Commercial,France,Europe,5,1,1,4,0,1,4,Unknown
1973-12-24 00:00:00,Aeroflot - Russian International Airlines,Flight,Operational,Russia,Asia,2,2,1,0,0,1,1,Human Factor
1973-12-26 00:00:00,Tricon Airlines,Takeoff (climb),Operational,United States of America,North America,1,1,1,0,0,1,0,Other
1973-12-27 00:00:00,American Sign %26 Indicator Corporation,Landing (descent or approach),Business,United States of America,North America,1,1,1,0,0,1,0,Human Factor
1973-12-28 00:00:00,Executive Funds,Landing (descent or approach),Commercial,South Africa,Africa,25,3,0,22,1,1,24,Technical Failure
1974-01-14 00:00:00,Al Harmon,Flight,Business,United States of America,North America,1,1,1,0,0,1,0,Human Factor
1974-02-10 00:00:00,Pellet Air,Flight,Business,Bahamas,Central America,1,1,1,0,0,1,0,Unknown
1974-02-20 00:00:00,Empire Gas Corporation,Flight,Business,United States of America,North America,1,1,1,0,0,1,0,Human Factor
1974-03-03 00:00:00,Tiffany Realty,Flight,Humanitarian,United States of America,North America,2,1,1,1,0,1,1,Human Factor
1974-03-09 00:00:00,Macair - Melanesian Airline Company,Landing (descent or approach),Operational,Papua New Guinea,Oceania,1,1,1,0,0,1,0,Unknown
1974-03-25 00:00:00,Thames Aerial Topdressing Company,Flight,Military / Government,New Zealand,Oceania,1,1,1,0,0,1,0,Human Factor
1974-03-29 00:00:00,Empresa de Transportes Aéreos de Porto Amélia,Landing (descent or approach),Operational,Mozambique,Africa,1,1,1,0,0,1,0,Unknown
1974-05-01 00:00:00,Aeroflot - Russian International Airlines,Takeoff (climb),Operational,Russia,Asia,16,7,1,9,0,1,15,Human Factor
1974-05-02 00:00:00,Aeroflot - Russian International Airlines,Takeoff (climb),Commercial,Russia,Asia,38,4,1,34,0,1,37,Human Factor
1974-06-19 00:00:00,Ontario Central Airlines,Flight,Commercial,Canada,North America,3,1,0,2,1,1,2,Human Factor
1974-06-24 00:00:00,Aeroflot - Russian International Airlines,Takeoff (climb),Commercial,Uzbekistan,Asia,114,8,0,106,1,1,113,Other
1974-06-28 00:00:00,Aeroflot - Russian International Airlines,Flight,Military / Government,Kazakhstan,Asia,2,2,1,0,0,1,1,Human Factor
1974-06-29 00:00:00,Aeroflot - Russian International Airlines,Flight,Military / Government,Russia,Asia,1,1,1,0,0,1,0,Technical Failure
1974-07-03 00:00:00,Fontana Aviation,Landing (descent or approach),Operational,United States of America,North America,1,1,1,0,0,1,0,Human Factor
1974-07-05 00:00:00,Topps Factory Outlet of Nashville,Flight,Business,United States of America,North America,1,1,1,0,0,1,0,Human Factor
1974-07-16 00:00:00,West Coal Corporation,Landing (descent or approach),Business,United States of America,North America,1,1,1,0,0,1,0,Technical Failure
1974-08-01 00:00:00,Reeder Flying Service,Taxiing,Humanitarian,United States of America,North America,1,1,1,0,0,1,0,Human Factor
1974-08-19 00:00:00,Aviatik,Landing (descent or approach),Operational,Finland,Europe,1,1,1,0,0,1,0,Unknown
1974-08-22 00:00:00,Harold S. Johnston,Flight,Business,United States of America,North America,1,1,1,0,0,1,0,Human Factor
1974-09-12 00:00:00,Charles W. Cobler,Takeoff (climb),Business,Canada,North America,4,1,0,3,1,1,3,Weather
1974-09-26 00:00:00,Aircraft Facilities,Flight,Operational,Pakistan,Asia,1,1,1,0,0,1,0,Technical Failure
1974-09-27 00:00:00,Ronald Brinkhoff,Landing (descent or approach),Business,United States of America,North America,1,1,1,0,0,1,0,Human Factor
1974-10-01 00:00:00,Cookson Airspread,Flight,Military / Government,New Zealand,Oceania,1,1,1,0,0,1,0,Human Factor
1974-10-16 00:00:00,Map Studios Productions,Flight,Specialised Services,South Africa,Africa,3,2,0,1,1,1,2,Weather
1974-10-17 00:00:00,Fontana Aviation,Landing (descent or approach),Operational,United States of America,North America,1,1,1,0,0,1,0,Human Factor
1974-10-18 00:00:00,Aeroflot - Russian International Airlines,Landing (descent or approach),Operational,Russia,Asia,12,6,1,6,0,1,11,Human Factor
1974-10-19 00:00:00,Mabuhay Airways,Landing (descent or approach),Commercial,Philippines,Asia,8,4,1,4,0,1,7,Technical Failure
1974-10-20 00:00:00,Aviatia Utilitara,Flight,Military / Government,Romania,Europe,3,3,1,0,0,1,2,Unknown
1974-11-12 00:00:00,Montana Power Company,Flight,Operational,United States of America,North America,1,1,1,0,0,1,0,Human Factor
1974-11-13 00:00:00,Aeroflot - Russian International Airlines,Flight,Operational,Russia,Asia,8,5,0,3,1,1,7,Technical Failure
1974-11-15 00:00:00,OASIS - Orient Air System %26 Integrated Services,Takeoff (climb),Commercial,Philippines,Asia,8,3,0,5,1,1,7,Technical Failure
1974-12-24 00:00:00,Aeroflot - Russian International Airlines,Flight,Operational,Russia,Asia,3,2,1,1,0,1,2,Technical Failure
1975-01-02 00:00:00,BJ Aero Freight,Landing (descent or approach),Operational,United States of America,North America,3,2,0,1,1,1,2,Weather
1975-01-07 00:00:00,Transaéreos Frimo - Frigorifico Movima,Landing (descent or approach),Commercial,Bolivia,South America,29,4,0,25,1,1,28,Technical Failure
1975-01-25 00:00:00,Gerardin Mazariegos Sanabria,Flight,Business,Guatemala,Central America,2,2,1,0,0,1,1,Unknown
1975-01-31 00:00:00,Dale Electronic,Landing (descent or approach),Business,United States of America,North America,1,1,1,0,0,1,0,Human Factor
1975-02-11 00:00:00,Spa Flying Service,Flight,Business,United States of America,North America,1,1,1,0,0,1,0,Unknown
1975-02-21 00:00:00,Salvador Esquino,Landing (descent or approach),Business,United States of America,North America,4,1,1,3,0,1,3,Human Factor
1975-02-21 00:00:00,Aero Aviation,Flight,Business,United States of America,North America,1,1,1,0,0,1,0,Technical Failure
1975-02-23 00:00:00,General Motors Company - GMC,Landing (descent or approach),Business,United States of America,North America,2,2,1,0,0,1,1,Human Factor
1975-03-03 00:00:00,SMB Stage Line,Takeoff (climb),Operational,United States of America,North America,1,1,1,0,0,1,0,Unknown
1975-03-04 00:00:00,Brazilian Air Force - Força Aérea Brasileira,Takeoff (climb),Military / Government,Brazil,South America,4,4,1,0,0,1,3,Unknown
1975-03-06 00:00:00,Bob Kilpatrick Aircraft,Takeoff (climb),Operational,United States of America,North America,2,2,1,0,0,1,1,Human Factor
1975-03-06 00:00:00,Trans National Airlines - TNA,Flight,Operational,United States of America,North America,1,1,1,0,0,1,0,Technical Failure
1975-03-06 00:00:00,Semo Aviation,Flight,Operational,United States of America,North America,1,1,1,0,0,1,0,Human Factor
1975-03-14 00:00:00,Aeroflot - Russian International Airlines,Flight,Military / Government,Lithuania,Europe,2,2,1,0,0,1,1,Human Factor
1975-03-16 00:00:00,Bulair,Flight,Military / Government,Bulgaria,Europe,1,1,1,0,0,1,0,Unknown
1975-04-01 00:00:00,Burlington Air Express,Flight,Operational,United States of America,North America,1,1,1,0,0,1,0,Technical Failure
1975-04-02 00:00:00,Aeroflot - Russian International Airlines,Takeoff (climb),Military / Government,Russia,Asia,2,2,1,0,0,1,1,Human Factor
1975-04-18 00:00:00,United Power Associates Company,Landing (descent or approach),Business,United States of America,North America,2,1,0,1,1,1,1,Human Factor
1975-05-08 00:00:00,Partenavia,Flight,Operational,Italy,Europe,1,1,1,0,0,1,0,Unknown
1975-05-15 00:00:00,Omar Stoltzfus,Takeoff (climb),Business,United States of America,North America,5,1,0,4,1,1,4,Human Factor
1975-05-20 00:00:00,Astro Airways,Takeoff (climb),Operational,United States of America,North America,1,1,1,0,0,1,0,Technical Failure
1975-05-21 00:00:00,Woods Air Service - Woods Air Fuel,Takeoff (climb),Operational,United States of America,North America,1,1,1,0,0,1,0,Other
1975-05-26 00:00:00,Private American,Flight,Business,United States of America,North America,1,1,1,0,0,1,0,Technical Failure
1975-05-28 00:00:00,Eureka Aero Industries,Flight,Operational,United States of America,North America,1,1,1,0,0,1,0,Human Factor
1975-05-28 00:00:00,Dobbs-Leventhal,Takeoff (climb),Business,United States of America,North America,2,2,1,0,0,1,1,Technical Failure
1975-06-17 00:00:00,VARIG - Viação Aérea Rio Grandense,Landing (descent or approach),Commercial,Brazil,South America,15,3,1,12,0,1,14,Human Factor
1975-07-02 00:00:00,Evergreen International Airlines,Flight,Operational,United States of America,North America,1,1,1,0,0,1,0,Human Factor
1975-07-02 00:00:00,Conair Aviation,Flight,Humanitarian,Canada,North America,1,1,1,0,0,1,0,Unknown
1975-07-16 00:00:00,ZUA - Zakładu Usług Agrolotniczych - AET Agroaviation Services,Flight,Business,Slovakia,Europe,1,1,1,0,0,1,0,Terrorism
1975-09-05 00:00:00,Transportes Aéreos Guatemaltecos,Flight,Operational,Guatemala,Central America,1,1,1,0,0,1,0,Human Factor
1975-09-11 00:00:00,Ethiopian Airlines,Flight,Commercial,Ethiopia,Africa,9,3,0,6,1,1,8,Human Factor
1975-09-22 00:00:00,Air America,Flight,Operational,World,World,1,1,1,0,0,1,0,Unknown
1975-09-30 00:00:00,Orion SA Mexico,Flight,Operational,United States of America,North America,1,1,1,0,0,1,0,Human Factor
1975-10-01 00:00:00,Greenville Air,Takeoff (climb),Operational,United States of America,North America,1,1,1,0,0,1,0,Technical Failure
1975-10-19 00:00:00,British Car Auctions,Takeoff (climb),Operational,United Kingdom,Europe,1,1,1,0,0,1,0,Human Factor
1975-11-26 00:00:00,T. A. Maag,Landing (descent or approach),Business,United States of America,North America,1,1,1,0,0,1,0,Weather
1975-12-24 00:00:00,Balbo Air,Flight,Operational,United States of America,North America,1,1,1,0,0,1,0,Human Factor
1975-12-29 00:00:00,Gail L. Bazzano,Flight,Business,United States of America,North America,1,1,1,0,0,1,0,Technical Failure
1976-01-12 00:00:00,A. S. Wikstrom,Takeoff (climb),Business,United States of America,North America,1,1,1,0,0,1,0,Human Factor
1976-01-14 00:00:00,Federal Aviation Administration - FAA,Flight,Operational,Brazil,South America,3,3,1,0,0,1,2,Technical Failure
1976-01-17 00:00:00,Andy Jackson Yacht %26 Aircraft,Landing (descent or approach),Business,United States of America,North America,1,1,1,0,0,1,0,Technical Failure
1976-02-11 00:00:00,Flight Service,Flight,Operational,World,World,1,1,1,0,0,1,0,Technical Failure
1976-02-18 00:00:00,Chemical Fabrics Corporation,Flight,Business,United States of America,North America,1,1,1,0,0,1,0,Human Factor
1976-02-25 00:00:00,West Coast Air Services,Landing (descent or approach),Commercial,Canada,North America,4,1,0,3,1,1,3,Human Factor
1976-03-01 00:00:00,Burlington Air Express,Landing (descent or approach),Operational,United States of America,North America,1,1,1,0,0,1,0,Weather
1976-03-04 00:00:00,Silvio J. Adamo,Landing (descent or approach),Business,United States of America,North America,3,1,1,2,0,1,2,Human Factor
1976-04-05 00:00:00,Alaska Airlines,Landing (descent or approach),Commercial,United States of America,North America,50,7,0,43,1,1,49,Human Factor
1976-04-17 00:00:00,Aeroflot - Russian International Airlines,Takeoff (climb),Military / Government,Russia,Asia,2,2,1,0,0,1,1,Human Factor
1976-04-29 00:00:00,Stilwell Aircraft Service,Landing (descent or approach),Business,United States of America,North America,4,1,1,3,0,1,3,Human Factor
1976-05-05 00:00:00,Danzer Zaïre,Takeoff (climb),Operational,Democratic Republic of Congo,Africa,1,1,1,0,0,1,0,Unknown
1976-05-07 00:00:00,Hripsimee Marsubiam,Landing (descent or approach),Business,United States of America,North America,1,1,1,0,0,1,0,Human Factor
1976-05-18 00:00:00,William R. Draper,Takeoff (climb),Specialised Services,United States of America,North America,5,1,0,4,1,1,4,Human Factor
1976-06-08 00:00:00,Civil Air Patrol,Flight,Military / Government,United States of America,North America,3,1,0,2,1,1,2,Human Factor
1976-06-26 00:00:00,Aeroflot - Russian International Airlines,Takeoff (climb),Commercial,Russia,Asia,12,2,1,10,0,1,11,Technical Failure
1976-06-27 00:00:00,Aeroflot - Russian International Airlines,Takeoff (climb),Military / Government,Kazakhstan,Asia,1,1,1,0,0,1,0,Human Factor
1976-06-27 00:00:00,Middle East Airlines - MEA,Parking,Commercial,Lebanon,Asia,3,3,1,0,0,1,2,Terrorism
1976-07-09 00:00:00,Bard Air Freight,Takeoff (climb),Operational,United States of America,North America,1,1,1,0,0,1,0,Human Factor
1976-07-13 00:00:00,Aeroflot - Russian International Airlines,Flight,Commercial,Russia,Asia,11,2,0,9,1,1,10,Technical Failure
1976-07-16 00:00:00,Don Goodman,Flight,Humanitarian,United States of America,North America,1,1,1,0,0,1,0,Human Factor
1976-08-01 00:00:00,Ingram Leasing Company,Landing (descent or approach),Business,United States of America,North America,1,1,1,0,0,1,0,Human Factor
1976-08-06 00:00:00,Somergul,Flight,Business,Nigeria,Africa,1,1,1,0,0,1,0,Unknown
1976-08-08 00:00:00,Lynch Air Tankers,Flight,Humanitarian,United States of America,North America,1,1,1,0,0,1,0,Human Factor
1976-08-08 00:00:00,Aircraft Investors,Flight,Business,United States of America,North America,1,1,1,0,0,1,0,Technical Failure
1976-08-15 00:00:00,Travair,Takeoff (climb),Operational,France,Europe,1,1,1,0,0,1,0,Unknown
1976-08-27 00:00:00,Wayne W. Johnson,Flight,Business,United States of America,North America,1,1,1,0,0,1,0,Technical Failure
1976-08-28 00:00:00,Air France,Parking,Commercial,Vietnam,Asia,20,5,0,15,1,1,19,Terrorism
1976-09-04 00:00:00,Aeroflot - Russian International Airlines,Flight,Business,Uzbekistan,Asia,2,2,1,0,0,1,1,Human Factor
1976-09-05 00:00:00,Vickii Meller,Flight,Business,Colombia,South America,3,3,1,0,0,1,2,Technical Failure
1976-09-07 00:00:00,Nicaraguayan Air Force - Fuerza Aérea - Ejercito de Nicaragua,Takeoff (climb),Military / Government,Nicaragua,Central America,9,2,0,7,1,1,8,Unknown
1976-09-22 00:00:00,Airwest Airlines,Flight,Commercial,Canada,North America,19,2,0,17,1,1,18,Unknown
1976-09-26 00:00:00,Aeroflot - Russian International Airlines,Flight,Business,Russia,Asia,1,1,1,0,0,1,0,Human Factor
1976-10-04 00:00:00,Aero Contractors,Landing (descent or approach),Operational,Nigeria,Africa,1,1,1,0,0,1,0,Unknown
1976-10-14 00:00:00,Falkland Islands Government Air Service - FIGAS,Flight,Commercial,Falkland Islands,South America,2,1,1,1,0,1,1,Unknown
1976-10-21 00:00:00,Hughes Aircraft Company,Landing (descent or approach),Business,United States of America,North America,1,1,1,0,0,1,0,Human Factor
1976-11-17 00:00:00,M I C Corporation,Flight,Business,United States of America,North America,1,1,1,0,0,1,0,Technical Failure
1976-11-18 00:00:00,United Resources,Flight,Military / Government,World,World,2,2,1,0,0,1,1,Technical Failure
1976-11-24 00:00:00,Fieldair,Takeoff (climb),Military / Government,New Zealand,Oceania,1,1,1,0,0,1,0,Unknown
1976-11-26 00:00:00,Vickers-Armstrongs Ltd,Landing (descent or approach),Business,United Kingdom,Europe,6,1,1,5,0,1,5,Human Factor
1976-12-11 00:00:00,Overmyer Corporation,Landing (descent or approach),Business,United States of America,North America,1,1,1,0,0,1,0,Human Factor
1977-01-31 00:00:00,TransNorthern Aviation,Takeoff (climb),Operational,United States of America,North America,3,3,1,0,0,1,2,Human Factor
1977-02-19 00:00:00,Victor M. Bernavides,Takeoff (climb),Business,United States of America,North America,1,1,1,0,0,1,0,Human Factor
1977-02-22 00:00:00,G. R. Board,Flight,Operational,Australia,Oceania,1,1,1,0,0,1,0,Technical Failure
1977-03-02 00:00:00,National Crude,Flight,Business,United States of America,North America,1,1,1,0,0,1,0,Human Factor
1977-03-03 00:00:00,INA Aviation,Landing (descent or approach),Business,Bahamas,Central America,1,1,1,0,0,1,0,Human Factor
1977-03-06 00:00:00,Aeroflot - Russian International Airlines,Takeoff (climb),Specialised Services,Russia,Asia,1,1,1,0,0,1,0,Human Factor
1977-03-12 00:00:00,California Air Charter - Cal Air Charter,Landing (descent or approach),Operational,United States of America,North America,1,1,1,0,0,1,0,Technical Failure
1977-03-18 00:00:00,Mitsubishi Air,Flight,Business,United States of America,North America,1,1,1,0,0,1,0,Unknown
1977-03-23 00:00:00,Aeroflot - Russian International Airlines,Landing (descent or approach),Commercial,Russia,Asia,9,2,0,7,1,1,8,Human Factor
1977-03-30 00:00:00,Modern Professional Aviation,Takeoff (climb),Operational,United States of America,North America,1,1,1,0,0,1,0,Human Factor
1977-04-06 00:00:00,Japan Maritime Self-Defense Force - Kaijō Jieitai,Landing (descent or approach),Military / Government,Japan,Asia,14,14,1,0,0,1,13,Unknown
1977-05-12 00:00:00,Patricia Air Transport,Takeoff (climb),Operational,Canada,North America,2,2,1,0,0,1,1,Technical Failure
1977-05-12 00:00:00,Geofoto,Flight,Operational,Brazil,South America,1,1,1,0,0,1,0,Unknown
1977-05-31 00:00:00,Air Force of Zimbabwe,Takeoff (climb),Military / Government,Mozambique,Africa,4,3,1,1,0,1,3,Terrorism
1977-06-02 00:00:00,Aeroflot - Russian International Airlines,Flight,Business,Russia,Asia,1,1,1,0,0,1,0,Human Factor
1977-06-03 00:00:00,Leone I. Van Torne,Landing (descent or approach),Business,United States of America,North America,1,1,1,0,0,1,0,Human Factor
1977-07-07 00:00:00,Private American,Takeoff (climb),Business,United States of America,North America,1,1,1,0,0,1,0,Human Factor
1977-07-20 00:00:00,Corporate Air - USA,Landing (descent or approach),Operational,United States of America,North America,1,1,1,0,0,1,0,Human Factor
1977-07-21 00:00:00,Harolds Air Service,Takeoff (climb),Commercial,United States of America,North America,4,1,0,3,1,1,3,Human Factor
1977-08-04 00:00:00,Woods Air Service - Woods Air Fuel,Takeoff (climb),Operational,United States of America,North America,1,1,1,0,0,1,0,Human Factor
1977-08-06 00:00:00,Air Service Hungary - Repülögépes Szolgalat Allami Vallat,Flight,Specialised Services,Hungary,Europe,4,2,1,2,0,1,3,Human Factor
1977-08-08 00:00:00,Dalhoff %26 King Flying School,Landing (descent or approach),Operational,New Zealand,Oceania,1,1,1,0,0,1,0,Human Factor
1977-08-12 00:00:00,Private American,Flight,Business,United States of America,North America,1,1,1,0,0,1,0,Human Factor
1977-08-19 00:00:00,James C. McKinney,Flight,Business,United States of America,North America,1,1,1,0,0,1,0,Human Factor
1977-08-20 00:00:00,William Mitchell,Takeoff (climb),Humanitarian,United States of America,North America,11,1,1,10,0,1,10,Human Factor
1977-08-31 00:00:00,Johnston Airways,Landing (descent or approach),Operational,United States of America,North America,1,1,1,0,0,1,0,Human Factor
1977-09-14 00:00:00,Aerolineas Especiales de Colombia - AE Colombia,Flight,Specialised Services,Colombia,South America,6,1,0,5,1,1,5,Unknown
1977-09-21 00:00:00,French Air Force - Armée de l'Air,Takeoff (climb),Humanitarian,France,Europe,6,2,1,4,0,1,5,Human Factor
1977-09-27 00:00:00,Delwood Furniture Company,Landing (descent or approach),Business,United States of America,North America,3,2,1,1,0,1,2,Human Factor
1977-09-30 00:00:00,Aviateca,Landing (descent or approach),Operational,Guatemala,Central America,4,4,1,0,0,1,3,Technical Failure
1977-10-03 00:00:00,Athabaska Airways,Flight,Commercial,Canada,North America,1,1,1,0,0,1,0,Unknown
1977-10-19 00:00:00,Barney S. Cam,Landing (descent or approach),Business,United States of America,North America,1,1,1,0,0,1,0,Human Factor
1977-10-25 00:00:00,Marvin Chrapun,Landing (descent or approach),Business,Canada,North America,1,1,1,0,0,1,0,Unknown
1977-10-31 00:00:00,Akarana Air,Flight,Operational,New Zealand,Oceania,1,1,1,0,0,1,0,Technical Failure
1977-11-20 00:00:00,Wardair Canada,Takeoff (climb),Operational,Canada,North America,2,2,1,0,0,1,1,Other
1977-11-27 00:00:00,Cameron %26 Cameron,Takeoff (climb),Business,United States of America,North America,7,1,0,6,1,1,6,Human Factor
1977-12-16 00:00:00,Growth Air,Flight,Business,Jamaica,Central America,1,1,1,0,0,1,0,Technical Failure
1977-12-22 00:00:00,Skyline Aviation,Flight,Operational,United States of America,North America,1,1,1,0,0,1,0,Unknown
1978-01-05 00:00:00,Combs FreightAir,Takeoff (climb),Operational,United States of America,North America,1,1,1,0,0,1,0,Human Factor
1978-01-06 00:00:00,United Brands,Landing (descent or approach),Business,United States of America,North America,1,1,1,0,0,1,0,Human Factor
1978-01-20 00:00:00,Bush Air,Flight,Operational,United States of America,North America,1,1,1,0,0,1,0,Human Factor
1978-02-01 00:00:00,Dixie Air,Landing (descent or approach),Business,United States of America,North America,2,1,0,1,1,1,1,Human Factor
1978-02-06 00:00:00,Klumb Lumber Company,Landing (descent or approach),Business,United States of America,North America,1,1,1,0,0,1,0,Human Factor
1978-02-16 00:00:00,Northcutt Chevrolet Company,Landing (descent or approach),Business,United States of America,North America,6,1,0,5,1,1,5,Human Factor
1978-02-28 00:00:00,Talair,Landing (descent or approach),Operational,Papua New Guinea,Oceania,1,1,1,0,0,1,0,Unknown
1978-03-16 00:00:00,Aborne Airbourne,Flight,Business,United States of America,North America,2,1,0,1,1,1,1,Human Factor
1978-03-23 00:00:00,Dominican Services,Takeoff (climb),Operational,Turks and Caicos Islands,Central America,3,3,1,0,0,1,2,Technical Failure
1978-03-30 00:00:00,Australian Air Charters,Takeoff (climb),Operational,Australia,Oceania,1,1,1,0,0,1,0,Technical Failure
1978-04-05 00:00:00,Mid South Flying Services,Flight,Humanitarian,United States of America,North America,1,1,1,0,0,1,0,Human Factor
1978-04-27 00:00:00,Private American,Flight,Business,World,World,1,1,1,0,0,1,0,Human Factor
1978-05-02 00:00:00,Sizer Airways,Takeoff (climb),Operational,United States of America,North America,1,1,1,0,0,1,0,Unknown
1978-05-11 00:00:00,Cim Associates,Takeoff (climb),Operational,United States of America,North America,1,1,1,0,0,1,0,Technical Failure
1978-05-19 00:00:00,Gateway Aviation,Landing (descent or approach),Operational,United States of America,North America,2,1,1,1,0,1,1,Human Factor
1978-05-23 00:00:00,Safair Flying Services,Flight,Operational,United States of America,North America,1,1,1,0,0,1,0,Human Factor
1978-06-16 00:00:00,Private Canadian,Takeoff (climb),Business,Canada,North America,2,1,0,1,1,1,1,Unknown
1978-06-27 00:00:00,Solaqueen,Landing (descent or approach),Business,United States of America,North America,1,1,1,0,0,1,0,Human Factor
1978-06-30 00:00:00,Aurora Air Services,Flight,Operational,United States of America,North America,1,1,1,0,0,1,0,Human Factor
1978-07-25 00:00:00,Conair Aviation,Flight,Operational,Canada,North America,1,1,1,0,0,1,0,Unknown
1978-08-13 00:00:00,Aeroflot - Russian International Airlines,Flight,Commercial,Russia,Asia,3,2,0,1,1,1,2,Technical Failure
1978-08-20 00:00:00,CDF Aviation - California Department of Forestry - Cal Fire,Flight,Humanitarian,United States of America,North America,1,1,1,0,0,1,0,Human Factor
1978-08-23 00:00:00,Bradley Air Services,Landing (descent or approach),Commercial,Canada,North America,6,2,1,4,0,1,5,Human Factor
1978-09-04 00:00:00,Pye of Cambridge,Landing (descent or approach),Specialised Services,United Kingdom,Europe,2,2,1,0,0,1,1,Human Factor
1978-09-04 00:00:00,Rancho San Gabriel,Flight,Humanitarian,United States of America,North America,1,1,1,0,0,1,0,Unknown
1978-09-06 00:00:00,Advance Aviation,Flight,Humanitarian,United States of America,North America,6,2,0,4,1,1,5,Human Factor
1978-09-06 00:00:00,Combs FreightAir,Landing (descent or approach),Operational,United States of America,North America,1,1,1,0,0,1,0,Human Factor
1978-10-01 00:00:00,Evergreen Air of Montana,Flight,Business,World,World,4,2,1,2,0,1,3,Technical Failure
1978-10-05 00:00:00,Edok-Eter-Mandilas,Flight,Operational,Nigeria,Africa,1,1,1,0,0,1,0,Technical Failure
1978-10-13 00:00:00,Arctic Guide Air Taxi,Landing (descent or approach),Commercial,United States of America,North America,2,1,1,1,0,1,1,Weather
1978-10-15 00:00:00,Skyways International,Takeoff (climb),Operational,Colombia,South America,3,3,1,0,0,1,2,Human Factor
1978-10-17 00:00:00,Martin Aviation,Takeoff (climb),Operational,United States of America,North America,2,2,1,0,0,1,1,Human Factor
1978-10-27 00:00:00,Private German,Takeoff (climb),Business,Germany,Europe,1,1,1,0,0,1,0,Human Factor
1978-10-28 00:00:00,Private Canadian,Landing (descent or approach),Operational,Canada,North America,1,1,1,0,0,1,0,Human Factor
1978-11-03 00:00:00,Eastern Caribbean Airways,Landing (descent or approach),Operational,United States of America,Central America,1,1,1,0,0,1,0,Unknown
1978-11-17 00:00:00,John D. Kennedy,Takeoff (climb),Business,United States of America,North America,2,1,0,1,1,1,1,Human Factor
1978-11-18 00:00:00,Wanganui Aero Work,Flight,Military / Government,New Zealand,Oceania,1,1,1,0,0,1,0,Unknown
1978-11-20 00:00:00,Larry Johnson Air Services,Takeoff (climb),Operational,United States of America,North America,1,1,1,0,0,1,0,Unknown
1978-11-22 00:00:00,Two Jacks Cycle %26 Powersports,Landing (descent or approach),Business,United States of America,North America,1,1,1,0,0,1,0,Human Factor
1978-11-29 00:00:00,Juan Maria Cuadros,Takeoff (climb),Operational,United States of America,North America,2,2,1,0,0,1,1,Human Factor
1978-11-30 00:00:00,Argentinian Air Force - Fuerza Aérea Argentina,Flight,Operational,Argentina,South America,1,1,1,0,0,1,0,Unknown
1978-12-15 00:00:00,Pakistan International Airlines - PIA,Landing (descent or approach),Operational,Pakistan,Asia,2,2,1,0,0,1,1,Technical Failure
1978-12-17 00:00:00,Indian Airlines,Takeoff (climb),Commercial,India,Asia,132,6,0,126,1,1,131,Technical Failure
1978-12-27 00:00:00,WDL Aviation,Flight,Operational,Germany,Europe,1,1,1,0,0,1,0,Technical Failure
1978-12-28 00:00:00,Kenneth L. McMillin,Landing (descent or approach),Operational,United States of America,North America,2,2,1,0,0,1,1,Technical Failure
1978-12-30 00:00:00,Crawford Enterprises,Landing (descent or approach),Business,United States of America,North America,5,1,1,4,0,1,4,Human Factor
1979-01-16 00:00:00,Crutcher Resources Corporation,Landing (descent or approach),Business,United States of America,North America,3,2,1,1,0,1,2,Technical Failure
1979-01-18 00:00:00,Private American,Landing (descent or approach),Business,United States of America,North America,2,2,1,0,0,1,1,Human Factor
1979-02-23 00:00:00,Cargair,Landing (descent or approach),Operational,Canada,North America,1,1,1,0,0,1,0,Human Factor
1979-03-04 00:00:00,Oklahoma Aircraft,Flight,Humanitarian,United States of America,North America,1,1,1,0,0,1,0,Unknown
1979-03-21 00:00:00,B-M Aviation,Flight,Operational,Canada,North America,2,1,0,1,1,1,1,Human Factor
1979-03-22 00:00:00,Cape Central Airways,Flight,Business,United States of America,North America,2,1,1,1,0,1,1,Technical Failure
1979-03-29 00:00:00,Private American,Landing (descent or approach),Business,United States of America,North America,1,1,1,0,0,1,0,Technical Failure
1979-04-02 00:00:00,Bush Aviation,Flight,Business,Bahamas,Central America,1,1,1,0,0,1,0,Unknown
1979-04-10 00:00:00,Thames Aerial Topdressing Company,Takeoff (climb),Military / Government,New Zealand,Oceania,1,1,1,0,0,1,0,Human Factor
1979-04-14 00:00:00,Catalina Airlines,Landing (descent or approach),Commercial,United States of America,North America,11,1,0,10,1,1,10,Human Factor
1979-04-21 00:00:00,Business Aircraft Leasing,Takeoff (climb),Business,Bahamas,Central America,1,1,1,0,0,1,0,Unknown
1979-05-09 00:00:00,Wyman Pilot Services,Flight,Operational,United States of America,North America,1,1,1,0,0,1,0,Human Factor
1979-05-15 00:00:00,Private Australian,Takeoff (climb),Commercial,Australia,Oceania,6,2,1,4,0,1,5,Human Factor
1979-05-25 00:00:00,Wyman Pilot Services,Landing (descent or approach),Operational,United States of America,North America,1,1,1,0,0,1,0,Technical Failure
1979-05-27 00:00:00,Edward Orlando,Landing (descent or approach),Business,United States of America,North America,4,1,1,3,0,1,3,Human Factor
1979-06-11 00:00:00,Jonathan Airways,Landing (descent or approach),Operational,France,Europe,1,1,1,0,0,1,0,Human Factor
1979-06-11 00:00:00,Kenmore Air,Flight,Commercial,Canada,North America,1,1,1,0,0,1,0,Unknown
1979-06-13 00:00:00,Thomas J. Rose,Flight,Humanitarian,United States of America,North America,1,1,1,0,0,1,0,Technical Failure
1979-06-14 00:00:00,James Aviation,Flight,Military / Government,New Zealand,Oceania,1,1,1,0,0,1,0,Human Factor
1979-06-17 00:00:00,Air New England,Landing (descent or approach),Commercial,United States of America,North America,10,2,1,8,0,1,9,Human Factor
1979-06-22 00:00:00,Go Transportation,Takeoff (climb),Humanitarian,United States of America,North America,6,2,1,4,0,1,5,Human Factor
1979-06-28 00:00:00,Philippe Cousteau,Landing (descent or approach),Other,Portugal,Europe,8,2,1,6,0,1,7,Human Factor
1979-07-21 00:00:00,Private American,Flight,Operational,United States of America,North America,1,1,1,0,0,1,0,Technical Failure
1979-08-02 00:00:00,Thurman L. Munson,Landing (descent or approach),Operational,United States of America,North America,3,3,1,0,0,1,2,Human Factor
1979-08-05 00:00:00,Private American,Landing (descent or approach),Business,United States of America,North America,3,1,0,2,1,1,2,Technical Failure
1979-08-07 00:00:00,Blue Wings,Landing (descent or approach),Business,United States of America,North America,1,1,1,0,0,1,0,Technical Failure
1979-08-07 00:00:00,Butler Aviation,Takeoff (climb),Operational,United States of America,North America,2,2,1,0,0,1,1,Technical Failure
1979-08-22 00:00:00,SATENA - Servicio de Aeronavegacion a Territorios Nacionales,Takeoff (climb),Humanitarian,Colombia,South America,1,1,1,0,0,1,0,Human Factor
1979-08-23 00:00:00,Plumley Air Service,Landing (descent or approach),Operational,United States of America,North America,1,1,1,0,0,1,0,Human Factor
1979-08-31 00:00:00,Procuraduría General de la República,Flight,Military / Government,Mexico,Central America,3,1,1,2,0,1,2,Technical Failure
1979-09-17 00:00:00,Catalina Airlines,Takeoff (climb),Commercial,United States of America,North America,4,1,0,3,1,1,3,Human Factor
1979-09-19 00:00:00,Mountain Air Cargo,Takeoff (climb),Operational,United States of America,North America,1,1,1,0,0,1,0,Other
1979-09-20 00:00:00,Aeroflot - Russian International Airlines,Flight,Military / Government,Belarus,Europe,4,2,0,2,1,1,3,Human Factor
1979-09-24 00:00:00,Galena Air Service,Flight,Operational,United States of America,North America,1,1,1,0,0,1,0,Human Factor
1979-09-30 00:00:00,Ambergate,Flight,Humanitarian,United States of America,North America,2,2,1,0,0,1,1,Human Factor
1979-10-04 00:00:00,Iron Bird,Flight,Operational,World,World,1,1,1,0,0,1,0,Weather
1979-10-09 00:00:00,Coal Baron,Landing (descent or approach),Business,United States of America,North America,1,1,1,0,0,1,0,Human Factor
1979-11-04 00:00:00,Polynesian Air-Ways,Flight,Operational,World,World,1,1,1,0,0,1,0,Technical Failure
1979-11-13 00:00:00,United States Navy - USN,Flight,Operational,United States of America,North America,2,2,1,0,0,1,1,Unknown
1979-11-26 00:00:00,Turbine Aircraft Parts,Flight,Business,United States of America,North America,1,1,1,0,0,1,0,Human Factor
1979-12-05 00:00:00,Fieldair,Flight,Military / Government,New Zealand,Oceania,1,1,1,0,0,1,0,Unknown
1979-12-06 00:00:00,Aerial Agriculture,Flight,Military / Government,Australia,Oceania,1,1,1,0,0,1,0,Technical Failure
1979-12-09 00:00:00,Big Pine Trucking Company,Flight,Operational,United States of America,North America,1,1,1,0,0,1,0,Human Factor
1979-12-15 00:00:00,J. O’Connell,Takeoff (climb),Business,Australia,Oceania,1,1,1,0,0,1,0,Unknown
1979-12-22 00:00:00,Combs FreightAir,Flight,Operational,United States of America,North America,1,1,1,0,0,1,0,Human Factor
1979-12-28 00:00:00,Vernon E. Faulconer,Landing (descent or approach),Business,United States of America,North America,1,1,1,0,0,1,0,Human Factor
1980-01-07 00:00:00,Soviet Air Force - Voyenno-vozdushnye sily CCCP,Landing (descent or approach),Military / Government,Afghanistan,Asia,6,6,1,0,0,1,5,Human Factor
1980-01-24 00:00:00,Volonteer Aviation,Takeoff (climb),Operational,United States of America,North America,1,1,1,0,0,1,0,Technical Failure
1980-01-30 00:00:00,Private American,Takeoff (climb),Business,United States of America,North America,4,2,1,2,0,1,3,Human Factor
1980-02-03 00:00:00,Cubana de Aviación,Landing (descent or approach),Commercial,Cuba,Central America,37,4,0,33,1,1,36,Unknown
1980-02-11 00:00:00,Stephen H. Elmore,Flight,Operational,United States of America,North America,1,1,1,0,0,1,0,Unknown
1980-02-11 00:00:00,Super Spread Aviation,Flight,Military / Government,Australia,Oceania,1,1,1,0,0,1,0,Unknown
1980-02-15 00:00:00,Allen County Airlines,Takeoff (climb),Operational,United States of America,North America,1,1,1,0,0,1,0,Weather
1980-02-26 00:00:00,Codds Air Service,Takeoff (climb),Operational,Australia,Oceania,1,1,1,0,0,1,0,Unknown
1980-03-11 00:00:00,Athabaska Airways,Takeoff (climb),Commercial,Canada,North America,6,1,0,5,1,1,5,Unknown
1980-04-03 00:00:00,Bombardier Aerospace,Flight,Specialised Services,United States of America,North America,3,3,1,0,0,1,2,Technical Failure
1980-04-07 00:00:00,Waldron Enterprises,Flight,Business,United States of America,North America,1,1,1,0,0,1,0,Human Factor
1980-04-23 00:00:00,Interflight,Landing (descent or approach),Operational,United States of America,North America,1,1,1,0,0,1,0,Human Factor
1980-04-24 00:00:00,Air Spray,Flight,Humanitarian,Canada,North America,1,1,1,0,0,1,0,Unknown
1980-04-26 00:00:00,Aeroflot - Russian International Airlines,Takeoff (climb),Operational,Russia,Asia,3,2,0,1,1,1,2,Human Factor
1980-04-27 00:00:00,Faraday Industries,Landing (descent or approach),Business,United States of America,North America,2,1,1,1,0,1,1,Technical Failure
1980-05-11 00:00:00,Pyrenair,Landing (descent or approach),Humanitarian,France,Europe,1,1,1,0,0,1,0,Unknown
1980-05-28 00:00:00,Private Australian,Takeoff (climb),Commercial,Australia,Oceania,3,1,1,2,0,1,2,Technical Failure
1980-07-07 00:00:00,Astro Wings,Landing (descent or approach),Operational,United States of America,North America,2,1,0,1,1,1,1,Weather
1980-07-10 00:00:00,Aircraft Finance and Leasing Company,Landing (descent or approach),Business,United States of America,North America,6,2,1,4,0,1,5,Technical Failure
1980-07-12 00:00:00,Chilean Air Force - Fuerza Aérea de Chile,Flight,Military / Government,Chile,South America,17,2,0,15,1,1,16,Technical Failure
1980-07-18 00:00:00,James Aviation,Flight,Operational,New Zealand,Oceania,1,1,1,0,0,1,0,Human Factor
1980-08-05 00:00:00,United States Forest Service - USFS,Flight,Military / Government,United States of America,North America,2,1,1,1,0,1,1,Human Factor
1980-08-07 00:00:00,TAROM - Transporturile Aeriene Române,Landing (descent or approach),Commercial,Mauritania,Africa,178,16,0,162,1,1,177,Human Factor
1980-08-20 00:00:00,Group Lotus Car Companies,Flight,Operational,United Kingdom,Europe,1,1,1,0,0,1,0,Human Factor
1980-08-25 00:00:00,George E. Harris %26 Company,Flight,Humanitarian,Jamaica,Central America,1,1,1,0,0,1,0,Human Factor
1980-08-27 00:00:00,TAM Paraguay - Transporte Aéreo Militar,Landing (descent or approach),Military / Government,Paraguay,South America,0,0,1,0,0,1,-1,Technical Failure
1980-09-02 00:00:00,Private American,Flight,Business,United States of America,North America,1,1,1,0,0,1,0,Unknown
1980-09-03 00:00:00,Clark Aviation,Takeoff (climb),Operational,United States of America,North America,1,1,1,0,0,1,0,Technical Failure
1980-09-10 00:00:00,Culpeper Aviation,Takeoff (climb),Operational,United States of America,North America,1,1,1,0,0,1,0,Technical Failure
1980-09-11 00:00:00,Air Mont-Laurier,Flight,Commercial,Canada,North America,3,1,0,2,1,1,2,Unknown
1980-09-12 00:00:00,Beier Radio,Landing (descent or approach),Business,United States of America,North America,1,1,1,0,0,1,0,Human Factor
1980-10-01 00:00:00,Penarth Commercial Properties,Landing (descent or approach),Business,United Kingdom,Europe,1,1,1,0,0,1,0,Human Factor
1980-10-11 00:00:00,Trans Island Airways - Bahamas,Landing (descent or approach),Commercial,Bahamas,Central America,8,2,0,6,1,1,7,Human Factor
1980-10-30 00:00:00,Cosmopolitan Broadcasting Corporation,Landing (descent or approach),Humanitarian,United States of America,North America,1,1,1,0,0,1,0,Technical Failure
1980-11-04 00:00:00,Aeroflot - Russian International Airlines,Landing (descent or approach),Operational,Ukraine,Europe,2,2,1,0,0,1,1,Human Factor
1980-11-18 00:00:00,Moonlight Express,Flight,Operational,United States of America,North America,1,1,1,0,0,1,0,Weather
1980-12-11 00:00:00,Private American,Landing (descent or approach),Humanitarian,United States of America,North America,1,1,1,0,0,1,0,Human Factor
1980-12-12 00:00:00,Castle Aero Club,Takeoff (climb),Business,United States of America,North America,5,1,1,4,0,1,4,Human Factor
1981-01-22 00:00:00,Calif Air Charter,Flight,Operational,United States of America,North America,1,1,1,0,0,1,0,Human Factor
1981-01-26 00:00:00,NorthWest Skyways,Takeoff (climb),Commercial,Australia,Oceania,10,1,0,9,1,1,9,Unknown
1981-02-02 00:00:00,Miller Air Transporters Company,Flight,Humanitarian,United States of America,North America,1,1,1,0,0,1,0,Human Factor
1981-03-02 00:00:00,Robertson Air Service,Flight,Military / Government,New Zealand,Oceania,1,1,1,0,0,1,0,Human Factor
1981-03-14 00:00:00,Alaska Air Guides,Flight,Business,United States of America,North America,2,1,1,1,0,1,1,Human Factor
1981-03-14 00:00:00,Aeroflot - Russian International Airlines,Takeoff (climb),Specialised Services,Georgia,Asia,6,2,0,4,1,1,5,Human Factor
1981-03-23 00:00:00,Cooper Wood Products,Takeoff (climb),Business,United States of America,North America,1,1,1,0,0,1,0,Human Factor
1981-03-25 00:00:00,J. C. Enterprises,Flight,Business,United States of America,North America,1,1,1,0,0,1,0,Human Factor
1981-03-26 00:00:00,LOT Polish Airlines - Polskie Linie Lotnicze,Landing (descent or approach),Commercial,Poland,Europe,52,5,0,47,1,1,51,Human Factor
1981-03-28 00:00:00,Caribbean Air Cargo,Landing (descent or approach),Operational,United States of America,Central America,3,3,1,0,0,1,2,Technical Failure
1981-04-21 00:00:00,Donald C. Meyer,Takeoff (climb),Operational,United States of America,North America,1,1,1,0,0,1,0,Technical Failure
1981-05-03 00:00:00,MG Kailis Group,Landing (descent or approach),Operational,Australia,Oceania,1,1,1,0,0,1,0,Unknown
1981-05-24 00:00:00,Kestutis Petrauskas,Takeoff (climb),Business,United States of America,North America,1,1,1,0,0,1,0,Human Factor
1981-05-24 00:00:00,Grand Canyon Airlines,Flight,Commercial,United States of America,North America,7,1,0,6,1,1,6,Technical Failure
1981-06-04 00:00:00,Alaska Express,Takeoff (climb),Operational,United States of America,North America,1,1,1,0,0,1,0,Human Factor
1981-06-11 00:00:00,A. W. Hirshberg,Flight,Humanitarian,United States of America,North America,2,1,0,1,1,1,1,Human Factor
1981-06-19 00:00:00,Private New Zealand,Flight,Operational,United States of America,North America,1,1,1,0,0,1,0,Unknown
1981-06-30 00:00:00,Cessna Aircraft Company,Flight,Specialised Services,United States of America,North America,1,1,1,0,0,1,0,Human Factor
1981-07-09 00:00:00,Private American,Flight,Operational,United States of America,North America,1,1,1,0,0,1,0,Human Factor
1981-07-11 00:00:00,Ralph Lowry Aircraft Sales,Landing (descent or approach),Operational,United States of America,North America,1,1,1,0,0,1,0,Human Factor
1981-08-01 00:00:00,Aurora Air Services,Flight,Operational,United States of America,North America,1,1,1,0,0,1,0,Human Factor
1981-08-04 00:00:00,Kodiak Western Alaska Airlines,Flight,Operational,United States of America,North America,1,1,1,0,0,1,0,Human Factor
1981-08-09 00:00:00,Aeroflot - Russian International Airlines,Flight,Commercial,Russia,Asia,6,2,0,4,1,1,5,Human Factor
1981-08-21 00:00:00,Air Freight Express,Takeoff (climb),Operational,United States of America,North America,1,1,1,0,0,1,0,Technical Failure
1981-08-30 00:00:00,Donald L. Stoneburner,Landing (descent or approach),Business,United States of America,North America,1,1,1,0,0,1,0,Human Factor
1981-10-04 00:00:00,McKinley Aviation,Takeoff (climb),Business,United States of America,North America,1,1,1,0,0,1,0,Human Factor
1981-10-24 00:00:00,Pac Exec Charter,Landing (descent or approach),Business,United States of America,North America,1,1,1,0,0,1,0,Human Factor
1981-10-26 00:00:00,Butler-Johnson,Takeoff (climb),Business,United States of America,North America,1,1,1,0,0,1,0,Human Factor
1981-10-31 00:00:00,Cameroon Airlines,Takeoff (climb),Commercial,Cameroon,Africa,24,2,0,22,1,1,23,Human Factor
1981-11-07 00:00:00,Munz Northern Airlines,Flight,Operational,United States of America,North America,1,1,1,0,0,1,0,Human Factor
1981-11-08 00:00:00,Safcol Seafoods,Takeoff (climb),Business,Australia,Oceania,1,1,1,0,0,1,0,Unknown
1981-11-18 00:00:00,Synergistic Flights,Landing (descent or approach),Operational,United States of America,North America,1,1,1,0,0,1,0,Human Factor
1981-11-22 00:00:00,Dick Sawyer International,Flight,Operational,Samoa,Oceania,1,1,1,0,0,1,0,Technical Failure
1981-12-06 00:00:00,North American Road,Landing (descent or approach),Business,Canada,North America,2,1,1,1,0,1,1,Unknown
1981-12-28 00:00:00,Air Chaparral,Landing (descent or approach),Operational,United States of America,North America,1,1,1,0,0,1,0,Human Factor
1982-01-02 00:00:00,United States Navy - USN,Landing (descent or approach),Military / Government,United States of America,North America,8,2,1,6,0,1,7,Unknown
1982-01-05 00:00:00,Reprographics,Takeoff (climb),Specialised Services,Australia,Oceania,1,1,1,0,0,1,0,Human Factor
1982-01-17 00:00:00,Aviation Services International,Landing (descent or approach),Humanitarian,United States of America,North America,1,1,1,0,0,1,0,Human Factor
1982-01-21 00:00:00,Springdale Air Service,Landing (descent or approach),Operational,United States of America,North America,1,1,1,0,0,1,0,Human Factor
1982-01-22 00:00:00,RFG Regionalflug,Landing (descent or approach),Operational,Germany,Europe,1,1,1,0,0,1,0,Unknown
1982-02-11 00:00:00,Vietnam People's Air Force,Flight,Military / Government,Thailand,Asia,13,3,0,10,1,1,12,Terrorism
1982-02-21 00:00:00,Pilgrim Airlines,Flight,Commercial,United States of America,North America,12,2,0,10,1,1,11,Human Factor
1982-03-15 00:00:00,Private American,Landing (descent or approach),Business,United States of America,North America,1,1,1,0,0,1,0,Other
1982-03-18 00:00:00,Atlas Plastics Corporation,Landing (descent or approach),Business,United States of America,North America,3,2,1,1,0,1,2,Human Factor
1982-03-29 00:00:00,Gulfstream Aerospace Corporation,Flight,Operational,United States of America,North America,1,1,1,0,0,1,0,Human Factor
1982-04-28 00:00:00,Harry Noe,Takeoff (climb),Business,United States of America,North America,1,1,1,0,0,1,0,Technical Failure
1982-05-05 00:00:00,Astro Airways,Flight,Business,United States of America,North America,2,1,1,1,0,1,1,Human Factor
1982-05-18 00:00:00,Air Security Transport,Takeoff (climb),Commercial,United States of America,North America,2,1,1,1,0,1,1,Human Factor
1982-05-21 00:00:00,Aeroflot - Russian International Airlines,Takeoff (climb),Military / Government,Russia,Asia,1,1,1,0,0,1,0,Technical Failure
1982-05-24 00:00:00,Wilderness Airlines,Landing (descent or approach),Humanitarian,Canada,North America,2,1,0,1,1,1,1,Unknown
1982-06-11 00:00:00,Private German,Flight,Business,Italy,Europe,1,1,1,0,0,1,0,Unknown
1982-06-29 00:00:00,Robertson Air Service,Flight,Military / Government,New Zealand,Oceania,1,1,1,0,0,1,0,Human Factor
1982-07-01 00:00:00,Air Spray,Flight,Humanitarian,Canada,North America,1,1,1,0,0,1,0,Unknown
1982-07-15 00:00:00,Aeroflot - Russian International Airlines,Flight,Military / Government,Russia,Asia,2,2,1,0,0,1,1,Other
1982-08-18 00:00:00,Siimes Aviation,Landing (descent or approach),Operational,Finland,Europe,1,1,1,0,0,1,0,Technical Failure
1982-08-24 00:00:00,Soviet Air Force - Voyenno-vozdushnye sily CCCP,Flight,Operational,Russia,Asia,7,7,1,0,0,1,6,Human Factor
1982-09-24 00:00:00,Ford Motor Credit Company,Flight,Operational,United States of America,North America,1,1,1,0,0,1,0,Human Factor
1982-09-25 00:00:00,Mott Corporation,Landing (descent or approach),Business,United States of America,North America,1,1,1,0,0,1,0,Unknown
1982-10-05 00:00:00,Partenavia,Flight,Specialised Services,Italy,Europe,1,1,1,0,0,1,0,Technical Failure
1982-10-29 00:00:00,Starduff Inc.,Landing (descent or approach),Business,United States of America,North America,1,1,1,0,0,1,0,Human Factor
1982-11-03 00:00:00,Pars Air,Flight,Operational,Iran,Asia,1,1,1,0,0,1,0,Unknown
1982-11-12 00:00:00,Hill-Williford Aviation,Flight,Operational,United States of America,North America,1,1,1,0,0,1,0,Human Factor
1982-11-13 00:00:00,Golden Bear Aviation,Flight,Business,United States of America,North America,1,1,1,0,0,1,0,Unknown
1982-12-08 00:00:00,James Aviation,Flight,Military / Government,New Zealand,Oceania,1,1,1,0,0,1,0,Human Factor
1982-12-27 00:00:00,Murnane Aviation,Takeoff (climb),Commercial,United States of America,North America,7,1,1,6,0,1,6,Human Factor
1983-01-05 00:00:00,Moser Engine Service,Landing (descent or approach),Operational,United States of America,North America,1,1,1,0,0,1,0,Human Factor
1983-02-21 00:00:00,Sunshine Coast Air Charter,Flight,Operational,Australia,Oceania,1,1,1,0,0,1,0,Unknown
1983-03-01 00:00:00,Wanganui Aero Work,Flight,Military / Government,New Zealand,Oceania,1,1,1,0,0,1,0,Unknown
1983-03-05 00:00:00,Lynch Air Tankers,Flight,Humanitarian,United States of America,North America,1,1,1,0,0,1,0,Human Factor
1983-05-24 00:00:00,Interair,Takeoff (climb),Operational,Australia,Oceania,1,1,1,0,0,1,0,Unknown
1983-05-30 00:00:00,Hallers Air Conditioning Maintenance,Landing (descent or approach),Business,United States of America,North America,1,1,1,0,0,1,0,Human Factor
1983-06-15 00:00:00,Champion Air Adelaide,Takeoff (climb),Commercial,Australia,Oceania,4,1,0,3,1,1,3,Human Factor
1983-06-21 00:00:00,Raul A. Lopez Jr.,Flight,Business,Mexico,Central America,1,1,1,0,0,1,0,Unknown
1983-06-21 00:00:00,Central Air Transport - Canada,Takeoff (climb),Commercial,Canada,North America,3,1,1,2,0,1,2,Unknown
1983-06-24 00:00:00,Norman L. Marxen,Landing (descent or approach),Business,United States of America,North America,1,1,1,0,0,1,0,Human Factor
1983-06-30 00:00:00,Blackhawk Airways,Flight,Operational,United States of America,North America,1,1,1,0,0,1,0,Human Factor
1983-06-30 00:00:00,Holmstroem Air,Landing (descent or approach),Operational,Sweden,Europe,1,1,1,0,0,1,0,Human Factor
1983-07-09 00:00:00,Keith David Wickenden,Takeoff (climb),Specialised Services,United Kingdom,Europe,1,1,1,0,0,1,0,Technical Failure
1983-07-27 00:00:00,British Army Air Corps,Flight,Operational,United Kingdom,Europe,1,1,1,0,0,1,0,Human Factor
1983-07-30 00:00:00,Red Dodge,Flight,Business,United States of America,North America,2,1,0,1,1,1,1,Human Factor
1983-08-20 00:00:00,Ralph Anderson,Takeoff (climb),Business,United States of America,North America,3,1,1,2,0,1,2,Technical Failure
1983-09-11 00:00:00,Winward Aviation,Flight,Operational,United States of America,North America,1,1,1,0,0,1,0,Human Factor
1983-09-30 00:00:00,Allan Jeffries,Flight,Business,United States of America,North America,2,1,1,1,0,1,1,Human Factor
1983-10-03 00:00:00,Private American,Flight,Military / Government,Nicaragua,Central America,3,3,1,0,0,1,2,Terrorism
1983-10-24 00:00:00,Lightning Air Service,Takeoff (climb),Operational,United States of America,North America,1,1,1,0,0,1,0,Human Factor
1983-11-15 00:00:00,Southeast Airmotive,Landing (descent or approach),Operational,United States of America,North America,1,1,1,0,0,1,0,Human Factor
1983-11-20 00:00:00,Melvyn J. Goodman,Flight,Business,United States of America,North America,1,1,1,0,0,1,0,Unknown
1983-11-25 00:00:00,Aero Taxi - USA,Landing (descent or approach),Operational,United States of America,North America,1,1,1,0,0,1,0,Weather
1983-11-29 00:00:00,Zaire Catholic Mission,Takeoff (climb),Humanitarian,Democratic Republic of Congo,Africa,1,1,1,0,0,1,0,Unknown
1983-12-05 00:00:00,Isabel Castillo,Landing (descent or approach),Business,United States of America,North America,1,1,1,0,0,1,0,Other
1983-12-05 00:00:00,Connie Kalitta Services,Landing (descent or approach),Operational,United States of America,North America,1,1,1,0,0,1,0,Human Factor
1983-12-07 00:00:00,Royal Australian Army,Flight,Operational,Australia,Oceania,1,1,1,0,0,1,0,Unknown
1983-12-12 00:00:00,Blue Conquest Aviation,Landing (descent or approach),Business,United States of America,North America,1,1,1,0,0,1,0,Human Factor
1983-12-29 00:00:00,Mexican Government,Takeoff (climb),Military / Government,Mexico,Central America,3,1,1,2,0,1,2,Unknown
1983-12-30 00:00:00,Air BC - Air British Colombia,Takeoff (climb),Operational,Canada,North America,1,1,1,0,0,1,0,Unknown
1984-01-09 00:00:00,Skycraft Air Transport,Takeoff (climb),Operational,United States of America,North America,2,2,1,0,0,1,1,Human Factor
1984-01-13 00:00:00,North East Bolivian Airways - NEBA,Landing (descent or approach),Operational,Bolivia,South America,3,3,1,0,0,1,2,Technical Failure
1984-01-20 00:00:00,Private Australian,Flight,Operational,Australia,Oceania,1,1,1,0,0,1,0,Human Factor
1984-01-20 00:00:00,Atlantida Linea Aérea Sudamericana - ALAS,Landing (descent or approach),Commercial,Salvador,Central America,0,0,0,0,1,1,-1,Terrorism
1984-02-26 00:00:00,Vivian Industrial Plastics,Landing (descent or approach),Business,United States of America,North America,2,1,1,1,0,1,1,Human Factor
1984-03-19 00:00:00,Sair Aviation,Takeoff (climb),Operational,United States of America,North America,1,1,1,0,0,1,0,Weather
1984-03-21 00:00:00,Private New Zealand,Takeoff (climb),Military / Government,New Zealand,Oceania,2,1,0,1,1,1,1,Human Factor
1984-04-05 00:00:00,David N. Power,Landing (descent or approach),Operational,United States of America,North America,1,1,1,0,0,1,0,Human Factor
1984-04-18 00:00:00,Votec Taxi Aéreo,Landing (descent or approach),Commercial,Brazil,South America,17,2,0,15,1,1,16,Human Factor
1984-04-19 00:00:00,Turbine Air Management,Takeoff (climb),Operational,United States of America,North America,1,1,1,0,0,1,0,Human Factor
1984-05-06 00:00:00,Aeroflot - Russian International Airlines,Flight,Military / Government,Russia,Asia,1,1,1,0,0,1,0,Human Factor
1984-05-11 00:00:00,Hawk Aviation,Flight,Humanitarian,Bahamas,Central America,1,1,1,0,0,1,0,Unknown
1984-05-30 00:00:00,Air Service Hungary - Repülögépes Szolgalat Allami Vallat,Takeoff (climb),Military / Government,Hungary,Europe,1,1,1,0,0,1,0,Human Factor
1984-06-16 00:00:00,Aeroflot - Russian International Airlines,Flight,Military / Government,Ukraine,Europe,2,2,1,0,0,1,1,Technical Failure
1984-06-19 00:00:00,Aeroflot - Russian International Airlines,Flight,Military / Government,Kazakhstan,Asia,2,2,1,0,0,1,1,Unknown
1984-06-30 00:00:00,Provincetown-Boston Airline - PBA,Landing (descent or approach),Operational,United States of America,North America,2,2,1,0,0,1,1,Human Factor
1984-07-11 00:00:00,Yugoslav Air Force - Ratno Vazduhoplovstvo i Protivvazdušna Odbrana,Landing (descent or approach),Humanitarian,Croatia,Europe,3,3,1,0,0,1,2,Unknown
1984-07-13 00:00:00,Air Spray,Flight,Humanitarian,Canada,North America,1,1,1,0,0,1,0,Technical Failure
1984-07-15 00:00:00,Troy E. Stimson,Flight,Business,United States of America,North America,2,1,0,1,1,1,1,Human Factor
1984-07-21 00:00:00,South Pacific Island Airways - SPIA,Landing (descent or approach),Commercial,Samoa Islands (Western Samoa),Oceania,14,3,0,11,1,1,13,Technical Failure
1984-08-13 00:00:00,Earl H. Nonow,Landing (descent or approach),Business,United States of America,North America,1,1,1,0,0,1,0,Human Factor
1984-08-14 00:00:00,Latham Island Airways,Takeoff (climb),Commercial,Canada,North America,2,1,1,1,0,1,1,Unknown
1984-08-24 00:00:00,Seren,Landing (descent or approach),Business,United States of America,North America,1,1,1,0,0,1,0,Human Factor
1984-09-03 00:00:00,Palm Beach Aviation,Landing (descent or approach),Business,United States of America,North America,1,1,1,0,0,1,0,Technical Failure
1984-09-07 00:00:00,Provincetown-Boston Airline - PBA,Takeoff (climb),Commercial,United States of America,North America,6,1,0,5,1,1,5,Human Factor
1984-09-11 00:00:00,Private American,Takeoff (climb),Business,Australia,Oceania,1,1,1,0,0,1,0,Unknown
1984-09-14 00:00:00,Buss Automation,Landing (descent or approach),Business,United States of America,North America,1,1,1,0,0,1,0,Human Factor
1984-09-28 00:00:00,Aero Services - USA,Landing (descent or approach),Business,United States of America,North America,1,1,1,0,0,1,0,Human Factor
1984-09-28 00:00:00,Ronald Kaldor,Flight,Business,United States of America,North America,3,1,1,2,0,1,2,Technical Failure
1984-10-18 00:00:00,Continental Mortgage,Landing (descent or approach),Business,United States of America,North America,1,1,1,0,0,1,0,Technical Failure
1984-10-18 00:00:00,Private American,Takeoff (climb),Business,Mexico,Central America,1,1,1,0,0,1,0,Technical Failure
1984-10-23 00:00:00,NewCal Aviation,Flight,Operational,World,World,2,2,1,0,0,1,1,Human Factor
1984-10-24 00:00:00,Aeroflot - Russian International Airlines,Takeoff (climb),Commercial,Russia,Asia,16,2,0,14,1,1,15,Human Factor
1984-10-28 00:00:00,Rowley Aviation,Takeoff (climb),Humanitarian,New Zealand,Oceania,5,1,1,4,0,1,4,Human Factor
1984-10-29 00:00:00,Richard S. Dickenson,Landing (descent or approach),Humanitarian,United States of America,North America,1,1,1,0,0,1,0,Human Factor
1984-11-04 00:00:00,Private American,Takeoff (climb),Humanitarian,Belize,Central America,1,1,1,0,0,1,0,Technical Failure
1984-11-12 00:00:00,Fieldair,Takeoff (climb),Military / Government,New Zealand,Oceania,1,1,1,0,0,1,0,Human Factor
1984-11-19 00:00:00,EuroAir,Takeoff (climb),Operational,United Kingdom,Europe,1,1,1,0,0,1,0,Human Factor
1984-12-13 00:00:00,Eric W. Laub,Flight,Business,United States of America,North America,1,1,1,0,0,1,0,Human Factor
1984-12-16 00:00:00,Paul Meyer Guyer,Takeoff (climb),Business,United States of America,North America,1,1,1,0,0,1,0,Human Factor
1984-12-20 00:00:00,Northwest Air Charter,Landing (descent or approach),Business,United States of America,North America,2,1,0,1,1,1,1,Human Factor
1984-12-22 00:00:00,Falcon Air,Takeoff (climb),Commercial,United States of America,North America,1,1,1,0,0,1,0,Technical Failure
1984-12-25 00:00:00,Clinton Manges Oil %26 Refining Company,Landing (descent or approach),Business,United States of America,North America,1,1,1,0,0,1,0,Human Factor
1985-01-04 00:00:00,Chesapeake Aviation,Landing (descent or approach),Operational,United States of America,North America,1,1,1,0,0,1,0,Human Factor
1985-01-16 00:00:00,Vanderpool Flying Service,Flight,Commercial,United States of America,North America,1,1,1,0,0,1,0,Human Factor
1985-01-24 00:00:00,Southern Cross Aviation,Takeoff (climb),Business,South Africa,Africa,1,1,1,0,0,1,0,Technical Failure
1985-01-31 00:00:00,Private German,Takeoff (climb),Business,Germany,Europe,1,1,1,0,0,1,0,Unknown
1985-02-12 00:00:00,Phoenix Air - USA,Takeoff (climb),Operational,United States of America,North America,1,1,1,0,0,1,0,Human Factor
1985-02-14 00:00:00,PenAir - Peninsula Airways - Alaska Airlines Commuter,Flight,Operational,United States of America,North America,1,1,1,0,0,1,0,Human Factor
1985-03-06 00:00:00,Wild Blue,Landing (descent or approach),Business,United States of America,North America,1,1,1,0,0,1,0,Unknown
1985-03-17 00:00:00,Culen %26 Hamilton,Flight,Business,United States of America,North America,1,1,1,0,0,1,0,Human Factor
1985-03-28 00:00:00,Riviera Drilling %26 Exploration Company,Flight,Business,United States of America,North America,4,1,0,3,1,1,3,Human Factor
1985-05-09 00:00:00,Diversified Drilling Muds,Taxiing,Military / Government,United States of America,North America,3,2,1,1,0,1,2,Human Factor
1985-05-15 00:00:00,Regional Express,Takeoff (climb),Operational,United States of America,North America,1,1,1,0,0,1,0,Human Factor
1985-05-21 00:00:00,Bulair,Flight,Military / Government,Bulgaria,Europe,2,2,1,0,0,1,1,Unknown
1985-05-24 00:00:00,Lynch Flying Service,Landing (descent or approach),Specialised Services,United States of America,North America,1,1,1,0,0,1,0,Human Factor
1985-06-06 00:00:00,Skycraft Air Transport,Landing (descent or approach),Operational,United States of America,North America,1,1,1,0,0,1,0,Unknown
1985-06-12 00:00:00,Bulair,Flight,Military / Government,Bulgaria,Europe,1,1,1,0,0,1,0,Unknown
1985-06-19 00:00:00,Telco Systems,Flight,Business,United States of America,North America,1,1,1,0,0,1,0,Technical Failure
1985-06-20 00:00:00,SmithAir - USA,Takeoff (climb),Operational,United States of America,North America,1,1,1,0,0,1,0,Human Factor
1985-07-17 00:00:00,Precision Holding,Landing (descent or approach),Operational,Canada,North America,1,1,1,0,0,1,0,Unknown
1985-07-19 00:00:00,HMGS,Takeoff (climb),Business,United States of America,North America,5,2,0,3,1,1,4,Human Factor
1985-07-27 00:00:00,McSweeney's Mill %26 Mine Service,Takeoff (climb),Business,United States of America,North America,1,1,1,0,0,1,0,Human Factor
1985-07-30 00:00:00,United Air Charters,Takeoff (climb),Humanitarian,Mozambique,Africa,1,1,1,0,0,1,0,Terrorism
1985-08-07 00:00:00,Norfolk Island Airlines,Flight,Operational,Australia,Oceania,1,1,1,0,0,1,0,Human Factor
1985-08-13 00:00:00,Private German,Takeoff (climb),Business,Germany,Europe,1,1,1,0,0,1,0,Unknown
1985-08-16 00:00:00,Wolverine Air Charter,Takeoff (climb),Commercial,United States of America,North America,1,1,1,0,0,1,0,Technical Failure
1985-09-08 00:00:00,Aeroflot - Russian International Airlines,Flight,Military / Government,Kazakhstan,Asia,2,2,1,0,0,1,1,Technical Failure
1985-09-11 00:00:00,Opex Aviation,Flight,Business,United States of America,North America,1,1,1,0,0,1,0,Unknown
1985-09-12 00:00:00,Air Parcel Express,Takeoff (climb),Operational,United States of America,North America,1,1,1,0,0,1,0,Unknown
1985-09-16 00:00:00,Potlatch Corporation,Landing (descent or approach),Business,United States of America,North America,1,1,1,0,0,1,0,Human Factor
1985-09-17 00:00:00,Air Parcel Express,Flight,Operational,United States of America,North America,1,1,1,0,0,1,0,Technical Failure
1985-09-22 00:00:00,Louisiana-Pacific Corporation,Landing (descent or approach),Business,United States of America,North America,7,2,1,5,0,1,6,Human Factor
1985-09-25 00:00:00,Transtar Aviation,Landing (descent or approach),Operational,United States of America,North America,1,1,1,0,0,1,0,Human Factor
1985-10-11 00:00:00,Mountain Air Cargo,Flight,Operational,United States of America,North America,1,1,1,0,0,1,0,Human Factor
1985-10-11 00:00:00,Avia-Nor,Landing (descent or approach),Operational,Norway,Europe,1,1,1,0,0,1,0,Unknown
1985-10-16 00:00:00,Air Exchange,Landing (descent or approach),Operational,United States of America,North America,1,1,1,0,0,1,0,Human Factor
1985-11-03 00:00:00,Guyana Mining Company,Flight,Business,Guyana,South America,1,1,1,0,0,1,0,Unknown
1985-11-12 00:00:00,Gateway Pace Aviation,Landing (descent or approach),Operational,United States of America,North America,1,1,1,0,0,1,0,Human Factor
1985-12-03 00:00:00,Precision Holding,Landing (descent or approach),Operational,Canada,North America,1,1,1,0,0,1,0,Unknown
1985-12-03 00:00:00,Douglas P. Serpa,Takeoff (climb),Business,United States of America,North America,1,1,1,0,0,1,0,Human Factor
1985-12-08 00:00:00,Lawlor Service Corporation,Flight,Business,United States of America,North America,1,1,1,0,0,1,0,Technical Failure
1985-12-26 00:00:00,Soviet Air Force - Voyenno-vozdushnye sily CCCP,Flight,Military / Government,Afghanistan,Asia,6,6,1,0,0,1,5,Terrorism
1986-01-27 00:00:00,Aeroservicio Parragué - ASPAR,Landing (descent or approach),Humanitarian,Chile,South America,2,2,1,0,0,1,1,Other
1986-01-28 00:00:00,VASP - Viação Aérea de São Paulo,Takeoff (climb),Commercial,Brazil,South America,72,5,0,67,1,1,71,Human Factor
1986-02-07 00:00:00,Air Savoie,Flight,Operational,France,Europe,1,1,1,0,0,1,0,Unknown
1986-02-12 00:00:00,Steel City Aviation,Landing (descent or approach),Operational,United States of America,North America,1,1,1,0,0,1,0,Human Factor
1986-02-22 00:00:00,K Airways,Flight,Operational,United States of America,North America,1,1,1,0,0,1,0,Human Factor
1986-03-04 00:00:00,Muk Air,Landing (descent or approach),Operational,Sweden,Europe,1,1,1,0,0,1,0,Human Factor
1986-03-11 00:00:00,Private Australian,Landing (descent or approach),Operational,Australia,Oceania,1,1,1,0,0,1,0,Human Factor
1986-03-13 00:00:00,Private German,Landing (descent or approach),Business,United Kingdom,Europe,2,1,1,1,0,1,1,Human Factor
1986-03-14 00:00:00,James W. Cooper,Landing (descent or approach),Humanitarian,United States of America,North America,1,1,1,0,0,1,0,Human Factor
1986-03-23 00:00:00,Phaega Corporation,Flight,Operational,Canada,North America,1,1,1,0,0,1,0,Unknown
1986-03-26 00:00:00,Air Service Hungary - Repülögépes Szolgalat Allami Vallat,Flight,Military / Government,Hungary,Europe,1,1,1,0,0,1,0,Unknown
1986-04-05 00:00:00,Raymond C. Jopling Jr.,Flight,Business,United States of America,North America,1,1,1,0,0,1,0,Human Factor
1986-04-17 00:00:00,Gilbert Storey Machinery,Takeoff (climb),Commercial,Canada,North America,5,1,1,4,0,1,4,Unknown
1986-05-01 00:00:00,Wildlife %26 Fisheries,Flight,Business,United States of America,North America,1,1,1,0,0,1,0,Human Factor
1986-05-07 00:00:00,Barckley Airlines,Landing (descent or approach),Operational,United States of America,North America,1,1,1,0,0,1,0,Human Factor
1986-05-09 00:00:00,Gromex,Flight,Humanitarian,Germany,Europe,10,1,1,9,0,1,9,Unknown
1986-05-09 00:00:00,Suburban Air Freight,Landing (descent or approach),Operational,United States of America,North America,1,1,1,0,0,1,0,Technical Failure
1986-06-02 00:00:00,Martinaire,Takeoff (climb),Operational,United States of America,North America,1,1,1,0,0,1,0,Human Factor
1986-06-12 00:00:00,Loganair,Landing (descent or approach),Commercial,United Kingdom,Europe,16,2,1,14,0,1,15,Human Factor
1986-06-16 00:00:00,Ryan Air,Landing (descent or approach),Operational,United States of America,North America,1,1,1,0,0,1,0,Human Factor
1986-06-16 00:00:00,John B. McKee Jr.,Flight,Business,United States of America,North America,1,1,1,0,0,1,0,Human Factor
1986-06-22 00:00:00,Aeroflot - Russian International Airlines,Takeoff (climb),Commercial,Russia,Asia,65,6,0,59,1,1,64,Technical Failure
1986-07-22 00:00:00,Borinquen Air,Takeoff (climb),Operational,Puerto Rico,Central America,2,2,1,0,0,1,1,Technical Failure
1986-07-26 00:00:00,High Winds,Flight,Specialised Services,United States of America,North America,1,1,1,0,0,1,0,Human Factor
1986-08-06 00:00:00,Telesite,Flight,Business,United States of America,North America,1,1,1,0,0,1,0,Human Factor
1986-08-08 00:00:00,Air Parcel Express,Flight,Operational,United States of America,North America,1,1,1,0,0,1,0,Human Factor
1986-08-15 00:00:00,Conair Aviation,Flight,Humanitarian,Canada,North America,1,1,1,0,0,1,0,Unknown
1986-09-01 00:00:00,North Coast Air Services,Flight,Commercial,Canada,North America,4,1,0,3,1,1,3,Human Factor
1986-09-11 00:00:00,Fiji Air Services,Takeoff (climb),Commercial,Fiji Islands,Oceania,3,1,0,2,1,1,2,Human Factor
1986-09-14 00:00:00,Kondair,Landing (descent or approach),Operational,Netherlands,Europe,1,1,1,0,0,1,0,Weather
1986-09-28 00:00:00,Viking Express,Landing (descent or approach),Operational,United States of America,North America,1,1,1,0,0,1,0,Human Factor
1986-09-28 00:00:00,Cerrand Aviation,Takeoff (climb),Business,United States of America,North America,1,1,1,0,0,1,0,Human Factor
1986-10-02 00:00:00,Jozen Tap Corporation,Landing (descent or approach),Business,United States of America,North America,1,1,1,0,0,1,0,Technical Failure
1986-10-22 00:00:00,Travelair - Sweden,Landing (descent or approach),Operational,Sweden,Europe,1,1,1,0,0,1,0,Unknown
1986-10-23 00:00:00,OSG Tap %26 Dies,Takeoff (climb),Operational,United States of America,North America,1,1,1,0,0,1,0,Human Factor
1986-10-28 00:00:00,Virgin Island Seaplane Shuttle,Takeoff (climb),Commercial,United States of America,Central America,15,2,0,13,1,1,14,Technical Failure
1986-10-29 00:00:00,Jamie Muñoz,Takeoff (climb),Business,Puerto Rico,Central America,2,1,1,1,0,1,1,Other
1986-11-06 00:00:00,Lynch Flying Service,Landing (descent or approach),Operational,United States of America,North America,1,1,1,0,0,1,0,Human Factor
1986-11-07 00:00:00,Springdale Air Service,Landing (descent or approach),Operational,United States of America,North America,1,1,1,0,0,1,0,Human Factor
1986-11-08 00:00:00,Executive Fliteways,Landing (descent or approach),Commercial,United States of America,North America,4,2,1,2,0,1,3,Technical Failure
1986-12-18 00:00:00,Decks of Houston,Takeoff (climb),Business,United States of America,North America,1,1,1,0,0,1,0,Human Factor
1986-12-22 00:00:00,Aerial Agriculture,Takeoff (climb),Military / Government,Australia,Oceania,1,1,1,0,0,1,0,Human Factor
1986-12-28 00:00:00,Siimes Aviation,Landing (descent or approach),Operational,Finland,Europe,1,1,1,0,0,1,0,Human Factor
1986-12-30 00:00:00,Wright International Express,Flight,Operational,United States of America,North America,1,1,1,0,0,1,0,Human Factor
1987-01-12 00:00:00,Trillium Air,Landing (descent or approach),Commercial,Canada,North America,2,1,1,1,0,1,1,Technical Failure
1987-01-14 00:00:00,Birchwood Aircraft Services,Flight,Commercial,United States of America,North America,7,1,0,6,1,1,6,Human Factor
1987-01-16 00:00:00,California Air Charter - Cal Air Charter,Flight,Operational,United States of America,North America,1,1,1,0,0,1,0,Human Factor
1987-01-21 00:00:00,Ernir Airlines Isafirdi - Flugfelgid Ernir,Landing (descent or approach),Operational,Iceland,Europe,1,1,1,0,0,1,0,Human Factor
1987-04-13 00:00:00,Rowley Aviation,Flight,Military / Government,New Zealand,Oceania,1,1,1,0,0,1,0,Human Factor
1987-04-25 00:00:00,Private German,Flight,Business,Austria,Europe,1,1,1,0,0,1,0,Unknown
1987-04-26 00:00:00,Brown Air Services,Landing (descent or approach),Operational,United Kingdom,Europe,1,1,1,0,0,1,0,Human Factor
1987-05-06 00:00:00,Fieldair,Takeoff (climb),Military / Government,New Zealand,Oceania,1,1,1,0,0,1,0,Human Factor
1987-05-07 00:00:00,Yute Air Alaska,Flight,Operational,United States of America,North America,1,1,1,0,0,1,0,Human Factor
1987-05-20 00:00:00,Las Vegas Airlines,Takeoff (climb),Business,United States of America,North America,1,1,1,0,0,1,0,Human Factor
1987-05-27 00:00:00,Aero Coach Aviation International,Flight,Operational,United States of America,North America,1,1,1,0,0,1,0,Unknown
1987-06-13 00:00:00,Sécurité civile française,Flight,Humanitarian,France,Europe,1,1,1,0,0,1,0,Unknown
1987-06-18 00:00:00,George E. Moore,Flight,Specialised Services,United States of America,North America,1,1,1,0,0,1,0,Human Factor
1987-06-19 00:00:00,Aeroflot - Russian International Airlines,Flight,Military / Government,Kazakhstan,Asia,2,2,1,0,0,1,1,Human Factor
1987-07-13 00:00:00,KKD Aviation,Landing (descent or approach),Operational,Mexico,Central America,2,2,1,0,0,1,1,Other
1987-07-18 00:00:00,Government of Quebec,Landing (descent or approach),Operational,Canada,North America,2,2,1,0,0,1,1,Human Factor
1987-07-20 00:00:00,Air Maryland,Takeoff (climb),Operational,United States of America,North America,1,1,1,0,0,1,0,Human Factor
1987-07-24 00:00:00,Hayden W. Head,Landing (descent or approach),Business,United States of America,North America,2,1,1,1,0,1,1,Human Factor
1987-08-04 00:00:00,LAN Chile - Linea Aérea Nacional de Chile,Landing (descent or approach),Commercial,Chile,South America,35,4,0,31,1,1,34,Human Factor
1987-08-08 00:00:00,Hermens Air,Flight,Operational,United States of America,North America,1,1,1,0,0,1,0,Human Factor
1987-08-10 00:00:00,Samuel Kasdin,Takeoff (climb),Business,United States of America,North America,1,1,1,0,0,1,0,Technical Failure
1987-08-29 00:00:00,Cologne Commercial Flight,Flight,Operational,Germany,Europe,1,1,1,0,0,1,0,Human Factor
1987-09-02 00:00:00,J. Douglas Cameron,Flight,Business,United States of America,North America,1,1,1,0,0,1,0,Human Factor
1987-09-08 00:00:00,Private German,Landing (descent or approach),Business,Netherlands,Europe,1,1,1,0,0,1,0,Human Factor
1987-09-12 00:00:00,National Airways - UK,Takeoff (climb),Operational,United Kingdom,Europe,1,1,1,0,0,1,0,Human Factor
1987-09-17 00:00:00,United States Air Force - USAF,Parking,Military / Government,United States of America,North America,3,3,1,0,0,1,2,Unknown
1987-09-22 00:00:00,Smith Air,Flight,Operational,United States of America,North America,1,1,1,0,0,1,0,Human Factor
1987-10-06 00:00:00,Muk Air,Landing (descent or approach),Operational,Denmark,Europe,1,1,1,0,0,1,0,Unknown
1987-10-07 00:00:00,CDF Aviation - California Department of Forestry - Cal Fire,Flight,Humanitarian,United States of America,North America,1,1,1,0,0,1,0,Unknown
1987-10-09 00:00:00,Connie Kalitta Services,Takeoff (climb),Operational,United States of America,North America,1,1,1,0,0,1,0,Human Factor
1987-10-19 00:00:00,Artix,Landing (descent or approach),Operational,United Kingdom,Europe,1,1,1,0,0,1,0,Human Factor
1987-10-21 00:00:00,James Munson Harmon,Flight,Business,United States of America,North America,1,1,1,0,0,1,0,Weather
1987-10-23 00:00:00,Federal Express - FedEx,Flight,Operational,United States of America,North America,1,1,1,0,0,1,0,Weather
1987-10-23 00:00:00,Air Continental,Landing (descent or approach),Operational,United States of America,North America,1,1,1,0,0,1,0,Technical Failure
1987-11-29 00:00:00,Million Air Charter,Landing (descent or approach),Operational,United States of America,North America,2,2,1,0,0,1,1,Human Factor
1987-12-05 00:00:00,New Bight Enterprises Company,Landing (descent or approach),Business,Bahamas,Central America,1,1,1,0,0,1,0,Unknown
1987-12-08 00:00:00,Talair,Takeoff (climb),Commercial,Papua New Guinea,Oceania,4,1,0,3,1,1,3,Unknown
1987-12-10 00:00:00,Bering Air,Flight,Operational,United States of America,North America,1,1,1,0,0,1,0,Human Factor
1987-12-12 00:00:00,Private New Zealand,Flight,Military / Government,New Zealand,Oceania,1,1,1,0,0,1,0,Unknown
1987-12-21 00:00:00,Soviet Air Force - Voyenno-vozdushnye sily CCCP,Takeoff (climb),Operational,Afghanistan,Asia,6,6,1,0,0,1,5,Terrorism
1987-12-27 00:00:00,Niemeyer Aviation,Landing (descent or approach),Operational,Saint-Barthélemy,Central America,1,1,1,0,0,1,0,Weather
1988-01-04 00:00:00,Murray Fasken,Takeoff (climb),Business,United States of America,North America,1,1,1,0,0,1,0,Human Factor
1988-01-18 00:00:00,Robinson Foundry,Landing (descent or approach),Business,United States of America,North America,4,1,1,3,0,1,3,Human Factor
1988-01-18 00:00:00,Aero Astra,Landing (descent or approach),Commercial,United States of America,North America,8,2,1,6,0,1,7,Human Factor
1988-01-19 00:00:00,Central Air Charter,Landing (descent or approach),Operational,United States of America,North America,1,1,1,0,0,1,0,Human Factor
1988-01-25 00:00:00,National Airways - UK,Landing (descent or approach),Operational,United Kingdom,Europe,1,1,1,0,0,1,0,Human Factor
1988-01-27 00:00:00,William J. Brien,Takeoff (climb),Business,United States of America,North America,1,1,1,0,0,1,0,Technical Failure
1988-02-11 00:00:00,Interstate Farm,Landing (descent or approach),Business,United States of America,North America,2,1,1,1,0,1,1,Human Factor
1988-03-10 00:00:00,Lafayette Aviation,Takeoff (climb),Operational,United States of America,North America,1,1,1,0,0,1,0,Other
1988-04-01 00:00:00,ACE Air Cargo Express,Landing (descent or approach),Operational,United States of America,North America,1,1,1,0,0,1,0,Human Factor
1988-04-04 00:00:00,Northland Air Cargo,Flight,Operational,United States of America,North America,1,1,1,0,0,1,0,Human Factor
1988-04-28 00:00:00,Aloha Airlines,Flight,Commercial,United States of America,North America,95,5,1,90,0,1,94,Technical Failure
1988-05-17 00:00:00,Bankair,Landing (descent or approach),Operational,United States of America,North America,1,1,1,0,0,1,0,Human Factor
1988-05-20 00:00:00,Anglers Island Lodge,Takeoff (climb),Specialised Services,United States of America,North America,1,1,1,0,0,1,0,Human Factor
1988-05-25 00:00:00,Napier Air Service,Takeoff (climb),Operational,United States of America,North America,1,1,1,0,0,1,0,Technical Failure
1988-06-09 00:00:00,David M. Bailie,Flight,Business,United States of America,North America,1,1,1,0,0,1,0,Human Factor
1988-06-10 00:00:00,Pete E. Bloomfield,Takeoff (climb),Business,United States of America,North America,1,1,1,0,0,1,0,Human Factor
1988-06-17 00:00:00,Laurence D. Gavolic,Landing (descent or approach),Operational,United States of America,North America,3,2,1,1,0,1,2,Human Factor
1988-06-20 00:00:00,Executive Air,Takeoff (climb),Operational,Puerto Rico,Central America,1,1,1,0,0,1,0,Human Factor
1988-06-27 00:00:00,Dale R. A. Cady,Landing (descent or approach),Business,Bahamas,Central America,1,1,1,0,0,1,0,Unknown
1988-06-30 00:00:00,Perris Valley Skydiving Club,Flight,Humanitarian,United States of America,North America,1,1,1,0,0,1,0,Technical Failure
1988-07-02 00:00:00,J%26S Aero,Flight,Business,United States of America,North America,1,1,1,0,0,1,0,Human Factor
1988-07-14 00:00:00,Vadala Management Corporation,Landing (descent or approach),Business,United States of America,North America,1,1,1,0,0,1,0,Human Factor
1988-07-14 00:00:00,Kenn Borek Air,Flight,Operational,United States of America,North America,1,1,1,0,0,1,0,Human Factor
1988-07-19 00:00:00,Private Australian,Flight,Military / Government,Australia,Oceania,1,1,1,0,0,1,0,Human Factor
1988-07-20 00:00:00,Fairways Corporation,Takeoff (climb),Operational,United States of America,North America,1,1,1,0,0,1,0,Human Factor
1988-07-24 00:00:00,Aeroflot - Russian International Airlines,Takeoff (climb),Military / Government,Kazakhstan,Asia,4,2,0,2,1,1,3,Technical Failure
1988-07-25 00:00:00,Richard L. Bird,Flight,Business,United States of America,North America,1,1,1,0,0,1,0,Human Factor
1988-07-26 00:00:00,Northeast Jet,Landing (descent or approach),Operational,United States of America,North America,2,2,1,0,0,1,1,Human Factor
1988-07-31 00:00:00,Curtis D. Lorenz,Flight,Business,United States of America,North America,1,1,1,0,0,1,0,Human Factor
1988-08-18 00:00:00,Bellair,Takeoff (climb),Commercial,United States of America,North America,1,1,1,0,0,1,0,Human Factor
1988-08-26 00:00:00,Aeroflot - Russian International Airlines,Flight,Military / Government,Russia,Asia,4,2,0,2,1,1,3,Human Factor
1988-08-31 00:00:00,Aerocaribe - Aerovias Caribe,Takeoff (climb),Commercial,Mexico,Central America,20,3,0,17,1,1,19,Unknown
1988-09-05 00:00:00,Wrangell Air Service,Flight,Commercial,United States of America,North America,10,1,0,9,1,1,9,Human Factor
1988-09-11 00:00:00,Snowy Butte Aviation,Takeoff (climb),Operational,United States of America,North America,1,1,1,0,0,1,0,Human Factor
1988-09-20 00:00:00,Exportadora Unifrutti Traders,Flight,Business,Chile,South America,1,1,1,0,0,1,0,Unknown
1988-09-30 00:00:00,Executive Aircraft Leasing,Takeoff (climb),Business,United States of America,North America,1,1,1,0,0,1,0,Human Factor
1988-10-08 00:00:00,Confederate Air Force,Flight,Operational,United States of America,North America,1,1,1,0,0,1,0,Human Factor
1988-10-13 00:00:00,PacificAir - Pacific Airways,Landing (descent or approach),Commercial,Philippines,Asia,6,2,1,4,0,1,5,Unknown
1988-10-20 00:00:00,Diesel Service and Sales Company,Flight,Business,United States of America,North America,1,1,1,0,0,1,0,Human Factor
1988-10-31 00:00:00,Clarry McCarthy,Flight,Military / Government,Australia,Oceania,1,1,1,0,0,1,0,Human Factor
1988-11-01 00:00:00,Hubert G. Toll,Landing (descent or approach),Business,United States of America,North America,1,1,1,0,0,1,0,Technical Failure
1988-11-02 00:00:00,LOT Polish Airlines - Polskie Linie Lotnicze,Landing (descent or approach),Commercial,Poland,Europe,29,4,0,25,1,1,28,Technical Failure
1988-11-02 00:00:00,Conroe Aviation Services,Landing (descent or approach),Operational,United States of America,North America,1,1,1,0,0,1,0,Human Factor
1988-11-05 00:00:00,Carroll Air Services,Flight,Operational,United States of America,North America,1,1,1,0,0,1,0,Human Factor
1988-11-08 00:00:00,Ethiopian Airlines,Landing (descent or approach),Operational,Ethiopia,Africa,4,4,1,0,0,1,3,Technical Failure
1988-11-16 00:00:00,Corporate Aviation Services,Takeoff (climb),Operational,United States of America,North America,1,1,1,0,0,1,0,Human Factor
1988-11-20 00:00:00,Air Saint Hubert,Flight,Operational,Canada,North America,1,1,1,0,0,1,0,Unknown
1988-12-09 00:00:00,Sunny Moon Association,Flight,Operational,World,World,1,1,1,0,0,1,0,Unknown
1988-12-14 00:00:00,Ketchikan Air Service,Landing (descent or approach),Commercial,United States of America,North America,3,1,1,2,0,1,2,Human Factor
1988-12-28 00:00:00,Garrow Aviation,Flight,Military / Government,New Zealand,Oceania,1,1,1,0,0,1,0,Unknown
1989-01-03 00:00:00,Apollo Lines,Landing (descent or approach),Operational,United States of America,North America,1,1,1,0,0,1,0,Technical Failure
1989-01-09 00:00:00,VIP Properties,Landing (descent or approach),Business,United States of America,North America,1,1,1,0,0,1,0,Human Factor
1989-02-14 00:00:00,Sheldon L. Pollack,Flight,Business,United States of America,North America,1,1,1,0,0,1,0,Technical Failure
1989-02-28 00:00:00,Flight International,Flight,Military / Government,United States of America,North America,1,1,1,0,0,1,0,Human Factor
1989-03-09 00:00:00,Active Aero Charter,Takeoff (climb),Operational,United States of America,North America,1,1,1,0,0,1,0,Human Factor
1989-03-22 00:00:00,Top Flight Air Service,Landing (descent or approach),Operational,United States of America,North America,1,1,1,0,0,1,0,Human Factor
1989-03-28 00:00:00,Camel Leasing Company,Landing (descent or approach),Business,United States of America,North America,1,1,1,0,0,1,0,Human Factor
1989-03-31 00:00:00,Private American,Landing (descent or approach),Business,Bahamas,Central America,1,1,1,0,0,1,0,Unknown
1989-04-02 00:00:00,Aviation Centre,Landing (descent or approach),Operational,Australia,Oceania,1,1,1,0,0,1,0,Unknown
1989-04-04 00:00:00,Transport Air,Flight,Commercial,Canada,North America,6,1,1,5,0,1,5,Human Factor
1989-04-06 00:00:00,Central Airspread,Takeoff (climb),Military / Government,New Zealand,Oceania,1,1,1,0,0,1,0,Technical Failure
1989-04-06 00:00:00,Aeroflot - Russian International Airlines,Takeoff (climb),Military / Government,Belarus,Europe,2,2,1,0,0,1,1,Human Factor
1989-04-19 00:00:00,Aero Service Corporation - USA,Takeoff (climb),Business,Bolivia,South America,1,1,1,0,0,1,0,Technical Failure
1989-05-03 00:00:00,Harry A. Veite,Takeoff (climb),Business,United States of America,North America,1,1,1,0,0,1,0,Human Factor
1989-05-05 00:00:00,Aeroflot - Russian International Airlines,Takeoff (climb),Operational,Russia,Asia,4,2,0,2,1,1,3,Other
1989-05-06 00:00:00,Provincetown-Boston Airline - PBA,Landing (descent or approach),Operational,United States of America,North America,2,2,1,0,0,1,1,Human Factor
1989-05-10 00:00:00,Mesa Airlines,Flight,Operational,United States of America,North America,1,1,1,0,0,1,0,Human Factor
1989-05-17 00:00:00,FSZ Hassfurt - Fallschirm Sport Zentrum,Flight,Humanitarian,Germany,Europe,8,1,0,7,1,1,7,Human Factor
1989-05-29 00:00:00,Alaska Coastal Airlines,Landing (descent or approach),Operational,United States of America,North America,1,1,1,0,0,1,0,Human Factor
1989-06-18 00:00:00,Sécurité civile française,Flight,Humanitarian,France,Europe,1,1,1,0,0,1,0,Unknown
1989-07-06 00:00:00,Air Eastern,Flight,Operational,Australia,Oceania,1,1,1,0,0,1,0,Human Factor
1989-07-19 00:00:00,Centre Airlines,Takeoff (climb),Operational,United States of America,North America,1,1,1,0,0,1,0,Technical Failure
1989-07-21 00:00:00,Philippine Airlines - PAL,Landing (descent or approach),Commercial,Philippines,Asia,98,5,0,93,1,1,97,Human Factor
1989-08-03 00:00:00,Air South Airlines,Takeoff (climb),Operational,Turks and Caicos Islands,Central America,1,1,1,0,0,1,0,Unknown
1989-08-07 00:00:00,Ryan Air,Landing (descent or approach),Commercial,United States of America,North America,1,1,1,0,0,1,0,Human Factor
1989-08-08 00:00:00,Robert L. Blunt,Takeoff (climb),Business,United States of America,North America,1,1,1,0,0,1,0,Human Factor
1989-08-09 00:00:00,United States Air Force - USAF,Landing (descent or approach),Operational,United States of America,North America,7,7,1,0,0,1,6,Technical Failure
1989-09-10 00:00:00,Peter M. Maveal,Takeoff (climb),Business,United States of America,North America,2,1,1,1,0,1,1,Human Factor
1989-09-15 00:00:00,Ameriflight,Takeoff (climb),Operational,United States of America,North America,1,1,1,0,0,1,0,Technical Failure
1989-09-20 00:00:00,Aerial Agriculture,Flight,Military / Government,Australia,Oceania,1,1,1,0,0,1,0,Human Factor
1989-10-29 00:00:00,Springdale Air Service,Takeoff (climb),Commercial,United States of America,North America,2,1,1,1,0,1,1,Technical Failure
1989-11-01 00:00:00,Transcontinental Aviation,Landing (descent or approach),Commercial,United States of America,North America,2,1,0,1,1,1,1,Human Factor
1989-11-24 00:00:00,Aeroflot - Russian International Airlines,Takeoff (climb),Commercial,Kazakhstan,Asia,12,2,1,10,0,1,11,Weather
1989-11-29 00:00:00,Private Australian,Flight,Military / Government,Australia,Oceania,1,1,1,0,0,1,0,Human Factor
1989-12-21 00:00:00,Walter V. Wicker Jr.,Flight,Business,United States of America,North America,1,1,1,0,0,1,0,Technical Failure
1989-12-22 00:00:00,SouthCentral Air,Landing (descent or approach),Operational,United States of America,North America,1,1,1,0,0,1,0,Human Factor
1990-01-06 00:00:00,Greco Air,Takeoff (climb),Operational,United States of America,North America,2,2,1,0,0,1,1,Human Factor
1990-01-16 00:00:00,Superior Aviation,Landing (descent or approach),Operational,United States of America,North America,1,1,1,0,0,1,0,Human Factor
1990-01-17 00:00:00,Federal Express - FedEx,Flight,Operational,United States of America,North America,1,1,1,0,0,1,0,Human Factor
1990-01-18 00:00:00,EPPS Air Service,Landing (descent or approach),Operational,United States of America,North America,2,2,1,0,0,1,1,Human Factor
1990-01-29 00:00:00,Federal Express - FedEx,Takeoff (climb),Operational,United States of America,North America,1,1,1,0,0,1,0,Weather
1990-01-30 00:00:00,Slender You,Landing (descent or approach),Business,United States of America,North America,3,2,1,1,0,1,2,Technical Failure
1990-02-05 00:00:00,Sports Air Travel,Flight,Operational,United States of America,North America,1,1,1,0,0,1,0,Human Factor
1990-02-09 00:00:00,Aeromedical Services,Takeoff (climb),Humanitarian,United States of America,North America,4,2,1,2,0,1,3,Technical Failure
1990-02-12 00:00:00,TAM Brasil - Taxi Aéreo Marilia - Transportes Aéreos Regionais,Landing (descent or approach),Commercial,Brazil,South America,41,3,1,38,0,1,40,Human Factor
1990-02-17 00:00:00,PenAir - Peninsula Airways - Alaska Airlines Commuter,Landing (descent or approach),Operational,United States of America,North America,1,1,1,0,0,1,0,Human Factor
1990-02-27 00:00:00,Federal Express - FedEx,Landing (descent or approach),Operational,United States of America,North America,1,1,1,0,0,1,0,Weather
1990-03-12 00:00:00,Royal Australian Air Force - RAAF,Landing (descent or approach),Operational,Australia,Oceania,1,1,1,0,0,1,0,Technical Failure
1990-03-28 00:00:00,KASET - Bureau of Royal Rainmaking and Agricultural Aviation,Flight,Military / Government,Thailand,Asia,1,1,1,0,0,1,0,Unknown
1990-04-05 00:00:00,AMSA - Aerolineas Mundo SA,Flight,Operational,Puerto Rico,Central America,3,3,1,0,0,1,2,Technical Failure
1990-04-08 00:00:00,Private Philippine,Flight,Business,Philippines,Asia,7,1,0,6,1,1,6,Unknown
1990-04-13 00:00:00,Mount Vernon Fireplaces,Takeoff (climb),Business,United States of America,North America,1,1,1,0,0,1,0,Human Factor
1990-04-13 00:00:00,Aeroflot - Russian International Airlines,Takeoff (climb),Commercial,Russia,Asia,6,2,0,4,1,1,5,Other
1990-04-30 00:00:00,Frontier Air,Landing (descent or approach),Commercial,Canada,North America,4,2,1,2,0,1,3,Human Factor
1990-06-20 00:00:00,Juan A. Zeley,Flight,Business,Bahamas,Central America,1,1,1,0,0,1,0,Technical Failure
1990-06-26 00:00:00,D %26 M express,Flight,Business,United States of America,North America,1,1,1,0,0,1,0,Weather
1990-07-23 00:00:00,Federal Armored Service,Flight,Operational,United States of America,North America,1,1,1,0,0,1,0,Human Factor
1990-08-09 00:00:00,Royal Air Freight - Royal Air Charter,Takeoff (climb),Operational,United States of America,North America,1,1,1,0,0,1,0,Human Factor
1990-08-12 00:00:00,Aviex Jet,Landing (descent or approach),Commercial,Mexico,Central America,8,2,1,6,0,1,7,Human Factor
1990-08-25 00:00:00,Royal Malaysian Air Force - Tentera Udara Diraja Malaysia,Landing (descent or approach),Military / Government,Malaysia,Asia,40,8,0,32,1,1,39,Unknown
1990-09-03 00:00:00,Robert Seale,Takeoff (climb),Business,United States of America,North America,5,2,1,3,0,1,4,Human Factor
1990-09-06 00:00:00,Tennessee Air,Takeoff (climb),Operational,United States of America,North America,1,1,1,0,0,1,0,Human Factor
1990-09-19 00:00:00,National Jet Company,Landing (descent or approach),Business,United States of America,North America,1,1,1,0,0,1,0,Human Factor
1990-09-20 00:00:00,Victoria Air - USA,Flight,Commercial,Dominican Republic,Central America,2,1,1,1,0,1,1,Technical Failure
1990-09-20 00:00:00,Omega Air,Takeoff (climb),Operational,United States of America,North America,3,3,1,0,0,1,2,Human Factor
1990-09-21 00:00:00,P.M. Air,Landing (descent or approach),Operational,United States of America,North America,1,1,1,0,0,1,0,Human Factor
1990-09-24 00:00:00,Sécurité civile française,Flight,Humanitarian,France,Europe,1,1,1,0,0,1,0,Weather
1990-10-02 00:00:00,China Southwest Airlines,Parking,Commercial,China,Asia,131,9,1,122,0,1,130,Terrorism
1990-10-20 00:00:00,Air Kilroe,Takeoff (climb),Operational,United Kingdom,Europe,1,1,1,0,0,1,0,Human Factor
1990-11-07 00:00:00,Western N.S.W. Airlines,Landing (descent or approach),Operational,Australia,Oceania,1,1,1,0,0,1,0,Unknown
1990-11-09 00:00:00,Air Malawi,Landing (descent or approach),Operational,Malawi,Africa,2,2,1,0,0,1,1,Technical Failure
1990-11-23 00:00:00,Mansur T. Aftab,Landing (descent or approach),Business,United States of America,North America,1,1,1,0,0,1,0,Human Factor
1990-11-29 00:00:00,Century Life of America,Landing (descent or approach),Business,United States of America,North America,1,1,1,0,0,1,0,Technical Failure
1990-12-11 00:00:00,Private New Zealand,Takeoff (climb),Military / Government,New Zealand,Oceania,1,1,1,0,0,1,0,Technical Failure
1990-12-18 00:00:00,Alpine Aviation,Landing (descent or approach),Operational,United States of America,North America,1,1,1,0,0,1,0,Human Factor
1990-12-21 00:00:00,MarkAir Express,Landing (descent or approach),Operational,United States of America,North America,1,1,1,0,0,1,0,Human Factor
1991-01-17 00:00:00,Muk Air,Landing (descent or approach),Operational,Denmark,Europe,1,1,1,0,0,1,0,Unknown
1991-01-30 00:00:00,Merpati Nusantara Airlines - MNA,Flight,Commercial,Indonesia,Asia,21,3,0,18,1,1,20,Human Factor
1991-02-08 00:00:00,Labrador Airways,Flight,Operational,Canada,North America,1,1,1,0,0,1,0,Unknown
1991-02-14 00:00:00,Amann Aviation,Landing (descent or approach),Operational,Australia,Oceania,1,1,1,0,0,1,0,Technical Failure
1991-03-01 00:00:00,Lawrence R. Edwards,Landing (descent or approach),Business,United States of America,North America,1,1,1,0,0,1,0,Human Factor
1991-04-26 00:00:00,Royal Australian Air Force - RAAF,Flight,Military / Government,Australia,Oceania,21,4,0,17,1,1,20,Technical Failure
1991-05-01 00:00:00,John Westbrook,Takeoff (climb),Business,United States of America,North America,1,1,1,0,0,1,0,Human Factor
1991-05-07 00:00:00,Corporate Aviation Services,Flight,Business,United States of America,North America,1,1,1,0,0,1,0,Human Factor
1991-05-27 00:00:00,Cargair,Flight,Commercial,Canada,North America,4,1,1,3,0,1,3,Human Factor
1991-06-13 00:00:00,Air Ukraine,Takeoff (climb),Humanitarian,Ukraine,Europe,2,1,0,1,1,1,1,Human Factor
1991-06-30 00:00:00,Paul A. %26 Andrew Wood,Flight,Operational,United Kingdom,Europe,1,1,1,0,0,1,0,Human Factor
1991-07-15 00:00:00,TyumenAviaTrans,Takeoff (climb),Commercial,Russia,Asia,13,2,1,11,0,1,12,Technical Failure
1991-07-31 00:00:00,Central Air Southwest,Flight,Operational,United States of America,North America,1,1,1,0,0,1,0,Human Factor
1991-07-31 00:00:00,Central Air Southwest,Flight,Operational,United States of America,North America,1,1,1,0,0,1,0,Human Factor
1991-08-01 00:00:00,Hyman S. Fisher,Takeoff (climb),Business,United States of America,North America,1,1,1,0,0,1,0,Technical Failure
1991-08-07 00:00:00,John P. Larche,Flight,Business,Canada,North America,2,1,0,1,1,1,1,Human Factor
1991-09-16 00:00:00,Private Colombian,Takeoff (climb),Business,Colombia,South America,5,2,1,3,0,1,4,Technical Failure
1991-09-23 00:00:00,Special Cargo Airlines,Landing (descent or approach),Operational,Russia,Asia,16,7,0,9,1,1,15,Technical Failure
1991-09-26 00:00:00,Soviet Air Force - Voyenno-vozdushnye sily CCCP,Landing (descent or approach),Military / Government,Ukraine,Europe,9,8,1,1,0,1,8,Technical Failure
1991-09-29 00:00:00,Coral Colombia - Coronado Aerolineas,Landing (descent or approach),Operational,Colombia,South America,10,4,0,6,1,1,9,Technical Failure
1991-10-08 00:00:00,Deraya Air Taxi,Landing (descent or approach),Commercial,Indonesia,Asia,9,1,0,8,1,1,8,Unknown
1991-11-16 00:00:00,Federal Express - FedEx,Landing (descent or approach),Operational,United States of America,North America,1,1,1,0,0,1,0,Human Factor
1991-11-25 00:00:00,Scan Transportes Aéreos,Landing (descent or approach),Operational,Mozambique,Africa,3,3,1,0,0,1,2,Human Factor
1991-12-13 00:00:00,SouthCentral Air,Flight,Commercial,United States of America,North America,1,1,1,0,0,1,0,Unknown
1991-12-22 00:00:00,MarkAir Express,Landing (descent or approach),Operational,United States of America,North America,1,1,1,0,0,1,0,Human Factor
1991-12-28 00:00:00,Hellenic Air Force - Elleniki Polemiki Aeroporia,Takeoff (climb),Military / Government,Greece,Europe,6,4,1,2,0,1,5,Technical Failure
1992-01-02 00:00:00,Becher Hoppe Engineers,Landing (descent or approach),Business,United States of America,North America,1,1,1,0,0,1,0,Human Factor
1992-01-11 00:00:00,Private American,Landing (descent or approach),Business,United States of America,North America,1,1,1,0,0,1,0,Technical Failure
1992-02-06 00:00:00,Michael Stanton-Hicks,Flight,Specialised Services,United States of America,North America,1,1,1,0,0,1,0,Technical Failure
1992-02-11 00:00:00,Maximo Air,Landing (descent or approach),Operational,United States of America,North America,1,1,1,0,0,1,0,Human Factor
1992-02-26 00:00:00,Piedmont Air Cargo,Landing (descent or approach),Operational,United States of America,North America,1,1,1,0,0,1,0,Human Factor
1992-03-16 00:00:00,Airpasture,Flight,Military / Government,Australia,Oceania,1,1,1,0,0,1,0,Unknown
1992-03-29 00:00:00,Legal Air Flight Services,Takeoff (climb),Business,United States of America,North America,6,1,0,5,1,1,5,Human Factor
1992-03-30 00:00:00,Magadan Avia,Flight,Commercial,Russia,Asia,5,2,1,3,0,1,4,Human Factor
1992-04-04 00:00:00,Kamchatavia,Landing (descent or approach),Commercial,Russia,Asia,12,2,0,10,1,1,11,Human Factor
1992-04-23 00:00:00,Howard F. Arends,Landing (descent or approach),Operational,United States of America,North America,1,1,1,0,0,1,0,Human Factor
1992-05-18 00:00:00,Tanzanair - Tanzanian Air Services,Landing (descent or approach),Operational,Tanzania,Africa,1,1,1,0,0,1,0,Technical Failure
1992-06-19 00:00:00,CDF Aviation - California Department of Forestry - Cal Fire,Flight,Humanitarian,United States of America,North America,1,1,1,0,0,1,0,Human Factor
1992-06-25 00:00:00,Aircraft Sales International,Flight,Operational,United States of America,North America,1,1,1,0,0,1,0,Human Factor
1992-07-02 00:00:00,Turkish Navy - Türk Deniz Kuvvetleri,Flight,Operational,Turkey,Asia,1,1,1,0,0,1,0,Technical Failure
1992-07-13 00:00:00,Arctic Circle Air Service,Takeoff (climb),Operational,United States of America,North America,1,1,1,0,0,1,0,Other
1992-07-29 00:00:00,Gulf Air Taxi,Landing (descent or approach),Operational,United States of America,North America,1,1,1,0,0,1,0,Human Factor
1992-08-07 00:00:00,Marketplace America,Flight,Business,United States of America,North America,1,1,1,0,0,1,0,Human Factor
1992-08-27 00:00:00,Indian Government,Takeoff (climb),Operational,India,Asia,1,1,1,0,0,1,0,Unknown
1992-09-08 00:00:00,Miami Valley Services,Flight,Business,United States of America,North America,1,1,1,0,0,1,0,Human Factor
1992-09-10 00:00:00,Expresso Aéreo,Landing (descent or approach),Commercial,Peru,South America,43,7,1,36,0,1,42,Human Factor
1992-10-06 00:00:00,William L. Benson,Taxiing,Specialised Services,United States of America,North America,2,1,1,1,0,1,1,Human Factor
1992-10-09 00:00:00,Kievskoye MAP,Landing (descent or approach),Operational,Somalia,Africa,13,6,1,7,0,1,12,Human Factor
1992-12-10 00:00:00,Connie Kalitta Services,Landing (descent or approach),Operational,United States of America,North America,1,1,1,0,0,1,0,Other
1992-12-15 00:00:00,Mohican Air Service,Takeoff (climb),Operational,United States of America,North America,1,1,1,0,0,1,0,Human Factor
1992-12-17 00:00:00,Ernst Rüdiger Voggenreiter,Takeoff (climb),Business,Germany,Europe,1,1,1,0,0,1,0,Unknown
1992-12-22 00:00:00,Casper Air Service,Landing (descent or approach),Operational,United States of America,North America,1,1,1,0,0,1,0,Weather
1992-12-25 00:00:00,Corporate Air - USA,Flight,Operational,United States of America,North America,1,1,1,0,0,1,0,Unknown
1993-01-22 00:00:00,Executive Air Service Austria,Flight,Operational,Germany,Europe,1,1,1,0,0,1,0,Unknown
1993-02-05 00:00:00,Schäfer %26 Seidler,Takeoff (climb),Business,Germany,Europe,1,1,1,0,0,1,0,Technical Failure
1993-02-24 00:00:00,Centre Airlines,Landing (descent or approach),Operational,United States of America,North America,1,1,1,0,0,1,0,Human Factor
1993-03-03 00:00:00,Cherokee Express Air Cargo,Landing (descent or approach),Operational,United States of America,North America,1,1,1,0,0,1,0,Human Factor
1993-03-23 00:00:00,Springdale Air Service,Takeoff (climb),Operational,United States of America,North America,1,1,1,0,0,1,0,Other
1993-04-06 00:00:00,Eagle Airways - USA,Flight,Operational,United States of America,North America,1,1,1,0,0,1,0,Technical Failure
1993-04-26 00:00:00,Syktyvkar Avia,Flight,Humanitarian,Angola,Africa,7,7,1,0,0,1,6,Terrorism
1993-04-27 00:00:00,Arkansas Aircraft,Landing (descent or approach),Business,United States of America,North America,3,1,0,2,1,1,2,Human Factor
1993-05-04 00:00:00,Viking Express,Landing (descent or approach),Operational,United States of America,North America,1,1,1,0,0,1,0,Technical Failure
1993-05-17 00:00:00,Lineas Aéreas Covitrans,Landing (descent or approach),Operational,Peru,South America,2,2,1,0,0,1,1,Human Factor
1993-05-22 00:00:00,David L. Scott,Landing (descent or approach),Business,United States of America,North America,2,1,1,1,0,1,1,Human Factor
1993-06-01 00:00:00,Ecuadorian Air Force - Fuerza Aérea Ecuatoriana,Takeoff (climb),Military / Government,Ecuador,South America,11,3,1,8,0,1,10,Technical Failure
1993-06-08 00:00:00,Active Aero Charter,Takeoff (climb),Operational,United States of America,North America,1,1,1,0,0,1,0,Human Factor
1993-06-19 00:00:00,CDF Aviation - California Department of Forestry - Cal Fire,Flight,Humanitarian,United States of America,North America,1,1,1,0,0,1,0,Human Factor
1993-07-02 00:00:00,ROSTO,Takeoff (climb),Humanitarian,Russia,Asia,6,1,0,5,1,1,5,Human Factor
1993-07-20 00:00:00,Private Australian,Takeoff (climb),Business,Australia,Oceania,1,1,1,0,0,1,0,Human Factor
1993-07-30 00:00:00,Hornbill Skyways,Flight,Commercial,Malaysia,Asia,17,2,0,15,1,1,16,Human Factor
1993-08-15 00:00:00,Stapleford Tawney Air Taxis,Flight,Operational,United Kingdom,Europe,1,1,1,0,0,1,0,Unknown
1993-08-16 00:00:00,Aviation %26 Services Europe,Flight,Operational,France,Europe,1,1,1,0,0,1,0,Human Factor
1993-09-06 00:00:00,Andaman %26 Nicobar Administration,Landing (descent or approach),Commercial,India,Asia,4,1,0,3,1,1,3,Human Factor
1993-09-23 00:00:00,Transair Georgia Airlines,Parking,Commercial,Georgia,Asia,30,6,1,24,0,1,29,Terrorism
1993-09-27 00:00:00,Kent K. Gillingham,Takeoff (climb),Business,United States of America,North America,1,1,1,0,0,1,0,Technical Failure
1993-10-16 00:00:00,SouthCentral Air,Flight,Operational,United States of America,North America,1,1,1,0,0,1,0,Human Factor
1993-10-24 00:00:00,Private Swiss,Landing (descent or approach),Business,Switzerland,Europe,2,1,1,1,0,1,1,Human Factor
1993-10-29 00:00:00,Bulair,Flight,Military / Government,Sudan,Africa,1,1,1,0,0,1,0,Unknown
1993-11-12 00:00:00,Cherokee Express Air Cargo,Takeoff (climb),Operational,United States of America,North America,1,1,1,0,0,1,0,Technical Failure
1993-11-22 00:00:00,Phillip G. Aslett,Flight,Business,United States of America,North America,1,1,1,0,0,1,0,Human Factor
1993-12-28 00:00:00,Peterborough Parachute Centre,Landing (descent or approach),Humanitarian,Spain,Europe,1,1,1,0,0,1,0,Technical Failure
1993-12-30 00:00:00,Saint Proteus Air Système,Flight,Operational,France,Europe,1,1,1,0,0,1,0,Unknown
1994-01-14 00:00:00,Newcastle Aviation,Landing (descent or approach),Operational,Australia,Oceania,1,1,1,0,0,1,0,Human Factor
1994-02-25 00:00:00,British World Airlines - BWA,Flight,Operational,United Kingdom,Europe,2,2,1,0,0,1,1,Weather
1994-03-03 00:00:00,Ameriflight,Flight,Operational,United States of America,North America,1,1,1,0,0,1,0,Human Factor
1994-03-09 00:00:00,Jetcraft Air Cargo,Landing (descent or approach),Operational,Australia,Oceania,1,1,1,0,0,1,0,Human Factor
1994-03-18 00:00:00,Eagle Aviation - USA,Landing (descent or approach),Operational,United States of America,North America,1,1,1,0,0,1,0,Human Factor
1994-03-19 00:00:00,James E. Hogan,Landing (descent or approach),Business,United States of America,North America,1,1,1,0,0,1,0,Human Factor
1994-03-19 00:00:00,Light Air Transport,Flight,Operational,Libya,Africa,2,2,1,0,0,1,1,Unknown
1994-03-30 00:00:00,Jetspread,Flight,Military / Government,New Zealand,Oceania,1,1,1,0,0,1,0,Human Factor
1994-04-06 00:00:00,Nozaki Sangyo,Landing (descent or approach),Operational,Japan,Asia,1,1,1,0,0,1,0,Human Factor
1994-05-27 00:00:00,Grob Aerospace,Takeoff (climb),Operational,Germany,Europe,1,1,1,0,0,1,0,Human Factor
1994-07-13 00:00:00,Russian Air Force - Voyenno-vozdushnye sily Rossii,Flight,Humanitarian,Russia,Asia,1,1,1,0,0,1,0,Human Factor
1994-07-19 00:00:00,Rogers Helicopters,Takeoff (climb),Humanitarian,United States of America,North America,4,3,0,1,1,1,3,Human Factor
1994-08-04 00:00:00,Westchester Air,Takeoff (climb),Operational,United States of America,North America,1,1,1,0,0,1,0,Human Factor
1994-09-03 00:00:00,Air Material,Flight,Specialised Services,Switzerland,Europe,1,1,1,0,0,1,0,Technical Failure
1994-09-26 00:00:00,TAM Paraguay - Transporte Aéreo Militar,Takeoff (climb),Military / Government,Paraguay,South America,29,4,1,25,0,1,28,Technical Failure
1994-10-05 00:00:00,Caudle Hay Sales,Flight,Business,United States of America,North America,1,1,1,0,0,1,0,Human Factor
1994-10-08 00:00:00,Bill B. Limbaugh,Takeoff (climb),Business,United States of America,North America,1,1,1,0,0,1,0,Human Factor
1994-10-27 00:00:00,Donavia,Parking,Commercial,Russia,Asia,29,4,0,25,1,1,28,Terrorism
1994-11-05 00:00:00,Menary Aviation,Flight,Military / Government,New Zealand,Oceania,1,1,1,0,0,1,0,Human Factor
1994-11-16 00:00:00,Ameriflight,Flight,Operational,United States of America,North America,1,1,1,0,0,1,0,Human Factor
1994-11-18 00:00:00,Island Airlines,Landing (descent or approach),Operational,United States of America,North America,1,1,1,0,0,1,0,Human Factor
1994-12-04 00:00:00,Air Team,Takeoff (climb),Operational,Norway,Europe,1,1,1,0,0,1,0,Weather
1994-12-08 00:00:00,Cape Central Airways,Landing (descent or approach),Operational,United States of America,North America,1,1,1,0,0,1,0,Human Factor
1994-12-10 00:00:00,New Creations,Flight,Operational,United States of America,North America,1,1,1,0,0,1,0,Human Factor
1994-12-14 00:00:00,Air Charter - Germany,Takeoff (climb),Commercial,Russia,Asia,7,3,1,4,0,1,6,Unknown
1994-12-19 00:00:00,Walcha Aerial Services,Flight,Military / Government,Australia,Oceania,1,1,1,0,0,1,0,Human Factor
1994-12-21 00:00:00,Newcastle Aviation,Landing (descent or approach),Operational,Australia,Oceania,1,1,1,0,0,1,0,Human Factor
1995-01-09 00:00:00,Equator Airlines,Takeoff (climb),Commercial,Kenya,Africa,3,1,1,2,0,1,2,Unknown
1995-01-11 00:00:00,Federal Express - FedEx,Takeoff (climb),Operational,United States of America,North America,1,1,1,0,0,1,0,Human Factor
1995-01-12 00:00:00,Federal Express - FedEx,Landing (descent or approach),Operational,United States of America,North America,1,1,1,0,0,1,0,Human Factor
1995-01-18 00:00:00,Miabi Air,Landing (descent or approach),Humanitarian,Democratic Republic of Congo,Africa,32,4,0,28,1,1,31,Other
1995-01-26 00:00:00,Methow Aviation,Landing (descent or approach),Operational,United States of America,North America,1,1,1,0,0,1,0,Human Factor
1995-02-11 00:00:00,Edward M. Malone,Flight,Business,United States of America,North America,1,1,1,0,0,1,0,Human Factor
1995-02-25 00:00:00,Yute Air Alaska,Flight,Commercial,United States of America,North America,1,1,1,0,0,1,0,Human Factor
1995-03-15 00:00:00,Charles Powell,Takeoff (climb),Business,United States of America,North America,1,1,1,0,0,1,0,Human Factor
1995-03-22 00:00:00,Union Flights,Landing (descent or approach),Operational,United States of America,North America,1,1,1,0,0,1,0,Human Factor
1995-04-01 00:00:00,African Air Charter - Sierra Leone,Takeoff (climb),Operational,Sierra Leone,Africa,1,1,1,0,0,1,0,Unknown
1995-04-12 00:00:00,Robert L. Kovach,Landing (descent or approach),Business,United States of America,North America,4,1,0,3,1,1,3,Human Factor
1995-04-12 00:00:00,Air Cargo Masters,Flight,Operational,United States of America,North America,1,1,1,0,0,1,0,Human Factor
1995-04-18 00:00:00,Islamic Republic of Iran Air Force,Flight,Operational,Iran,Asia,1,1,1,0,0,1,0,Unknown
1995-04-18 00:00:00,Pacific Island Aviation - PIA,Flight,Operational,World,World,1,1,1,0,0,1,0,Unknown
1995-04-21 00:00:00,Daniel J. Hommel,Landing (descent or approach),Business,United States of America,North America,1,1,1,0,0,1,0,Technical Failure
1995-04-23 00:00:00,Bristow Helicopters,Landing (descent or approach),Commercial,Nigeria,Africa,9,2,1,7,0,1,8,Weather
1995-05-22 00:00:00,Servicios Aéreos Santa Ana - SASA,Takeoff (climb),Operational,Bolivia,South America,5,3,0,2,1,1,4,Technical Failure
1995-06-07 00:00:00,Fieldair,Takeoff (climb),Military / Government,New Zealand,Oceania,1,1,1,0,0,1,0,Human Factor
1995-06-30 00:00:00,Private Icelandic,Flight,Commercial,Iceland,Europe,1,1,1,0,0,1,0,Human Factor
1995-07-10 00:00:00,Palm Beach Aviation,Takeoff (climb),Commercial,Bahamas,Central America,7,1,0,6,1,1,6,Technical Failure
1995-07-17 00:00:00,Merpati Nusantara Airlines - MNA,Takeoff (climb),Commercial,Indonesia,Asia,18,2,1,16,0,1,17,Other
1995-07-19 00:00:00,Jet Air Express,Flight,Operational,United States of America,North America,2,2,1,0,0,1,1,Technical Failure
1995-08-19 00:00:00,Air North - Canada,Takeoff (climb),Operational,Canada,North America,3,3,1,0,0,1,2,Technical Failure
1995-08-22 00:00:00,Elizabeth M. Brand,Landing (descent or approach),Business,United States of America,North America,1,1,1,0,0,1,0,Human Factor
1995-08-28 00:00:00,Avmac Air,Flight,Operational,Bahamas,Central America,1,1,1,0,0,1,0,Technical Failure
1995-09-01 00:00:00,North Star Air Cargo,Flight,Operational,United States of America,North America,1,1,1,0,0,1,0,Human Factor
1995-09-02 00:00:00,May Industries,Landing (descent or approach),Business,United States of America,North America,1,1,1,0,0,1,0,Human Factor
1995-09-21 00:00:00,Hanseatic Air,Takeoff (climb),Business,United States of America,North America,1,1,1,0,0,1,0,Human Factor
1995-10-03 00:00:00,Sabang Merauke Raya Air Charter - SMAC,Flight,Commercial,Indonesia,Asia,14,2,1,12,0,1,13,Technical Failure
1995-10-10 00:00:00,Private Swiss,Landing (descent or approach),Business,Switzerland,Europe,1,1,1,0,0,1,0,Human Factor
1995-10-18 00:00:00,East Coast Aviation Services,Flight,Commercial,United States of America,North America,6,2,0,4,1,1,5,Technical Failure
1995-10-21 00:00:00,Tango Victor 421,Landing (descent or approach),Business,United States of America,North America,1,1,1,0,0,1,0,Human Factor
1995-10-26 00:00:00,Talon Air Service,Flight,Operational,United States of America,North America,1,1,1,0,0,1,0,Human Factor
1995-11-01 00:00:00,Fieldair,Flight,Military / Government,New Zealand,Oceania,1,1,1,0,0,1,0,Human Factor
1995-11-22 00:00:00,Nav Air Charter,Landing (descent or approach),Operational,Canada,North America,2,2,1,0,0,1,1,Human Factor
1995-11-28 00:00:00,Casey Industrial,Flight,Operational,United States of America,North America,1,1,1,0,0,1,0,Human Factor
1995-12-07 00:00:00,Hugh J. Gallagher,Landing (descent or approach),Business,United States of America,North America,1,1,1,0,0,1,0,Human Factor
1995-12-12 00:00:00,GAM Air Service - General Aviation Maintenance,Flight,Operational,Australia,Oceania,1,1,1,0,0,1,0,Unknown
1995-12-13 00:00:00,CDSI Holding Company,Flight,Business,United States of America,North America,1,1,1,0,0,1,0,Human Factor
1995-12-23 00:00:00,Chilean Air Force - Fuerza Aérea de Chile,Takeoff (climb),Humanitarian,Chile,South America,12,2,0,10,1,1,11,Technical Failure
1996-01-08 00:00:00,African Air,Takeoff (climb),Operational,Democratic Republic of Congo,Africa,6,4,1,2,0,1,5,Other
1996-01-08 00:00:00,Mustique Airways,Flight,Commercial,Barbados,Central America,10,1,0,9,1,1,9,Technical Failure
1996-01-09 00:00:00,Aspen Helicopters,Flight,Operational,United States of America,North America,1,1,1,0,0,1,0,Unknown
1996-01-22 00:00:00,Budget Marketing,Flight,Business,United States of America,North America,1,1,1,0,0,1,0,Human Factor
1996-01-24 00:00:00,Private German,Landing (descent or approach),Operational,Germany,Europe,2,2,1,0,0,1,1,Human Factor
1996-01-29 00:00:00,Trans Air - USA,Takeoff (climb),Operational,United States of America,North America,3,2,1,1,0,1,2,Human Factor
1996-02-08 00:00:00,King Island Airlines,Landing (descent or approach),Operational,Australia,Oceania,1,1,1,0,0,1,0,Human Factor
1996-02-16 00:00:00,West Coast Air Cargo,Flight,Operational,United States of America,North America,1,1,1,0,0,1,0,Unknown
1996-02-17 00:00:00,Roger Dunbar,Flight,Business,World,World,1,1,1,0,0,1,0,Unknown
1996-02-20 00:00:00,Servicios Aéreos Tomás Acevedo,Takeoff (climb),Commercial,Costa Rica,Central America,5,1,0,4,1,1,4,Technical Failure
1996-03-03 00:00:00,Hi Tech Aviation,Landing (descent or approach),Operational,Philippines,Asia,1,1,1,0,0,1,0,Unknown
1996-04-24 00:00:00,Tanzanair - Tanzanian Air Services,Landing (descent or approach),Operational,Tanzania,Africa,1,1,1,0,0,1,0,Human Factor
1996-05-11 00:00:00,Milne Bay Air - MBA,Flight,Commercial,Papua New Guinea,Oceania,10,1,0,9,1,1,9,Human Factor
1996-05-19 00:00:00,Loganair,Landing (descent or approach),Humanitarian,United Kingdom,Europe,3,1,1,2,0,1,2,Unknown
1996-05-19 00:00:00,Daniel E. Smith,Landing (descent or approach),Business,United States of America,North America,1,1,1,0,0,1,0,Human Factor
1996-06-04 00:00:00,Aeroexecutivos Taxi Aéreo,Takeoff (climb),Operational,Brazil,South America,4,2,1,2,0,1,3,Human Factor
1996-06-19 00:00:00,Hi Hat Leasing,Landing (descent or approach),Business,United States of America,North America,1,1,1,0,0,1,0,Human Factor
1996-07-17 00:00:00,Aerolatino,Landing (descent or approach),Commercial,Mexico,Central America,18,2,0,16,1,1,17,Unknown
1996-07-19 00:00:00,Loken Aviation,Landing (descent or approach),Operational,United States of America,North America,1,1,1,0,0,1,0,Human Factor
1996-07-30 00:00:00,Socièta Italiana Servizi Aerei Mediterranei - SISAM,Landing (descent or approach),Humanitarian,Italy,Europe,2,2,1,0,0,1,1,Human Factor
1996-08-14 00:00:00,Air North - Canada,Flight,Operational,Canada,North America,3,3,1,0,0,1,2,Technical Failure
1996-08-23 00:00:00,Private New Zealand,Flight,Military / Government,New Zealand,Oceania,1,1,1,0,0,1,0,Human Factor
1996-08-25 00:00:00,Sécurité civile française,Flight,Humanitarian,France,Europe,1,1,1,0,0,1,0,Unknown
1996-09-05 00:00:00,Michael A. O’Keefe,Flight,Business,United States of America,North America,1,1,1,0,0,1,0,Human Factor
1996-09-09 00:00:00,Robert D. Simpson,Takeoff (climb),Business,United States of America,North America,1,1,1,0,0,1,0,Technical Failure
1996-09-20 00:00:00,Scenic Airlines,Flight,Operational,United States of America,North America,1,1,1,0,0,1,0,Human Factor
1996-09-22 00:00:00,Watson Lake Flying Services,Flight,Operational,Canada,North America,1,1,1,0,0,1,0,Unknown
1996-10-30 00:00:00,Pay's Air Service,Flight,Military / Government,Australia,Oceania,1,1,1,0,0,1,0,Human Factor
1996-11-15 00:00:00,Leafair,Flight,Military / Government,Australia,Oceania,1,1,1,0,0,1,0,Human Factor
1996-11-26 00:00:00,Arctic Transportation Services,Takeoff (climb),Operational,United States of America,North America,1,1,1,0,0,1,0,Human Factor
1996-11-30 00:00:00,Amber Aviation,Landing (descent or approach),Business,United States of America,North America,1,1,1,0,0,1,0,Human Factor
1996-12-11 00:00:00,TolAir Services,Landing (descent or approach),Operational,Puerto Rico,Central America,1,1,1,0,0,1,0,Technical Failure
1996-12-12 00:00:00,Taquan Air,Takeoff (climb),Commercial,United States of America,North America,2,1,1,1,0,1,1,Human Factor
1997-01-22 00:00:00,Wanganui Aero Work,Flight,Military / Government,New Zealand,Oceania,1,1,1,0,0,1,0,Unknown
1997-01-29 00:00:00,SouthCentral Air,Landing (descent or approach),Operational,United States of America,North America,2,2,1,0,0,1,1,Technical Failure
1997-02-14 00:00:00,VARIG - Viação Aérea Rio Grandense,Landing (descent or approach),Commercial,Brazil,South America,54,6,1,48,0,1,53,Human Factor
1997-03-02 00:00:00,Coast Hotels %26 Casinos,Landing (descent or approach),Business,United States of America,North America,4,1,0,3,1,1,3,Human Factor
1997-03-19 00:00:00,MTK Jet,Landing (descent or approach),Business,United States of America,North America,1,1,1,0,0,1,0,Technical Failure
1997-03-25 00:00:00,Arctic Circle Air Service,Takeoff (climb),Operational,United States of America,North America,1,1,1,0,0,1,0,Human Factor
1997-03-25 00:00:00,Grant Aviation,Takeoff (climb),Operational,United States of America,North America,1,1,1,0,0,1,0,Human Factor
1997-04-10 00:00:00,Air Turicum,Landing (descent or approach),Operational,Switzerland,Europe,2,2,1,0,0,1,1,Technical Failure
1997-04-27 00:00:00,William Z. Williams,Flight,Business,United States of America,North America,1,1,1,0,0,1,0,Human Factor
1997-07-23 00:00:00,Tropic Air,Landing (descent or approach),Commercial,Belize,Central America,1,1,1,0,0,1,0,Human Factor
1997-07-29 00:00:00,ADC Airlines - Aviation Development Company,Landing (descent or approach),Commercial,Nigeria,Africa,55,6,1,49,0,1,54,Human Factor
1997-07-30 00:00:00,Air Littoral,Landing (descent or approach),Commercial,Italy,Europe,17,3,1,14,0,1,16,Human Factor
1997-08-14 00:00:00,Colvin Aviation,Landing (descent or approach),Operational,United States of America,North America,1,1,1,0,0,1,0,Human Factor
1997-08-18 00:00:00,TANTK - Taganrog ANTK,Takeoff (climb),Operational,Russia,Asia,1,1,1,0,0,1,0,Unknown
1997-09-02 00:00:00,Roland %26 Meckbach,Takeoff (climb),Business,Germany,Europe,1,1,1,0,0,1,0,Unknown
1997-09-26 00:00:00,Yute Air Alaska,Flight,Operational,United States of America,North America,1,1,1,0,0,1,0,Human Factor
1997-09-29 00:00:00,Promech Air,Takeoff (climb),Operational,United States of America,North America,1,1,1,0,0,1,0,Human Factor
1997-11-01 00:00:00,Air Zanzibar,Flight,Operational,Tanzania,Africa,1,1,1,0,0,1,0,Human Factor
1997-11-13 00:00:00,A%26H Aircraft Sales,Landing (descent or approach),Business,United States of America,North America,1,1,1,0,0,1,0,Human Factor
1997-11-17 00:00:00,Sécurité civile française,Landing (descent or approach),Operational,France,Europe,2,2,1,0,0,1,1,Technical Failure
1997-12-04 00:00:00,Société Soon,Flight,Business,France,Europe,1,1,1,0,0,1,0,Unknown
1997-12-10 00:00:00,Spitfire Sales %26 Leasing,Landing (descent or approach),Business,United States of America,North America,2,1,1,1,0,1,1,Human Factor
1997-12-19 00:00:00,Big Bang Aviation,Takeoff (climb),Business,United States of America,North America,1,1,1,0,0,1,0,Human Factor
1997-12-30 00:00:00,Sioux Falls Aviation,Takeoff (climb),Operational,United States of America,North America,1,1,1,0,0,1,0,Weather
1998-01-09 00:00:00,Federal Express - FedEx,Takeoff (climb),Operational,United States of America,North America,1,1,1,0,0,1,0,Human Factor
1998-01-17 00:00:00,Redding Aero Enterprises,Flight,Commercial,United States of America,North America,2,1,1,1,0,1,1,Weather
1998-02-06 00:00:00,SouthCentral Air,Takeoff (climb),Operational,United States of America,North America,1,1,1,0,0,1,0,Technical Failure
1998-03-05 00:00:00,Airpac Airlines,Flight,Operational,United States of America,North America,1,1,1,0,0,1,0,Human Factor
1998-03-05 00:00:00,Federal Express - FedEx,Flight,Operational,United States of America,North America,1,1,1,0,0,1,0,Weather
1998-04-06 00:00:00,Private German,Takeoff (climb),Operational,Germany,Europe,1,1,1,0,0,1,0,Technical Failure
1998-04-07 00:00:00,Federal Express - FedEx,Landing (descent or approach),Operational,United States of America,North America,1,1,1,0,0,1,0,Human Factor
1998-04-09 00:00:00,Private Isreali,Flight,Operational,World,World,1,1,1,0,0,1,0,Weather
1998-04-10 00:00:00,Maine Flight Center,Takeoff (climb),Operational,United States of America,North America,1,1,1,0,0,1,0,Unknown
1998-06-01 00:00:00,George Fortier III,Takeoff (climb),Specialised Services,United States of America,North America,1,1,1,0,0,1,0,Human Factor
1998-06-02 00:00:00,ZUA - Zakładu Usług Agrolotniczych - AET Agroaviation Services,Flight,Military / Government,Iran,Asia,1,1,1,0,0,1,0,Unknown
1998-06-12 00:00:00,Rif Air,Landing (descent or approach),Operational,United Kingdom,Europe,1,1,1,0,0,1,0,Technical Failure
1998-06-16 00:00:00,Corporate Air - USA,Landing (descent or approach),Operational,United States of America,North America,1,1,1,0,0,1,0,Human Factor
1998-07-08 00:00:00,ROSTO,Flight,Commercial,Russia,Asia,10,3,0,7,1,1,9,Technical Failure
1998-07-17 00:00:00,Jon Speisman,Takeoff (climb),Business,United States of America,North America,1,1,1,0,0,1,0,Human Factor
1998-08-01 00:00:00,Kenneth E. Asher,Takeoff (climb),Business,United States of America,North America,4,1,0,3,1,1,3,Human Factor
1998-08-11 00:00:00,Alada - Empresa de Transportes Aéreos,Landing (descent or approach),Commercial,Angola,Africa,13,7,1,6,0,1,12,Technical Failure
1998-08-21 00:00:00,Extra Aircraft,Flight,Operational,Germany,Europe,1,1,1,0,0,1,0,Human Factor
1998-08-24 00:00:00,Airworld,Takeoff (climb),Operational,South Africa,Africa,2,2,1,0,0,1,1,Human Factor
1998-09-04 00:00:00,David C. Blessing,Landing (descent or approach),Operational,United States of America,North America,1,1,1,0,0,1,0,Human Factor
1998-09-17 00:00:00,Village Aviation,Flight,Operational,United States of America,North America,1,1,1,0,0,1,0,Human Factor
1998-09-18 00:00:00,U.S. Customs %26 Border Protection,Flight,Operational,Puerto Rico,Central America,2,2,1,0,0,1,1,Human Factor
1998-09-28 00:00:00,Transportes Aéreos de Cabo Verde - TACV,Landing (descent or approach),Military / Government,Cabo Verde,Africa,22,3,0,19,1,1,21,Human Factor
1998-10-01 00:00:00,Desert Aircraft Sales,Landing (descent or approach),Business,United States of America,North America,1,1,1,0,0,1,0,Human Factor
1998-10-02 00:00:00,Servivensa - Servicios Avensa - Servicios Aerovias Venezolanas,Landing (descent or approach),Commercial,Venezuela,South America,25,3,1,22,0,1,24,Technical Failure
1998-10-05 00:00:00,CDF Aviation - California Department of Forestry - Cal Fire,Flight,Humanitarian,United States of America,North America,1,1,1,0,0,1,0,Human Factor
1998-10-28 00:00:00,Sundance Air,Landing (descent or approach),Operational,United States of America,North America,1,1,1,0,0,1,0,Human Factor
1998-11-19 00:00:00,Royal Nepal Airlines,Landing (descent or approach),Operational,Nepal,Asia,1,1,1,0,0,1,0,Human Factor
1998-11-20 00:00:00,Gemco,Flight,Business,United States of America,North America,1,1,1,0,0,1,0,Technical Failure
1998-12-02 00:00:00,Yates Aviation,Flight,Operational,United States of America,North America,1,1,1,0,0,1,0,Human Factor
1998-12-04 00:00:00,L %26 W Flying Service,Landing (descent or approach),Operational,United States of America,North America,1,1,1,0,0,1,0,Human Factor
1998-12-17 00:00:00,Zanex,Landing (descent or approach),Operational,Angola,Africa,10,8,1,2,0,1,9,Human Factor
1999-02-12 00:00:00,Ameriflight,Flight,Operational,United States of America,North America,1,1,1,0,0,1,0,Human Factor
1999-03-11 00:00:00,BAJ Aircraft Management Group,Takeoff (climb),Operational,United States of America,North America,1,1,1,0,0,1,0,Human Factor
1999-03-19 00:00:00,Provincial Airlines,Landing (descent or approach),Operational,Canada,North America,2,2,1,0,0,1,1,Human Factor
1999-03-25 00:00:00,Tropic Bird Landing,Landing (descent or approach),Operational,United States of America,North America,2,1,1,1,0,1,1,Technical Failure
1999-03-27 00:00:00,Fieldair,Takeoff (climb),Military / Government,New Zealand,Oceania,1,1,1,0,0,1,0,Other
1999-04-04 00:00:00,Robert R. Meredith,Flight,Business,United States of America,North America,1,1,1,0,0,1,0,Weather
1999-04-14 00:00:00,Village Aviation,Flight,Operational,United States of America,North America,1,1,1,0,0,1,0,Human Factor
1999-04-27 00:00:00,Texas Air Charters,Landing (descent or approach),Operational,United States of America,North America,1,1,1,0,0,1,0,Other
1999-04-29 00:00:00,TANTK - Taganrog ANTK,Takeoff (climb),Specialised Services,Germany,Europe,1,1,1,0,0,1,0,Human Factor
1999-05-12 00:00:00,EEC Investments,Landing (descent or approach),Business,Bahamas,Central America,1,1,1,0,0,1,0,Unknown
1999-05-22 00:00:00,Pacific International Skydiving Center,Landing (descent or approach),Humanitarian,United States of America,North America,1,1,1,0,0,1,0,Human Factor
1999-05-23 00:00:00,Robert A. Younkin,Landing (descent or approach),Business,United States of America,North America,1,1,1,0,0,1,0,Technical Failure
1999-06-09 00:00:00,PacificAir - Pacific Airways,Flight,Commercial,Philippines,Asia,1,1,1,0,0,1,0,Unknown
1999-06-11 00:00:00,Larry's Flying Service,Takeoff (climb),Operational,United States of America,North America,1,1,1,0,0,1,0,Technical Failure
1999-06-25 00:00:00,Blue Water Aviation - Manitoba Air Charter Services,Takeoff (climb),Specialised Services,Canada,North America,2,1,0,1,1,1,1,Other
1999-07-01 00:00:00,Brian Hawley,Flight,Business,United States of America,North America,1,1,1,0,0,1,0,Human Factor
1999-07-01 00:00:00,Savanair,Flight,Operational,Angola,Africa,5,5,1,0,0,1,4,Terrorism
1999-08-12 00:00:00,RégionnAir,Landing (descent or approach),Commercial,Canada,North America,4,2,1,2,0,1,3,Human Factor
1999-09-04 00:00:00,Private French,Flight,Business,France,Europe,1,1,1,0,0,1,0,Unknown
1999-09-14 00:00:00,Britannia Airways,Landing (descent or approach),Commercial,Spain,Europe,245,9,0,236,1,1,244,Human Factor
1999-09-27 00:00:00,Merline Nix,Landing (descent or approach),Operational,United States of America,North America,1,1,1,0,0,1,0,Human Factor
1999-10-11 00:00:00,Air Botswana,Flight,Humanitarian,Botswana,Africa,1,1,1,0,0,1,0,Human Factor
1999-10-14 00:00:00,Ameriflight,Flight,Operational,United States of America,North America,1,1,1,0,0,1,0,Human Factor
1999-10-17 00:00:00,World Wide Air Ferries,Flight,Operational,Canada,North America,1,1,1,0,0,1,0,Human Factor
1999-11-21 00:00:00,Walter L. Cecil,Flight,Specialised Services,United States of America,North America,1,1,1,0,0,1,0,Human Factor
1999-12-19 00:00:00,University of South Carolina,Landing (descent or approach),Business,United States of America,North America,2,2,1,0,0,1,1,Human Factor
1999-12-21 00:00:00,McMahan Enterprises,Landing (descent or approach),Business,United States of America,North America,1,1,1,0,0,1,0,Human Factor
2000-01-02 00:00:00,Brasier Asphalt Company,Flight,Business,United States of America,North America,1,1,1,0,0,1,0,Human Factor
2000-01-05 00:00:00,Skypower Express Airways,Landing (descent or approach),Commercial,Nigeria,Africa,13,2,0,11,1,1,12,Unknown
2000-02-11 00:00:00,American Check Transport,Landing (descent or approach),Operational,United States of America,North America,1,1,1,0,0,1,0,Human Factor
2000-03-21 00:00:00,Menekse Air,Landing (descent or approach),Commercial,Turkey,Asia,5,1,0,4,1,1,4,Human Factor
2000-03-26 00:00:00,Mike G. Rutherford,Landing (descent or approach),Operational,United States of America,North America,1,1,1,0,0,1,0,Human Factor
2000-04-01 00:00:00,Taxval,Takeoff (climb),Business,Argentina,South America,1,1,1,0,0,1,0,Human Factor
2000-05-03 00:00:00,Trans Guyana Airways,Landing (descent or approach),Operational,Guyana,South America,1,1,1,0,0,1,0,Human Factor
2000-05-25 00:00:00,Streamline Aviation,Taxiing,Operational,France,Europe,2,2,1,0,0,1,1,Human Factor
2000-05-26 00:00:00,Lemanair,Takeoff (climb),Operational,Switzerland,Europe,1,1,1,0,0,1,0,Human Factor
2000-06-02 00:00:00,Air Century,Takeoff (climb),Operational,Dominican Republic,Central America,2,2,1,0,0,1,1,Human Factor
2000-06-29 00:00:00,Air Manubada,Landing (descent or approach),Operational,Papua New Guinea,Oceania,1,1,1,0,0,1,0,Unknown
2000-07-08 00:00:00,M %26 N Aviation,Flight,Operational,Puerto Rico,Central America,1,1,1,0,0,1,0,Unknown
2000-07-31 00:00:00,Win Win Aviation,Landing (descent or approach),Operational,United States of America,North America,3,1,1,2,0,1,2,Human Factor
2000-08-18 00:00:00,XJ6 Inc.,Landing (descent or approach),Business,United States of America,North America,1,1,1,0,0,1,0,Human Factor
2000-08-24 00:00:00,NewTek Enterprise,Landing (descent or approach),Business,United States of America,North America,1,1,1,0,0,1,0,Human Factor
2000-08-25 00:00:00,Big Island Air,Landing (descent or approach),Commercial,United States of America,North America,9,1,0,8,1,1,8,Technical Failure
2000-09-02 00:00:00,Sandgar,Flight,Operational,Australia,Oceania,1,1,1,0,0,1,0,Unknown
2000-09-09 00:00:00,Rentacorp,Landing (descent or approach),Operational,Ecuador,South America,3,2,1,1,0,1,2,Human Factor
2000-09-09 00:00:00,Private French,Takeoff (climb),Business,France,Europe,1,1,1,0,0,1,0,Technical Failure
2000-09-20 00:00:00,Inland Aviation Services,Takeoff (climb),Operational,United States of America,North America,1,1,1,0,0,1,0,Human Factor
2000-10-09 00:00:00,Federal Express - FedEx,Flight,Operational,United States of America,North America,1,1,1,0,0,1,0,Human Factor
2000-10-10 00:00:00,Northern Airmotive,Takeoff (climb),Operational,United States of America,North America,1,1,1,0,0,1,0,Unknown
2000-10-20 00:00:00,Aircraft Guaranty Corporation Trustee,Landing (descent or approach),Business,Germany,Europe,1,1,1,0,0,1,0,Human Factor
2000-11-06 00:00:00,Air San Luis,Landing (descent or approach),Humanitarian,United States of America,North America,2,1,1,1,0,1,1,Human Factor
2000-11-07 00:00:00,Malu Aviation,Takeoff (climb),Operational,Mozambique,Africa,11,6,1,5,0,1,10,Technical Failure
2000-11-09 00:00:00,Superior Aviation,Takeoff (climb),Operational,United States of America,North America,1,1,1,0,0,1,0,Technical Failure
2000-11-25 00:00:00,Mayoral Executive Jet,Landing (descent or approach),Operational,Spain,Europe,2,2,1,0,0,1,1,Human Factor
2000-11-30 00:00:00,Gardner Aircraft Sales,Flight,Operational,United Kingdom,Europe,1,1,1,0,0,1,0,Weather
2000-12-14 00:00:00,Gordon E. Montgomery,Landing (descent or approach),Business,United States of America,North America,1,1,1,0,0,1,0,Human Factor
2001-02-20 00:00:00,Confidential Management Services,Takeoff (climb),Business,United States of America,North America,1,1,1,0,0,1,0,Human Factor
2001-03-03 00:00:00,Thai Airways International,Parking,Commercial,Thailand,Asia,8,8,1,0,0,1,7,Technical Failure
2001-03-26 00:00:00,Technical Leasing,Takeoff (climb),Business,United States of America,North America,1,1,1,0,0,1,0,Human Factor
2001-03-31 00:00:00,Crosco,Landing (descent or approach),Business,United States of America,North America,1,1,1,0,0,1,0,Human Factor
2001-04-02 00:00:00,Travelers Solution,Takeoff (climb),Operational,United States of America,North America,1,1,1,0,0,1,0,Human Factor
2001-04-15 00:00:00,Private Colombian,Landing (descent or approach),Business,Colombia,South America,1,1,1,0,0,1,0,Unknown
2001-04-26 00:00:00,Texas Air Charters,Landing (descent or approach),Operational,United States of America,North America,1,1,1,0,0,1,0,Human Factor
2001-04-29 00:00:00,Alan McVinish,Flight,Humanitarian,Australia,Oceania,12,1,0,11,1,1,11,Human Factor
2001-05-05 00:00:00,Max Schaldach,Takeoff (climb),Business,Germany,Europe,1,1,1,0,0,1,0,Human Factor
2001-05-05 00:00:00,Federal Express - FedEx,Landing (descent or approach),Operational,United States of America,North America,1,1,1,0,0,1,0,Human Factor
2001-05-13 00:00:00,City Wings,Flight,Operational,Puerto Rico,Central America,1,1,1,0,0,1,0,Human Factor
2001-05-14 00:00:00,CMH Investments,Flight,Business,United States of America,North America,1,1,1,0,0,1,0,Human Factor
2001-06-05 00:00:00,Oliveira e Silva Táxi Aéreo,Landing (descent or approach),Operational,Brazil,South America,1,1,1,0,0,1,0,Technical Failure
2001-06-13 00:00:00,Soltuca,Landing (descent or approach),Business,United States of America,North America,3,1,0,2,1,1,2,Technical Failure
2001-06-14 00:00:00,Fieldair,Takeoff (climb),Military / Government,New Zealand,Oceania,1,1,1,0,0,1,0,Human Factor
2001-06-16 00:00:00,Manunggal Air,Landing (descent or approach),Commercial,Indonesia,Asia,19,3,0,16,1,1,18,Technical Failure
2001-07-07 00:00:00,Northwest Flying,Flight,Commercial,Canada,North America,1,1,1,0,0,1,0,Human Factor
2001-07-21 00:00:00,William C. Plate,Flight,Business,United States of America,North America,1,1,1,0,0,1,0,Human Factor
2001-07-28 00:00:00,Munir H. Abbasy,Landing (descent or approach),Business,United States of America,North America,3,1,1,2,0,1,2,Human Factor
2001-08-01 00:00:00,Bankair,Landing (descent or approach),Operational,United States of America,North America,1,1,1,0,0,1,0,Human Factor
2001-08-23 00:00:00,Klinck Store N°3 Inc.,Takeoff (climb),Business,United States of America,North America,2,2,1,0,0,1,1,Human Factor
2001-08-24 00:00:00,Middletown Corporate Aviation,Landing (descent or approach),Operational,United States of America,North America,1,1,1,0,0,1,0,Human Factor
2001-08-27 00:00:00,CDF Aviation - California Department of Forestry - Cal Fire,Flight,Humanitarian,United States of America,North America,1,1,1,0,0,1,0,Human Factor
2001-08-27 00:00:00,CDF Aviation - California Department of Forestry - Cal Fire,Flight,Humanitarian,United States of America,North America,1,1,1,0,0,1,0,Human Factor
2001-09-05 00:00:00,Panda Air,Takeoff (climb),Operational,United States of America,North America,1,1,1,0,0,1,0,Technical Failure
2001-11-23 00:00:00,Base Aerofotogrametria e Projetos,Landing (descent or approach),Specialised Services,Brazil,South America,2,1,0,1,1,1,1,Technical Failure
2001-11-27 00:00:00,MK Airlines,Landing (descent or approach),Operational,Nigeria,Africa,13,4,1,9,0,1,12,Human Factor
2001-12-10 00:00:00,Royal Flying Doctor Service - RFDS,Landing (descent or approach),Humanitarian,Australia,Oceania,2,1,1,1,0,1,1,Human Factor
2001-12-23 00:00:00,Private New Zealand,Flight,Military / Government,New Zealand,Oceania,1,1,1,0,0,1,0,Human Factor
2002-01-01 00:00:00,Air Taxi,Landing (descent or approach),Commercial,United States of America,North America,5,1,0,4,1,1,4,Human Factor
2002-01-23 00:00:00,Riley Aviation,Flight,Operational,United States of America,North America,1,1,1,0,0,1,0,Human Factor
2002-02-15 00:00:00,Tiramavia,Landing (descent or approach),Operational,Liberia,Africa,10,7,1,3,0,1,9,Technical Failure
2002-02-17 00:00:00,Madeira Helicopters,Landing (descent or approach),Business,United States of America,North America,1,1,1,0,0,1,0,Human Factor
2002-03-03 00:00:00,Mapleleaf Acquisitions,Takeoff (climb),Business,United States of America,North America,1,1,1,0,0,1,0,Human Factor
2002-03-15 00:00:00,United States Army,Flight,Humanitarian,United States of America,North America,1,1,1,0,0,1,0,Human Factor
2002-03-15 00:00:00,Priority Air Charter,Flight,Operational,United States of America,North America,1,1,1,0,0,1,0,Weather
2002-04-10 00:00:00,Aleutian Air,Takeoff (climb),Operational,United States of America,North America,1,1,1,0,0,1,0,Other
2002-04-15 00:00:00,Maxfly Aviation,Landing (descent or approach),Humanitarian,Puerto Rico,Central America,1,1,1,0,0,1,0,Human Factor
2002-04-19 00:00:00,Private New Zealand,Flight,Military / Government,New Zealand,Oceania,1,1,1,0,0,1,0,Technical Failure
2002-04-23 00:00:00,Columbine Farm,Flight,Business,United States of America,North America,1,1,1,0,0,1,0,Technical Failure
2002-05-03 00:00:00,Private Papuan,Flight,Operational,Papua New Guinea,Oceania,1,1,1,0,0,1,0,Unknown
2002-06-09 00:00:00,Namur Air Promotion,Takeoff (climb),Humanitarian,Belgium,Europe,11,1,0,10,1,1,10,Human Factor
2002-06-11 00:00:00,Keystone Air Service,Landing (descent or approach),Commercial,Canada,North America,7,1,0,6,1,1,6,Technical Failure
2002-07-01 00:00:00,Eureka Operating Company,Flight,Business,United States of America,North America,1,1,1,0,0,1,0,Human Factor
2002-07-18 00:00:00,Grand Aire Express - Executive Aire Express,Landing (descent or approach),Operational,United States of America,North America,1,1,1,0,0,1,0,Human Factor
2002-07-24 00:00:00,Private New Zealand,Flight,Military / Government,New Zealand,Oceania,1,1,1,0,0,1,0,Human Factor
2002-07-28 00:00:00,Maria Cristina Cubo Brandão,Takeoff (climb),Business,Brazil,South America,6,1,0,5,1,1,5,Human Factor
2002-08-15 00:00:00,Europlane,Flight,Humanitarian,Italy,Europe,1,1,1,0,0,1,0,Technical Failure
2002-08-16 00:00:00,Hill Peterson Carper Bee %26 Deitzler,Landing (descent or approach),Operational,United States of America,North America,1,1,1,0,0,1,0,Human Factor
2002-08-24 00:00:00,Kakabeka Air Service,Landing (descent or approach),Commercial,Canada,North America,5,1,0,4,1,1,4,Human Factor
2002-08-28 00:00:00,General Communications Inc.,Landing (descent or approach),Business,United States of America,North America,3,1,1,2,0,1,2,Human Factor
2002-08-30 00:00:00,Care Flight International,Landing (descent or approach),Humanitarian,United States of America,North America,5,2,0,3,1,1,4,Human Factor
2002-09-06 00:00:00,Albert Prost,Takeoff (climb),Specialised Services,France,Europe,1,1,1,0,0,1,0,Unknown
2002-10-03 00:00:00,Poke Aire,Landing (descent or approach),Business,United States of America,North America,1,1,1,0,0,1,0,Human Factor
2002-10-07 00:00:00,Dwiggins LLC,Landing (descent or approach),Business,Brazil,South America,5,3,1,2,0,1,4,Human Factor
2002-10-23 00:00:00,Mid-Atlantic Freight,Takeoff (climb),Operational,United States of America,North America,1,1,1,0,0,1,0,Human Factor
2002-10-31 00:00:00,Robert D. Calhoon,Takeoff (climb),Business,United States of America,North America,1,1,1,0,0,1,0,Human Factor
2002-11-03 00:00:00,Preferred Interest Leasing,Flight,Business,Dominican Republic,Central America,3,1,0,2,1,1,2,Technical Failure
2002-11-28 00:00:00,Eagle Aviation - Kenya,Landing (descent or approach),Commercial,Kenya,Africa,20,2,1,18,0,1,19,Technical Failure
2002-12-03 00:00:00,Air Transport - Air Med El Paso,Flight,Operational,United States of America,North America,1,1,1,0,0,1,0,Human Factor
2002-12-04 00:00:00,TexStar AirFreight,Takeoff (climb),Operational,United States of America,North America,1,1,1,0,0,1,0,Technical Failure
2002-12-17 00:00:00,Planemasters,Landing (descent or approach),Operational,United States of America,North America,1,1,1,0,0,1,0,Human Factor
2002-12-25 00:00:00,Telford Aviation,Landing (descent or approach),Operational,United States of America,North America,1,1,1,0,0,1,0,Human Factor
2002-12-27 00:00:00,Ocean Airlines,Landing (descent or approach),Commercial,Comoros Islands,Africa,16,3,0,13,1,1,15,Weather
2002-12-29 00:00:00,PARSA,Flight,Operational,Panama,Central America,1,1,1,0,0,1,0,Unknown
2003-01-03 00:00:00,Private Dominican,Takeoff (climb),Business,Dominican Republic,Central America,2,1,0,1,1,1,1,Technical Failure
2003-02-28 00:00:00,Taxi Aéreo Colibri,Takeoff (climb),Commercial,Bolivia,South America,5,2,1,3,0,1,4,Technical Failure
2003-04-10 00:00:00,Trace Aviation,Landing (descent or approach),Business,United States of America,North America,1,1,1,0,0,1,0,Human Factor
2003-04-24 00:00:00,Quest Diagnostics,Landing (descent or approach),Business,United States of America,North America,1,1,1,0,0,1,0,Human Factor
2003-04-26 00:00:00,Sino Swearingen,Flight,Specialised Services,United States of America,North America,1,1,1,0,0,1,0,Other
2003-05-04 00:00:00,Roger L. Maino,Takeoff (climb),Business,United States of America,North America,1,1,1,0,0,1,0,Human Factor
2003-06-22 00:00:00,Brit Air,Landing (descent or approach),Commercial,France,Europe,24,3,1,21,0,1,23,Human Factor
2003-07-23 00:00:00,Água Limpa Transportes,Landing (descent or approach),Operational,Brazil,South America,3,2,1,1,0,1,2,Human Factor
2003-08-02 00:00:00,Harvey Christiansen,Landing (descent or approach),Business,Canada,North America,3,1,1,2,0,1,2,Technical Failure
2003-08-08 00:00:00,WSP Leasing,Takeoff (climb),Business,United States of America,North America,1,1,1,0,0,1,0,Human Factor
2003-08-08 00:00:00,Servicios Aéreos Sucre - SASCA,Landing (descent or approach),Commercial,Venezuela,South America,16,2,0,14,1,1,15,Technical Failure
2003-09-16 00:00:00,MGS Corporation,Takeoff (climb),Operational,Mexico,Central America,1,1,1,0,0,1,0,Technical Failure
2003-09-19 00:00:00,Ameristar Jet Charter,Landing (descent or approach),Operational,United States of America,North America,2,2,1,0,0,1,1,Human Factor
2003-09-23 00:00:00,Alta Flights Charters,Flight,Operational,Canada,North America,1,1,1,0,0,1,0,Human Factor
2003-09-23 00:00:00,Island Airlines,Landing (descent or approach),Operational,United States of America,North America,2,1,1,1,0,1,1,Human Factor
2003-10-11 00:00:00,Transmandu - Transportes Aéreos Manduca,Takeoff (climb),Operational,Venezuela,South America,2,2,1,0,0,1,1,Technical Failure
2003-10-29 00:00:00,Federal Express - FedEx,Landing (descent or approach),Operational,United States of America,North America,1,1,1,0,0,1,0,Human Factor
2003-11-27 00:00:00,George C. Swanson,Landing (descent or approach),Business,United States of America,North America,5,1,1,4,0,1,4,Human Factor
2003-11-29 00:00:00,Ameriflight,Landing (descent or approach),Operational,United States of America,North America,1,1,1,0,0,1,0,Human Factor
2003-12-15 00:00:00,Steven N. Kaplan,Landing (descent or approach),Business,United States of America,North America,1,1,1,0,0,1,0,Human Factor
2003-12-19 00:00:00,Super Air,Flight,Military / Government,New Zealand,Oceania,1,1,1,0,0,1,0,Unknown
2003-12-26 00:00:00,Utility Aircraft Corporation,Flight,Operational,World,World,1,1,1,0,0,1,0,Technical Failure
2003-12-30 00:00:00,NL Five,Landing (descent or approach),Operational,United States of America,North America,1,1,1,0,0,1,0,Human Factor
2004-01-03 00:00:00,Air West - USA,Landing (descent or approach),Operational,United States of America,North America,1,1,1,0,0,1,0,Human Factor
2004-01-28 00:00:00,Tassili Airlines,Landing (descent or approach),Commercial,Algeria,Africa,5,3,1,2,0,1,4,Human Factor
2004-02-19 00:00:00,Tasair,Flight,Operational,Australia,Oceania,1,1,1,0,0,1,0,Unknown
2004-03-25 00:00:00,Royal Air Freight - Royal Air Charter,Flight,Operational,United States of America,North America,1,1,1,0,0,1,0,Unknown
2004-05-14 00:00:00,EPPS Air Service,Landing (descent or approach),Operational,United States of America,North America,1,1,1,0,0,1,0,Human Factor
2004-05-19 00:00:00,AraiAvia,Takeoff (climb),Commercial,Kazakhstan,Asia,12,2,0,10,1,1,11,Human Factor
2004-06-14 00:00:00,Alain Bourbonnais,Landing (descent or approach),Operational,Canada,North America,1,1,1,0,0,1,0,Unknown
2004-06-14 00:00:00,Bellair,Landing (descent or approach),Operational,United States of America,North America,1,1,1,0,0,1,0,Human Factor
2004-07-12 00:00:00,Dodita Air Cargo,Flight,Operational,British Virgin Islands,Central America,2,2,1,0,0,1,1,Technical Failure
2004-08-10 00:00:00,Private Mexican,Flight,Humanitarian,Mexico,Central America,3,3,1,0,0,1,2,Human Factor
2004-08-13 00:00:00,Air Tahoma,Landing (descent or approach),Operational,United States of America,North America,2,2,1,0,0,1,1,Technical Failure
2004-08-20 00:00:00,Bill Law Aviation,Flight,Operational,United States of America,North America,1,1,1,0,0,1,0,Human Factor
2004-08-27 00:00:00,Mavrik Aire,Flight,Commercial,United States of America,North America,3,2,1,1,0,1,2,Human Factor
2004-09-29 00:00:00,Air Flamenco,Flight,Operational,Puerto Rico,Central America,1,1,1,0,0,1,0,Weather
2004-10-22 00:00:00,Highland Airways,Flight,Operational,United Kingdom,Europe,1,1,1,0,0,1,0,Unknown
2004-12-07 00:00:00,Tiffin Aire,Landing (descent or approach),Operational,United States of America,North America,1,1,1,0,0,1,0,Human Factor
2004-12-08 00:00:00,King Airelines,Flight,Other,United States of America,North America,1,1,1,0,0,1,0,Technical Failure
2004-12-29 00:00:00,Ronald L. Patton,Landing (descent or approach),Business,United States of America,North America,1,1,1,0,0,1,0,Human Factor
2005-01-13 00:00:00,AirNow,Landing (descent or approach),Operational,United States of America,North America,1,1,1,0,0,1,0,Human Factor
2005-05-05 00:00:00,Douglas R. Reichardt,Landing (descent or approach),Business,United States of America,North America,3,1,1,2,0,1,2,Human Factor
2005-07-04 00:00:00,Stephen D. Jensen,Takeoff (climb),Business,United States of America,North America,1,1,1,0,0,1,0,Human Factor
2005-08-04 00:00:00,Flight Line - USA,Landing (descent or approach),Operational,United States of America,North America,1,1,1,0,0,1,0,Human Factor
2005-08-09 00:00:00,Yemeni Air Force,Landing (descent or approach),Military / Government,Yemen,Asia,49,5,1,44,0,1,48,Technical Failure
2005-08-14 00:00:00,Wayumi Aero-Taxi - Linea Aéreo Taxi Wayumi,Takeoff (climb),Commercial,Venezuela,South America,13,1,0,12,1,1,12,Technical Failure
2005-09-01 00:00:00,NordPlus 1998,Flight,Operational,Canada,North America,1,1,1,0,0,1,0,Human Factor
2005-09-06 00:00:00,Royal Thai Air Force - Kong Thap Akat Thai,Flight,Operational,Thailand,Asia,1,1,1,0,0,1,0,Unknown
2005-09-22 00:00:00,McNeely Charter Service,Landing (descent or approach),Operational,United States of America,North America,1,1,1,0,0,1,0,Human Factor
2005-10-06 00:00:00,Federal Express - FedEx,Takeoff (climb),Operational,Canada,North America,1,1,1,0,0,1,0,Weather
2005-10-23 00:00:00,William F. Holdgate,Landing (descent or approach),Business,United States of America,North America,1,1,1,0,0,1,0,Human Factor
2005-11-16 00:00:00,Central Air Southwest,Landing (descent or approach),Operational,United States of America,North America,1,1,1,0,0,1,0,Human Factor
2005-11-29 00:00:00,Tech II,Landing (descent or approach),Business,United States of America,North America,1,1,1,0,0,1,0,Human Factor
2006-01-25 00:00:00,Sugar Financial Inc.,Landing (descent or approach),Business,United States of America,North America,1,1,1,0,0,1,0,Human Factor
2006-02-03 00:00:00,Private Venezuelan,Flight,Humanitarian,Colombia,South America,1,1,1,0,0,1,0,Human Factor
2006-02-08 00:00:00,TriCoastal Air,Flight,Operational,United States of America,North America,1,1,1,0,0,1,0,Technical Failure
2006-03-31 00:00:00,Private New Zealand,Flight,Military / Government,New Zealand,Oceania,1,1,1,0,0,1,0,Human Factor
2006-04-16 00:00:00,TAM Bolivia - Transporte Aéreo Militar Boliviano,Landing (descent or approach),Military / Government,Bolivia,South America,31,4,0,27,1,1,30,Unknown
2006-05-14 00:00:00,Saskatchewan Government Northern Air Operations,Takeoff (climb),Operational,Canada,North America,3,3,1,0,0,1,2,Human Factor
2006-05-18 00:00:00,Niagara Air Tours,Flight,Operational,Canada,North America,1,1,1,0,0,1,0,Human Factor
2006-06-12 00:00:00,Dynamic Aviation,Landing (descent or approach),Business,United States of America,North America,2,2,1,0,0,1,1,Human Factor
2006-06-17 00:00:00,Air Flamingo,Flight,Military / Government,Kazakhstan,Asia,2,2,1,0,0,1,1,Human Factor
2006-06-24 00:00:00,Aero Charter Services,Landing (descent or approach),Business,United States of America,North America,3,1,0,2,1,1,2,Human Factor
2006-06-25 00:00:00,Flying Cloud,Takeoff (climb),Operational,United States of America,North America,1,1,1,0,0,1,0,Human Factor
2006-06-30 00:00:00,Naturelink Charter,Landing (descent or approach),Commercial,Mozambique,Africa,3,2,1,1,0,1,2,Human Factor
2006-07-11 00:00:00,Airpac Airlines,Landing (descent or approach),Operational,United States of America,North America,1,1,1,0,0,1,0,Technical Failure
2006-08-04 00:00:00,AirNow,Landing (descent or approach),Operational,United States of America,North America,1,1,1,0,0,1,0,Human Factor
2006-08-12 00:00:00,Orlan 2000,Landing (descent or approach),Military / Government,Kazakhstan,Asia,2,2,1,0,0,1,1,Human Factor
2006-09-01 00:00:00,Intercontinental Jet,Landing (descent or approach),Operational,United States of America,North America,1,1,1,0,0,1,0,Human Factor
2006-09-21 00:00:00,Alaska Sportsman's Lodge,Landing (descent or approach),Commercial,United States of America,North America,6,1,0,5,1,1,5,Human Factor
2006-11-02 00:00:00,Paradise Air - Costa Rica,Flight,Operational,Costa Rica,Central America,1,1,1,0,0,1,0,Unknown
2006-11-17 00:00:00,Tourism Aéreo Amazonas - TAA,Takeoff (climb),Operational,Venezuela,South America,1,1,1,0,0,1,0,Technical Failure
2006-11-29 00:00:00,Grob Aerospace,Takeoff (climb),Operational,Germany,Europe,1,1,1,0,0,1,0,Other
2006-12-02 00:00:00,Robert B. North Jr.,Landing (descent or approach),Business,United States of America,North America,1,1,1,0,0,1,0,Unknown
2007-01-05 00:00:00,DJB Air Charter,Landing (descent or approach),Commercial,Tanzania,Africa,11,1,0,10,1,1,10,Human Factor
2007-01-07 00:00:00,Transwest Air,Landing (descent or approach),Humanitarian,Canada,North America,4,2,1,2,0,1,3,Human Factor
2007-01-08 00:00:00,FTBA,Takeoff (climb),Business,United States of America,North America,1,1,1,0,0,1,0,Human Factor
2007-01-09 00:00:00,Air Supply Alaska,Flight,Operational,United States of America,North America,1,1,1,0,0,1,0,Technical Failure
2007-02-06 00:00:00,Air Turks %26 Caicos,Takeoff (climb),Commercial,Turks and Caicos Islands,Central America,6,1,1,5,0,1,5,Human Factor
2007-02-09 00:00:00,Bygone Aviation,Landing (descent or approach),Operational,United States of America,North America,1,1,1,0,0,1,0,Human Factor
2007-02-12 00:00:00,BHS Direct,Takeoff (climb),Operational,Germany,Europe,1,1,1,0,0,1,0,Human Factor
2007-02-15 00:00:00,Stellavia,Landing (descent or approach),Operational,Democratic Republic of Congo,Africa,1,1,1,0,0,1,0,Unknown
2007-03-11 00:00:00,Para-Flite,Takeoff (climb),Humanitarian,United Kingdom,Europe,9,1,1,8,0,1,8,Human Factor
2007-04-01 00:00:00,Aéropro,Flight,Humanitarian,Canada,North America,1,1,1,0,0,1,0,Human Factor
2007-06-02 00:00:00,Black Sheep Aviation %26 Cattle Company,Takeoff (climb),Operational,Canada,North America,1,1,1,0,0,1,0,Human Factor
2007-06-21 00:00:00,Karibu Airways,Takeoff (climb),Commercial,Democratic Republic of Congo,Africa,26,2,0,24,1,1,25,Unknown
2007-06-30 00:00:00,IHR Administrative Services,Landing (descent or approach),Business,United States of America,North America,2,1,1,1,0,1,1,Human Factor
2007-07-08 00:00:00,Liard Air,Takeoff (climb),Commercial,Canada,North America,5,2,0,3,1,1,4,Human Factor
2007-07-23 00:00:00,SOREM - Società Ricerche Esperienze Meteorologiche,Flight,Humanitarian,Italy,Europe,2,2,1,0,0,1,1,Human Factor
2007-07-23 00:00:00,Aquiline,Takeoff (climb),Operational,Ethiopia,Africa,9,3,0,6,1,1,8,Technical Failure
2007-08-16 00:00:00,Thunderbirds International,Flight,Operational,Australia,Oceania,1,1,1,0,0,1,0,Human Factor
2007-09-20 00:00:00,Arctic Circle Air Service,Takeoff (climb),Operational,United States of America,North America,1,1,1,0,0,1,0,Unknown
2007-09-24 00:00:00,Free Airlines,Landing (descent or approach),Commercial,Democratic Republic of Congo,Africa,7,3,1,4,0,1,6,Unknown
2007-10-17 00:00:00,Auxiliar de Actividades Aérea,Flight,Operational,Spain,Europe,2,2,1,0,0,1,1,Other
2007-11-10 00:00:00,Super Air,Flight,Military / Government,New Zealand,Oceania,1,1,1,0,0,1,0,Human Factor
2007-12-04 00:00:00,AvWerks,Takeoff (climb),Business,United States of America,North America,1,1,1,0,0,1,0,Human Factor
2007-12-11 00:00:00,Sinarmas,Flight,Military / Government,Indonesia,Asia,1,1,1,0,0,1,0,Unknown
2007-12-21 00:00:00,Inversiones Aéreas,Flight,Business,Dominican Republic,Central America,7,2,0,5,1,1,6,Technical Failure
2007-12-26 00:00:00,Jet Connection Businessflight,Takeoff (climb),Commercial,Kazakhstan,Asia,4,3,1,1,0,1,3,Human Factor
2008-01-11 00:00:00,Letalska Šola Šolt,Flight,Operational,Slovenia,Europe,2,2,1,0,0,1,1,Human Factor
2008-01-14 00:00:00,Alpine Air,Landing (descent or approach),Operational,United States of America,North America,1,1,1,0,0,1,0,Human Factor
2008-01-16 00:00:00,Central Air Southwest,Takeoff (climb),Operational,United States of America,North America,1,1,1,0,0,1,0,Human Factor
2008-01-18 00:00:00,William J. Easterling,Landing (descent or approach),Business,United States of America,North America,1,1,1,0,0,1,0,Human Factor
2008-04-09 00:00:00,Airtex Aviation,Takeoff (climb),Operational,Australia,Oceania,1,1,1,0,0,1,0,Human Factor
2008-05-10 00:00:00,Aviatia Utilitara,Flight,Military / Government,Romania,Europe,2,2,1,0,0,1,1,Unknown
2008-05-23 00:00:00,Alpine Air,Takeoff (climb),Operational,United States of America,North America,1,1,1,0,0,1,0,Human Factor
2008-06-03 00:00:00,Angel Flight Central,Takeoff (climb),Humanitarian,United States of America,North America,3,1,0,2,1,1,2,Human Factor
2008-06-07 00:00:00,Patagonia Airlines,Flight,Commercial,Chile,South America,10,1,1,9,0,1,9,Human Factor
2008-06-18 00:00:00,Wiggins Airways,Takeoff (climb),Operational,United States of America,North America,1,1,1,0,0,1,0,Human Factor
2008-07-06 00:00:00,USA Jet Airlines,Landing (descent or approach),Operational,Mexico,Central America,2,2,1,0,0,1,1,Human Factor
2008-07-15 00:00:00,Flying Max,Landing (descent or approach),Business,United States of America,North America,1,1,1,0,0,1,0,Human Factor
2008-07-16 00:00:00,ProSoft Technology,Landing (descent or approach),Business,United States of America,North America,1,1,1,0,0,1,0,Human Factor
2008-08-09 00:00:00,Associated Mission Aviation - AMA,Flight,Operational,Indonesia,Asia,1,1,1,0,0,1,0,Human Factor
2008-08-16 00:00:00,Air Training,Landing (descent or approach),Business,Latvia,Europe,8,1,1,7,0,1,7,Human Factor
2008-08-18 00:00:00,Corus Hardware Corporation,Takeoff (climb),Operational,Dominican Republic,Central America,1,1,1,0,0,1,0,Unknown
2008-08-28 00:00:00,Aeronet Supply,Takeoff (climb),Business,United States of America,North America,1,1,1,0,0,1,0,Technical Failure
2008-09-26 00:00:00,Cape Air,Takeoff (climb),Operational,United States of America,North America,1,1,1,0,0,1,0,Human Factor
2008-09-29 00:00:00,Gardner Leasing,Landing (descent or approach),Operational,United States of America,North America,1,1,1,0,0,1,0,Human Factor
2008-10-12 00:00:00,Woolie Enterprises,Takeoff (climb),Operational,Brazil,South America,1,1,1,0,0,1,0,Unknown
2008-10-16 00:00:00,Arnhem Land Community Airlines,Flight,Operational,Australia,Oceania,1,1,1,0,0,1,0,Unknown
2008-11-03 00:00:00,John A. Lyddon,Takeoff (climb),Business,Mexico,Central America,1,1,1,0,0,1,0,Unknown
2008-12-14 00:00:00,Western Wings,Flight,Operational,United States of America,North America,1,1,1,0,0,1,0,Human Factor
2008-12-14 00:00:00,Vector Sky Service,Landing (descent or approach),Business,Austria,Europe,1,1,1,0,0,1,0,Human Factor
2008-12-14 00:00:00,Wanganui Aero Work,Takeoff (climb),Military / Government,New Zealand,Oceania,1,1,1,0,0,1,0,Other
2008-12-19 00:00:00,Air Vanuatu,Flight,Commercial,Vanuatu,Oceania,10,1,1,9,0,1,9,Human Factor
2009-01-19 00:00:00,Heli-Flight,Takeoff (climb),Operational,Germany,Europe,1,1,1,0,0,1,0,Human Factor
2009-03-06 00:00:00,Royal Thai Air Force - Kong Thap Akat Thai,Takeoff (climb),Military / Government,Thailand,Asia,5,5,1,0,0,1,4,Technical Failure
2009-04-17 00:00:00,Linea Turistica Aerotuy - LTA,Takeoff (climb),Commercial,Venezuela,South America,12,2,0,10,1,1,11,Human Factor
2009-04-17 00:00:00,Sebring Air Charter,Takeoff (climb),Operational,United States of America,North America,1,1,1,0,0,1,0,Technical Failure
2009-05-10 00:00:00,Private Venezuelan,Landing (descent or approach),Humanitarian,Honduras,Central America,3,2,1,1,0,1,2,Technical Failure
2009-05-25 00:00:00,Commonwealth Aviation,Landing (descent or approach),Business,United States of America,North America,2,1,0,1,1,1,1,Human Factor
2009-06-06 00:00:00,Private Ecuadorian,Flight,Business,Ecuador,South America,1,1,1,0,0,1,0,Human Factor
2009-06-07 00:00:00,Strait Air,Landing (descent or approach),Operational,Canada,North America,1,1,1,0,0,1,0,Human Factor
2009-06-30 00:00:00,Logan Investments of Nevada,Flight,Business,United States of America,North America,1,1,1,0,0,1,0,Unknown
2009-07-18 00:00:00,Richard D. Nielsen,Takeoff (climb),Business,United States of America,North America,2,1,0,1,1,1,1,Technical Failure
2009-08-04 00:00:00,Bangkok Airways,Landing (descent or approach),Commercial,Thailand,Asia,72,4,1,68,0,1,71,Unknown
2009-09-14 00:00:00,Kenya Police Air Wing,Takeoff (climb),Operational,Kenya,Africa,2,2,1,0,0,1,1,Unknown
2009-09-24 00:00:00,South African Airlink,Takeoff (climb),Operational,South Africa,Africa,3,3,1,0,0,1,2,Technical Failure
2009-10-06 00:00:00,Bashmia Aero Spray,Landing (descent or approach),Military / Government,Sudan,Africa,1,1,1,0,0,1,0,Human Factor
2009-10-22 00:00:00,Divi Divi Air,Landing (descent or approach),Commercial,Netherlands,Central America,10,1,1,9,0,1,9,Technical Failure
2009-11-12 00:00:00,Jetlink Express,Taxiing,Commercial,Rwanda,Africa,15,4,0,11,1,1,14,Human Factor
2009-12-04 00:00:00,Cheyenne Sales %26 Leasing,Flight,Operational,United States of America,North America,1,1,1,0,0,1,0,Technical Failure
2010-02-08 00:00:00,Robert Peter Watson Sr.,Takeoff (climb),Business,United States of America,North America,4,1,1,3,0,1,3,Technical Failure
2010-02-12 00:00:00,GoJump,Landing (descent or approach),Humanitarian,Portugal,Europe,4,1,0,3,1,1,3,Terrorism
2010-02-12 00:00:00,Mayes Aviation,Landing (descent or approach),Business,United States of America,North America,1,1,1,0,0,1,0,Human Factor
2010-03-04 00:00:00,James A. Youngquist,Takeoff (climb),Business,United States of America,North America,1,1,1,0,0,1,0,Human Factor
2010-03-30 00:00:00,Aviation Development Group,Takeoff (climb),Business,United States of America,North America,2,1,1,1,0,1,1,Technical Failure
2010-03-31 00:00:00,United States Navy - USN,Flight,Military / Government,World,World,4,4,1,0,0,1,3,Technical Failure
2010-06-07 00:00:00,Joseph S. Konicki,Takeoff (climb),Operational,United States of America,North America,2,2,1,0,0,1,1,Human Factor
2010-07-19 00:00:00,Bogco Aviation,Landing (descent or approach),Business,United States of America,North America,1,1,1,0,0,1,0,Human Factor
2010-07-23 00:00:00,Pacific Airways,Flight,Operational,United States of America,North America,1,1,1,0,0,1,0,Human Factor
2010-08-05 00:00:00,SVG Air - Saint Vincent %26 Grenadines Air,Flight,Humanitarian,Saint Vincent and Grenadines,Central America,1,1,1,0,0,1,0,Unknown
2010-10-25 00:00:00,Kenn Borek Air,Landing (descent or approach),Commercial,Canada,North America,10,2,1,8,0,1,9,Human Factor
2010-12-20 00:00:00,Cloud 9 Aviation,Landing (descent or approach),Military / Government,Australia,Oceania,1,1,1,0,0,1,0,Unknown
2010-12-20 00:00:00,Christopher J. Petrikas,Flight,Business,United States of America,North America,1,1,1,0,0,1,0,Human Factor
2011-02-23 00:00:00,Starr Services,Landing (descent or approach),Business,United States of America,North America,1,1,1,0,0,1,0,Human Factor
2011-02-24 00:00:00,Flightech,Landing (descent or approach),Operational,Australia,Oceania,1,1,1,0,0,1,0,Unknown
2011-03-31 00:00:00,Black Sheep Aviation %26 Cattle Company,Flight,Operational,Canada,North America,1,1,1,0,0,1,0,Unknown
2011-04-01 00:00:00,Fugro Airborne Surveys Canada,Landing (descent or approach),Specialised Services,Canada,North America,3,3,1,0,0,1,2,Technical Failure
2011-04-10 00:00:00,My Plane,Landing (descent or approach),Business,United States of America,North America,1,1,1,0,0,1,0,Human Factor
2011-05-02 00:00:00,Island Air Service,Takeoff (climb),Operational,United States of America,North America,1,1,1,0,0,1,0,Human Factor
2011-07-04 00:00:00,Missinippi Airways,Takeoff (climb),Commercial,Canada,North America,9,1,0,8,1,1,8,Human Factor
2011-08-22 00:00:00,Sayanian Cedar,Flight,Business,Russia,Asia,8,1,1,7,0,1,7,Human Factor
2011-08-28 00:00:00,Pilot,Takeoff (climb),Military / Government,Russia,Asia,2,1,0,1,1,1,1,Other
2011-09-02 00:00:00,Grant Aviation,Flight,Operational,United States of America,North America,1,1,1,0,0,1,0,Human Factor
2011-09-03 00:00:00,Yunikom Avia,Flight,Military / Government,Ukraine,Europe,1,1,1,0,0,1,0,Human Factor
2011-09-05 00:00:00,Green Plane,Landing (descent or approach),Business,United States of America,North America,1,1,1,0,0,1,0,Human Factor
2011-09-13 00:00:00,AFIT,Takeoff (climb),Business,Germany,Europe,1,1,1,0,0,1,0,Human Factor
2011-09-23 00:00:00,Servant Air,Flight,Commercial,United States of America,North America,3,1,1,2,0,1,2,Human Factor
2011-10-05 00:00:00,Penobscot Island Air,Landing (descent or approach),Operational,United States of America,North America,1,1,1,0,0,1,0,Human Factor
2011-11-09 00:00:00,Claude Hochner,Landing (descent or approach),Business,France,Europe,1,1,1,0,0,1,0,Human Factor
2011-11-10 00:00:00,Michel Tabrizian,Takeoff (climb),Business,Switzerland,Europe,1,1,1,0,0,1,0,Human Factor
2011-11-23 00:00:00,Susi Air,Landing (descent or approach),Operational,Indonesia,Asia,2,2,1,0,0,1,1,Human Factor
2011-11-29 00:00:00,Inland Aviation Services,Landing (descent or approach),Operational,United States of America,North America,1,1,1,0,0,1,0,Human Factor
2011-12-22 00:00:00,N48BS LLC,Landing (descent or approach),Business,United States of America,North America,1,1,1,0,0,1,0,Technical Failure
2011-12-26 00:00:00,Millenium Air,Landing (descent or approach),Operational,United States of America,North America,1,1,1,0,0,1,0,Technical Failure
2012-01-16 00:00:00,M %26 H Ventures,Takeoff (climb),Business,United States of America,North America,1,1,1,0,0,1,0,Human Factor
2012-01-27 00:00:00,Flying G Aviation,Landing (descent or approach),Business,United States of America,North America,2,1,1,1,0,1,1,Human Factor
2012-02-28 00:00:00,Cleiton Taxi Aéreo,Takeoff (climb),Operational,Brazil,South America,1,1,1,0,0,1,0,Human Factor
2012-04-06 00:00:00,Spanish Fly,Takeoff (climb),Business,United States of America,North America,1,1,1,0,0,1,0,Human Factor
2012-04-19 00:00:00,Lee H Aviation,Flight,Business,World,World,1,1,1,0,0,1,0,Human Factor
2012-04-20 00:00:00,Private Brazilian,Landing (descent or approach),Business,Brazil,South America,1,1,1,0,0,1,0,Human Factor
2012-06-08 00:00:00,Family Celebrations,Flight,Specialised Services,United States of America,North America,1,1,1,0,0,1,0,Unknown
2012-06-22 00:00:00,OZ Gas Aviation,Landing (descent or approach),Operational,United States of America,North America,1,1,1,0,0,1,0,Human Factor
2012-06-30 00:00:00,Donald L. Holbrook,Takeoff (climb),Specialised Services,United States of America,North America,1,1,1,0,0,1,0,Technical Failure
2012-07-03 00:00:00,Private Brazilian,Flight,Humanitarian,Honduras,Central America,2,2,1,0,0,1,1,Human Factor
2012-07-06 00:00:00,Microsurvey Aéreogeofísica e Consultoria Cientifica,Flight,Specialised Services,Brazil,South America,3,1,1,2,0,1,2,Technical Failure
2012-07-07 00:00:00,Win Win Aviation,Flight,Operational,United States of America,North America,1,1,1,0,0,1,0,Weather
2012-07-17 00:00:00,Delta Connection,Taxiing,Humanitarian,United States of America,North America,1,1,1,0,0,1,0,Human Factor
2012-07-22 00:00:00,DOSAAF,Landing (descent or approach),Humanitarian,Russia,Asia,2,2,1,0,0,1,1,Unknown
2012-08-11 00:00:00,Barron Aviation,Flight,Humanitarian,United States of America,North America,1,1,1,0,0,1,0,Human Factor
2012-10-08 00:00:00,Lorenzo Girones,Flight,Business,Canada,North America,1,1,1,0,0,1,0,Unknown
2012-10-15 00:00:00,Fuel Services,Flight,Operational,United States of America,North America,1,1,1,0,0,1,0,Unknown
2012-11-06 00:00:00,Federal Express - FedEx,Landing (descent or approach),Operational,United States of America,North America,1,1,1,0,0,1,0,Technical Failure
2012-11-17 00:00:00,1692614 Alberta,Landing (descent or approach),Business,Canada,North America,1,1,1,0,0,1,0,Human Factor
2012-11-18 00:00:00,Gogal Air Services,Takeoff (climb),Commercial,Canada,North America,8,1,1,7,0,1,7,Human Factor
2012-11-25 00:00:00,Maestro Aeroclub,Takeoff (climb),Humanitarian,Russia,Asia,10,1,0,9,1,1,9,Technical Failure
2012-11-26 00:00:00,H-S Air,Flight,Business,United States of America,North America,1,1,1,0,0,1,0,Weather
2012-12-08 00:00:00,Subway Development of Southeast Florida,Takeoff (climb),Business,United States of America,North America,1,1,1,0,0,1,0,Human Factor
2012-12-08 00:00:00,Super Air,Flight,Military / Government,New Zealand,Oceania,1,1,1,0,0,1,0,Human Factor
2012-12-18 00:00:00,Ameriflight,Flight,Operational,United States of America,North America,1,1,1,0,0,1,0,Weather
2012-12-22 00:00:00,Perimeter Aviation,Landing (descent or approach),Commercial,Canada,North America,9,2,0,7,1,1,8,Human Factor
2012-12-24 00:00:00,John Thomas Fetcko,Landing (descent or approach),Business,United States of America,North America,2,1,1,1,0,1,1,Human Factor
2012-12-25 00:00:00,Air Bagan,Landing (descent or approach),Commercial,Myanmar,Asia,71,6,0,65,1,1,70,Human Factor
2013-01-15 00:00:00,Martinaire,Takeoff (climb),Operational,United States of America,North America,1,1,1,0,0,1,0,Human Factor
2013-01-16 00:00:00,LabCorp - Laboratory Corporation of America,Takeoff (climb),Business,United States of America,North America,1,1,1,0,0,1,0,Human Factor
2013-03-23 00:00:00,Yug Line,Takeoff (climb),Military / Government,Russia,Asia,2,2,1,0,0,1,1,Technical Failure
2013-04-07 00:00:00,Sahel Aviation Service,Landing (descent or approach),Operational,São Tomé and Principe,Africa,1,1,1,0,0,1,0,Unknown
2013-05-02 00:00:00,Michael B. Braunstein,Flight,Business,United States of America,North America,1,1,1,0,0,1,0,Human Factor
2013-05-11 00:00:00,Sinarmas,Takeoff (climb),Military / Government,Indonesia,Asia,1,1,1,0,0,1,0,Unknown
2013-05-15 00:00:00,Aviakompania Annushka,Flight,Military / Government,Russia,Asia,1,1,1,0,0,1,0,Human Factor
2013-05-16 00:00:00,Tri-Wings,Flight,Business,United States of America,North America,1,1,1,0,0,1,0,Human Factor
2013-06-04 00:00:00,Pacific Wings,Flight,Commercial,United States of America,North America,7,1,0,6,1,1,6,Human Factor
2013-06-07 00:00:00,Osage Air,Takeoff (climb),Business,United States of America,North America,1,1,1,0,0,1,0,Human Factor
2013-06-08 00:00:00,Paul S. Soule Enterprises,Flight,Business,United States of America,North America,1,1,1,0,0,1,0,Human Factor
2013-06-10 00:00:00,CotonTchad,Landing (descent or approach),Business,Cameroon,Africa,5,2,1,3,0,1,4,Technical Failure
2013-06-28 00:00:00,Asia Continental Airlines,Flight,Military / Government,Kazakhstan,Asia,2,2,1,0,0,1,1,Human Factor
2013-08-01 00:00:00,Private Isreali,Landing (descent or approach),Business,Israel,Asia,3,1,1,2,0,1,2,Human Factor
2013-08-06 00:00:00,Jingmen General Aviation Company,Flight,Military / Government,China,Asia,2,2,1,0,0,1,1,Unknown
2013-08-22 00:00:00,Transwest Air,Flight,Operational,Canada,North America,1,1,1,0,0,1,0,Human Factor
2013-08-27 00:00:00,RSB Aviation,Takeoff (climb),Business,United States of America,North America,1,1,1,0,0,1,0,Human Factor
2013-09-25 00:00:00,Federal Express - FedEx,Flight,Operational,Canada,North America,1,1,1,0,0,1,0,Unknown
2013-10-06 00:00:00,Air Flamenco,Landing (descent or approach),Operational,Puerto Rico,Central America,1,1,1,0,0,1,0,Human Factor
2013-11-10 00:00:00,Anasazi Winds,Landing (descent or approach),Business,United States of America,North America,1,1,1,0,0,1,0,Human Factor
2013-12-11 00:00:00,Makani Kai Air,Takeoff (climb),Commercial,United States of America,North America,9,1,0,8,1,1,8,Technical Failure
2014-01-05 00:00:00,Vineland Corporation Company,Landing (descent or approach),Operational,United States of America,North America,3,3,1,0,0,1,2,Human Factor
2014-02-17 00:00:00,Global Airlift,Landing (descent or approach),Humanitarian,South Sudan,Africa,4,4,1,0,0,1,3,Human Factor
2014-02-19 00:00:00,TDC Aviation,Landing (descent or approach),Business,United States of America,North America,1,1,1,0,0,1,0,Human Factor
2014-03-19 00:00:00,Private American,Flight,Business,United States of America,North America,1,1,1,0,0,1,0,Human Factor
2014-05-10 00:00:00,American Aviation,Landing (descent or approach),Commercial,United States of America,North America,7,1,0,6,1,1,6,Human Factor
2014-05-12 00:00:00,Kenya Air Force,Takeoff (climb),Military / Government,Kenya,Africa,12,2,1,10,0,1,11,Unknown
2014-05-17 00:00:00,Ponderosa Aviation,Takeoff (climb),Operational,United States of America,North America,2,2,1,0,0,1,1,Human Factor
2014-06-13 00:00:00,Richard Rockefeller,Takeoff (climb),Business,United States of America,North America,1,1,1,0,0,1,0,Human Factor
2014-06-17 00:00:00,Paul C. Ehlen,Flight,Operational,United States of America,North America,1,1,1,0,0,1,0,Human Factor
2014-07-26 00:00:00,Max Two,Takeoff (climb),Business,United States of America,North America,1,1,1,0,0,1,0,Human Factor
2014-09-10 00:00:00,David Anderson,Landing (descent or approach),Business,United States of America,North America,1,1,1,0,0,1,0,Human Factor
2014-10-13 00:00:00,Grand River Emergency Department Consultants,Landing (descent or approach),Business,United States of America,North America,1,1,1,0,0,1,0,Human Factor
2014-10-30 00:00:00,Gilleland Aviation,Takeoff (climb),Operational,United States of America,North America,1,1,1,0,0,1,0,Human Factor
2014-11-18 00:00:00,Central Air Southwest,Landing (descent or approach),Operational,United States of America,North America,1,1,1,0,0,1,0,Human Factor
2014-11-23 00:00:00,Aerial Viewpoint,Flight,Operational,United States of America,North America,1,1,1,0,0,1,0,Human Factor
2014-12-02 00:00:00,Ferg's Air Charter,Flight,Commercial,Bahamas,Central America,11,1,0,10,1,1,10,Technical Failure
2014-12-23 00:00:00,Private Venezuelan,Flight,Business,Venezuela,South America,1,1,1,0,0,1,0,Unknown
2014-12-30 00:00:00,Key Lime Air,Takeoff (climb),Operational,United States of America,North America,1,1,1,0,0,1,0,Technical Failure
2015-01-30 00:00:00,Southern Aircraft Consultancy,Takeoff (climb),Business,Switzerland,Europe,1,1,1,0,0,1,0,Human Factor
2015-02-04 00:00:00,Del Air Enterprises II,Landing (descent or approach),Business,United States of America,North America,1,1,1,0,0,1,0,Human Factor
2015-02-04 00:00:00,Daedalus Air,Landing (descent or approach),Business,United States of America,North America,1,1,1,0,0,1,0,Human Factor
2015-02-22 00:00:00,Michael J. Clements,Takeoff (climb),Business,United States of America,North America,1,1,1,0,0,1,0,Human Factor
2015-05-30 00:00:00,Yute Air Alaska,Flight,Specialised Services,United States of America,North America,1,1,1,0,0,1,0,Human Factor
2015-06-20 00:00:00,Jorge Alberto Rodas Estrada,Flight,Business,Colombia,South America,3,1,1,2,0,1,2,Human Factor
2015-07-17 00:00:00,Wings of Alaska,Flight,Commercial,United States of America,North America,5,1,1,4,0,1,4,Human Factor
2015-08-01 00:00:00,Aero West,Takeoff (climb),Military / Government,Romania,Europe,2,1,1,1,0,1,1,Human Factor
2015-08-09 00:00:00,Private American,Flight,Operational,Iceland,Europe,2,2,1,0,0,1,1,Human Factor
2015-08-12 00:00:00,Komala Air,Landing (descent or approach),Commercial,Indonesia,Asia,6,1,0,5,1,1,5,Human Factor
2015-09-24 00:00:00,STS Aviation,Flight,Commercial,Bosnia and Herzegovina,Europe,3,1,1,2,0,1,2,Human Factor
2015-10-02 00:00:00,KASI - KalusAir Services Inc.,Flight,Specialised Services,Nicaragua,Central America,1,1,1,0,0,1,0,Unknown
2015-12-07 00:00:00,Dixco Transport,Flight,Business,South Africa,Africa,1,1,1,0,0,1,0,Unknown
2015-12-10 00:00:00,Airsea Charters,Takeoff (climb),Business,United States of America,North America,1,1,1,0,0,1,0,Human Factor
2015-12-11 00:00:00,Wasaya Airways,Flight,Operational,Canada,North America,1,1,1,0,0,1,0,Weather
2016-04-14 00:00:00,Private Russian,Flight,Military / Government,Russia,Asia,1,1,1,0,0,1,0,Unknown
2016-06-19 00:00:00,Grupo Seven Air,Flight,Humanitarian,Portugal,Europe,8,1,1,7,0,1,7,Technical Failure
2016-06-26 00:00:00,Private Kazakh,Flight,Military / Government,Kazakhstan,Asia,2,1,1,1,0,1,1,Technical Failure
2016-07-15 00:00:00,Tsayta Aviation,Flight,Operational,Canada,North America,1,1,1,0,0,1,0,Unknown
2016-08-01 00:00:00,Thai Regional Airlines,Landing (descent or approach),Commercial,Thailand,Asia,4,2,1,2,0,1,3,Unknown
2016-08-02 00:00:00,Cessna 414 LLC,Takeoff (climb),Business,United States of America,North America,1,1,1,0,0,1,0,Human Factor
2016-09-07 00:00:00,Wolf Aviation - USA,Flight,Business,United States of America,North America,1,1,1,0,0,1,0,Human Factor
2016-10-10 00:00:00,101190984 Saskatchewan,Flight,Business,Canada,North America,5,1,1,4,0,1,4,Human Factor
2016-10-28 00:00:00,Highland Air,Flight,Business,United States of America,North America,1,1,1,0,0,1,0,Human Factor
2016-11-24 00:00:00,Ger-Pol Air Taxi,Takeoff (climb),Operational,Poland,Europe,1,1,1,0,0,1,0,Human Factor
2016-12-01 00:00:00,Weather Modification,Landing (descent or approach),Other,United States of America,North America,1,1,1,0,0,1,0,Technical Failure
2016-12-05 00:00:00,Key Lime Air,Flight,Operational,United States of America,North America,1,1,1,0,0,1,0,Human Factor
2016-12-12 00:00:00,Redtail Air,Takeoff (climb),Operational,United States of America,North America,1,1,1,0,0,1,0,Human Factor
2016-12-21 00:00:00,Royal Malaysian Air Force - Tentera Udara Diraja Malaysia,Landing (descent or approach),Operational,Malaysia,Asia,4,4,1,0,0,1,3,Unknown
2017-03-04 00:00:00,Michael W. Rogers,Landing (descent or approach),Business,United States of America,North America,1,1,1,0,0,1,0,Human Factor
2017-03-05 00:00:00,Air Charter Services,Landing (descent or approach),Humanitarian,Thailand,Asia,5,2,1,3,0,1,4,Unknown
2017-03-24 00:00:00,Shelter Charter Services,Landing (descent or approach),Business,United States of America,North America,1,1,1,0,0,1,0,Human Factor
2017-04-12 00:00:00,Spirit Avia Sentosa,Flight,Operational,Indonesia,Asia,1,1,1,0,0,1,0,Human Factor
2017-04-25 00:00:00,Klass Enterprises,Landing (descent or approach),Specialised Services,United States of America,North America,1,1,1,0,0,1,0,Human Factor
2017-05-01 00:00:00,Grant Aviation,Flight,Operational,United States of America,North America,1,1,1,0,0,1,0,Human Factor
2017-05-03 00:00:00,Strait Air,Flight,Operational,United States of America,North America,1,1,1,0,0,1,0,Human Factor
2017-05-30 00:00:00,Nepalese Army,Landing (descent or approach),Military / Government,Nepal,Asia,3,3,1,0,0,1,2,Unknown
2017-05-30 00:00:00,Russian Air Force - Voyenno-vozdushnye sily Rossii,Landing (descent or approach),Operational,Russia,Asia,6,6,1,0,0,1,5,Human Factor
2017-06-16 00:00:00,Airspread Aviation,Flight,Military / Government,Australia,Oceania,1,1,1,0,0,1,0,Unknown
2017-07-25 00:00:00,Roraima Airways,Landing (descent or approach),Operational,Guyana,South America,1,1,1,0,0,1,0,Human Factor
2017-08-16 00:00:00,Honduran Air Force - Fuerza Aérea Hondureña,Flight,Operational,Honduras,Central America,3,3,1,0,0,1,2,Unknown
2017-09-05 00:00:00,Private Venezuelan,,Business,Venezuela,South America,0,0,0,0,1,1,-1,Unknown
2017-09-06 00:00:00,Sky West Aviation,Landing (descent or approach),Business,United Kingdom,Europe,1,1,1,0,0,1,0,Technical Failure
2017-09-23 00:00:00,RA Aircraft Management,Takeoff (climb),Business,United States of America,North America,1,1,1,0,0,1,0,Human Factor
2017-10-17 00:00:00,Greenpeace,Landing (descent or approach),Operational,Brazil,South America,5,1,0,4,1,1,4,Human Factor
2017-11-07 00:00:00,DalTransAero,Landing (descent or approach),Operational,Russia,Asia,2,2,1,0,0,1,1,Technical Failure
2017-12-10 00:00:00,Carman W. Rollo,Takeoff (climb),Business,United States of America,North America,1,1,1,0,0,1,0,Unknown
2017-12-13 00:00:00,West Wind Aviation,Takeoff (climb),Commercial,Canada,North America,25,3,0,22,1,1,24,Weather
2017-12-23 00:00:00,North Coast Aviation - PNG,Flight,Operational,Papua New Guinea,Oceania,1,1,1,0,0,1,0,Human Factor
2018-04-15 00:00:00,Augusta Aviation LLC,Flight,Business,United States of America,North America,1,1,1,0,0,1,0,Human Factor
2018-06-03 00:00:00,Algerian Air Force - Al Quwwat Aljawwija Aljaza'Eriiya,Landing (descent or approach),Humanitarian,Algeria,Africa,9,9,1,0,0,1,8,Unknown
2018-06-13 00:00:00,Spernak Airways,Flight,Operational,United States of America,North America,1,1,1,0,0,1,0,Human Factor
2018-07-10 00:00:00,Rovos Air,Landing (descent or approach),Business,South Africa,Africa,20,3,1,17,0,1,19,Technical Failure
2018-07-18 00:00:00,Regal Air,Takeoff (climb),Commercial,United States of America,North America,3,1,1,2,0,1,2,Human Factor
2018-07-29 00:00:00,Videplast,Landing (descent or approach),Business,Brazil,South America,7,2,1,5,0,1,6,Unknown
2018-08-10 00:00:00,Alaska Airlines,Flight,Humanitarian,United States of America,North America,1,1,1,0,0,1,0,Human Factor
2018-08-13 00:00:00,VanCon,Flight,Humanitarian,United States of America,North America,1,1,1,0,0,1,0,Human Factor
2018-09-06 00:00:00,Flex Air Services,Landing (descent or approach),Business,United States of America,North America,1,1,1,0,0,1,0,Human Factor
2018-09-15 00:00:00,Grupo Gambatto,Flight,Business,Brazil,South America,1,1,1,0,0,1,0,Human Factor
2018-09-25 00:00:00,Kalitta Charters - Kalitta Services,Landing (descent or approach),Operational,United States of America,North America,1,1,1,0,0,1,0,Human Factor
2018-09-27 00:00:00,CGG Aviation,Flight,Operational,World,World,1,1,1,0,0,1,0,Human Factor
2018-09-28 00:00:00,Air Niugini,Landing (descent or approach),Commercial,Micronesia,Oceania,47,12,0,35,1,1,46,Human Factor
2018-11-09 00:00:00,Fly Jamaica Airways,Landing (descent or approach),Commercial,Guyana,South America,128,8,0,120,1,1,127,Technical Failure
2018-12-08 00:00:00,Par-Avion,Flight,Operational,Australia,Oceania,1,1,1,0,0,1,0,Human Factor
2019-02-03 00:00:00,KL Management,Takeoff (climb),Business,United States of America,North America,1,1,1,0,0,1,0,Human Factor
2019-02-08 00:00:00,Conquest Air Cargo,Flight,Operational,United States of America,North America,2,2,1,0,0,1,1,Human Factor
2019-03-10 00:00:00,Private American,Flight,Humanitarian,Mexico,Central America,2,2,1,0,0,1,1,Human Factor
2019-03-12 00:00:00,Marc Inc,Flight,Military / Government,United States of America,North America,1,1,1,0,0,1,0,Human Factor
2019-03-17 00:00:00,Classic Solutions Company,Landing (descent or approach),Business,United States of America,North America,1,1,1,0,0,1,0,Weather
2019-03-23 00:00:00,Major Blue Air,Flight,Humanitarian,Botswana,Africa,1,1,1,0,0,1,0,Human Factor
2019-04-14 00:00:00,Summit Air,Takeoff (climb),Operational,Nepal,Asia,3,3,1,0,0,1,2,Human Factor
2019-04-18 00:00:00,KMA Technology Solutions,Takeoff (climb),Business,United States of America,North America,1,1,1,0,0,1,0,Human Factor
2019-05-01 00:00:00,Southern Aircraft Consultancy,Flight,Operational,Canada,North America,2,2,1,0,0,1,1,Human Factor
2019-05-13 00:00:00,Taquan Air,Flight,Commercial,United States of America,North America,11,1,0,10,1,1,10,Human Factor
2019-05-15 00:00:00,Private American,Landing (descent or approach),Operational,United States of America,North America,1,1,1,0,0,1,0,Technical Failure
2019-05-24 00:00:00,Jet Sales,Flight,Operational,World,World,1,1,1,0,0,1,0,Unknown
2019-06-10 00:00:00,Santa Fe Investments,Landing (descent or approach),Business,United States of America,North America,1,1,1,0,0,1,0,Technical Failure
2019-07-19 00:00:00,Rust's Flying Service - Rustair,Takeoff (climb),Commercial,United States of America,North America,7,1,0,6,1,1,6,Other
2019-08-02 00:00:00,Sécurité civile française,Flight,Humanitarian,France,Europe,1,1,1,0,0,1,0,Human Factor
2019-08-04 00:00:00,DOSAAF,Landing (descent or approach),Humanitarian,Tajikistan,Asia,2,2,1,0,0,1,1,Unknown
2019-08-06 00:00:00,Private Chilean,Landing (descent or approach),Business,Chile,South America,1,1,1,0,0,1,0,Unknown
2019-08-17 00:00:00,Pegasus Aviation - USA,Takeoff (climb),Business,United States of America,North America,3,1,1,2,0,1,2,Unknown
2019-09-11 00:00:00,GoJump,Landing (descent or approach),Humanitarian,Germany,Europe,1,1,1,0,0,1,0,Unknown
2019-10-05 00:00:00,Indiana Paging Network,Takeoff (climb),Business,United States of America,North America,1,1,1,0,0,1,0,Human Factor
2019-10-17 00:00:00,PenAir - Peninsula Airways - Alaska Airlines Commuter,Landing (descent or approach),Commercial,United States of America,North America,42,3,0,39,1,1,41,Human Factor
2019-10-29 00:00:00,Warbird Associates,Landing (descent or approach),Business,United States of America,North America,1,1,1,0,0,1,0,Human Factor
2019-12-02 00:00:00,Private Brazilian,Landing (descent or approach),Business,Brazil,South America,1,1,1,0,0,1,0,Unknown
2019-12-09 00:00:00,Martinaire,Flight,Operational,United States of America,North America,1,1,1,0,0,1,0,Human Factor
2020-02-20 00:00:00,Private Spanish,Landing (descent or approach),Business,Spain,Europe,1,1,1,0,0,1,0,Technical Failure
2020-03-17 00:00:00,Planemasters,Flight,Operational,United States of America,North America,1,1,1,0,0,1,0,Unknown
2020-04-13 00:00:00,Sitrex Group,Takeoff (climb),Business,Brazil,South America,1,1,1,0,0,1,0,Unknown
2020-04-20 00:00:00,FMR Aviation,Takeoff (climb),Business,United States of America,North America,1,1,1,0,0,1,0,Unknown
2020-04-23 00:00:00,Tiadaghton Aviation,Flight,Business,United States of America,North America,1,1,1,0,0,1,0,Unknown
2020-04-24 00:00:00,Ravensdown Aerowork,Takeoff (climb),Military / Government,New Zealand,Oceania,1,1,1,0,0,1,0,Unknown
2020-05-12 00:00:00,Missionary Aviation Fellowship - MAF,Takeoff (climb),Operational,Indonesia,Asia,1,1,1,0,0,1,0,Unknown
2020-06-07 00:00:00,McNeely Charter Service,Takeoff (climb),Operational,United States of America,North America,1,1,1,0,0,1,0,Unknown
2020-06-15 00:00:00,Private American,Landing (descent or approach),Humanitarian,Venezuela,South America,2,2,1,0,0,1,1,Human Factor
2020-08-08 00:00:00,Babcock,Flight,Humanitarian,Spain,Europe,2,2,1,0,0,1,1,Human Factor
2020-08-20 00:00:00,Bomac air,Takeoff (climb),Business,United States of America,North America,1,1,1,0,0,1,0,Unknown
2020-11-08 00:00:00,Private Guatemalan,Takeoff (climb),Operational,Guatemala,Central America,1,1,1,0,0,1,0,Unknown
2020-11-09 00:00:00,Private Mexican,Landing (descent or approach),Humanitarian,Guatemala,Central America,1,1,1,0,0,1,0,Human Factor
2020-12-09 00:00:00,Private Ukrainian,Flight,Humanitarian,Ukraine,Europe,1,1,1,0,0,1,0,Human Factor
2020-12-19 00:00:00,Private American,Landing (descent or approach),Humanitarian,Guatemala,Central America,3,3,1,0,0,1,2,Human Factor
2021-01-08 00:00:00,Private Colombian,Flight,Business,Colombia,South America,1,1,1,0,0,1,0,Unknown
2021-02-13 00:00:00,IST Solutions,Flight,Business,United States of America,North America,1,1,1,0,0,1,0,Unknown
2021-04-16 00:00:00,Goyo Air,Takeoff (climb),Business,Bahamas,Central America,2,1,0,1,1,1,1,Unknown
2021-04-19 00:00:00,William J. Weatherspoon,Flight,Specialised Services,United States of America,North America,1,1,1,0,0,1,0,Unknown
2021-04-20 00:00:00,Electric Power Construção,Landing (descent or approach),Specialised Services,Brazil,South America,3,3,1,0,0,1,2,Unknown
2021-05-04 00:00:00,CentralAv,Flight,Business,Dominican Republic,Central America,1,1,1,0,0,1,0,Unknown
2021-05-06 00:00:00,Michael Stockton,Flight,Business,United States of America,North America,2,1,1,1,0,1,1,Technical Failure
2021-05-21 00:00:00,PJS,Takeoff (climb),Business,United States of America,North America,1,1,1,0,0,1,0,Unknown
2021-07-12 00:00:00,Desert Locust Control Organization for Eastern Africa,Flight,Military / Government,Kenya,Africa,3,1,0,2,1,1,2,Unknown
2021-07-13 00:00:00,M. E. Mullaly,Takeoff (climb),Business,United States of America,North America,1,1,1,0,0,1,0,Unknown
2021-07-26 00:00:00,Skydive Binz,Landing (descent or approach),Humanitarian,Germany,Europe,1,1,1,0,0,1,0,Unknown
2021-08-06 00:00:00,Opium Events,Landing (descent or approach),Business,France,Europe,3,1,0,2,1,1,2,Unknown
2021-08-16 00:00:00,MAG Aerospace,Takeoff (climb),Business,Canada,North America,1,1,1,0,0,1,0,Unknown
2021-08-20 00:00:00,Kevin C. Scott,Flight,Business,United States of America,North America,1,1,1,0,0,1,0,Unknown
2021-10-11 00:00:00,Samarth Aviation,Landing (descent or approach),Business,United States of America,North America,1,1,1,0,0,1,0,Unknown
2021-10-19 00:00:00,Servicios Mubarqui,Takeoff (climb),Operational,Mexico,Central America,1,1,1,0,0,1,0,Technical Failure
2021-10-25 00:00:00,Smart Cakrawala Aviation,Landing (descent or approach),Operational,Indonesia,Asia,2,2,1,0,0,1,1,Unknown
2021-12-05 00:00:00,Donald H. Sefton,Takeoff (climb),Business,United States of America,North America,1,1,1,0,0,1,0,Unknown
2021-12-10 00:00:00,Castle Aviation,Landing (descent or approach),Operational,United States of America,North America,1,1,1,0,0,1,0,Unknown
2021-12-10 00:00:00,Cowboy Air,Landing (descent or approach),Business,United States of America,North America,1,1,1,0,0,1,0,Unknown
2021-12-21 00:00:00,Martinaire,Flight,Operational,United States of America,North America,1,1,1,0,0,1,0,Human Factor
2022-02-13 00:00:00,Quadrant Investments 1,Takeoff (climb),Business,United States of America,North America,1,1,1,0,0,1,0,Unknown
2022-03-30 00:00:00,United States Navy - USN,Flight,Military / Government,United States of America,North America,3,3,1,0,0,1,2,Unknown
2022-03-30 00:00:00,Skydive Costa d'Argento,Flight,Operational,Switzerland,Europe,1,1,1,0,0,1,0,Human Factor
2022-04-13 00:00:00,GEM Air,Landing (descent or approach),Operational,United States of America,North America,1,1,1,0,0,1,0,Unknown
2022-04-22 00:00:00,Constanta Airlines,Flight,Specialised Services,Ukraine,Europe,3,3,1,0,0,1,2,Unknown
2022-06-03 00:00:00,GoJump Oceanside,Landing (descent or approach),Humanitarian,United States of America,North America,2,1,0,1,1,1,1,Unknown
1918-08-26 00:00:00,Royal Air Force - RAF,Landing (descent or approach),Military / Government,United Kingdom,Europe,2,2,0,0,0,0,2,Unknown
1918-09-13 00:00:00,Royal Air Force - RAF,Flight,Military / Government,United Kingdom,Europe,1,1,0,0,0,0,1,Weather
1918-10-06 00:00:00,Royal Air Force - RAF,Takeoff (climb),Operational,United Kingdom,Europe,1,1,0,0,0,0,1,Technical Failure
1918-11-14 00:00:00,U.S. Air Mail Service,Flight,Operational,United States of America,North America,0,0,0,0,0,0,0,Technical Failure
1918-12-02 00:00:00,United States Signal Corps - USSC,,Military / Government,United States of America,North America,0,0,0,0,0,0,0,Unknown
1918-12-21 00:00:00,Royal Air Force - RAF,Flight,Operational,United Kingdom,Europe,2,2,0,0,0,0,2,Unknown
1919-01-16 00:00:00,Handley Page Aircraft Company Ltd,Takeoff (climb),Operational,United Kingdom,Europe,5,2,0,3,0,0,5,Unknown
1919-02-23 00:00:00,United States Army Air Service - USAAS,Flight,Military / Government,United States of America,North America,0,0,0,0,0,0,0,Technical Failure
1919-03-10 00:00:00,United States Army Air Service - USAAS,Flight,Military / Government,United States of America,North America,0,0,0,0,0,0,0,Technical Failure
1919-03-18 00:00:00,Royal Air Force - RAF,Landing (descent or approach),Specialised Services,United Kingdom,Europe,5,1,0,4,0,0,5,Weather
1919-03-19 00:00:00,U.S. Air Mail Service,Flight,Operational,United States of America,North America,0,0,0,0,0,0,0,Weather
1919-03-23 00:00:00,Private French,Flight,Commercial,France,Europe,2,2,0,0,0,0,2,Technical Failure
1919-04-15 00:00:00,U.S. Air Mail Service,Flight,Operational,United States of America,North America,0,0,0,0,0,0,0,Weather
1919-04-26 00:00:00,U.S. Air Mail Service,Flight,Operational,United States of America,North America,0,0,0,0,0,0,0,Technical Failure
1919-05-02 00:00:00,United States Army Air Service - USAAS,,Military / Government,United States of America,North America,0,0,0,0,0,0,0,Unknown
1919-05-03 00:00:00,United States Army Air Service - USAAS,,Military / Government,United States of America,North America,0,0,0,0,0,0,0,Unknown
1919-05-06 00:00:00,United States Army Air Service - USAAS,Flight,Military / Government,United States of America,North America,0,0,0,0,0,0,0,Unknown
1919-05-15 00:00:00,U.S. Air Mail Service,Flight,Operational,United States of America,North America,0,0,0,0,0,0,0,Unknown
1919-05-31 00:00:00,Grahame-White Aviation,Takeoff (climb),Commercial,United Kingdom,Europe,3,1,0,2,0,0,3,Technical Failure
1919-06-02 00:00:00,United States Army Air Service - USAAS,,Military / Government,United States of America,North America,0,0,0,0,0,0,0,Unknown
1919-06-15 00:00:00,Vickers-Armstrongs Ltd,Landing (descent or approach),Business,Ireland,Europe,2,2,0,0,0,0,2,Unknown
1919-06-15 00:00:00,U.S. Air Mail Service,Flight,Operational,United States of America,North America,0,0,0,0,0,0,0,Technical Failure
1919-06-24 00:00:00,United States Army Air Service - USAAS,Flight,Military / Government,United States of America,North America,0,0,0,0,0,0,0,Unknown
1919-06-29 00:00:00,Grahame-White Aviation,Takeoff (climb),Operational,United Kingdom,Europe,3,3,0,0,0,0,3,Unknown
1919-07-15 00:00:00,U.S. Air Mail Service,Flight,Operational,United States of America,North America,0,0,0,0,0,0,0,Weather
1919-07-19 00:00:00,U.S. Air Mail Service,Flight,Operational,United States of America,North America,1,1,0,0,0,0,1,Technical Failure
1919-07-21 00:00:00,Berkshire Aviation,Landing (descent or approach),Operational,United Kingdom,Europe,1,1,0,0,0,0,1,Unknown
1919-07-21 00:00:00,U.S. Air Mail Service,Flight,Operational,United States of America,North America,0,0,0,0,0,0,0,Human Factor
1919-08-05 00:00:00,United States Army Air Service - USAAS,Landing (descent or approach),Military / Government,United States of America,North America,0,0,0,0,0,0,0,Unknown
1919-08-14 00:00:00,Private Czech,Flight,Other,Czech Republic,Europe,0,0,0,0,0,0,0,Unknown
1919-08-15 00:00:00,London %26 Provincial Aviation,Flight,Commercial,United Kingdom,Europe,2,1,0,1,0,0,2,Unknown
1919-08-18 00:00:00,United States Army Air Service - USAAS,Flight,Military / Government,United States of America,North America,0,0,0,0,0,0,0,Unknown
1919-08-20 00:00:00,United States Army Air Service - USAAS,Flight,Military / Government,Mexico,Central America,1,1,0,0,0,0,1,Technical Failure
1919-08-21 00:00:00,Avro Air Transport,Flight,Operational,United Kingdom,Europe,1,1,0,0,0,0,1,Unknown
1919-08-23 00:00:00,United States Army Air Service - USAAS,Flight,Military / Government,United States of America,North America,0,0,0,0,0,0,0,Unknown
1919-08-28 00:00:00,H. V. David,Flight,Business,United Kingdom,Europe,1,1,0,0,0,0,1,Unknown
1919-08-28 00:00:00,Avro Air Transport,Flight,Commercial,United Kingdom,Europe,0,0,0,0,0,0,0,Unknown
1919-08-30 00:00:00,Avro Air Transport,Takeoff (climb),Commercial,United Kingdom,Europe,3,1,0,2,0,0,3,Weather
1919-09-01 00:00:00,Avro Air Transport,Landing (descent or approach),Operational,United Kingdom,Europe,1,1,0,0,0,0,1,Unknown
1919-09-01 00:00:00,United States Army Air Service - USAAS,Flight,Military / Government,United States of America,North America,0,0,0,0,0,0,0,Technical Failure
1919-09-09 00:00:00,Avro Air Transport,Flight,Operational,United Kingdom,Europe,1,1,0,0,0,0,1,Unknown
1919-09-09 00:00:00,United States Army Air Service - USAAS,Flight,Military / Government,United States of America,North America,0,0,0,0,0,0,0,Unknown
1919-09-09 00:00:00,United States Army Air Service - USAAS,Flight,Military / Government,United States of America,North America,0,0,0,0,0,0,0,Unknown
1919-09-17 00:00:00,United States Army Air Service - USAAS,Landing (descent or approach),Military / Government,United States of America,North America,0,0,0,0,0,0,0,Unknown
1919-09-20 00:00:00,United States Army Air Service - USAAS,Landing (descent or approach),Military / Government,United States of America,North America,0,0,0,0,0,0,0,Unknown
1919-09-26 00:00:00,United States Army Air Service - USAAS,Takeoff (climb),Military / Government,United States of America,North America,0,0,0,0,0,0,0,Unknown
1919-10-02 00:00:00,United States Army Air Service - USAAS,Landing (descent or approach),Military / Government,United States of America,North America,0,0,0,0,0,0,0,Unknown
1919-10-06 00:00:00,United States Army Air Service - USAAS,Landing (descent or approach),Military / Government,United States of America,North America,0,0,0,0,0,0,0,Unknown
1919-10-16 00:00:00,U.S. Air Mail Service,Flight,Operational,United States of America,North America,0,0,0,0,0,0,0,Human Factor
1919-10-17 00:00:00,United States Army Air Service - USAAS,Landing (descent or approach),Military / Government,United States of America,North America,0,0,0,0,0,0,0,Unknown
1919-10-19 00:00:00,Central Aircraft Company,Landing (descent or approach),Business,United Kingdom,Europe,1,1,0,0,0,0,1,Unknown
1919-10-20 00:00:00,Aircraft Transport %26 Travel - AT%26T,Flight,Operational,United Kingdom,Europe,1,1,0,0,0,0,1,Unknown
1919-10-21 00:00:00,United States Army Air Service - USAAS,Takeoff (climb),Military / Government,United States of America,North America,1,1,0,0,0,0,1,Technical Failure
1919-10-24 00:00:00,U.S. Air Mail Service,Flight,Operational,United States of America,North America,0,0,0,0,0,0,0,Human Factor
1919-10-29 00:00:00,United States Army Air Service - USAAS,Landing (descent or approach),Operational,United States of America,North America,0,0,0,0,0,0,0,Unknown
1919-10-29 00:00:00,United States Army Air Service - USAAS,Landing (descent or approach),Military / Government,United States of America,North America,0,0,0,0,0,0,0,Unknown
1919-11-04 00:00:00,Avro Air Transport,Flight,Commercial,United Kingdom,Europe,3,1,0,2,0,0,3,Technical Failure
1919-12-02 00:00:00,Avro Air Transport,Flight,Business,United Kingdom,Europe,0,0,0,0,0,0,0,Unknown
1919-12-02 00:00:00,By Air,Takeoff (climb),Operational,United Kingdom,Europe,1,1,0,0,0,0,1,Unknown
1919-12-08 00:00:00,Blackburn Aeroplane %26 Motor Company,Flight,Business,Greece,Europe,3,3,0,0,0,0,3,Technical Failure
1919-12-09 00:00:00,Avro Air Transport,Landing (descent or approach),Commercial,United Kingdom,Europe,2,1,0,1,0,0,2,Unknown
1919-12-18 00:00:00,Central Aircraft Company,Landing (descent or approach),Commercial,United Kingdom,Europe,1,1,0,0,0,0,1,Unknown
1919-12-21 00:00:00,T. D. Lewis,Flight,Business,United Kingdom,Europe,1,1,0,0,0,0,1,Unknown
1919-12-29 00:00:00,United States Army Air Service - USAAS,,Military / Government,United States of America,North America,0,0,0,0,0,0,0,Unknown
1920-01-12 00:00:00,U.S. Air Mail Service,Flight,Operational,United States of America,North America,0,0,0,0,0,0,0,Technical Failure
1920-01-15 00:00:00,Cosmos Engineering Company,Flight,Business,United Kingdom,Europe,2,2,0,0,0,0,2,Technical Failure
1920-01-17 00:00:00,Compagnie des Messageries Aériennes - CMA,Flight,Operational,United Kingdom,Europe,0,0,0,0,0,0,0,Unknown
1920-01-19 00:00:00,U.S. Air Mail Service,Landing (descent or approach),Operational,United States of America,North America,0,0,0,0,0,0,0,Unknown
1920-02-04 00:00:00,South African Air Force,Landing (descent or approach),Military / Government,Sudan,Africa,2,2,0,0,0,0,2,Technical Failure
1920-02-22 00:00:00,United States Army Air Service - USAAS,Landing (descent or approach),Military / Government,United States of America,North America,0,0,0,0,0,0,0,Unknown
1920-02-23 00:00:00,Handley Page Transport,Flight,Commercial,South Africa,Africa,9,1,0,8,0,0,9,Technical Failure
1920-02-25 00:00:00,Handley Page Transport,Flight,Business,Sudan,Africa,4,4,0,0,0,0,4,Technical Failure
1920-02-27 00:00:00,United States Army Air Service - USAAS,Landing (descent or approach),Military / Government,United States of America,North America,0,0,0,0,0,0,0,Unknown
1920-02-28 00:00:00,Vickers-Armstrongs Ltd,Takeoff (climb),Business,Tanzania,Africa,5,4,0,1,0,0,5,Technical Failure
1920-03-05 00:00:00,United States Army Air Service - USAAS,Landing (descent or approach),Military / Government,United States of America,North America,0,0,0,0,0,0,0,Unknown
1920-03-05 00:00:00,United States Army Air Service - USAAS,Flight,Military / Government,United States of America,North America,0,0,0,0,0,0,0,Unknown
1920-03-05 00:00:00,United States Army Air Service - USAAS,Flight,Operational,Mexico,Central America,1,1,0,0,0,0,1,Technical Failure
1920-03-06 00:00:00,South African Air Force,Landing (descent or approach),Military / Government,Zimbabwe,Africa,2,2,0,0,0,0,2,Unknown
1920-03-06 00:00:00,Martin Seidler,Flight,Business,Switzerland,Europe,1,1,0,0,0,0,1,Unknown
1920-03-07 00:00:00,Lignes Aériennes Latécoère,Flight,Operational,Spain,Europe,1,1,0,0,0,0,1,Unknown
1920-03-18 00:00:00,Aircraft Transport %26 Travel - AT%26T,Flight,Operational,United Kingdom,Europe,1,1,0,0,0,0,1,Technical Failure
1920-03-18 00:00:00,U.S. Air Mail Service,Flight,Operational,United States of America,North America,1,1,0,0,0,0,1,Technical Failure
1920-03-24 00:00:00,Junkers-Larsen,Takeoff (climb),Operational,United States of America,North America,1,1,0,0,0,0,1,Technical Failure
1920-03-26 00:00:00,Royal Air Force - RAF,Takeoff (climb),Military / Government,Egypt,Africa,0,0,0,0,0,0,0,Unknown
1920-03-31 00:00:00,Handley Page Transport,Flight,Specialised Services,United Kingdom,Europe,2,1,0,1,0,0,2,Technical Failure
1920-04-12 00:00:00,Lignes Aériennes Latécoère,Landing (descent or approach),Operational,Spain,Europe,1,1,0,0,0,0,1,Unknown
1920-04-15 00:00:00,Vickers-Armstrongs Ltd,Takeoff (climb),Business,United Kingdom,Europe,1,1,0,0,0,0,1,Unknown
1920-04-16 00:00:00,W. G. Pudney,Flight,Business,United Kingdom,Europe,1,1,0,0,0,0,1,Unknown
1920-04-19 00:00:00,U.S. Air Mail Service,Flight,Operational,United States of America,North America,0,0,0,0,0,0,0,Human Factor
1920-04-22 00:00:00,U.S. Air Mail Service,Flight,Operational,United States of America,North America,1,1,0,0,0,0,1,Technical Failure
1920-04-22 00:00:00,United States Army Air Service - USAAS,Flight,Military / Government,United States of America,North America,0,0,0,0,0,0,0,Unknown
1920-04-30 00:00:00,Vickers-Armstrongs Ltd,Takeoff (climb),Operational,United Kingdom,Europe,1,1,0,0,0,0,1,Unknown
1920-05-04 00:00:00,U.S. Air Mail Service,Flight,Operational,United States of America,North America,1,1,0,0,0,0,1,Technical Failure
1920-05-15 00:00:00,U.S. Air Mail Service,Landing (descent or approach),Operational,United States of America,North America,0,0,0,0,0,0,0,Human Factor
1920-05-16 00:00:00,Lignes Aériennes Latécoère,Flight,Operational,Spain,Europe,1,1,0,0,0,0,1,Unknown
1920-05-21 00:00:00,United States Army Air Service - USAAS,Landing (descent or approach),Military / Government,United States of America,North America,0,0,0,0,0,0,0,Unknown
1920-05-22 00:00:00,United States Army Air Service - USAAS,Takeoff (climb),Military / Government,United States of America,North America,0,0,0,0,0,0,0,Unknown
1920-05-25 00:00:00,U.S. Air Mail Service,Flight,Operational,United States of America,North America,0,0,0,0,0,0,0,Human Factor
1920-05-28 00:00:00,United States Army Air Service - USAAS,Flight,Military / Government,United States of America,North America,0,0,0,0,0,0,0,Unknown
1920-06-04 00:00:00,U.S. Air Mail Service,Flight,Operational,United States of America,North America,0,0,0,0,0,0,0,Technical Failure
1920-06-08 00:00:00,United States Army Air Service - USAAS,Takeoff (climb),Military / Government,United States of America,North America,0,0,0,0,0,0,0,Unknown
1920-06-09 00:00:00,United States Army Air Service - USAAS,Landing (descent or approach),Military / Government,United States of America,North America,0,0,0,0,0,0,0,Unknown
1920-06-10 00:00:00,Aircraft Transport %26 Travel - AT%26T,Flight,Commercial,United Kingdom,Europe,4,1,0,3,0,0,4,Technical Failure
1920-06-12 00:00:00,United States Army Air Service - USAAS,Takeoff (climb),Military / Government,United States of America,North America,0,0,0,0,0,0,0,Unknown
1920-06-22 00:00:00,U.S. Air Mail Service,Flight,Operational,United States of America,North America,0,0,0,0,0,0,0,Technical Failure
1920-06-30 00:00:00,Handley Page Transport,Takeoff (climb),Operational,Sweden,Europe,7,4,0,3,0,0,7,Human Factor
1920-07-01 00:00:00,Royal Netherlands East Indies Air Force - ML-KNIL,Landing (descent or approach),Operational,Indonesia,Asia,1,1,0,0,0,0,1,Unknown
1920-07-04 00:00:00,Central Aircraft Company,Takeoff (climb),Commercial,United Kingdom,Europe,2,1,0,1,0,0,2,Unknown
1920-07-10 00:00:00,United States Army Air Service - USAAS,Flight,Military / Government,United States of America,North America,0,0,0,0,0,0,0,Unknown
1920-07-10 00:00:00,United States Army Air Service - USAAS,,Military / Government,United States of America,North America,0,0,0,0,0,0,0,Unknown
1920-07-12 00:00:00,Eastbourne Aviation,Flight,Commercial,United Kingdom,Europe,3,1,0,2,0,0,3,Technical Failure
1920-07-12 00:00:00,Royal Norwegian Navy,Takeoff (climb),Operational,Norway,Europe,3,1,0,2,0,0,3,Weather
1920-07-18 00:00:00,United States Army Air Service - USAAS,Landing (descent or approach),Military / Government,United States of America,North America,0,0,0,0,0,0,0,Unknown
1920-07-21 00:00:00,North Sea Aerial Navigation Company,Takeoff (climb),Commercial,United Kingdom,Europe,3,1,0,2,0,0,3,Unknown
1920-07-27 00:00:00,P.O. Flygkompani,Flight,Commercial,Sweden,Europe,2,1,0,1,0,0,2,Technical Failure
1920-08-03 00:00:00,North Sea Aerial Navigation Company,Landing (descent or approach),Commercial,United Kingdom,Europe,3,1,0,2,0,0,3,Technical Failure
1920-08-07 00:00:00,Bournemouth Aviation,Landing (descent or approach),Operational,United Kingdom,Europe,1,1,0,0,0,0,1,Technical Failure
1920-08-11 00:00:00,United States Army Air Service - USAAS,Flight,Military / Government,United States of America,North America,0,0,0,0,0,0,0,Unknown
1920-08-12 00:00:00,United States Army Air Service - USAAS,Flight,Military / Government,Philippines,Asia,0,0,0,0,0,0,0,Technical Failure
1920-08-12 00:00:00,Royal Canadian Air Force - RCAF,Takeoff (climb),Operational,Canada,North America,1,1,0,0,0,0,1,Unknown
1920-08-16 00:00:00,Aircraft Transport %26 Travel - AT%26T,Takeoff (climb),Commercial,United Kingdom,Europe,9,1,0,8,0,0,9,Technical Failure
1920-08-18 00:00:00,Lignes Aériennes Latécoère,,Operational,Spain,Europe,1,1,0,0,0,0,1,Unknown
1920-08-19 00:00:00,Eastbourne Aviation,Takeoff (climb),Commercial,United Kingdom,Europe,2,1,0,1,0,0,2,Unknown
1920-08-20 00:00:00,United States Army Air Service - USAAS,Flight,Military / Government,United States of America,North America,0,0,0,0,0,0,0,Unknown
1920-08-22 00:00:00,Aircraft Transport %26 Travel - AT%26T,Landing (descent or approach),Operational,United Kingdom,Europe,2,2,0,0,0,0,2,Unknown
1920-08-23 00:00:00,Royal Canadian Air Force - RCAF,,Military / Government,Canada,North America,0,0,0,0,0,0,0,Unknown
1920-08-26 00:00:00,Canadian Aircraft Company,Landing (descent or approach),Commercial,Canada,North America,2,1,0,1,0,0,2,Unknown
1920-08-28 00:00:00,Regia Marina Italiana,Flight,Military / Government,Switzerland,Europe,2,2,0,0,0,0,2,Unknown
1920-09-10 00:00:00,Bishop-Barker Aeroplanes,Flight,Business,Canada,North America,0,0,0,0,0,0,0,Unknown
1920-09-14 00:00:00,Adastral Air Lines,Flight,Commercial,France,Europe,3,1,0,2,0,0,3,Unknown
1920-09-16 00:00:00,United States Army Air Service - USAAS,Takeoff (climb),Military / Government,United States of America,North America,0,0,0,0,0,0,0,Unknown
1920-09-20 00:00:00,Vancouver Island Aerial Service,Flight,Business,Canada,North America,1,1,0,0,0,0,1,Unknown
1920-09-23 00:00:00,H. W. B. Hansford,Flight,Business,United Kingdom,Europe,1,1,0,0,0,0,1,Unknown
1920-09-23 00:00:00,Det Norske Luftfartrederi - DNL,Flight,Operational,Norway,Europe,1,1,0,0,0,0,1,Technical Failure
1920-09-29 00:00:00,Eastbourne Aviation,,Other,United Kingdom,Europe,0,0,0,0,0,0,0,Unknown
1920-09-30 00:00:00,Royal Canadian Air Force - RCAF,,Military / Government,Canada,North America,0,0,0,0,0,0,0,Unknown
1920-10-05 00:00:00,Royal Air Force - RAF,Flight,Operational,United Kingdom,Europe,0,0,0,0,0,0,0,Unknown
1920-10-07 00:00:00,Royal Canadian Air Force - RCAF,Flight,Operational,Canada,North America,0,0,0,0,0,0,0,Unknown
1920-10-19 00:00:00,Tryggve Gran,Takeoff (climb),Business,Sweden,Europe,2,2,0,0,0,0,2,Technical Failure
1920-11-09 00:00:00,Aircraft Transport %26 Travel - AT%26T,Landing (descent or approach),Commercial,France,Europe,0,0,0,0,0,0,0,Unknown
1920-11-13 00:00:00,United States Army Air Service - USAAS,Landing (descent or approach),Military / Government,United States of America,North America,0,0,0,0,0,0,0,Unknown
1920-11-22 00:00:00,United States Army Air Service - USAAS,Landing (descent or approach),Military / Government,United States of America,North America,0,0,0,0,0,0,0,Unknown
1920-11-22 00:00:00,United States Army Air Service - USAAS,,Military / Government,United States of America,North America,0,0,0,0,0,0,0,Unknown
1920-11-22 00:00:00,Royal Canadian Air Force - RCAF,Flight,Operational,Canada,North America,0,0,0,0,0,0,0,Unknown
1920-12-04 00:00:00,United States Army Air Service - USAAS,,Military / Government,United States of America,North America,0,0,0,0,0,0,0,Unknown
1920-12-11 00:00:00,United States Army Air Service - USAAS,Landing (descent or approach),Military / Government,United States of America,North America,0,0,0,0,0,0,0,Unknown
1920-12-17 00:00:00,Aircraft Transport %26 Travel - AT%26T,Takeoff (climb),Commercial,United Kingdom,Europe,3,1,0,2,0,0,3,Unknown
1920-12-29 00:00:00,Lignes Aériennes Latécoère,,Operational,France,Europe,0,0,0,0,0,0,0,Unknown
1920-12-30 00:00:00,United States Army Air Service - USAAS,Flight,Operational,United States of America,North America,1,1,0,0,0,0,1,Technical Failure
1920-12-31 00:00:00,United States Army Air Service - USAAS,Flight,Military / Government,United States of America,North America,0,0,0,0,0,0,0,Technical Failure
1921-01-03 00:00:00,Edmonton Aircraft Company,Takeoff (climb),Business,Canada,North America,1,1,0,0,0,0,1,Unknown
1921-01-14 00:00:00,U.S. Air Mail Service,Flight,Operational,United States of America,North America,1,1,0,0,0,0,1,Technical Failure
1921-01-18 00:00:00,United States Army Air Service - USAAS,Takeoff (climb),Military / Government,United States of America,North America,0,0,0,0,0,0,0,Unknown
1921-01-21 00:00:00,United States Army Air Service - USAAS,Flight,Military / Government,United States of America,North America,2,1,0,1,0,0,2,Technical Failure
1921-01-22 00:00:00,Lignes Aériennes Latécoère,,Operational,France,Europe,0,0,0,0,0,0,0,Unknown
1921-01-24 00:00:00,Leif Lier,Flight,Operational,Norway,Europe,1,1,0,0,0,0,1,Technical Failure
1921-01-28 00:00:00,United States Army Air Service - USAAS,Flight,Military / Government,Germany,Europe,0,0,0,0,0,0,0,Unknown
1921-01-28 00:00:00,United States Army Air Service - USAAS,Flight,Military / Government,United States of America,North America,0,0,0,0,0,0,0,Unknown
1921-02-04 00:00:00,United States Army Air Service - USAAS,,Military / Government,United States of America,North America,0,0,0,0,0,0,0,Unknown
1921-02-04 00:00:00,United States Army Air Service - USAAS,Landing (descent or approach),Military / Government,United States of America,North America,0,0,0,0,0,0,0,Unknown
1921-02-14 00:00:00,U.S. Air Mail Service,Flight,Operational,United States of America,North America,1,1,0,0,0,0,1,Technical Failure
1921-02-18 00:00:00,U.S. Air Mail Service,Takeoff (climb),Operational,United States of America,North America,1,1,0,0,0,0,1,Human Factor
1921-02-20 00:00:00,Royal Canadian Air Force - RCAF,Flight,Operational,Canada,North America,1,1,0,0,0,0,1,Technical Failure
1921-02-20 00:00:00,Royal Air Force - RAF,Flight,Operational,Iraq,Asia,1,1,0,0,0,0,1,Technical Failure
1921-02-21 00:00:00,United States Army Air Service - USAAS,Flight,Military / Government,United States of America,North America,0,0,0,0,0,0,0,Unknown
1921-02-26 00:00:00,Syndicat National pour l'Etude du Transport Aérien - SNETA,Takeoff (climb),Operational,United Kingdom,Europe,1,1,0,0,0,0,1,Unknown
1921-03-04 00:00:00,Caproni Trasporti,Takeoff (climb),Specialised Services,Italy,Europe,1,1,0,0,0,0,1,Unknown
1921-03-22 00:00:00,Royal Canadian Air Force - RCAF,Flight,Operational,Canada,North America,0,0,0,0,0,0,0,Unknown
1921-04-01 00:00:00,Royal Canadian Air Force - RCAF,Flight,Operational,Canada,North America,0,0,0,0,0,0,0,Unknown
1921-04-02 00:00:00,United States Army Air Service - USAAS,Flight,Operational,United States of America,North America,1,1,0,0,0,0,1,Technical Failure
1921-04-05 00:00:00,Royal Canadian Air Force - RCAF,Flight,Operational,Canada,North America,0,0,0,0,0,0,0,Unknown
1921-04-07 00:00:00,Handley Page Transport,Takeoff (climb),Commercial,United Kingdom,Europe,2,1,0,1,0,0,2,Unknown
1921-04-08 00:00:00,Royal Air Force - RAF,Flight,Military / Government,Iraq,Asia,2,1,0,1,0,0,2,Weather
1921-04-13 00:00:00,Syndicat National pour l'Etude du Transport Aérien - SNETA,Landing (descent or approach),Operational,France,Europe,1,1,0,0,0,0,1,Unknown
1921-04-13 00:00:00,Royal Canadian Air Force - RCAF,Flight,Operational,Canada,North America,0,0,0,0,0,0,0,Unknown
1921-04-21 00:00:00,United States Army Air Service - USAAS,Flight,Operational,United States of America,North America,0,0,0,0,0,0,0,Unknown
1921-04-29 00:00:00,United States Army Air Service - USAAS,,Military / Government,United States of America,North America,0,0,0,0,0,0,0,Unknown
1921-05-10 00:00:00,United States Army Air Service - USAAS,Flight,Military / Government,United States of America,North America,1,1,0,0,0,0,1,Technical Failure
1921-05-11 00:00:00,United States Army Air Service - USAAS,Flight,Operational,United States of America,North America,0,0,0,0,0,0,0,Unknown
1921-05-13 00:00:00,Instone Air Line,Flight,Commercial,France,Europe,10,2,0,8,0,0,10,Unknown
1921-05-21 00:00:00,KLM Royal Dutch Airlines - Koninklijke Luchtvaart Maatschappij,Landing (descent or approach),Commercial,Netherlands,Europe,3,1,0,2,0,0,3,Unknown
1921-05-21 00:00:00,United States Army Air Service - USAAS,Flight,Military / Government,United States of America,North America,0,0,0,0,0,0,0,Technical Failure
1921-05-30 00:00:00,Price Brothers %26 Company,Takeoff (climb),Business,Canada,North America,0,0,0,0,0,0,0,Other
1921-05-31 00:00:00,Royal Canadian Air Force - RCAF,Flight,Operational,Canada,North America,2,2,0,0,0,0,2,Unknown
1921-05-31 00:00:00,Royal Canadian Air Force - RCAF,Flight,Military / Government,Canada,North America,0,0,0,0,0,0,0,Unknown
1921-06-07 00:00:00,United States Army Air Service - USAAS,Takeoff (climb),Military / Government,United States of America,North America,0,0,0,0,0,0,0,Unknown
1921-06-08 00:00:00,Compagnie des Messageries Aériennes - CMA,Flight,Operational,France,Europe,1,1,0,0,0,0,1,Weather
1921-06-17 00:00:00,United States Army Air Service - USAAS,Takeoff (climb),Military / Government,United States of America,North America,0,0,0,0,0,0,0,Technical Failure
1921-06-17 00:00:00,United States Army Air Service - USAAS,Flight,Military / Government,United States of America,North America,0,0,0,0,0,0,0,Technical Failure
1921-06-23 00:00:00,Compagnie des Messageries Aériennes - CMA,Flight,Commercial,United Kingdom,Europe,3,1,0,2,0,0,3,Technical Failure
1921-06-26 00:00:00,Deutsche Luft-Reederei,Takeoff (climb),Commercial,Germany,Europe,2,1,0,1,0,0,2,Unknown
1921-06-28 00:00:00,United States Army Air Service - USAAS,Flight,Operational,United States of America,North America,0,0,0,0,0,0,0,Technical Failure
1921-06-30 00:00:00,United States Army Air Service - USAAS,Flight,Military / Government,United States of America,North America,0,0,0,0,0,0,0,Unknown
1921-07-06 00:00:00,McCall-Hanrahan Air Service,Takeoff (climb),Business,Canada,North America,0,0,0,0,0,0,0,Unknown
1921-07-10 00:00:00,United States Army Air Service - USAAS,Takeoff (climb),Military / Government,United States of America,North America,2,2,0,0,0,0,2,Technical Failure
1921-07-11 00:00:00,United States Army Air Service - USAAS,Takeoff (climb),Military / Government,United States of America,North America,0,0,0,0,0,0,0,Unknown
1921-07-13 00:00:00,United States Army Air Service - USAAS,Takeoff (climb),Military / Government,United States of America,North America,0,0,0,0,0,0,0,Technical Failure
1921-07-22 00:00:00,United States Army Air Service - USAAS,Takeoff (climb),Military / Government,United States of America,North America,0,0,0,0,0,0,0,Unknown
1921-07-23 00:00:00,United States Army Air Service - USAAS,Flight,Military / Government,United States of America,North America,0,0,0,0,0,0,0,Unknown
1921-07-25 00:00:00,United States Army Air Service - USAAS,Takeoff (climb),Military / Government,United States of America,North America,1,1,0,0,0,0,1,Technical Failure
1921-07-27 00:00:00,United States Army Air Service - USAAS,Flight,Military / Government,United States of America,North America,0,0,0,0,0,0,0,Technical Failure
1921-07-28 00:00:00,United States Army Air Service - USAAS,Flight,Military / Government,United States of America,North America,0,0,0,0,0,0,0,Technical Failure
1921-08-01 00:00:00,Royal Canadian Air Force - RCAF,Flight,Military / Government,Canada,North America,0,0,0,0,0,0,0,Unknown
1921-08-01 00:00:00,United States Army Air Service - USAAS,Flight,Operational,United States of America,North America,0,0,0,0,0,0,0,Unknown
1921-08-03 00:00:00,Canadian Aerial Services,Landing (descent or approach),Commercial,Canada,North America,0,0,0,0,0,0,0,Unknown
1921-08-10 00:00:00,United States Army Air Service - USAAS,Takeoff (climb),Military / Government,United States of America,North America,0,0,0,0,0,0,0,Unknown
1921-08-10 00:00:00,United States Army Air Service - USAAS,Takeoff (climb),Military / Government,United States of America,North America,0,0,0,0,0,0,0,Unknown
1921-08-10 00:00:00,United States Army Air Service - USAAS,Flight,Military / Government,United States of America,North America,0,0,0,0,0,0,0,Technical Failure
1921-08-11 00:00:00,United States Army Air Service - USAAS,Takeoff (climb),Military / Government,United States of America,North America,0,0,0,0,0,0,0,Technical Failure
1921-08-18 00:00:00,United States Army Air Service - USAAS,Takeoff (climb),Military / Government,United States of America,North America,0,0,0,0,0,0,0,Technical Failure
1921-08-21 00:00:00,Imperial Oil,Takeoff (climb),Business,Canada,North America,2,2,0,0,0,0,2,Technical Failure
1921-08-24 00:00:00,Canadian Aerial Services,Takeoff (climb),Commercial,Canada,North America,0,0,0,0,0,0,0,Technical Failure
1921-08-26 00:00:00,Royal Canadian Air Force - RCAF,Flight,Operational,Canada,North America,0,0,0,0,0,0,0,Unknown
1921-08-29 00:00:00,United States Army Air Service - USAAS,Landing (descent or approach),Military / Government,United States of America,North America,0,0,0,0,0,0,0,Technical Failure
1921-09-02 00:00:00,KLM Royal Dutch Airlines - Koninklijke Luchtvaart Maatschappij,Flight,Commercial,Netherlands,Europe,1,1,0,0,0,0,1,Technical Failure
1921-09-09 00:00:00,United States Army Air Service - USAAS,Flight,Military / Government,United States of America,North America,0,0,0,0,0,0,0,Technical Failure
1921-09-15 00:00:00,United States Army Air Service - USAAS,Landing (descent or approach),Military / Government,United States of America,North America,0,0,0,0,0,0,0,Unknown
1921-09-16 00:00:00,United States Army Air Service - USAAS,Flight,Military / Government,United States of America,North America,0,0,0,0,0,0,0,Unknown
1921-09-17 00:00:00,Compagnie des Messageries Aériennes - CMA,Landing (descent or approach),Operational,United Kingdom,Europe,1,1,0,0,0,0,1,Weather
1921-09-20 00:00:00,United States Army Air Service - USAAS,Flight,Military / Government,United States of America,North America,0,0,0,0,0,0,0,Unknown
1921-09-22 00:00:00,United States Army Air Service - USAAS,Flight,Military / Government,United States of America,North America,0,0,0,0,0,0,0,Unknown
1921-09-22 00:00:00,United States Army Air Service - USAAS,Flight,Military / Government,United States of America,North America,0,0,0,0,0,0,0,Technical Failure
1921-09-25 00:00:00,S. Summerfield Company,Takeoff (climb),Commercial,United Kingdom,Europe,3,1,0,2,0,0,3,Unknown
1921-09-29 00:00:00,United States Army Air Service - USAAS,Landing (descent or approach),Military / Government,United States of America,North America,0,0,0,0,0,0,0,Unknown
1921-10-01 00:00:00,Herbert Sykes,Takeoff (climb),Business,United Kingdom,Europe,1,1,0,0,0,0,1,Unknown
1921-10-06 00:00:00,J. M. Landry,Takeoff (climb),Business,Canada,North America,1,1,0,0,0,0,1,Technical Failure
1921-10-16 00:00:00,United States Army Air Service - USAAS,Landing (descent or approach),Military / Government,United States of America,North America,0,0,0,0,0,0,0,Unknown
1921-10-17 00:00:00,Det Danske Luftfartselskab - DDL,Flight,Commercial,Denmark,Europe,0,0,0,0,0,0,0,Unknown
1921-10-18 00:00:00,Royal Canadian Air Force - RCAF,Flight,Operational,Canada,North America,0,0,0,0,0,0,0,Unknown
1921-10-22 00:00:00,United States Army Air Service - USAAS,Flight,Military / Government,United States of America,North America,0,0,0,0,0,0,0,Unknown
1921-10-26 00:00:00,KLM Royal Dutch Airlines - Koninklijke Luchtvaart Maatschappij,Landing (descent or approach),Operational,Netherlands,Europe,1,1,0,0,0,0,1,Unknown
1921-10-26 00:00:00,United States Army Air Service - USAAS,Flight,Military / Government,United States of America,North America,0,0,0,0,0,0,0,Unknown
1921-11-08 00:00:00,Compagnie Générale d'Entreprises Aéronautiques - CGEA,Flight,Operational,Spain,Europe,1,1,0,0,0,0,1,Technical Failure
1921-11-17 00:00:00,United States Army Air Service - USAAS,Landing (descent or approach),Military / Government,United States of America,North America,0,0,0,0,0,0,0,Unknown
1921-11-23 00:00:00,Compagnie Générale d'Entreprises Aéronautiques - CGEA,Takeoff (climb),Commercial,Spain,Europe,3,1,0,2,0,0,3,Technical Failure
1921-11-26 00:00:00,Stallard Airways,Flight,Commercial,United Kingdom,Europe,2,1,0,1,0,0,2,Human Factor
1921-11-30 00:00:00,Marconi Wireless Telegraph Company,Takeoff (climb),Specialised Services,United Kingdom,Europe,1,1,0,0,0,0,1,Unknown
1921-12-05 00:00:00,Ingham %26 Little Aviation Company,Flight,Business,United Kingdom,Europe,1,1,0,0,0,0,1,Technical Failure
1921-12-05 00:00:00,United States Army Air Service - USAAS,Landing (descent or approach),Military / Government,United States of America,North America,0,0,0,0,0,0,0,Unknown
1921-12-08 00:00:00,Royal Air Force - RAF,Flight,Operational,Egypt,Africa,1,1,0,0,0,0,1,Technical Failure
1921-12-09 00:00:00,Royal Canadian Air Force - RCAF,Flight,Operational,Canada,North America,2,2,0,0,0,0,2,Unknown
1921-12-11 00:00:00,United States Army Air Service - USAAS,Landing (descent or approach),Military / Government,United States of America,North America,0,0,0,0,0,0,0,Unknown
1921-12-12 00:00:00,Royal Air Force - RAF,Landing (descent or approach),Operational,United Kingdom,Europe,2,2,0,0,0,0,2,Unknown
1921-12-12 00:00:00,Royal Air Force - RAF,Flight,Operational,United Kingdom,Europe,0,0,0,0,0,0,0,Unknown
1921-12-13 00:00:00,United States Army Air Service - USAAS,Takeoff (climb),Military / Government,Philippines,Asia,0,0,0,0,0,0,0,Unknown
1921-12-13 00:00:00,United States Army Air Service - USAAS,Flight,Military / Government,United States of America,North America,0,0,0,0,0,0,0,Unknown
1921-12-20 00:00:00,United States Army Air Service - USAAS,Takeoff (climb),Military / Government,United States of America,North America,0,0,0,0,0,0,0,Technical Failure
1921-12-20 00:00:00,United States Army Air Service - USAAS,Landing (descent or approach),Military / Government,United States of America,North America,0,0,0,0,0,0,0,Unknown
1921-12-21 00:00:00,United States Army Air Service - USAAS,,Military / Government,United States of America,North America,0,0,0,0,0,0,0,Unknown
1921-12-30 00:00:00,Handley Page Transport,Landing (descent or approach),Commercial,France,Europe,0,0,0,0,0,0,0,Unknown
1922-01-14 00:00:00,Handley Page Transport,Landing (descent or approach),Commercial,France,Europe,5,2,0,3,0,0,5,Human Factor
1922-01-22 00:00:00,United States Army Air Service - USAAS,Landing (descent or approach),Military / Government,United States of America,North America,0,0,0,0,0,0,0,Unknown
1922-02-08 00:00:00,United States Army Air Service - USAAS,Landing (descent or approach),Military / Government,United States of America,North America,0,0,0,0,0,0,0,Unknown
1922-02-10 00:00:00,United States Army Air Service - USAAS,Flight,Military / Government,United States of America,North America,0,0,0,0,0,0,0,Unknown
1922-02-14 00:00:00,United States Army Air Service - USAAS,Flight,Military / Government,United States of America,North America,0,0,0,0,0,0,0,Unknown
1922-02-20 00:00:00,United States Army Air Service - USAAS,Takeoff (climb),Military / Government,United States of America,North America,0,0,0,0,0,0,0,Technical Failure
1922-03-06 00:00:00,United States Army Air Service - USAAS,Flight,Military / Government,Germany,Europe,0,0,0,0,0,0,0,Technical Failure
1922-03-13 00:00:00,United States Army Air Service - USAAS,,Military / Government,United States of America,North America,0,0,0,0,0,0,0,Technical Failure
1922-03-15 00:00:00,Vickers-Armstrongs Ltd,Flight,Operational,United Kingdom,Europe,3,3,0,0,0,0,3,Unknown
1922-03-17 00:00:00,United States Army Air Service - USAAS,Flight,Military / Government,United States of America,North America,0,0,0,0,0,0,0,Unknown
1922-03-19 00:00:00,Vancouver Island Aerial Service,Flight,Commercial,Canada,North America,0,0,0,0,0,0,0,Unknown
1922-03-22 00:00:00,Instone Air Line,Landing (descent or approach),Commercial,United Kingdom,Europe,0,0,0,0,0,0,0,Unknown
1922-03-29 00:00:00,Ad Astra Aero,Flight,Commercial,Switzerland,Europe,1,1,0,0,0,0,1,Human Factor
1922-03-31 00:00:00,Brompton Motor Company,Flight,Business,United Kingdom,Europe,2,1,0,1,0,0,2,Unknown
1922-04-22 00:00:00,United States Army Air Service - USAAS,,Military / Government,United States of America,North America,0,0,0,0,0,0,0,Unknown
1922-04-29 00:00:00,United States Army Air Service - USAAS,Flight,Military / Government,United States of America,North America,0,0,0,0,0,0,0,Unknown
1922-05-05 00:00:00,Compagnie Générale d'Entreprises Aéronautiques - CGEA,Flight,Operational,Spain,Europe,2,2,0,0,0,0,2,Unknown
1922-05-07 00:00:00,United States Army Air Service - USAAS,Takeoff (climb),Military / Government,United States of America,North America,0,0,0,0,0,0,0,Unknown
1922-05-08 00:00:00,Compagnie Générale d'Entreprises Aéronautiques - CGEA,Flight,Operational,France,Europe,2,2,0,0,0,0,2,Unknown
1922-05-09 00:00:00,United States Army Air Service - USAAS,Takeoff (climb),Military / Government,United States of America,North America,0,0,0,0,0,0,0,Unknown
1922-05-17 00:00:00,KLM Royal Dutch Airlines - Koninklijke Luchtvaart Maatschappij,Flight,Commercial,United Kingdom,Europe,4,1,0,3,0,0,4,Human Factor
1922-05-26 00:00:00,United States Army Air Service - USAAS,Landing (descent or approach),Military / Government,United States of America,North America,0,0,0,0,0,0,0,Unknown
1922-05-26 00:00:00,United States Army Air Service - USAAS,Flight,Operational,United States of America,North America,1,1,0,0,0,0,1,Technical Failure
1922-05-28 00:00:00,Wilfred Theodore Blake,Landing (descent or approach),Business,France,Europe,3,2,0,1,0,0,3,Human Factor
1922-06-05 00:00:00,United States Army Air Service - USAAS,Flight,Operational,United States of America,North America,0,0,0,0,0,0,0,Unknown
1922-06-11 00:00:00,United States Army Air Service - USAAS,Flight,Military / Government,United States of America,North America,1,1,0,0,0,0,1,Technical Failure
1922-06-12 00:00:00,B. Martin,Takeoff (climb),Business,United Kingdom,Europe,3,1,0,2,0,0,3,Unknown
1922-06-28 00:00:00,United States Army Air Service - USAAS,Flight,Military / Government,United States of America,North America,0,0,0,0,0,0,0,Unknown
1922-07-06 00:00:00,United States Army Air Service - USAAS,Takeoff (climb),Military / Government,United States of America,North America,0,0,0,0,0,0,0,Unknown
1922-07-07 00:00:00,Royal Air Force - RAF,Landing (descent or approach),Operational,United Kingdom,Europe,1,1,0,0,0,0,1,Human Factor
1922-08-04 00:00:00,United States Army Air Service - USAAS,Flight,Military / Government,United States of America,North America,0,0,0,0,0,0,0,Technical Failure
1922-08-14 00:00:00,United States Army Air Service - USAAS,Flight,Military / Government,United States of America,North America,0,0,0,0,0,0,0,Technical Failure
1922-08-15 00:00:00,Instone Air Line,Flight,Commercial,United Kingdom,Europe,0,0,0,0,0,0,0,Technical Failure
1922-08-17 00:00:00,United States Army Air Service - USAAS,Flight,Military / Government,United States of America,North America,0,0,0,0,0,0,0,Technical Failure
1922-08-18 00:00:00,C. B. Wilson,Flight,Business,United Kingdom,Europe,1,1,0,0,0,0,1,Unknown
1922-08-20 00:00:00,Thomas Baden-Powell,Flight,Business,United Kingdom,Europe,3,1,0,2,0,0,3,Technical Failure
1922-08-20 00:00:00,Leatherhead Aviation Services,Flight,Operational,United Kingdom,Europe,3,1,0,2,0,0,3,Human Factor
1922-08-23 00:00:00,United States Army Air Service - USAAS,Landing (descent or approach),Military / Government,United States of America,North America,0,0,0,0,0,0,0,Unknown
1922-08-25 00:00:00,Wilfred Theodore Blake,Flight,Business,India,Asia,3,3,0,0,0,0,3,Unknown
1922-08-27 00:00:00,Provincial Flying Services,Landing (descent or approach),Commercial,United Kingdom,Europe,2,1,0,1,0,0,2,Human Factor
1922-08-30 00:00:00,Swedish Navy - Svenska Marinen,Flight,Military / Government,Sweden,Europe,1,1,0,0,0,0,1,Unknown
1922-09-02 00:00:00,United States Army Air Service - USAAS,Flight,Military / Government,Philippines,Asia,0,0,0,0,0,0,0,Unknown
1922-09-02 00:00:00,United States Army Air Service - USAAS,Landing (descent or approach),Military / Government,United States of America,North America,0,0,0,0,0,0,0,Unknown
1922-09-02 00:00:00,United States Army Air Service - USAAS,,Military / Government,United States of America,North America,0,0,0,0,0,0,0,Unknown
1922-09-12 00:00:00,Compagnie Générale d'Entreprises Aéronautiques - CGEA,Landing (descent or approach),Operational,Spain,Europe,0,0,0,0,0,0,0,Unknown
1922-09-12 00:00:00,Royal Navy,Takeoff (climb),Operational,United Kingdom,Europe,6,6,0,0,0,0,6,Technical Failure
1922-09-15 00:00:00,United States Army Air Service - USAAS,Landing (descent or approach),Military / Government,United States of America,North America,0,0,0,0,0,0,0,Unknown
1922-09-15 00:00:00,Swedish Navy - Svenska Marinen,Flight,Operational,Sweden,Europe,2,2,0,0,0,0,2,Unknown
1922-10-14 00:00:00,United States Army Air Service - USAAS,Flight,Military / Government,United States of America,North America,0,0,0,0,0,0,0,Unknown
1922-10-26 00:00:00,United States Army Air Service - USAAS,Flight,Military / Government,United States of America,North America,0,0,0,0,0,0,0,Unknown
1922-10-30 00:00:00,United States Army Air Service - USAAS,Flight,Military / Government,United States of America,North America,0,0,0,0,0,0,0,Unknown
1922-10-30 00:00:00,United States Army Air Service - USAAS,Flight,Military / Government,United States of America,North America,1,1,0,0,0,0,1,Technical Failure
1922-10-30 00:00:00,Royal Netherlands East Indies Air Force - ML-KNIL,Flight,Military / Government,Indonesia,Asia,2,2,0,0,0,0,2,Technical Failure
1922-11-03 00:00:00,Daimler Airway,Flight,Commercial,United Kingdom,Europe,10,2,0,8,0,0,10,Technical Failure
1922-11-07 00:00:00,United States Army Air Service - USAAS,Flight,Military / Government,United States of America,North America,0,0,0,0,0,0,0,Technical Failure
1922-11-12 00:00:00,United States Army Air Service - USAAS,,Military / Government,United States of America,North America,0,0,0,0,0,0,0,Unknown
1922-11-14 00:00:00,United States Army Air Service - USAAS,,Military / Government,United States of America,North America,0,0,0,0,0,0,0,Unknown
1922-11-17 00:00:00,KLM Royal Dutch Airlines - Koninklijke Luchtvaart Maatschappij,Takeoff (climb),Commercial,Netherlands,Europe,0,0,0,0,0,0,0,Unknown
1922-11-26 00:00:00,United States Army Air Service - USAAS,Flight,Military / Government,United States of America,North America,1,1,0,0,0,0,1,Technical Failure
1922-11-27 00:00:00,United States Army Air Service - USAAS,Takeoff (climb),Military / Government,United States of America,North America,0,0,0,0,0,0,0,Unknown
1922-12-04 00:00:00,United States Army Air Service - USAAS,Takeoff (climb),Military / Government,United States of America,North America,0,0,0,0,0,0,0,Unknown
1922-12-11 00:00:00,United States Army Air Service - USAAS,Takeoff (climb),Operational,United States of America,North America,1,1,0,0,0,0,1,Technical Failure
1922-12-15 00:00:00,U.S. Air Mail Service,Flight,Operational,United States of America,North America,1,1,0,0,0,0,1,Weather
1922-12-18 00:00:00,United States Army Air Service - USAAS,Landing (descent or approach),Military / Government,United States of America,North America,0,0,0,0,0,0,0,Unknown
1922-12-26 00:00:00,Compagnie Générale d'Entreprises Aéronautiques - CGEA,Flight,Operational,Spain,Europe,2,1,0,1,0,0,2,Technical Failure
1922-12-29 00:00:00,United States Army Air Service - USAAS,Flight,Operational,United States of America,North America,1,1,0,0,0,0,1,Technical Failure
1923-01-04 00:00:00,U.S. Air Mail Service,Flight,Operational,United States of America,North America,1,1,0,0,0,0,1,Technical Failure
1923-01-23 00:00:00,O. Ramsay,Takeoff (climb),Business,Australia,Oceania,3,1,0,2,0,0,3,Unknown
1923-02-25 00:00:00,Qantas Airways - Queensland and Northern Territory Aerial Services,Takeoff (climb),Commercial,Australia,Oceania,0,0,0,0,0,0,0,Unknown
1923-03-15 00:00:00,Rumpler Luftverkehr,Takeoff (climb),Commercial,Germany,Europe,1,1,0,0,0,0,1,Unknown
1923-04-12 00:00:00,Compagnie Générale d'Entreprises Aéronautiques - CGEA,Flight,Operational,Morocco,Africa,2,2,0,0,0,0,2,Technical Failure
1923-04-23 00:00:00,Brazilian Air Force - Aviação Militar,Landing (descent or approach),Operational,Brazil,South America,2,2,0,0,0,0,2,Unknown
1923-05-04 00:00:00,Compagnie Franco-Roumaine de Navigation Aérienne,Flight,Commercial,France,Europe,7,2,0,5,0,0,7,Unknown
1923-05-11 00:00:00,Roald Amundsen,Takeoff (climb),Specialised Services,United States of America,North America,1,1,0,0,0,0,1,Technical Failure
1923-06-02 00:00:00,Laurentide Air Service,Takeoff (climb),Business,Canada,North America,0,0,0,0,0,0,0,Technical Failure
1923-06-05 00:00:00,Manchester Aviation,Flight,Commercial,United Kingdom,Europe,3,1,0,2,0,0,3,Unknown
1923-06-15 00:00:00,CSA Czech Airlines - Československé Státní Aerolinie,Takeoff (climb),Operational,Czech Republic,Europe,8,2,0,6,0,0,8,Unknown
1923-07-15 00:00:00,Compagnie Aérienne Française,Flight,Operational,France,Europe,12,2,0,10,0,0,12,Technical Failure
1923-07-17 00:00:00,KLM Royal Dutch Airlines - Koninklijke Luchtvaart Maatschappij,Landing (descent or approach),Commercial,United Kingdom,Europe,4,1,0,3,0,0,4,Technical Failure
1923-07-17 00:00:00,Laurentide Air Service,Flight,Commercial,Canada,North America,0,0,0,0,0,0,0,Technical Failure
1923-08-03 00:00:00,Armstrong-Whitworth Aircraft,Takeoff (climb),Specialised Services,United Kingdom,Europe,2,2,0,0,0,0,2,Unknown
1923-08-11 00:00:00,Surrey Flying Services,Landing (descent or approach),Commercial,United Kingdom,Europe,3,1,0,2,0,0,3,Unknown
1923-08-11 00:00:00,Renfrewshire Flying Services,Takeoff (climb),Commercial,United Kingdom,Europe,3,1,0,2,0,0,3,Unknown
1923-08-22 00:00:00,Lithuania Aeroclub,Takeoff (climb),Operational,Lithuania,Europe,1,1,0,0,0,0,1,Unknown
1923-08-26 00:00:00,Compagnie Franco-Roumaine de Navigation Aérienne,Takeoff (climb),Commercial,Czech Republic,Europe,0,0,0,0,0,0,0,Unknown
1923-08-26 00:00:00,De Havilland Aircraft UK,Flight,Operational,United Kingdom,Europe,1,1,0,0,0,0,1,Human Factor
1923-08-30 00:00:00,Daimler Airway,Takeoff (climb),Commercial,United Kingdom,Europe,0,0,0,0,0,0,0,Unknown
1923-08-30 00:00:00,U.S. Air Mail Service,Flight,Specialised Services,United States of America,North America,1,1,0,0,0,0,1,Technical Failure
1923-09-10 00:00:00,Midland Aviation,Flight,Business,United Kingdom,Europe,1,1,0,0,0,0,1,Unknown
1923-09-13 00:00:00,Qantas Airways - Queensland and Northern Territory Aerial Services,Flight,Commercial,Australia,Oceania,1,1,0,0,0,0,1,Technical Failure
1923-09-15 00:00:00,French Navy,Flight,Commercial,World,World,0,0,0,0,0,0,0,Technical Failure
1923-09-28 00:00:00,Swedish Air Force - Flygvapnet,Flight,Operational,Sweden,Europe,2,2,0,0,0,0,2,Unknown
1923-09-30 00:00:00,British Marine Air Navigation Company - BMANC,Flight,Commercial,United Kingdom,Europe,4,2,0,2,0,0,4,Unknown
1923-10-05 00:00:00,Royal Netherlands East Indies Air Force - ML-KNIL,Takeoff (climb),Military / Government,Indonesia,Asia,1,1,0,0,0,0,1,Unknown
1923-10-14 00:00:00,E. F. Edwards,Takeoff (climb),Business,United Kingdom,Europe,1,1,0,0,0,0,1,Unknown
1923-10-19 00:00:00,KLM Royal Dutch Airlines - Koninklijke Luchtvaart Maatschappij,Flight,Commercial,United Kingdom,Europe,4,1,0,3,0,0,4,Technical Failure
1923-11-22 00:00:00,Handley Page Transport,Flight,Commercial,France,Europe,9,2,0,7,0,0,9,Technical Failure
1923-12-03 00:00:00,Air Union France,Flight,Commercial,United Kingdom,Europe,0,0,0,0,0,0,0,Technical Failure
1923-12-31 00:00:00,SCADTA - Sociedad Colombo-Alemana de Transportes Aéreos,,Other,Colombia,South America,0,0,0,0,0,0,0,Unknown
1923-12-31 00:00:00,New York-Newport Air Service,,Commercial,United States of America,North America,0,0,0,0,0,0,0,Unknown
1923-12-31 00:00:00,Danziger Luftreederei,Landing (descent or approach),Operational,Poland,Europe,1,1,0,0,0,0,1,Unknown
1924-01-10 00:00:00,Compagnie Générale d'Entreprises Aéronautiques - CGEA,Flight,Operational,Spain,Europe,1,1,0,0,0,0,1,Technical Failure
1924-01-22 00:00:00,Air Union France,Landing (descent or approach),Commercial,United Kingdom,Europe,0,0,0,0,0,0,0,Human Factor
1924-02-17 00:00:00,Canterbury Aviation,Flight,Business,New Zealand,Oceania,0,0,0,0,0,0,0,Unknown
1924-04-24 00:00:00,French Air Force - Armée de l'Air,Landing (descent or approach),Operational,France,Europe,4,4,0,0,0,0,4,Technical Failure
1924-05-03 00:00:00,Northern Aviation,Flight,Commercial,United Kingdom,Europe,2,1,0,1,0,0,2,Unknown
1924-05-07 00:00:00,Brito Pais,Flight,Business,India,Asia,2,2,0,0,0,0,2,Technical Failure
1924-05-09 00:00:00,Westland Aircraft,Takeoff (climb),Specialised Services,United Kingdom,Europe,1,1,0,0,0,0,1,Unknown
1924-05-27 00:00:00,Imperial Airways,Takeoff (climb),Commercial,Belgium,Europe,0,0,0,0,0,0,0,Unknown
1924-06-10 00:00:00,CSA Czech Airlines - Československé Státní Aerolinie,Takeoff (climb),Operational,Czech Republic,Europe,1,1,0,0,0,0,1,Technical Failure
1924-06-12 00:00:00,William M. Beardmore %26 Company,Takeoff (climb),Business,United Kingdom,Europe,2,1,0,1,0,0,2,Unknown
1924-06-20 00:00:00,Ateliers de Constructions Aéronautiques de Zeebrugge,Landing (descent or approach),Operational,Belgium,Europe,2,2,0,0,0,0,2,Human Factor
1924-07-07 00:00:00,Royal Air Force - RAF,Landing (descent or approach),Operational,United Kingdom,Europe,4,4,0,0,0,0,4,Technical Failure
1924-07-07 00:00:00,U.S. Air Mail Service,Flight,Operational,United States of America,North America,1,1,0,0,0,0,1,Weather
1924-07-14 00:00:00,Compagnie Franco-Roumaine de Navigation Aérienne,Landing (descent or approach),Commercial,Poland,Europe,4,1,0,3,0,0,4,Unknown
1924-07-15 00:00:00,Royal Netherlands East Indies Air Force - ML-KNIL,Takeoff (climb),Operational,Indonesia,Asia,2,2,0,0,0,0,2,Unknown
1924-07-25 00:00:00,F. J. V. Holmes,Takeoff (climb),Business,United Kingdom,Europe,2,1,0,1,0,0,2,Unknown
1924-07-30 00:00:00,Swedish Air Force - Flygvapnet,Landing (descent or approach),Operational,Sweden,Europe,2,2,0,0,0,0,2,Unknown
1924-07-31 00:00:00,Compagnie Internationale de Navigation Aérienne - CIDNA,Takeoff (climb),Commercial,France,Europe,1,1,0,0,0,0,1,Technical Failure
1924-07-31 00:00:00,Laurentide Air Service,Flight,Business,Canada,North America,0,0,0,0,0,0,0,Unknown
1924-08-02 00:00:00,Northern Aviation,Takeoff (climb),Commercial,United Kingdom,Europe,3,1,0,2,0,0,3,Unknown
1924-08-02 00:00:00,U.S. Air Mail Service,Flight,Operational,United States of America,North America,1,1,0,0,0,0,1,Technical Failure
1924-08-13 00:00:00,Compagnie Générale d'Entreprises Aéronautiques - CGEA,Landing (descent or approach),Operational,Spain,Europe,2,2,0,0,0,0,2,Technical Failure
1924-08-16 00:00:00,Department of Lands %26 Forestry,Landing (descent or approach),Military / Government,Canada,North America,0,0,0,0,0,0,0,Other
1924-08-20 00:00:00,Portuguese Air Force - Aeronáutica Militar,Flight,Operational,Portugal,Europe,1,1,0,0,0,0,1,Unknown
1924-08-21 00:00:00,Regia Aeronautica,Flight,Business,World,World,5,5,0,0,0,0,5,Technical Failure
1924-08-23 00:00:00,Farman Line,Takeoff (climb),Commercial,Netherlands,Europe,10,2,0,8,0,0,10,Technical Failure
1924-08-26 00:00:00,Royal Air Force - RAF,Flight,Operational,Egypt,Africa,1,1,0,0,0,0,1,Unknown
1924-08-29 00:00:00,Air Union France,Flight,Operational,United Kingdom,Europe,1,1,0,0,0,0,1,Technical Failure
1924-09-19 00:00:00,Royal Australian Air Force - RAAF,Landing (descent or approach),Operational,Australia,Oceania,1,1,0,0,0,0,1,Unknown
1924-09-23 00:00:00,Imperial Airways,Takeoff (climb),Commercial,United Kingdom,Europe,7,2,0,5,0,0,7,Unknown
1924-10-15 00:00:00,Deruluft - Deutsch-Russische Luftverkehrs Gesellschaft,Flight,Commercial,Russia,Asia,0,0,0,0,0,0,0,Unknown
1924-10-30 00:00:00,William M. Beardmore %26 Company,Takeoff (climb),Business,United Kingdom,Europe,2,1,0,1,0,0,2,Unknown
1924-11-28 00:00:00,Royal Australian Air Force - RAAF,Landing (descent or approach),Operational,Australia,Oceania,2,2,0,0,0,0,2,Unknown
1924-12-18 00:00:00,Compagnie Générale d'Entreprises Aéronautiques - CGEA,Flight,Operational,Spain,Europe,2,2,0,0,0,0,2,Technical Failure
1925-01-24 00:00:00,Laurentide Air Service,Flight,Commercial,Canada,North America,0,0,0,0,0,0,0,Weather
1925-02-05 00:00:00,Compagnie Générale d'Entreprises Aéronautiques - CGEA,Takeoff (climb),Operational,Brazil,South America,3,3,0,0,0,0,3,Unknown
1925-02-09 00:00:00,Compagnie Générale d'Entreprises Aéronautiques - CGEA,Flight,Operational,World,World,2,2,0,0,0,0,2,Technical Failure
1925-02-26 00:00:00,Compagnie Générale d'Entreprises Aéronautiques - CGEA,Flight,Operational,Morocco,Africa,0,0,0,0,0,0,0,Unknown
1925-03-07 00:00:00,Compagnie Générale d'Entreprises Aéronautiques - CGEA,Flight,Operational,Brazil,South America,1,1,0,0,0,0,1,Unknown
1925-03-14 00:00:00,Compagnie Générale d'Entreprises Aéronautiques - CGEA,Flight,Operational,World,World,2,2,0,0,0,0,2,Technical Failure
1925-03-19 00:00:00,Royal Netherlands East Indies Air Force - ML-KNIL,Landing (descent or approach),Military / Government,Indonesia,Asia,2,2,0,0,0,0,2,Unknown
1925-04-11 00:00:00,Compagnie Générale d'Entreprises Aéronautiques - CGEA,Flight,Operational,World,World,2,2,0,0,0,0,2,Technical Failure
1925-04-14 00:00:00,Compagnie Générale d'Entreprises Aéronautiques - CGEA,Flight,Operational,World,World,2,2,0,0,0,0,2,Technical Failure
1925-05-18 00:00:00,Aviakhim,,Commercial,Russia,Asia,0,0,0,0,0,0,0,Unknown
1925-05-25 00:00:00,Aviakhim,Flight,Commercial,Russia,Asia,0,0,0,0,0,0,0,Unknown
1925-06-09 00:00:00,George Hay,Landing (descent or approach),Business,France,Europe,1,1,0,0,0,0,1,Unknown
1925-06-12 00:00:00,Department of Lands %26 Forestry,Landing (descent or approach),Military / Government,Canada,North America,1,1,0,0,0,0,1,Weather
1925-06-17 00:00:00,Swedish Navy - Svenska Marinen,Landing (descent or approach),Military / Government,Sweden,Europe,2,2,0,0,0,0,2,Weather
1925-06-21 00:00:00,Compagnie Internationale de Navigation Aérienne - CIDNA,Flight,Commercial,Germany,Europe,0,0,0,0,0,0,0,Unknown
1925-06-26 00:00:00,Compagnie Internationale de Navigation Aérienne - CIDNA,Takeoff (climb),Commercial,Switzerland,Europe,0,0,0,0,0,0,0,Unknown
1925-07-03 00:00:00,Imperial Airways,Flight,Commercial,United Kingdom,Europe,7,2,0,5,0,0,7,Weather
1925-07-23 00:00:00,Compagnie Générale d'Entreprises Aéronautiques - CGEA,Flight,Operational,Spain,Europe,2,2,0,0,0,0,2,Technical Failure
1925-07-24 00:00:00,Deutscher Aero Lloyd,Flight,Commercial,Germany,Europe,4,1,0,3,0,0,4,Weather
1925-08-01 00:00:00,Farman Line,Flight,Commercial,Belgium,Europe,10,2,0,8,0,0,10,Unknown
1925-08-04 00:00:00,Compagnie Générale d'Entreprises Aéronautiques - CGEA,Flight,Operational,Morocco,Africa,1,1,0,0,0,0,1,Weather
1925-08-20 00:00:00,Dobrolet,Landing (descent or approach),Commercial,Russia,Asia,0,0,0,0,0,0,0,Unknown
1925-08-24 00:00:00,Compagnie Internationale de Navigation Aérienne - CIDNA,,Commercial,France,Europe,0,0,0,0,0,0,0,Unknown
1925-08-27 00:00:00,Schlesische Luftverkehrs,,Commercial,Germany,Europe,0,0,0,0,0,0,0,Unknown
1925-09-08 00:00:00,Compagnie Générale d'Entreprises Aéronautiques - CGEA,Flight,Operational,Spain,Europe,2,1,0,1,0,0,2,Unknown
1925-09-09 00:00:00,Südwestdeutsche Luftverkehrs,Landing (descent or approach),Commercial,Germany,Europe,5,2,0,3,0,0,5,Human Factor
1925-09-09 00:00:00,SABENA - Société Anonyme Belge d'Exploitation de la Navigation Aérienne,Flight,Commercial,Switzerland,Europe,0,0,0,0,0,0,0,Unknown
1925-09-10 00:00:00,Compagnie Générale d'Entreprises Aéronautiques - CGEA,Flight,Operational,World,World,0,0,0,0,0,0,0,Unknown
1925-09-25 00:00:00,Aviakhim,,Commercial,Russia,Asia,0,0,0,0,0,0,0,Unknown
1925-09-26 00:00:00,Paul Tarascon,Flight,Operational,France,Europe,2,2,0,0,0,0,2,Human Factor
1925-09-29 00:00:00,Air Union France,,Commercial,France,Europe,0,0,0,0,0,0,0,Unknown
1925-10-07 00:00:00,Royal Australian Air Force - RAAF,Landing (descent or approach),Operational,Australia,Oceania,2,2,0,0,0,0,2,Unknown
1925-10-22 00:00:00,Royal Canadian Air Force - RCAF,Flight,Operational,Canada,North America,2,2,0,0,0,0,2,Unknown
1925-11-04 00:00:00,KLM Royal Dutch Airlines - Koninklijke Luchtvaart Maatschappij,Takeoff (climb),Commercial,Germany,Europe,3,1,0,2,0,0,3,Weather
1925-11-19 00:00:00,Savoia Marchetti,Flight,Business,Morocco,Africa,0,0,0,0,0,0,0,Unknown
1925-12-11 00:00:00,Lignes Aériennes Latécoère,Landing (descent or approach),Operational,Spain,Europe,1,1,0,0,0,0,1,Human Factor
1925-12-19 00:00:00,Compagnie Générale d'Entreprises Aéronautiques - CGEA,Flight,Operational,World,World,2,2,0,0,0,0,2,Technical Failure
1925-12-23 00:00:00,Compagnie Internationale de Navigation Aérienne - CIDNA,Flight,Business,Italy,Europe,2,2,0,0,0,0,2,Technical Failure
1925-12-25 00:00:00,Lignes Aériennes Latécoère,Flight,Operational,Spain,Europe,2,2,0,0,0,0,2,Technical Failure
1926-01-08 00:00:00,Compagnie Générale d'Entreprises Aéronautiques - CGEA,Flight,Operational,France,Europe,2,2,0,0,0,0,2,Technical Failure
1926-01-08 00:00:00,London Aeroplane Club,Landing (descent or approach),Operational,United Kingdom,Europe,2,2,0,0,0,0,2,Human Factor
1926-01-09 00:00:00,Royal Australian Air Force - RAAF,Flight,Operational,Australia,Oceania,1,1,0,0,0,0,1,Technical Failure
1926-01-12 00:00:00,Royal Australian Air Force - RAAF,Flight,Operational,Australia,Oceania,1,1,0,0,0,0,1,Unknown
1926-01-13 00:00:00,Royal Australian Air Force - RAAF,Flight,Operational,Australia,Oceania,1,1,0,0,0,0,1,Unknown
1926-01-15 00:00:00,Royal Netherlands East Indies Air Force - ML-KNIL,Flight,Operational,Indonesia,Asia,1,1,0,0,0,0,1,Unknown
1926-01-15 00:00:00,SCADTA - Sociedad Colombo-Alemana de Transportes Aéreos,Flight,Commercial,Colombia,South America,0,0,0,0,0,0,0,Unknown
1926-01-20 00:00:00,Farman Line,Flight,Operational,France,Europe,1,1,0,0,0,0,1,Unknown
1926-01-28 00:00:00,Royal Australian Air Force - RAAF,Flight,Operational,Australia,Oceania,1,1,0,0,0,0,1,Unknown
1926-02-05 00:00:00,Compagnie Générale d'Entreprises Aéronautiques - CGEA,Landing (descent or approach),Operational,France,Europe,1,1,0,0,0,0,1,Human Factor
1926-02-10 00:00:00,Royal Australian Air Force - RAAF,Flight,Operational,Australia,Oceania,1,1,0,0,0,0,1,Unknown
1926-03-02 00:00:00,Lloyds Commercial Aircraft Company,Flight,Specialised Services,United Kingdom,Europe,3,2,0,1,0,0,3,Unknown
1926-03-02 00:00:00,Royal Australian Air Force - RAAF,Flight,Operational,Australia,Oceania,1,1,0,0,0,0,1,Unknown
1926-03-13 00:00:00,Lignes Aériennes Latécoère,,Operational,France,Europe,0,0,0,0,0,0,0,Unknown
1926-03-25 00:00:00,SABENA - Société Anonyme Belge d'Exploitation de la Navigation Aérienne,Flight,Commercial,Belgium,Europe,0,0,0,0,0,0,0,Unknown
1926-04-13 00:00:00,KLM Royal Dutch Airlines - Koninklijke Luchtvaart Maatschappij,Takeoff (climb),Commercial,Netherlands,Europe,3,1,0,2,0,0,3,Other
1926-04-14 00:00:00,Norsk Lufttrafik,Takeoff (climb),Commercial,Norway,Europe,3,2,0,1,0,0,3,Unknown
1926-04-15 00:00:00,Compagnie Française d'Aviation,Landing (descent or approach),Operational,France,Europe,1,1,0,0,0,0,1,Unknown
1926-04-19 00:00:00,United States Army Air Service - USAAS,Takeoff (climb),Military / Government,United States of America,North America,0,0,0,0,0,0,0,Unknown
1926-05-01 00:00:00,Balair - Switzerland,Landing (descent or approach),Commercial,Switzerland,Europe,5,1,0,4,0,0,5,Technical Failure
1926-05-21 00:00:00,Norsk Luftseiladsforening,Landing (descent or approach),Specialised Services,World,World,3,3,0,0,0,0,3,Technical Failure
1926-05-26 00:00:00,Georges Pelletier-Doisy,Takeoff (climb),Business,Poland,Europe,2,2,0,0,0,0,2,Other
1926-06-05 00:00:00,Dobrolet,,Commercial,Russia,Asia,0,0,0,0,0,0,0,Unknown
1926-06-21 00:00:00,KLM Royal Dutch Airlines - Koninklijke Luchtvaart Maatschappij,Flight,Commercial,United Kingdom,Europe,5,1,0,4,0,0,5,Human Factor
1926-06-22 00:00:00,Royal Netherlands East Indies Air Force - ML-KNIL,Flight,Military / Government,Indonesia,Asia,2,2,0,0,0,0,2,Weather
1926-07-01 00:00:00,CSA Czech Airlines - Československé Státní Aerolinie,Flight,Commercial,Czech Republic,Europe,4,1,0,3,0,0,4,Technical Failure
1926-07-06 00:00:00,Orebro Flygaktiebolaget,,Commercial,Sweden,Europe,0,0,0,0,0,0,0,Unknown
1926-07-07 00:00:00,Compagnie Générale d'Entreprises Aéronautiques - CGEA,Flight,Operational,Brazil,South America,0,0,0,0,0,0,0,Unknown
1926-07-12 00:00:00,Norsk Lufttrafik,Flight,Operational,Norway,Europe,1,1,0,0,0,0,1,Technical Failure
1926-07-15 00:00:00,Aviakhim,Flight,Commercial,Germany,Europe,3,1,0,2,0,0,3,Technical Failure
1926-07-16 00:00:00,Ontario Paper Company,Landing (descent or approach),Business,Canada,North America,0,0,0,0,0,0,0,Unknown
1926-07-18 00:00:00,Compagnie Générale d'Entreprises Aéronautiques - CGEA,Flight,Operational,Algeria,Africa,2,2,0,0,0,0,2,Technical Failure
1926-07-21 00:00:00,Provincial Air Service of Lands %26 Forests,Takeoff (climb),Commercial,Canada,North America,5,1,0,4,0,0,5,Human Factor
1926-08-02 00:00:00,Department of Lands %26 Forestry,Takeoff (climb),Military / Government,Canada,North America,0,0,0,0,0,0,0,Other
1926-08-07 00:00:00,Lloyd-Luftverkehr Sablatnig,Takeoff (climb),Commercial,Germany,Europe,0,0,0,0,0,0,0,Unknown
1926-09-03 00:00:00,SCADTA - Sociedad Colombo-Alemana de Transportes Aéreos,Landing (descent or approach),Commercial,Colombia,South America,4,2,0,2,0,0,4,Unknown
1926-09-16 00:00:00,Robertson Aircraft Corporation,Flight,Operational,United States of America,North America,1,1,0,0,0,0,1,Technical Failure
1926-09-17 00:00:00,Surrey Flying Services,Takeoff (climb),Commercial,United Kingdom,Europe,3,1,0,2,0,0,3,Unknown
1926-09-23 00:00:00,Uruguayan Air Force - Fuerza Aérea Uruguaya,Takeoff (climb),Military / Government,Uruguay,South America,2,2,0,0,0,0,2,Unknown
1926-09-24 00:00:00,Compagnie France-Algérie,Flight,Specialised Services,France,Europe,3,3,0,0,0,0,3,Unknown
1926-10-03 00:00:00,U.S. Air Mail Service,Flight,Operational,United States of America,North America,1,1,0,0,0,0,1,Human Factor
1926-10-08 00:00:00,Department of Lands %26 Forestry,Landing (descent or approach),Military / Government,Canada,North America,0,0,0,0,0,0,0,Human Factor
1926-10-17 00:00:00,Lloyd-Luftverkehr Sablatnig,Flight,Commercial,Germany,Europe,0,0,0,0,0,0,0,Unknown
1926-10-17 00:00:00,Compagnie Générale d'Entreprises Aéronautiques - CGEA,Flight,Commercial,Morocco,Africa,3,1,0,2,0,0,3,Technical Failure
1926-10-21 00:00:00,Imperial Airways,Flight,Commercial,World,World,12,2,0,10,0,0,12,Technical Failure
1926-11-03 00:00:00,Robertson Aircraft Corporation,Flight,Operational,United States of America,North America,1,1,0,0,0,0,1,Weather
1926-11-26 00:00:00,Deutsche Lufthansa,Takeoff (climb),Commercial,Russia,Asia,0,0,0,0,0,0,0,Technical Failure
1926-12-05 00:00:00,Turkish Government,Landing (descent or approach),Military / Government,Turkey,Asia,0,0,0,0,0,0,0,Unknown
1926-12-06 00:00:00,Compagnie Générale d'Entreprises Aéronautiques - CGEA,Flight,Commercial,Spain,Europe,4,2,0,2,0,0,4,Technical Failure
1926-12-12 00:00:00,Christopher P. B. Ogilvie,Flight,Business,United Kingdom,Europe,3,1,0,2,0,0,3,Unknown
1926-12-15 00:00:00,Deruluft - Deutsch-Russische Luftverkehrs Gesellschaft,,Commercial,Russia,Asia,0,0,0,0,0,0,0,Unknown
1926-12-23 00:00:00,U.S. Air Mail Service,Flight,Operational,United States of America,North America,1,1,0,0,0,0,1,Weather
1927-01-06 00:00:00,Royal Australian Air Force - RAAF,Flight,Operational,Australia,Oceania,1,1,0,0,0,0,1,Unknown
1927-01-12 00:00:00,Fokker Aircraft,Flight,Operational,France,Europe,2,2,0,0,0,0,2,Weather
1927-01-28 00:00:00,Royal Netherlands East Indies Air Force - ML-KNIL,Flight,Operational,Indonesia,Asia,2,2,0,0,0,0,2,Unknown
1927-02-24 00:00:00,Newcastle upon Tyne Light Aeroplane Club,Takeoff (climb),Operational,United Kingdom,Europe,2,2,0,0,0,0,2,Technical Failure
1927-03-10 00:00:00,Air Union France,Flight,Operational,United Kingdom,Europe,2,2,0,0,0,0,2,Technical Failure
1927-03-12 00:00:00,North Sea Aerial %26 General Transport,Landing (descent or approach),Business,Kenya,Africa,3,1,0,2,0,0,3,Technical Failure
1927-03-15 00:00:00,Compania Aeromaritima de Colombia,Flight,Operational,Venezuela,South America,3,3,0,0,0,0,3,Technical Failure
1927-03-21 00:00:00,Royal Air Force - RAF,Flight,Military / Government,United Kingdom,Europe,4,4,0,0,0,0,4,Technical Failure
1927-03-24 00:00:00,SCADTA - Sociedad Colombo-Alemana de Transportes Aéreos,Flight,Commercial,Colombia,South America,5,2,0,3,0,0,5,Technical Failure
1927-04-02 00:00:00,Bernard M. T. Shute Leete,Landing (descent or approach),Operational,Pakistan,Asia,2,1,0,1,0,0,2,Human Factor
1927-04-06 00:00:00,Portuguese Government,Landing (descent or approach),Military / Government,Brazil,South America,3,3,0,0,0,0,3,Other
1927-04-11 00:00:00,Swedish Air Force - Flygvapnet,Flight,Operational,Sweden,Europe,1,1,0,0,0,0,1,Unknown
1927-04-20 00:00:00,Det Danske Luftfartselskab - DDL,Flight,Commercial,Denmark,Europe,1,1,0,0,0,0,1,Technical Failure
1927-04-21 00:00:00,Lloyd-Luftverkehr Sablatnig,Flight,Commercial,Germany,Europe,0,0,0,0,0,0,0,Unknown
1927-05-15 00:00:00,Royal Australian Air Force - RAAF,Flight,Operational,Australia,Oceania,2,2,0,0,0,0,2,Unknown
1927-05-18 00:00:00,French Air Force - Armée de l'Air,Flight,Military / Government,France,Europe,5,5,0,0,0,0,5,Technical Failure
1927-05-28 00:00:00,Aero Oy,Landing (descent or approach),Commercial,Estonia,Europe,5,1,0,4,0,0,5,Unknown
1927-05-31 00:00:00,Lloyd-Luftverkehr Sablatnig,Flight,Commercial,Germany,Europe,0,0,0,0,0,0,0,Unknown
1927-06-12 00:00:00,Lancashire Aero Club,Flight,Operational,United Kingdom,Europe,2,2,0,0,0,0,2,Technical Failure
1927-06-18 00:00:00,Colonial Air Transport,Landing (descent or approach),Operational,United States of America,North America,1,1,0,0,0,0,1,Unknown
1927-06-30 00:00:00,Deruluft - Deutsch-Russische Luftverkehrs Gesellschaft,,Commercial,Russia,Asia,0,0,0,0,0,0,0,Unknown
1927-07-01 00:00:00,America Transoceanic Company,Flight,Operational,France,Europe,4,4,0,0,0,0,4,Technical Failure
1927-07-09 00:00:00,Compagnie Internationale de Navigation Aérienne - CIDNA,Flight,Commercial,Germany,Europe,0,0,0,0,0,0,0,Unknown
1927-07-10 00:00:00,Provincial Air Service of Lands %26 Forests,Flight,Military / Government,Canada,North America,2,2,0,0,0,0,2,Technical Failure
1927-07-12 00:00:00,KLM Royal Dutch Airlines - Koninklijke Luchtvaart Maatschappij,Flight,Commercial,France,Europe,8,1,0,7,0,0,8,Technical Failure
1927-07-14 00:00:00,Ernest L. Smith,Landing (descent or approach),Business,United States of America,North America,2,2,0,0,0,0,2,Technical Failure
1927-07-18 00:00:00,Thomas Neville Stack,Flight,Operational,India,Asia,1,1,0,0,0,0,1,Human Factor
1927-07-28 00:00:00,Ukrvozduchput,,Commercial,Ukraine,Europe,0,0,0,0,0,0,0,Unknown
1927-07-30 00:00:00,Deutsche Lufthansa,Takeoff (climb),Commercial,Germany,Europe,4,1,0,3,0,0,4,Technical Failure
1927-07-31 00:00:00,Provincial Air Service of Lands %26 Forests,Landing (descent or approach),Military / Government,Canada,North America,0,0,0,0,0,0,0,Unknown
1927-08-03 00:00:00,Deutsche Lufthansa,Flight,Commercial,Germany,Europe,0,0,0,0,0,0,0,Unknown
1927-08-04 00:00:00,Dennis M. M. Rooke,Takeoff (climb),Business,India,Asia,1,1,0,0,0,0,1,Unknown
1927-08-06 00:00:00,Ian H. McClure,Takeoff (climb),Operational,Hungary,Europe,2,2,0,0,0,0,2,Technical Failure
1927-08-06 00:00:00,Australian Aero Club,Landing (descent or approach),Operational,Australia,Oceania,2,2,0,0,0,0,2,Unknown
1927-08-12 00:00:00,Royal Australian Air Force - RAAF,Flight,Operational,Australia,Oceania,1,1,0,0,0,0,1,Unknown
1927-08-13 00:00:00,W. P. A. Straith,Takeoff (climb),Business,Canada,North America,2,1,0,1,0,0,2,Unknown
1927-08-14 00:00:00,Department of Lands %26 Forestry,Flight,Military / Government,Canada,North America,1,1,0,0,0,0,1,Technical Failure
1927-08-19 00:00:00,Royal Air Force - RAF,Flight,Operational,United Kingdom,Europe,4,4,0,0,0,0,4,Technical Failure
1927-08-20 00:00:00,West Indian Aerial Express,Takeoff (climb),Commercial,Dominican Republic,Central America,0,0,0,0,0,0,0,Unknown
1927-08-21 00:00:00,London Aero %26 Motor Services - LAMS,Landing (descent or approach),Business,United Kingdom,Europe,2,1,0,1,0,0,2,Unknown
1927-09-02 00:00:00,Norsk Lufttrafik,Takeoff (climb),Commercial,Norway,Europe,0,0,0,0,0,0,0,Other
1927-09-04 00:00:00,Maurice G. W. Burton,Landing (descent or approach),Business,Denmark,Europe,2,2,0,0,0,0,2,Unknown
1927-09-06 00:00:00,Lancashire Aero Club,Flight,Business,United Kingdom,Europe,1,1,0,0,0,0,1,Human Factor
1927-09-11 00:00:00,Tiroler Flugverkehrgesellschaft,Landing (descent or approach),Commercial,Austria,Europe,2,1,0,1,0,0,2,Technical Failure
1927-09-12 00:00:00,Patricia Airways,Takeoff (climb),Commercial,Canada,North America,2,1,0,1,0,0,2,Unknown
1927-09-19 00:00:00,Det Danske Luftfartselskab - DDL,Takeoff (climb),Commercial,Denmark,Europe,3,1,0,2,0,0,3,Unknown
1927-09-23 00:00:00,Deutsche Lufthansa,Flight,Commercial,Germany,Europe,0,0,0,0,0,0,0,Unknown
1927-10-03 00:00:00,Deutsche Lufthansa,Flight,Commercial,Germany,Europe,4,2,0,2,0,0,4,Weather
1927-10-05 00:00:00,L'Aéropostale,Flight,Operational,Spain,Europe,3,3,0,0,0,0,3,Technical Failure
1927-10-08 00:00:00,Air Taxis,Flight,Commercial,United Kingdom,Europe,3,1,0,2,0,0,3,Weather
1927-10-11 00:00:00,L'Aéropostale,Landing (descent or approach),Operational,Senegal,Africa,2,2,0,0,0,0,2,Unknown
1927-10-11 00:00:00,Canadian Airways,Flight,Commercial,Canada,North America,0,0,0,0,0,0,0,Unknown
1927-10-12 00:00:00,Ruth Elder,Flight,Business,World,World,2,1,0,1,0,0,2,Technical Failure
1927-10-17 00:00:00,North Sea Aerial %26 General Transport,Takeoff (climb),Operational,Kenya,Africa,1,1,0,0,0,0,1,Other
1927-10-26 00:00:00,Pacific Air Transport,Flight,Operational,United States of America,North America,1,1,0,0,0,0,1,Weather
1927-11-05 00:00:00,Gillies Air Service,Flight,Commercial,Canada,North America,0,0,0,0,0,0,0,Unknown
1927-11-09 00:00:00,United States Army Air Corps - USAAC,Flight,Military / Government,United States of America,North America,3,3,0,0,0,0,3,Unknown
1927-11-11 00:00:00,Georges Medaets,Flight,Business,France,Europe,2,2,0,0,0,0,2,Weather
1927-11-13 00:00:00,Heinkel Flugzeuge,Takeoff (climb),Business,Portugal,Europe,3,3,0,0,0,0,3,Weather
1927-11-27 00:00:00,Deutsche Lufthansa,Flight,Commercial,Germany,Europe,0,0,0,0,0,0,0,Unknown
1927-12-06 00:00:00,L'Aéropostale,Landing (descent or approach),Commercial,Algeria,Africa,4,2,0,2,0,0,4,Technical Failure
1927-12-08 00:00:00,L'Aéropostale,Flight,Operational,Western Sahara,Africa,1,1,0,0,0,0,1,Technical Failure
1927-12-10 00:00:00,Western Air Express,Flight,Operational,United States of America,North America,1,1,0,0,0,0,1,Unknown
1927-12-12 00:00:00,Air Union France,Flight,Operational,Italy,Europe,2,2,0,0,0,0,2,Technical Failure
1927-12-24 00:00:00,Western Canada Airways,Flight,Commercial,Canada,North America,0,0,0,0,0,0,0,Technical Failure
1927-12-25 00:00:00,Pacific Air Transport,Flight,Operational,United States of America,North America,1,1,0,0,0,0,1,Weather
1927-12-26 00:00:00,African Aerial Travels,Flight,Commercial,South Africa,Africa,2,1,0,1,0,0,2,Unknown
1927-12-31 00:00:00,Aviakhim,,Commercial,Russia,Asia,0,0,0,0,0,0,0,Unknown
1928-01-02 00:00:00,L'Aéropostale,Flight,Operational,Spain,Europe,2,2,0,0,0,0,2,Unknown
1928-01-05 00:00:00,Western Canada Airways,Landing (descent or approach),Specialised Services,Canada,North America,2,2,0,0,0,0,2,Unknown
1928-01-06 00:00:00,Deutsche Lufthansa,Flight,Commercial,France,Europe,3,3,0,0,0,0,3,Weather
1928-01-13 00:00:00,Qantas Airways - Queensland and Northern Territory Aerial Services,Takeoff (climb),Operational,Australia,Oceania,1,1,0,0,0,0,1,Unknown
1928-01-21 00:00:00,United States Army Air Corps - USAAC,Flight,Operational,United States of America,North America,0,0,0,0,0,0,0,Unknown
1928-01-22 00:00:00,Pacific Air Transport,Flight,Operational,United States of America,North America,1,1,0,0,0,0,1,Weather
1928-02-04 00:00:00,Stout Air Services,Flight,Commercial,United States of America,North America,5,1,0,4,0,0,5,Unknown
1928-02-05 00:00:00,Yorkshire Aero Club,Landing (descent or approach),Operational,United Kingdom,Europe,2,2,0,0,0,0,2,Human Factor
1928-02-07 00:00:00,African Aerial Travels,Landing (descent or approach),Commercial,South Africa,Africa,2,1,0,1,0,0,2,Unknown
1928-02-15 00:00:00,Imperial Airways,Flight,Commercial,France,Europe,0,0,0,0,0,0,0,Weather
1928-02-17 00:00:00,Department of Marine %26 Fishing,Flight,Military / Government,Canada,North America,2,1,0,1,0,0,2,Technical Failure
1928-02-28 00:00:00,Swedish Air Force - Flygvapnet,Takeoff (climb),Operational,Sweden,Europe,1,1,0,0,0,0,1,Unknown
1928-03-03 00:00:00,Guinea Airways,Takeoff (climb),Commercial,Papua New Guinea,Oceania,2,1,0,1,0,0,2,Unknown
1928-03-06 00:00:00,Air Union France,Flight,Operational,United Kingdom,Europe,0,0,0,0,0,0,0,Technical Failure
1928-03-14 00:00:00,Royal Australian Air Force - RAAF,Takeoff (climb),Operational,Australia,Oceania,2,2,0,0,0,0,2,Unknown
1928-03-23 00:00:00,Società Italiana Servizi Aerei - SISA,Flight,Commercial,Italy,Europe,0,0,0,0,0,0,0,Unknown
1928-03-29 00:00:00,Pacific Air Transport,Flight,Operational,United States of America,North America,1,1,0,0,0,0,1,Technical Failure
1928-03-30 00:00:00,Swedish Air Force - Flygvapnet,Flight,Operational,Sweden,Europe,1,1,0,0,0,0,1,Unknown
1928-04-08 00:00:00,Mary Bailey,Landing (descent or approach),Business,Tanzania,Africa,1,1,0,0,0,0,1,Unknown
1928-04-09 00:00:00,George Lockhart,Takeoff (climb),Business,United Kingdom,Europe,3,1,0,2,0,0,3,Unknown
1928-04-10 00:00:00,Unión Aérea Española,Flight,Commercial,Spain,Europe,0,0,0,0,0,0,0,Unknown
1928-04-11 00:00:00,KLM Royal Dutch Airlines - Koninklijke Luchtvaart Maatschappij,Landing (descent or approach),Commercial,Netherlands,Europe,11,3,0,8,0,0,11,Technical Failure
1928-04-15 00:00:00,Stout Air Services,Flight,Commercial,United States of America,North America,0,0,0,0,0,0,0,Unknown
1928-04-19 00:00:00,Deutsche Lufthansa,Flight,Commercial,Germany,Europe,8,2,0,6,0,0,8,Unknown
1928-04-23 00:00:00,Airgold,Landing (descent or approach),Commercial,Papua New Guinea,Oceania,2,1,0,1,0,0,2,Unknown
1928-05-01 00:00:00,Scottish Flying Club,Flight,Operational,United Kingdom,Europe,2,2,0,0,0,0,2,Unknown
1928-05-04 00:00:00,Aero Materiel,Flight,Operational,Sweden,Europe,2,2,0,0,0,0,2,Human Factor
1928-05-05 00:00:00,Yukon Airways %26 Exploration Company,Landing (descent or approach),Commercial,Canada,North America,3,1,0,2,0,0,3,Weather
1928-05-07 00:00:00,South Wales Airways,Takeoff (climb),Commercial,United Kingdom,Europe,3,1,0,2,0,0,3,Unknown
1928-05-07 00:00:00,Pitcairn Aviation,Flight,Operational,United States of America,North America,1,1,0,0,0,0,1,Unknown
1928-05-09 00:00:00,Syndicato Condor,Flight,Commercial,Brazil,South America,6,1,0,5,0,0,6,Unknown
1928-05-13 00:00:00,Afghan Government,Flight,Operational,Pakistan,Asia,2,2,0,0,0,0,2,Unknown
1928-05-16 00:00:00,Deruluft - Deutsch-Russische Luftverkehrs Gesellschaft,Takeoff (climb),Operational,Germany,Europe,1,1,0,0,0,0,1,Technical Failure
1928-05-17 00:00:00,Henry C. MacDonald,Flight,Business,Egypt,Africa,1,1,0,0,0,0,1,Technical Failure
1928-05-18 00:00:00,Deutsche Lufthansa,Flight,Operational,France,Europe,1,1,0,0,0,0,1,Unknown
1928-05-22 00:00:00,Pitcairn Aviation,Flight,Operational,United States of America,North America,1,1,0,0,0,0,1,Weather
1928-05-24 00:00:00,Compagnie Internationale de Navigation Aérienne - CIDNA,Flight,Commercial,Hungary,Europe,4,2,0,2,0,0,4,Unknown
1928-05-28 00:00:00,Deutsche Lufthansa,Flight,Commercial,Germany,Europe,0,0,0,0,0,0,0,Unknown
1928-06-04 00:00:00,Thomas Herbert Richardson,Landing (descent or approach),Business,United Kingdom,Europe,2,1,0,1,0,0,2,Unknown
1928-06-04 00:00:00,Irish Air Corps - Aer Chór na hÉireann,Landing (descent or approach),Operational,Ireland,Europe,2,2,0,0,0,0,2,Unknown
1928-06-05 00:00:00,Deutsche Lufthansa,Landing (descent or approach),Commercial,Germany,Europe,4,2,0,2,0,0,4,Unknown
1928-06-05 00:00:00,Johannesburg Light Plane Club,Flight,Operational,South Africa,Africa,2,2,0,0,0,0,2,Unknown
1928-06-05 00:00:00,United States Army Air Corps - USAAC,Flight,Military / Government,Panama,Central America,0,0,0,0,0,0,0,Unknown
1928-06-06 00:00:00,Airgold,Landing (descent or approach),Commercial,Papua New Guinea,Oceania,2,1,0,1,0,0,2,Unknown
1928-06-12 00:00:00,Norsk Flyveselskap,Flight,Specialised Services,Norway,Europe,1,1,0,0,0,0,1,Unknown
1928-06-14 00:00:00,Ad Astra Aero,Takeoff (climb),Commercial,Germany,Europe,4,1,0,3,0,0,4,Unknown
1928-06-15 00:00:00,Dobrolet,Flight,Commercial,Russia,Asia,0,0,0,0,0,0,0,Unknown
1928-06-20 00:00:00,Royal Danish Air Force - Flyvevåbnet,Flight,Operational,Denmark,Europe,0,0,0,0,0,0,0,Unknown
1928-06-20 00:00:00,Royal Air Force - RAF,Landing (descent or approach),Operational,United Kingdom,Europe,2,2,0,0,0,0,2,Unknown
1928-06-22 00:00:00,Royal Australian Air Force - RAAF,Flight,Operational,Australia,Oceania,2,2,0,0,0,0,2,Human Factor
1928-06-23 00:00:00,Belgian Air Force - Force Aérienne Belge - Belgische Luchtmacht,Flight,Operational,Belgium,Europe,1,1,0,0,0,0,1,Unknown
1928-06-29 00:00:00,L'Aéropostale,Flight,Operational,Western Sahara,Africa,2,2,0,0,0,0,2,Weather
1928-07-04 00:00:00,National Air Transport - USA,Flight,Operational,United States of America,North America,1,1,0,0,0,0,1,Technical Failure
1928-07-04 00:00:00,Surrey Flying Services,Flight,Commercial,United Kingdom,Europe,3,1,0,2,0,0,3,Unknown
1928-07-07 00:00:00,Balair - Switzerland,Flight,Commercial,Switzerland,Europe,1,1,0,0,0,0,1,Unknown
1928-07-07 00:00:00,Cinque Ports Flying Club,Landing (descent or approach),Operational,United Kingdom,Europe,1,1,0,0,0,0,1,Human Factor
1928-07-07 00:00:00,K. W. J. Hall,Flight,Business,New Zealand,Oceania,1,1,0,0,0,0,1,Unknown
1928-07-13 00:00:00,French Air Force - Armée de l'Air,Landing (descent or approach),Military / Government,France,Europe,6,2,0,4,0,0,6,Technical Failure
1928-07-13 00:00:00,Western Canada Airways,Flight,Commercial,Canada,North America,3,1,0,2,0,0,3,Human Factor
1928-07-23 00:00:00,L'Aéropostale,Takeoff (climb),Operational,Portugal,Europe,2,2,0,0,0,0,2,Unknown
1928-07-26 00:00:00,Irish Air Corps - Aer Chór na hÉireann,Landing (descent or approach),Operational,Ireland,Europe,2,2,0,0,0,0,2,Unknown
1928-07-26 00:00:00,Franz Clouth Rheinische Gummiwarenfabrik,Flight,Business,Germany,Europe,2,1,0,1,0,0,2,Technical Failure
1928-08-01 00:00:00,E. Hosmer,Flight,Business,World,World,3,3,0,0,0,0,3,Technical Failure
1928-08-04 00:00:00,Deutsche Lufthansa,Flight,Operational,Netherlands,Europe,1,1,0,0,0,0,1,Technical Failure
1928-08-15 00:00:00,Pan American World Airways - PAA,Flight,Commercial,United States of America,North America,5,3,0,2,0,0,5,Technical Failure
1928-08-15 00:00:00,Pitcairn Aviation,Flight,Operational,United States of America,North America,1,1,0,0,0,0,1,Unknown
1928-08-15 00:00:00,Canadian Vickers,Flight,Specialised Services,Canada,North America,1,1,0,0,0,0,1,Weather
1928-08-17 00:00:00,Royal Australian Air Force - RAAF,Flight,Operational,Australia,Oceania,1,1,0,0,0,0,1,Unknown
1928-08-22 00:00:00,Gnat Aero Company,Flight,Commercial,United Kingdom,Europe,3,1,0,2,0,0,3,Unknown
1928-08-22 00:00:00,Hammond Aerial Transport,Landing (descent or approach),Operational,Australia,Oceania,2,1,0,1,0,0,2,Unknown
1928-08-23 00:00:00,Lloyd-Luftverkehr Sablatnig,Flight,Commercial,Germany,Europe,0,0,0,0,0,0,0,Unknown
1928-08-23 00:00:00,Air Union France,Flight,Commercial,France,Europe,2,1,0,1,0,0,2,Unknown
1928-08-23 00:00:00,Belgian Air Force - Force Aérienne Belge - Belgische Luchtmacht,Flight,Operational,Belgium,Europe,1,1,0,0,0,0,1,Technical Failure
1928-08-24 00:00:00,Short Brothers,Landing (descent or approach),Specialised Services,United Kingdom,Europe,1,1,0,0,0,0,1,Unknown
1928-08-29 00:00:00,Department of Marine %26 Fishing,Takeoff (climb),Commercial,Canada,North America,0,0,0,0,0,0,0,Unknown
1928-08-30 00:00:00,Johannesburg Light Plane Club,Landing (descent or approach),Operational,South Africa,Africa,2,2,0,0,0,0,2,Unknown
1928-08-31 00:00:00,Frederick Edward Guest,Takeoff (climb),Business,Bahamas,Central America,2,1,0,1,0,0,2,Unknown
1928-09-04 00:00:00,Belgian Air Force - Force Aérienne Belge - Belgische Luchtmacht,Landing (descent or approach),Military / Government,Belgium,Europe,2,1,0,1,0,0,2,Unknown
1928-09-04 00:00:00,Royal Air Force - RAF,Landing (descent or approach),Operational,United Kingdom,Europe,2,2,0,0,0,0,2,Unknown
1928-09-06 00:00:00,Royal Australian Air Force - RAAF,Landing (descent or approach),Operational,Australia,Oceania,1,1,0,0,0,0,1,Unknown
1928-09-07 00:00:00,Air Union France,Takeoff (climb),Commercial,Tunisia,Africa,0,0,0,0,0,0,0,Unknown
1928-09-07 00:00:00,Badisch-Pfälzische Lufthansa,Flight,Commercial,Germany,Europe,2,1,0,1,0,0,2,Unknown
1928-09-13 00:00:00,Macfadden Publications,Flight,Business,United States of America,North America,2,2,0,0,0,0,2,Technical Failure
1928-09-13 00:00:00,Air Union France,Flight,Operational,United Kingdom,Europe,2,2,0,0,0,0,2,Technical Failure
1928-09-21 00:00:00,Royal Australian Air Force - RAAF,Flight,Operational,Australia,Oceania,1,1,0,0,0,0,1,Unknown
1928-09-22 00:00:00,L'Aéropostale,Flight,Operational,France,Europe,1,1,0,0,0,0,1,Unknown
1928-09-22 00:00:00,L'Aéropostale,Flight,Operational,Morocco,Africa,2,2,0,0,0,0,2,Technical Failure
1928-09-23 00:00:00,L'Aéropostale,Takeoff (climb),Operational,France,Europe,3,3,0,0,0,0,3,Unknown
1928-09-25 00:00:00,Deutsche Lufthansa,Flight,Commercial,Germany,Europe,9,4,0,5,0,0,9,Technical Failure
1928-09-25 00:00:00,North Sea Aerial %26 General Transport,Landing (descent or approach),Commercial,United Kingdom,Europe,3,1,0,2,0,0,3,Unknown
1928-10-01 00:00:00,United States Army Air Corps - USAAC,Takeoff (climb),Operational,United States of America,North America,0,0,0,0,0,0,0,Unknown
1928-10-01 00:00:00,United States Army Air Corps - USAAC,Flight,Military / Government,Panama,Central America,0,0,0,0,0,0,0,Unknown
1928-10-02 00:00:00,Avro Aircraft,Flight,Specialised Services,United Kingdom,Europe,2,2,0,0,0,0,2,Unknown
1928-10-10 00:00:00,L'Aéropostale,Flight,Operational,World,World,3,3,0,0,0,0,3,Technical Failure
1928-10-11 00:00:00,Ukrvozduchput,Flight,Commercial,Ukraine,Europe,0,0,0,0,0,0,0,Unknown
1928-10-11 00:00:00,L'Aéropostale,Flight,Operational,Morocco,Africa,0,0,0,0,0,0,0,Unknown
1928-10-13 00:00:00,Stout Air Services,Landing (descent or approach),Commercial,United States of America,North America,3,1,0,2,0,0,3,Unknown
1928-10-13 00:00:00,Cinque Ports Flying Club,Flight,Operational,United Kingdom,Europe,1,1,0,0,0,0,1,Human Factor
1928-10-14 00:00:00,O. B. Hall %26 D. G. Officer,Flight,Operational,Australia,Oceania,2,2,0,0,0,0,2,Unknown
1928-10-17 00:00:00,Royal Australian Air Force - RAAF,Flight,Operational,Australia,Oceania,1,1,0,0,0,0,1,Unknown
1928-10-18 00:00:00,Henry Drummond Wolff,Flight,Business,Zambia,Africa,1,1,0,0,0,0,1,Unknown
1928-10-20 00:00:00,Sicele J. M. O’Brien,Flight,Business,United Kingdom,Europe,2,2,0,0,0,0,2,Unknown
1928-10-23 00:00:00,Imperial Airways,Takeoff (climb),Commercial,United Kingdom,Europe,5,1,0,4,0,0,5,Unknown
1928-10-23 00:00:00,Western Canada Airways,Flight,Commercial,Canada,North America,0,0,0,0,0,0,0,Technical Failure
1928-10-24 00:00:00,Ottawa Flying Club,Takeoff (climb),Operational,Canada,North America,2,2,0,0,0,0,2,Unknown
1928-10-26 00:00:00,L'Aéropostale,Flight,Operational,Spain,Europe,4,4,0,0,0,0,4,Technical Failure
1928-10-27 00:00:00,L'Aéropostale,Flight,Commercial,Spain,Europe,3,1,0,2,0,0,3,Technical Failure
1928-10-29 00:00:00,Pan American World Airways - PAA,Takeoff (climb),Operational,Puerto Rico,Central America,2,2,0,0,0,0,2,Unknown
1928-11-02 00:00:00,West Coast Air Transport,Flight,Commercial,United States of America,North America,8,2,0,6,0,0,8,Technical Failure
1928-11-17 00:00:00,Surrey Flying Services,Takeoff (climb),Commercial,United Kingdom,Europe,3,1,0,2,0,0,3,Unknown
1928-11-18 00:00:00,National Air Transport - USA,Flight,Operational,United States of America,North America,1,1,0,0,0,0,1,Weather
1928-11-29 00:00:00,Brooklands School of Flying,Landing (descent or approach),Operational,United Kingdom,Europe,2,2,0,0,0,0,2,Unknown
1928-11-29 00:00:00,Aviakhim,,Commercial,Russia,Asia,0,0,0,0,0,0,0,Unknown
1928-12-02 00:00:00,United States Army Air Corps - USAAC,Takeoff (climb),Operational,United States of America,North America,1,1,0,0,0,0,1,Unknown
1928-12-03 00:00:00,Royal Australian Air Force - RAAF,Flight,Operational,Australia,Oceania,2,2,0,0,0,0,2,Weather
1928-12-09 00:00:00,Air Union France,Flight,Commercial,France,Europe,3,3,0,0,0,0,3,Unknown
1928-12-15 00:00:00,L'Aéropostale,Flight,Operational,Spain,Europe,1,1,0,0,0,0,1,Technical Failure
1928-12-16 00:00:00,Pitcairn Aviation,Flight,Operational,United States of America,North America,1,1,0,0,0,0,1,Weather
1928-12-17 00:00:00,National Air Transport - USA,Flight,Operational,United States of America,North America,1,1,0,0,0,0,1,Technical Failure
1928-12-20 00:00:00,United States Army Air Corps - USAAC,Flight,Operational,United States of America,North America,0,0,0,0,0,0,0,Unknown
1928-12-23 00:00:00,Boeing Air Transport,Flight,Operational,United States of America,North America,1,1,0,0,0,0,1,Human Factor
1928-12-29 00:00:00,Texaco Petroleum Company,Takeoff (climb),Business,United States of America,North America,4,1,0,3,0,0,4,Unknown
1928-12-30 00:00:00,L'Aéropostale,Takeoff (climb),Commercial,France,Europe,3,1,0,2,0,0,3,Unknown
1928-12-31 00:00:00,Deutsche Lufthansa,,Commercial,Germany,Europe,0,0,0,0,0,0,0,Unknown
1928-12-31 00:00:00,Ukrvozduchput,,Commercial,Ukraine,Europe,0,0,0,0,0,0,0,Unknown
1928-12-31 00:00:00,Pan American World Airways - PAA,Takeoff (climb),Military / Government,Costa Rica,Central America,4,2,0,2,0,0,4,Weather
1928-12-31 00:00:00,Bolivian Air Force - Fuerza Aérea Boliviana,Landing (descent or approach),Military / Government,Bolivia,South America,1,1,0,0,0,0,1,Technical Failure
1929-01-05 00:00:00,United States Army Air Corps - USAAC,Flight,Operational,United States of America,North America,0,0,0,0,0,0,0,Unknown
1929-01-06 00:00:00,Boeing Air Transport,Landing (descent or approach),Operational,United States of America,North America,1,1,0,0,0,0,1,Unknown
1929-01-08 00:00:00,Royal Netherlands Navy - Marineluchtvaartdienst,Landing (descent or approach),Operational,Indonesia,Asia,1,1,0,0,0,0,1,Unknown
1929-01-09 00:00:00,Canadian Transcontinental Airways,Flight,Commercial,Canada,North America,2,1,0,1,0,0,2,Technical Failure
1929-01-16 00:00:00,Stout Air Services,Takeoff (climb),Operational,United States of America,North America,1,1,0,0,0,0,1,Technical Failure
1929-01-21 00:00:00,Royal Australian Air Force - RAAF,Flight,Operational,Australia,Oceania,2,2,0,0,0,0,2,Human Factor
1929-01-26 00:00:00,De Havilland Aircraft UK,Flight,Operational,United Kingdom,Europe,1,1,0,0,0,0,1,Technical Failure
1929-01-30 00:00:00,Curtiss Flying Service,Flight,Operational,United States of America,North America,1,1,0,0,0,0,1,Weather
1929-02-01 00:00:00,Deutsche Lufthansa,Flight,Operational,France,Europe,3,3,0,0,0,0,3,Human Factor
1929-02-01 00:00:00,Johannesburg Light Plane Club,Landing (descent or approach),Operational,South Africa,Africa,2,2,0,0,0,0,2,Unknown
1929-02-05 00:00:00,Eugène de Ligne,Takeoff (climb),Specialised Services,Belgium,Europe,2,2,0,0,0,0,2,Unknown
1929-02-06 00:00:00,United States Army Air Corps - USAAC,Takeoff (climb),Operational,United States of America,North America,0,0,0,0,0,0,0,Unknown
1929-02-10 00:00:00,Scottish Flying Club,Flight,Operational,United Kingdom,Europe,2,2,0,0,0,0,2,Unknown
1929-02-13 00:00:00,Boeing Air Transport,Landing (descent or approach),Operational,United States of America,North America,1,1,0,0,0,0,1,Technical Failure
1929-02-15 00:00:00,Royal Australian Air Force - RAAF,Flight,Operational,Australia,Oceania,2,2,0,0,0,0,2,Unknown
1929-02-16 00:00:00,Royal Netherlands East Indies Air Force - ML-KNIL,Takeoff (climb),Operational,Indonesia,Asia,1,1,0,0,0,0,1,Technical Failure
1929-02-18 00:00:00,Reynolds Airways,Taxiing,Commercial,United States of America,North America,3,2,0,1,0,0,3,Other
1929-02-19 00:00:00,Breguet Industries,Flight,Business,France,Europe,3,3,0,0,0,0,3,Technical Failure
1929-02-19 00:00:00,United States Army Air Corps - USAAC,Takeoff (climb),Military / Government,Panama,Central America,0,0,0,0,0,0,0,Unknown
1929-02-25 00:00:00,Provincial Air Service of Lands %26 Forests,Landing (descent or approach),Commercial,Canada,North America,2,1,0,1,0,0,2,Unknown
1929-02-26 00:00:00,Société des Avions Bernard,Flight,Business,Myanmar,Asia,3,3,0,0,0,0,3,Technical Failure
1929-03-01 00:00:00,Pitcairn Aviation,Takeoff (climb),Operational,United States of America,North America,1,1,0,0,0,0,1,Unknown
1929-03-01 00:00:00,A. M. Miller,Takeoff (climb),Business,South Africa,Africa,1,1,0,0,0,0,1,Unknown
1929-03-05 00:00:00,Leigh B. Sheppard,Takeoff (climb),Business,Canada,North America,1,1,0,0,0,0,1,Unknown
1929-03-10 00:00:00,Simmonds Aircraft,Flight,Specialised Services,United Kingdom,Europe,2,2,0,0,0,0,2,Unknown
1929-03-10 00:00:00,Victoria Aero Club,Landing (descent or approach),Operational,Canada,North America,1,1,0,0,0,0,1,Technical Failure
1929-03-11 00:00:00,Boeing Air Transport,Flight,Commercial,United States of America,North America,2,1,0,1,0,0,2,Weather
1929-03-19 00:00:00,Deutsche Lufthansa,Flight,Operational,Germany,Europe,1,1,0,0,0,0,1,Unknown
1929-03-25 00:00:00,Edmonton %26 Northern Alberta Aero Club,Takeoff (climb),Operational,Canada,North America,2,2,0,0,0,0,2,Unknown
1929-03-26 00:00:00,Johannesburg Light Plane Club,Flight,Business,South Africa,Africa,1,1,0,0,0,0,1,Unknown
1929-03-27 00:00:00,Cinque Ports Flying Club,Takeoff (climb),Operational,United Kingdom,Europe,2,2,0,0,0,0,2,Technical Failure
1929-03-29 00:00:00,Macfadden Publications,Takeoff (climb),Business,United States of America,North America,1,1,0,0,0,0,1,Unknown
1929-04-06 00:00:00,Royal Canadian Air Force - RCAF,Landing (descent or approach),Operational,Canada,North America,1,1,0,0,0,0,1,Unknown
1929-04-08 00:00:00,International Airways of Canada,Flight,Operational,Canada,North America,1,1,0,0,0,0,1,Technical Failure
1929-04-10 00:00:00,Colonial Western Airways,Takeoff (climb),Operational,United States of America,North America,1,1,0,0,0,0,1,Unknown
1929-04-15 00:00:00,Dobrolet,,Commercial,Russia,Asia,0,0,0,0,0,0,0,Unknown
1929-04-24 00:00:00,Calgary Flying Club,Flight,Business,Canada,North America,2,1,0,1,0,0,2,Unknown
1929-04-25 00:00:00,Eastern Air Transport,Landing (descent or approach),Operational,United States of America,North America,1,1,0,0,0,0,1,Technical Failure
1929-04-26 00:00:00,Frank Mase,Flight,Business,France,Europe,1,1,0,0,0,0,1,Human Factor
1929-04-28 00:00:00,United States Army Air Corps - USAAC,Takeoff (climb),Military / Government,United States of America,North America,0,0,0,0,0,0,0,Unknown
1929-05-04 00:00:00,Moth Aircraft Corporation,Takeoff (climb),Business,United States of America,North America,1,1,0,0,0,0,1,Unknown
1929-05-07 00:00:00,Western Air Express,,Operational,United States of America,North America,0,0,0,0,0,0,0,Unknown
1929-05-11 00:00:00,West Australian Airways,Takeoff (climb),Commercial,Australia,Oceania,0,0,0,0,0,0,0,Unknown
1929-05-15 00:00:00,Ukrvozduchput,Flight,Commercial,Ukraine,Europe,0,0,0,0,0,0,0,Unknown
1929-05-16 00:00:00,TAT Flying Service,Flight,Operational,United States of America,North America,1,1,0,0,0,0,1,Weather
1929-05-19 00:00:00,Air Associates,Takeoff (climb),Commercial,United States of America,North America,4,1,0,3,0,0,4,Unknown
1929-05-19 00:00:00,Air Union France,Flight,Operational,United Kingdom,Europe,2,2,0,0,0,0,2,Technical Failure
1929-05-21 00:00:00,Nilfisk,Flight,Business,Denmark,Europe,2,1,0,1,0,0,2,Unknown
1929-05-22 00:00:00,Boeing Air Transport,Takeoff (climb),Commercial,United States of America,North America,9,2,0,7,0,0,9,Technical Failure
1929-05-24 00:00:00,Deutsche Verkehrsfliegerschule - DVS,Flight,Operational,Germany,Europe,2,2,0,0,0,0,2,Unknown
1929-05-31 00:00:00,Royal Canadian Air Force - RCAF,Flight,Operational,Canada,North America,2,2,0,0,0,0,2,Unknown
1929-06-05 00:00:00,Bodensee Aerolloyd,Landing (descent or approach),Commercial,Germany,Europe,5,1,0,4,0,0,5,Unknown
1929-06-10 00:00:00,Van Lear Black,Landing (descent or approach),Business,India,Asia,5,2,0,3,0,0,5,Unknown
1929-06-16 00:00:00,Royal Canadian Air Force - RCAF,Takeoff (climb),Operational,Canada,North America,2,2,0,0,0,0,2,Unknown
1929-06-28 00:00:00,Ottawa Car Manufacturing Company,Takeoff (climb),Specialised Services,Canada,North America,2,2,0,0,0,0,2,Human Factor
1929-06-29 00:00:00,Mexicana de Aviación,Flight,Commercial,Panama,Central America,0,0,0,0,0,0,0,Unknown
1929-06-29 00:00:00,National Air Transport - USA,Flight,Operational,United States of America,North America,1,1,0,0,0,0,1,Technical Failure
1929-06-30 00:00:00,Provincial Air Service of Lands %26 Forests,Landing (descent or approach),Military / Government,Canada,North America,2,1,0,1,0,0,2,Unknown
1929-07-04 00:00:00,Donald H. Drew,Flight,Business,South Sudan,Africa,4,2,0,2,0,0,4,Technical Failure
1929-07-04 00:00:00,Halifax Aero Club,Takeoff (climb),Business,Canada,North America,2,1,0,1,0,0,2,Technical Failure
1929-07-05 00:00:00,Royal Canadian Air Force - RCAF,Flight,Operational,Canada,North America,2,2,0,0,0,0,2,Unknown
1929-07-08 00:00:00,Montreal Light Aeroplane Club,Landing (descent or approach),Operational,Canada,North America,2,2,0,0,0,0,2,Unknown
1929-07-13 00:00:00,Western Canada Airways,Takeoff (climb),Commercial,Canada,North America,3,1,0,2,0,0,3,Technical Failure
1929-07-15 00:00:00,Dobrolet,,Commercial,Russia,Asia,0,0,0,0,0,0,0,Unknown
1929-07-15 00:00:00,Dobrolet,,Commercial,Russia,Asia,0,0,0,0,0,0,0,Unknown
1929-07-16 00:00:00,James Denby Roberts,Flight,Business,United Kingdom,Europe,2,1,0,1,0,0,2,Technical Failure
1929-07-20 00:00:00,E. F. Knight,Takeoff (climb),Business,Canada,North America,1,1,0,0,0,0,1,Unknown
1929-07-21 00:00:00,John Colquhoun Don,Landing (descent or approach),Business,United Kingdom,Europe,2,1,0,1,0,0,2,Unknown
1929-07-24 00:00:00,Nordbayerische Verkehrsflug,Landing (descent or approach),Commercial,Germany,Europe,4,1,0,3,0,0,4,Unknown
1929-07-25 00:00:00,Schlee-Brock Aircraft Corporation - SBAC,Flight,Specialised Services,United States of America,North America,3,3,0,0,0,0,3,Unknown
1929-07-26 00:00:00,Royal Canadian Air Force - RCAF,Flight,Operational,Canada,North America,2,2,0,0,0,0,2,Unknown
1929-07-28 00:00:00,National Flying Services,Flight,Specialised Services,United Kingdom,Europe,1,1,0,0,0,0,1,Unknown
1929-07-29 00:00:00,United States Airways,Takeoff (climb),Commercial,United States of America,North America,8,2,0,6,0,0,8,Unknown
1929-07-30 00:00:00,Belgian Air Force - Force Aérienne Belge - Belgische Luchtmacht,Flight,Operational,Belgium,Europe,1,1,0,0,0,0,1,Technical Failure
1929-08-02 00:00:00,Homi D. Bharucha,Takeoff (climb),Business,United Kingdom,Europe,1,1,0,0,0,0,1,Unknown
1929-08-04 00:00:00,Lockheed Aircraft Corporation,Landing (descent or approach),Specialised Services,United States of America,North America,4,4,0,0,0,0,4,Other
1929-08-07 00:00:00,Pickwick Airways,Takeoff (climb),Commercial,United States of America,North America,10,2,0,8,0,0,10,Technical Failure
1929-08-09 00:00:00,Dobrolet,Flight,Specialised Services,Russia,Asia,2,2,0,0,0,0,2,Technical Failure
1929-08-09 00:00:00,Northern Aerial Minerals Exploration,,Commercial,Canada,North America,0,0,0,0,0,0,0,Unknown
1929-08-10 00:00:00,Halifax Aero Club,Landing (descent or approach),Operational,Canada,North America,2,2,0,0,0,0,2,Unknown
1929-08-11 00:00:00,Thomas Owen Mills,Flight,Business,United Kingdom,Europe,2,1,0,1,0,0,2,Unknown
1929-08-11 00:00:00,L'Aéropostale,Flight,Operational,Morocco,Africa,1,1,0,0,0,0,1,Technical Failure
1929-08-13 00:00:00,A. D. Keith,Takeoff (climb),Business,Canada,North America,0,0,0,0,0,0,0,Technical Failure
1929-08-14 00:00:00,Swedish Air Force - Flygvapnet,Flight,Military / Government,Sweden,Europe,2,2,0,0,0,0,2,Unknown
1929-08-14 00:00:00,Royal Canadian Air Force - RCAF,Takeoff (climb),Operational,Canada,North America,2,2,0,0,0,0,2,Unknown
1929-08-15 00:00:00,Northern Aerial Minerals Exploration,Flight,Commercial,Canada,North America,0,0,0,0,0,0,0,Human Factor
1929-08-16 00:00:00,Popular Flights,Takeoff (climb),Business,United Kingdom,Europe,3,1,0,2,0,0,3,Unknown
1929-08-22 00:00:00,Winnipeg Flying Club,Flight,Operational,Canada,North America,2,2,0,0,0,0,2,Human Factor
1929-08-23 00:00:00,French Air Force - Armée de l'Air,Takeoff (climb),Operational,France,Europe,2,2,0,0,0,0,2,Unknown
1929-08-25 00:00:00,Northern Aerial Minerals Exploration,Landing (descent or approach),Operational,Canada,North America,1,1,0,0,0,0,1,Unknown
1929-08-29 00:00:00,Royal Canadian Air Force - RCAF,Landing (descent or approach),Operational,Canada,North America,2,2,0,0,0,0,2,Unknown
1929-08-29 00:00:00,Aktiebolaget Aerotransport - ABA,Flight,Commercial,Germany,Europe,0,0,0,0,0,0,0,Technical Failure
1929-09-01 00:00:00,Transcontinental Air Transport - TAT,Flight,Commercial,United States of America,North America,3,1,0,2,0,0,3,Technical Failure
1929-09-02 00:00:00,United States Army Air Corps - USAAC,Taxiing,Operational,United States of America,North America,0,0,0,0,0,0,0,Unknown
1929-09-05 00:00:00,Pitcairn Aviation,Flight,Operational,United States of America,North America,1,1,0,0,0,0,1,Technical Failure
1929-09-10 00:00:00,Deutsche Lufthansa,Flight,Commercial,Germany,Europe,0,0,0,0,0,0,0,Technical Failure
1929-09-11 00:00:00,British Air Lines - BAL,Takeoff (climb),Commercial,United Kingdom,Europe,6,2,0,4,0,0,6,Technical Failure
1929-09-12 00:00:00,L'Aéropostale,Flight,Operational,Spain,Europe,1,1,0,0,0,0,1,Unknown
1929-09-18 00:00:00,Compagnie Aérienne Française,Flight,Operational,France,Europe,1,1,0,0,0,0,1,Technical Failure
1929-09-19 00:00:00,Pan American World Airways - PAA,Takeoff (climb),Commercial,United States of America,North America,0,0,0,0,0,0,0,Unknown
1929-09-20 00:00:00,Spanish Air Force - Aeronáutica Militar,Flight,Operational,Spain,Europe,5,5,0,0,0,0,5,Unknown
1929-09-20 00:00:00,Continental Air Express,Flight,Commercial,United States of America,North America,0,0,0,0,0,0,0,Unknown
1929-09-22 00:00:00,Western Canada Airways,Landing (descent or approach),Commercial,Canada,North America,0,0,0,0,0,0,0,Unknown
1929-09-23 00:00:00,United Railway Employees Investments %26 Industrial Association,Landing (descent or approach),Operational,Canada,North America,0,0,0,0,0,0,0,Human Factor
1929-09-24 00:00:00,United States Army Air Corps - USAAC,Flight,Operational,Philippines,Asia,0,0,0,0,0,0,0,Unknown
1929-09-25 00:00:00,Harrington R. Law,Flight,Business,France,Europe,1,1,0,0,0,0,1,Technical Failure
1929-09-25 00:00:00,United States Army Air Corps - USAAC,Landing (descent or approach),Military / Government,United States of America,North America,0,0,0,0,0,0,0,Unknown
1929-10-05 00:00:00,Cherry Red Airline,Flight,Commercial,Canada,North America,0,0,0,0,0,0,0,Technical Failure
1929-10-07 00:00:00,United States Army Air Corps - USAAC,Landing (descent or approach),Specialised Services,United States of America,North America,0,0,0,0,0,0,0,Unknown
1929-10-09 00:00:00,L'Aéropostale,Flight,Operational,World,World,3,3,0,0,0,0,3,Technical Failure
1929-10-11 00:00:00,Skyways - USA,Flight,Operational,United States of America,North America,1,1,0,0,0,0,1,Unknown
1929-10-12 00:00:00,Italian Government,,Military / Government,Spain,Europe,0,0,0,0,0,0,0,Unknown
1929-10-15 00:00:00,Deruluft - Deutsch-Russische Luftverkehrs Gesellschaft,Flight,Commercial,Estonia,Europe,0,0,0,0,0,0,0,Unknown
1929-10-17 00:00:00,Concesionaria de Lineas Aéreas Subvencionadas SA - CLASSA,Landing (descent or approach),Commercial,Spain,Europe,3,1,0,2,0,0,3,Unknown
1929-10-18 00:00:00,Boeing Air Transport,Flight,Operational,United States of America,North America,1,1,0,0,0,0,1,Technical Failure
1929-10-19 00:00:00,SABENA - Société Anonyme Belge d'Exploitation de la Navigation Aérienne,Landing (descent or approach),Commercial,Belgium,Europe,12,2,0,10,0,0,12,Technical Failure
1929-10-19 00:00:00,KLM Royal Dutch Airlines - Koninklijke Luchtvaart Maatschappij,Flight,Operational,Turkey,Asia,3,3,0,0,0,0,3,Technical Failure
1929-10-21 00:00:00,Skyline Transportation Company,Flight,Operational,United States of America,North America,1,1,0,0,0,0,1,Technical Failure
1929-10-23 00:00:00,Société Générale des Transports Aériens - SGTA,Takeoff (climb),Commercial,Belgium,Europe,5,2,0,3,0,0,5,Technical Failure
1929-10-28 00:00:00,Western Air Express,Flight,Commercial,United States of America,North America,0,0,0,0,0,0,0,Unknown
1929-10-29 00:00:00,Royal Netherlands Navy - Marineluchtvaartdienst,Flight,Operational,Indonesia,Asia,2,2,0,0,0,0,2,Human Factor
1929-11-03 00:00:00,Midland Aero Club,Flight,Business,United Kingdom,Europe,2,1,0,1,0,0,2,Technical Failure
1929-11-03 00:00:00,Phillips %26 Powis Aircraft,Landing (descent or approach),Business,United Kingdom,Europe,1,1,0,0,0,0,1,Unknown
1929-11-05 00:00:00,Reading Airways,Landing (descent or approach),Operational,United Kingdom,Europe,1,1,0,0,0,0,1,Unknown
1929-11-06 00:00:00,National Air Transport - USA,Flight,Operational,United States of America,North America,1,1,0,0,0,0,1,Technical Failure
1929-11-07 00:00:00,L'Aéropostale,Flight,Operational,World,World,4,4,0,0,0,0,4,Technical Failure
1929-11-09 00:00:00,National Air Transport - USA,Flight,Operational,United States of America,North America,1,1,0,0,0,0,1,Weather
1929-11-09 00:00:00,Royal Australian Air Force - RAAF,Landing (descent or approach),Operational,Australia,Oceania,2,2,0,0,0,0,2,Unknown
1929-11-11 00:00:00,E. Hirschler,Takeoff (climb),Business,Germany,Europe,1,1,0,0,0,0,1,Unknown
1929-11-12 00:00:00,United States Army Air Corps - USAAC,Flight,Military / Government,United States of America,North America,0,0,0,0,0,0,0,Unknown
1929-11-14 00:00:00,St. Tammany Gulf Coast Airways,Landing (descent or approach),Operational,United States of America,North America,1,1,0,0,0,0,1,Unknown
1929-11-14 00:00:00,Royal Air Force - RAF,Landing (descent or approach),Operational,United Kingdom,Europe,2,2,0,0,0,0,2,Unknown
1929-11-16 00:00:00,Canadian Airways,Takeoff (climb),Commercial,Canada,North America,0,0,0,0,0,0,0,Other
1929-11-18 00:00:00,Deutsche Lufthansa,Takeoff (climb),Commercial,Germany,Europe,0,0,0,0,0,0,0,Unknown
1929-11-26 00:00:00,Australian Aero Club,Flight,Operational,Australia,Oceania,2,2,0,0,0,0,2,Technical Failure
1929-11-27 00:00:00,Fokker Aircraft,Takeoff (climb),Specialised Services,United States of America,North America,2,2,0,0,0,0,2,Technical Failure
1929-12-01 00:00:00,Newcastle upon Tyne Light Aeroplane Club,Landing (descent or approach),Business,United Kingdom,Europe,2,1,0,1,0,0,2,Unknown
1929-12-10 00:00:00,Skyways - USA,Flight,Operational,United States of America,North America,1,1,0,0,0,0,1,Technical Failure
1929-12-12 00:00:00,Aircraft Ltd,Flight,Commercial,Canada,North America,2,1,0,1,0,0,2,Unknown
1929-12-17 00:00:00,L'Aéropostale,Flight,Operational,Myanmar,Asia,2,2,0,0,0,0,2,Weather
1929-12-18 00:00:00,Boeing Air Transport,Flight,Commercial,United States of America,North America,4,2,0,2,0,0,4,Weather
1929-12-20 00:00:00,L'Aéropostale,Landing (descent or approach),Operational,France,Europe,1,1,0,0,0,0,1,Other
1929-12-21 00:00:00,Air Orient,Flight,Operational,Myanmar,Asia,2,2,0,0,0,0,2,Weather
1929-12-24 00:00:00,John Scott-Taggart,Landing (descent or approach),Business,United Kingdom,Europe,2,1,0,1,0,0,2,Human Factor
1929-12-24 00:00:00,L'Aéropostale,Flight,Operational,Spain,Europe,3,3,0,0,0,0,3,Technical Failure
1929-12-26 00:00:00,Western Air Express,Landing (descent or approach),Commercial,United States of America,North America,0,0,0,0,0,0,0,Technical Failure
1929-12-31 00:00:00,SCADTA - Sociedad Colombo-Alemana de Transportes Aéreos,,Commercial,Colombia,South America,0,0,0,0,0,0,0,Unknown
1929-12-31 00:00:00,SCADTA - Sociedad Colombo-Alemana de Transportes Aéreos,,Commercial,Colombia,South America,0,0,0,0,0,0,0,Unknown
1929-12-31 00:00:00,Dobrolet,,Commercial,Russia,Asia,0,0,0,0,0,0,0,Unknown
1929-12-31 00:00:00,Dobrolet,,Commercial,Russia,Asia,0,0,0,0,0,0,0,Unknown
1929-12-31 00:00:00,Chilean Air Force - Fuerza Aérea de Chile,Flight,Military / Government,Chile,South America,0,0,0,0,0,0,0,Unknown
1929-12-31 00:00:00,Bowring,Flight,Business,Canada,North America,1,1,0,0,0,0,1,Weather
1929-12-31 00:00:00,International Airways of Canada,Takeoff (climb),Commercial,Canada,North America,0,0,0,0,0,0,0,Unknown
1930-01-03 00:00:00,Societa Anonima di Navigazione Aerea - SANA,,Commercial,World,World,0,0,0,0,0,0,0,Unknown
1930-01-06 00:00:00,Western Air Express,Flight,Commercial,United States of America,North America,1,1,0,0,0,0,1,Weather
1930-01-07 00:00:00,International Airways of Canada,Flight,Operational,Canada,North America,1,1,0,0,0,0,1,Unknown
1930-01-11 00:00:00,Henry Charles Hiley Bathurst,Landing (descent or approach),Business,United Kingdom,Europe,1,1,0,0,0,0,1,Unknown
1930-01-17 00:00:00,Texaco Petroleum Company,Takeoff (climb),Business,United States of America,North America,3,2,0,1,0,0,3,Unknown
1930-01-19 00:00:00,Imperial Airways,Takeoff (climb),Commercial,Zambia,Africa,7,2,0,5,0,0,7,Unknown
1930-01-19 00:00:00,L'Aéropostale,Landing (descent or approach),Operational,Morocco,Africa,2,2,0,0,0,0,2,Unknown
1930-01-28 00:00:00,Royal Air Force - RAF,Takeoff (climb),Operational,United Kingdom,Europe,2,2,0,0,0,0,2,Technical Failure
1930-01-31 00:00:00,St. Tammany Gulf Coast Airways,Landing (descent or approach),Operational,United States of America,North America,1,1,0,0,0,0,1,Technical Failure
1930-02-03 00:00:00,Colonial Western Airways,Flight,Operational,United States of America,North America,1,1,0,0,0,0,1,Human Factor
1930-02-08 00:00:00,D. A. Seitz,Landing (descent or approach),Business,United States of America,North America,7,2,0,5,0,0,7,Technical Failure
1930-02-09 00:00:00,Flying %26 Services,Landing (descent or approach),Commercial,Canada,North America,2,1,0,1,0,0,2,Unknown
1930-02-14 00:00:00,Imperial Airways,Landing (descent or approach),Commercial,Egypt,Africa,7,3,0,4,0,0,7,Human Factor
1930-02-16 00:00:00,Winnipeg Flying Club,Landing (descent or approach),Operational,Canada,North America,1,1,0,0,0,0,1,Human Factor
1930-02-18 00:00:00,Thompson Aeronautical Corporation,Flight,Operational,United States of America,North America,1,1,0,0,0,0,1,Weather
1930-02-18 00:00:00,C. W. Petchell,Landing (descent or approach),Business,South Africa,Africa,1,1,0,0,0,0,1,Unknown
1930-02-19 00:00:00,Canadian Airways,Flight,Commercial,Canada,North America,0,0,0,0,0,0,0,Weather
1930-02-24 00:00:00,Western Air Express,Flight,Operational,United States of America,North America,1,1,0,0,0,0,1,Weather
1930-02-27 00:00:00,Cinque Ports Flying Club,Flight,Operational,United Kingdom,Europe,2,2,0,0,0,0,2,Unknown
1930-03-02 00:00:00,"New York, Rio %26 Buenos Aires Airlines",Landing (descent or approach),Commercial,Argentina,South America,0,0,0,0,0,0,0,Unknown
1930-03-05 00:00:00,Royal Air Force - RAF,Takeoff (climb),Military / Government,United Kingdom,Europe,4,4,0,0,0,0,4,Technical Failure
1930-03-05 00:00:00,L'Aéropostale,Flight,Operational,World,World,3,3,0,0,0,0,3,Unknown
1930-03-06 00:00:00,Guinea Airways,Landing (descent or approach),Commercial,Papua New Guinea,Oceania,1,1,0,0,0,0,1,Human Factor
1930-03-10 00:00:00,Frederick E. Guest,Flight,Business,United Kingdom,Europe,2,1,0,1,0,0,2,Unknown
1930-03-11 00:00:00,Thompson Aeronautical Corporation,Flight,Operational,United States of America,North America,1,1,0,0,0,0,1,Weather
1930-03-22 00:00:00,G. R. Boggs,Landing (descent or approach),Business,United States of America,North America,2,1,0,1,0,0,2,Weather
1930-03-24 00:00:00,National Flying Services,Flight,Commercial,Germany,Europe,0,0,0,0,0,0,0,Unknown
1930-03-25 00:00:00,Eastern Air Transport,Flight,Operational,United States of America,North America,1,1,0,0,0,0,1,Weather
1930-03-26 00:00:00,National Flying Services,Takeoff (climb),Operational,United Kingdom,Europe,1,1,0,0,0,0,1,Unknown
1930-03-26 00:00:00,CSA Czech Airlines - Československé Státní Aerolinie,Flight,Commercial,Czech Republic,Europe,6,1,0,5,0,0,6,Unknown
1930-03-27 00:00:00,Hampshire Aeroplane Club,Flight,Operational,United Kingdom,Europe,1,1,0,0,0,0,1,Unknown
1930-03-28 00:00:00,National Flying Services,Flight,Operational,United Kingdom,Europe,1,1,0,0,0,0,1,Unknown
1930-04-04 00:00:00,Deutsche Lufthansa,Flight,Humanitarian,Germany,Europe,2,1,0,1,0,0,2,Unknown
1930-04-05 00:00:00,Skyways - USA,Flight,Commercial,United States of America,North America,2,1,0,1,0,0,2,Technical Failure
1930-04-08 00:00:00,"New York, Rio %26 Buenos Aires Airlines",Takeoff (climb),Commercial,Argentina,South America,0,0,0,0,0,0,0,Unknown
1930-04-13 00:00:00,T. F. von Wachenfeldt,Landing (descent or approach),Business,Sweden,Europe,2,1,0,1,0,0,2,Unknown
1930-04-14 00:00:00,Henry Cockburn Gresley Heathcote-Stisted,Flight,Business,United Kingdom,Europe,1,1,0,0,0,0,1,Unknown
1930-04-20 00:00:00,London Flying Club,Landing (descent or approach),Operational,Canada,North America,2,2,0,0,0,0,2,Unknown
1930-04-21 00:00:00,Charles R. Parkerson,Flight,Business,France,Europe,1,1,0,0,0,0,1,Human Factor
1930-04-22 00:00:00,Marcel Goulette,Flight,Business,Mali,Africa,3,3,0,0,0,0,3,Technical Failure
1930-04-22 00:00:00,Bloemfontein Light Plane Club,Landing (descent or approach),Operational,South Africa,Africa,2,2,0,0,0,0,2,Unknown
1930-04-25 00:00:00,Deutsche Versuchsanstalt für Luftfahrt,Flight,Specialised Services,Germany,Europe,2,2,0,0,0,0,2,Unknown
1930-04-26 00:00:00,Sturmvogel,Takeoff (climb),Business,Germany,Europe,4,1,0,3,0,0,4,Human Factor
1930-04-26 00:00:00,National Air Transport - USA,Flight,Operational,United States of America,North America,1,1,0,0,0,0,1,Weather
1930-04-29 00:00:00,Canadian Airways,Flight,Commercial,Canada,North America,0,0,0,0,0,0,0,Unknown
1930-04-30 00:00:00,Schlee-Brock Aircraft Corporation - SBAC,Takeoff (climb),Business,United States of America,North America,0,0,0,0,0,0,0,Unknown
1930-05-02 00:00:00,Air Union France,Flight,Operational,United Kingdom,Europe,2,2,0,0,0,0,2,Technical Failure
1930-05-02 00:00:00,United States Army Air Corps - USAAC,Flight,Military / Government,United States of America,North America,8,2,0,6,0,0,8,Technical Failure
1930-05-04 00:00:00,L'Aéropostale,Flight,Operational,Algeria,Africa,3,3,0,0,0,0,3,Technical Failure
1930-05-07 00:00:00,Royal Canadian Air Force - RCAF,Flight,Operational,Canada,North America,2,2,0,0,0,0,2,Unknown
1930-05-08 00:00:00,Ottawa Flying Club,Takeoff (climb),Operational,Canada,North America,2,2,0,0,0,0,2,Technical Failure
1930-05-09 00:00:00,Pacific Air Transport,Takeoff (climb),Operational,United States of America,North America,1,1,0,0,0,0,1,Other
1930-05-10 00:00:00,National Flying Services,Flight,Operational,United Kingdom,Europe,2,2,0,0,0,0,2,Unknown
1930-05-13 00:00:00,United States Airways,Landing (descent or approach),Commercial,United States of America,North America,3,1,0,2,0,0,3,Technical Failure
1930-05-14 00:00:00,Schlee-Brock Aircraft Corporation - SBAC,Landing (descent or approach),Business,Canada,North America,3,1,0,2,0,0,3,Unknown
1930-05-15 00:00:00,Nora Thornton Trevelyan,Takeoff (climb),Business,United Kingdom,Europe,1,1,0,0,0,0,1,Unknown
1930-05-15 00:00:00,Hampshire Aeroplane Club,Flight,Operational,United Kingdom,Europe,2,2,0,0,0,0,2,Unknown
1930-05-16 00:00:00,French Air Force - Armée de l'Air,Flight,Military / Government,France,Europe,3,3,0,0,0,0,3,Weather
1930-05-20 00:00:00,Dobrolet,,Commercial,Russia,Asia,0,0,0,0,0,0,0,Unknown
1930-05-23 00:00:00,French Air Force - Armée de l'Air,Flight,Operational,France,Europe,4,4,0,0,0,0,4,Unknown
1930-05-24 00:00:00,National Air Transport - USA,Flight,Operational,United States of America,North America,1,1,0,0,0,0,1,Technical Failure
1930-05-25 00:00:00,Great Western Airways,Takeoff (climb),Operational,Canada,North America,0,0,0,0,0,0,0,Unknown
1930-05-27 00:00:00,Corporación Aeronautica de Transportes,Flight,Commercial,Mexico,Central America,0,0,0,0,0,0,0,Unknown
1930-05-30 00:00:00,Compagnie Internationale de Navigation Aérienne - CIDNA,Takeoff (climb),Commercial,Turkey,Asia,0,0,0,0,0,0,0,Unknown
1930-05-31 00:00:00,Ellyou Goldfields Development Corporation,Flight,Business,Papua New Guinea,Oceania,0,0,0,0,0,0,0,Unknown
1930-05-31 00:00:00,CSA Czech Airlines - Československé Státní Aerolinie,Flight,Commercial,Czech Republic,Europe,1,1,0,0,0,0,1,Technical Failure
1930-06-02 00:00:00,Air Ferries,Takeoff (climb),Commercial,United States of America,North America,8,2,0,6,0,0,8,Other
1930-06-02 00:00:00,Northern Aerial Minerals Exploration,Landing (descent or approach),Operational,Canada,North America,1,1,0,0,0,0,1,Weather
1930-06-10 00:00:00,Aero Espresso Italiana,Takeoff (climb),Commercial,Greece,Europe,12,3,0,9,0,0,12,Technical Failure
1930-06-12 00:00:00,Western Canada Airways,Landing (descent or approach),Commercial,Canada,North America,0,0,0,0,0,0,0,Unknown
1930-06-13 00:00:00,Deutsche Lufthansa,Flight,Commercial,Germany,Europe,0,0,0,0,0,0,0,Technical Failure
1930-06-14 00:00:00,Phillips %26 Powis Aircraft,Landing (descent or approach),Operational,United Kingdom,Europe,2,2,0,0,0,0,2,Unknown
1930-06-19 00:00:00,Simmonds Aircraft,Landing (descent or approach),Operational,United Kingdom,Europe,1,1,0,0,0,0,1,Technical Failure
1930-06-22 00:00:00,Boeing Air Transport,Flight,Operational,United States of America,North America,1,1,0,0,0,0,1,Unknown
1930-06-22 00:00:00,Harstad Lufttrafik,Takeoff (climb),Military / Government,Norway,Europe,2,1,0,1,0,0,2,Technical Failure
1930-06-22 00:00:00,Hylton R. Murray-Philipson,Flight,Business,United Kingdom,Europe,3,1,0,2,0,0,3,Human Factor
1930-06-23 00:00:00,Interlake Airways,Flight,Operational,Canada,North America,1,1,0,0,0,0,1,Technical Failure
1930-07-02 00:00:00,National Air Transport - USA,Flight,Operational,United States of America,North America,1,1,0,0,0,0,1,Human Factor
1930-07-02 00:00:00,Northwest Aero Marine,Flight,Operational,Canada,North America,1,1,0,0,0,0,1,Human Factor
1930-07-02 00:00:00,Northern Aerial Minerals Exploration,Landing (descent or approach),Operational,Canada,North America,1,1,0,0,0,0,1,Technical Failure
1930-07-04 00:00:00,J. R. Paget,Takeoff (climb),Business,Canada,North America,1,1,0,0,0,0,1,Unknown
1930-07-06 00:00:00,Charles S. Wynne-Eyton,Takeoff (climb),Business,Canada,North America,1,1,0,0,0,0,1,Unknown
1930-07-08 00:00:00,L'Aéropostale,Flight,Operational,Senegal,Africa,3,3,0,0,0,0,3,Technical Failure
1930-07-09 00:00:00,Royal Australian Air Force - RAAF,Flight,Operational,Australia,Oceania,2,2,0,0,0,0,2,Unknown
1930-07-10 00:00:00,Prince Jean Ghica,Flight,Business,Bulgaria,Europe,1,1,0,0,0,0,1,Unknown
1930-07-15 00:00:00,Provincial Air Service of Lands %26 Forests,Takeoff (climb),Military / Government,Canada,North America,0,0,0,0,0,0,0,Other
1930-07-17 00:00:00,Consolidated Mining %26 Smelting Company of Canada,Takeoff (climb),Specialised Services,Canada,North America,1,1,0,0,0,0,1,Unknown
1930-07-27 00:00:00,L'Aéropostale,Flight,Operational,Morocco,Africa,1,1,0,0,0,0,1,Technical Failure
1930-07-28 00:00:00,Deutsche Lufthansa,Flight,Commercial,Germany,Europe,2,1,0,1,0,0,2,Unknown
1930-07-29 00:00:00,Dobrolet,,Commercial,Russia,Asia,0,0,0,0,0,0,0,Unknown
1930-08-03 00:00:00,John Henry Mears,Takeoff (climb),Business,Canada,North America,2,2,0,0,0,0,2,Unknown
1930-08-03 00:00:00,George Scott Lindsay,Takeoff (climb),Business,South Africa,Africa,1,1,0,0,0,0,1,Unknown
1930-08-04 00:00:00,Alaska Washington Airways,Flight,Commercial,United States of America,North America,6,1,0,5,0,0,6,Technical Failure
1930-08-04 00:00:00,L'Aéropostale,Landing (descent or approach),Operational,Brazil,South America,2,2,0,0,0,0,2,Unknown
1930-08-04 00:00:00,United States Marine Corps,Landing (descent or approach),Military / Government,Nicaragua,Central America,3,3,0,0,0,0,3,Unknown
1930-08-05 00:00:00,J. V. Elliott,Flight,Business,Canada,North America,1,1,0,0,0,0,1,Human Factor
1930-08-10 00:00:00,Western Air Express,Flight,Operational,United States of America,North America,1,1,0,0,0,0,1,Unknown
1930-08-12 00:00:00,Fairchild Aerial Surveys,Taxiing,Commercial,Canada,North America,0,0,0,0,0,0,0,Weather
1930-08-22 00:00:00,Varney Air Lines - VAL,Flight,Operational,United States of America,North America,1,1,0,0,0,0,1,Technical Failure
1930-08-27 00:00:00,G. McIntyre,Takeoff (climb),Business,Canada,North America,1,1,0,0,0,0,1,Unknown
1930-08-28 00:00:00,French Air Force - Armée de l'Air,Takeoff (climb),Operational,France,Europe,4,4,0,0,0,0,4,Unknown
1930-09-06 00:00:00,Simmonds Aircraft,Takeoff (climb),Specialised Services,United Kingdom,Europe,2,1,0,1,0,0,2,Unknown
1930-09-11 00:00:00,L'Aéropostale,Flight,Operational,World,World,3,3,0,0,0,0,3,Technical Failure
1930-09-16 00:00:00,Mason %26 Dixon Air Lines,Flight,Commercial,United States of America,North America,0,0,0,0,0,0,0,Unknown
1930-09-21 00:00:00,National Air Transport - USA,Flight,Operational,United States of America,North America,1,1,0,0,0,0,1,Technical Failure
1930-09-23 00:00:00,Western Canada Airways,Flight,Commercial,Canada,North America,2,2,0,0,0,0,2,Unknown
1930-09-27 00:00:00,Royal Canadian Air Force - RCAF,Flight,Military / Government,Canada,North America,2,1,0,1,0,0,2,Unknown
1930-09-27 00:00:00,Royal Canadian Air Force - RCAF,Flight,Military / Government,Canada,North America,2,1,0,1,0,0,2,Unknown
1930-09-30 00:00:00,Northern Air Transport,Flight,Commercial,United Kingdom,Europe,2,1,0,1,0,0,2,Unknown
1930-10-07 00:00:00,Guinea Airways,Landing (descent or approach),Commercial,Papua New Guinea,Oceania,2,1,0,1,0,0,2,Weather
1930-10-10 00:00:00,Quebec %26 Eastern Aviation,Landing (descent or approach),Commercial,Canada,North America,0,0,0,0,0,0,0,Unknown
1930-10-15 00:00:00,London Aeroplane Club,Landing (descent or approach),Operational,United Kingdom,Europe,2,2,0,0,0,0,2,Unknown
1930-10-24 00:00:00,Flygindustri,Flight,Business,Sweden,Europe,1,1,0,0,0,0,1,Unknown
1930-10-25 00:00:00,Air Union France,Flight,Operational,France,Europe,1,1,0,0,0,0,1,Technical Failure
1930-10-26 00:00:00,Provincial Air Service of Lands %26 Forests,Landing (descent or approach),Military / Government,Canada,North America,0,0,0,0,0,0,0,Unknown
1930-11-02 00:00:00,R. T. McCully,Takeoff (climb),Business,Canada,North America,2,1,0,1,0,0,2,Technical Failure
1930-11-07 00:00:00,Royal Air Force - RAF,Landing (descent or approach),Military / Government,United Kingdom,Europe,1,1,0,0,0,0,1,Unknown
1930-11-12 00:00:00,Eastern Air Transport,Flight,Operational,United States of America,North America,1,1,0,0,0,0,1,Technical Failure
1930-11-22 00:00:00,L'Aéropostale,Flight,Operational,Brazil,South America,1,1,0,0,0,0,1,Technical Failure
1930-11-22 00:00:00,Southern Transcontinental Airways,Landing (descent or approach),Commercial,United States of America,North America,0,0,0,0,0,0,0,Unknown
1930-12-02 00:00:00,Brooklands School of Flying,Flight,Operational,United Kingdom,Europe,1,1,0,0,0,0,1,Unknown
1930-12-03 00:00:00,Winifred Spooner,Flight,Business,Italy,Europe,2,2,0,0,0,0,2,Unknown
1930-12-20 00:00:00,Pittsburgh Airways,Takeoff (climb),Operational,United States of America,North America,1,1,0,0,0,0,1,Technical Failure
1930-12-22 00:00:00,LAN Chile - Linea Aérea Nacional de Chile,Flight,Commercial,Chile,South America,0,0,0,0,0,0,0,Unknown
1930-12-22 00:00:00,Western Air Express,Landing (descent or approach),Operational,United States of America,North America,3,2,0,1,0,0,3,Unknown
1930-12-24 00:00:00,Canadian Airways,Flight,Commercial,United States of America,North America,2,2,0,0,0,0,2,Technical Failure
1930-12-27 00:00:00,L'Aéropostale,Flight,Commercial,Western Sahara,Africa,3,2,0,1,0,0,3,Unknown
1930-12-31 00:00:00,LAN Chile - Linea Aérea Nacional de Chile,Flight,Commercial,Chile,South America,0,0,0,0,0,0,0,Unknown
1931-01-01 00:00:00,Pacific Air Transport,Flight,Operational,United States of America,North America,1,1,0,0,0,0,1,Weather
1931-01-02 00:00:00,Sydenham Armstrong Payn,Landing (descent or approach),Business,United Kingdom,Europe,1,1,0,0,0,0,1,Technical Failure
1931-01-05 00:00:00,Royal Air Force - RAF,Flight,Operational,United Kingdom,Europe,2,2,0,0,0,0,2,Technical Failure
1931-01-06 00:00:00,United States Army Air Corps - USAAC,Takeoff (climb),Military / Government,United States of America,North America,4,4,0,0,0,0,4,Technical Failure
1931-01-06 00:00:00,Regia Aeronautica,Flight,Military / Government,World,World,4,4,0,0,0,0,4,Technical Failure
1931-01-17 00:00:00,Air Union France,Landing (descent or approach),Operational,France,Europe,1,1,0,0,0,0,1,Technical Failure
1931-01-17 00:00:00,Guinea Airways,Landing (descent or approach),Operational,Papua New Guinea,Oceania,2,1,0,1,0,0,2,Technical Failure
1931-01-19 00:00:00,Dobrolet,,Commercial,Russia,Asia,0,0,0,0,0,0,0,Unknown
1931-01-27 00:00:00,Transcontinental %26 Western Air - TWA,Landing (descent or approach),Commercial,United States of America,North America,0,0,0,0,0,0,0,Human Factor
1931-01-30 00:00:00,Ukrvozduchput,,Commercial,Russia,Asia,0,0,0,0,0,0,0,Unknown
1931-02-01 00:00:00,Southern Alberta Airlines,Takeoff (climb),Commercial,Canada,North America,2,1,0,1,0,0,2,Unknown
1931-02-02 00:00:00,Brooklands School of Flying,Flight,Specialised Services,United Kingdom,Europe,2,1,0,1,0,0,2,Unknown
1931-02-02 00:00:00,Bristol Aeroplane Company,Landing (descent or approach),Specialised Services,United Kingdom,Europe,1,1,0,0,0,0,1,Unknown
1931-02-03 00:00:00,Panagra - Pan American-Grace Airways,Flight,Operational,Chile,South America,2,2,0,0,0,0,2,Unknown
1931-02-04 00:00:00,L'Aéropostale,Flight,Operational,France,Europe,2,2,0,0,0,0,2,Technical Failure
1931-02-07 00:00:00,Panagra - Pan American-Grace Airways,Landing (descent or approach),Operational,Panama,Central America,3,3,0,0,0,0,3,Unknown
1931-02-15 00:00:00,Dobrolet,,Commercial,Russia,Asia,0,0,0,0,0,0,0,Unknown
1931-02-24 00:00:00,Royal Australian Air Force - RAAF,Landing (descent or approach),Operational,Australia,Oceania,2,2,0,0,0,0,2,Unknown
1931-03-02 00:00:00,Wight Aviation,Takeoff (climb),Commercial,United Kingdom,Europe,1,1,0,0,0,0,1,Unknown
1931-03-02 00:00:00,Boeing Air Transport,Flight,Commercial,United States of America,North America,3,1,0,2,0,0,3,Technical Failure
1931-03-07 00:00:00,Deutsche Lufthansa,Flight,Commercial,Netherlands,Europe,8,3,0,5,0,0,8,Technical Failure
1931-03-08 00:00:00,Montreal Light Aeroplane Club,Landing (descent or approach),Business,Canada,North America,2,1,0,1,0,0,2,Unknown
1931-03-10 00:00:00,United States Army Air Corps - USAAC,Flight,Military / Government,United States of America,North America,2,2,0,0,0,0,2,Technical Failure
1931-03-12 00:00:00,Canadian Airways,Flight,Commercial,Canada,North America,0,0,0,0,0,0,0,Technical Failure
1931-03-14 00:00:00,Private Japanese,Flight,Business,Japan,Asia,0,0,0,0,0,0,0,Unknown
1931-03-15 00:00:00,Eastern Air Transport,Flight,Operational,United States of America,North America,1,1,0,0,0,0,1,Weather
1931-03-18 00:00:00,Pacific Aerial Transport,Takeoff (climb),Commercial,Papua New Guinea,Oceania,2,1,0,1,0,0,2,Human Factor
1931-03-23 00:00:00,Tehmurusp Heerjeebhoy Dastur,Takeoff (climb),Business,United Kingdom,Europe,1,1,0,0,0,0,1,Unknown
1931-04-01 00:00:00,Panagra - Pan American-Grace Airways,Landing (descent or approach),Commercial,Chile,South America,7,2,0,5,0,0,7,Unknown
1931-04-08 00:00:00,Cinque Ports Flying Club,Flight,Business,United Kingdom,Europe,2,1,0,1,0,0,2,Unknown
1931-04-17 00:00:00,George Valentin Bibescu,Flight,Business,India,Asia,4,2,0,2,0,0,4,Other
1931-04-18 00:00:00,Deutsche Lufthansa,Flight,Commercial,France,Europe,6,3,0,3,0,0,6,Weather
1931-04-19 00:00:00,Imperial Airways,Landing (descent or approach),Operational,Indonesia,Asia,2,2,0,0,0,0,2,Technical Failure
1931-04-22 00:00:00,Imperial Airways,Takeoff (climb),Operational,United Kingdom,Europe,2,2,0,0,0,0,2,Technical Failure
1931-04-27 00:00:00,Air Union France,Takeoff (climb),Operational,United Kingdom,Europe,2,2,0,0,0,0,2,Unknown
1931-04-29 00:00:00,National Air Transport - USA,Landing (descent or approach),Commercial,United States of America,North America,10,2,0,8,0,0,10,Technical Failure
1931-05-02 00:00:00,Venetia Montagu,Flight,Business,Iran,Asia,2,1,0,1,0,0,2,Unknown
1931-05-04 00:00:00,Provincial Air Service of Lands %26 Forests,Landing (descent or approach),Military / Government,Canada,North America,0,0,0,0,0,0,0,Human Factor
1931-05-07 00:00:00,Royal Air Force - RAF,Flight,Operational,United Kingdom,Europe,2,2,0,0,0,0,2,Technical Failure
1931-05-08 00:00:00,Royal Air Force - RAF,Landing (descent or approach),Military / Government,United Kingdom,Europe,2,1,0,1,0,0,2,Unknown
1931-05-13 00:00:00,Royal Air Force - RAF,Flight,Operational,United Kingdom,Europe,2,2,0,0,0,0,2,Unknown
1931-05-13 00:00:00,Canadian Airways,Flight,Operational,Canada,North America,1,1,0,0,0,0,1,Unknown
1931-05-14 00:00:00,Tage C. J. Wahrgren,Flight,Business,Sweden,Europe,1,1,0,0,0,0,1,Technical Failure
1931-05-14 00:00:00,National Flying Services,Landing (descent or approach),Commercial,United Kingdom,Europe,2,1,0,1,0,0,2,Unknown
1931-05-16 00:00:00,B.F. Goodrich Company,Flight,Specialised Services,Canada,North America,2,2,0,0,0,0,2,Unknown
1931-05-20 00:00:00,Newcastle upon Tyne Light Aeroplane Club,Flight,Business,United Kingdom,Europe,2,1,0,1,0,0,2,Unknown
1931-05-22 00:00:00,Finnish Air Force - Suomen Ilmavoimat,Flight,Operational,Sweden,Europe,2,2,0,0,0,0,2,Unknown
1931-05-26 00:00:00,Aeroflot - Russian International Airlines,,Commercial,Russia,Asia,0,0,0,0,0,0,0,Unknown
1931-06-03 00:00:00,London Aeroplane Club,Takeoff (climb),Business,United Kingdom,Europe,1,1,0,0,0,0,1,Unknown
1931-06-03 00:00:00,Kent Aircraft Services,Takeoff (climb),Commercial,United Kingdom,Europe,3,1,0,2,0,0,3,Human Factor
1931-06-03 00:00:00,G. V. Forknall,Flight,Business,Australia,Oceania,1,1,0,0,0,0,1,Unknown
1931-06-15 00:00:00,Johannesburg Light Plane Club,Flight,Business,South Africa,Africa,2,2,0,0,0,0,2,Unknown
1931-06-16 00:00:00,Imperial Airways,Takeoff (climb),Commercial,Egypt,Africa,7,3,0,4,0,0,7,Unknown
1931-06-20 00:00:00,Royal Danish Air Force - Flyvevåbnet,Takeoff (climb),Operational,Denmark,Europe,2,2,0,0,0,0,2,Unknown
1931-06-28 00:00:00,Ottawa Flying Club,Takeoff (climb),Operational,Canada,North America,2,2,0,0,0,0,2,Unknown
1931-07-02 00:00:00,Phillips %26 Powis Aircraft,Flight,Business,United Kingdom,Europe,2,2,0,0,0,0,2,Unknown
1931-07-02 00:00:00,Eurasia Aviation Corporation,Landing (descent or approach),Operational,China,Asia,2,2,0,0,0,0,2,Unknown
1931-07-06 00:00:00,Hochi Shimbun,Flight,Business,Japan,Asia,1,1,0,0,0,0,1,Unknown
1931-07-13 00:00:00,Lauro Adolfo De Bosis,Flight,Business,France,Europe,1,1,0,0,0,0,1,Human Factor
1931-07-14 00:00:00,François Coty,Flight,Business,Russia,Asia,3,3,0,0,0,0,3,Technical Failure
1931-07-15 00:00:00,Tozai Teiki Kokukai,Flight,Specialised Services,World,World,1,1,0,0,0,0,1,Unknown
1931-07-15 00:00:00,Royal Canadian Air Force - RCAF,Flight,Operational,Canada,North America,1,1,0,0,0,0,1,Technical Failure
1931-07-16 00:00:00,Ontario Provincial Air Service,Takeoff (climb),Commercial,Canada,North America,0,0,0,0,0,0,0,Technical Failure
1931-07-16 00:00:00,Argentinian Navy - Armada Argentina,Flight,Operational,Argentina,South America,0,0,0,0,0,0,0,Unknown
1931-07-16 00:00:00,Brantford-Norfolk Aero Club,Landing (descent or approach),Operational,Canada,North America,2,2,0,0,0,0,2,Unknown
1931-07-18 00:00:00,Southern Transcontinental Airways,Flight,Operational,United States of America,North America,1,1,0,0,0,0,1,Unknown
1931-07-21 00:00:00,Air Union France,Flight,Operational,France,Europe,0,0,0,0,0,0,0,Unknown
1931-07-22 00:00:00,Royal Canadian Air Force - RCAF,Landing (descent or approach),Operational,Canada,North America,1,1,0,0,0,0,1,Unknown
1931-07-23 00:00:00,Royal Canadian Air Force - RCAF,Landing (descent or approach),Operational,Canada,North America,2,2,0,0,0,0,2,Unknown
1931-07-24 00:00:00,United States Army Air Corps - USAAC,Landing (descent or approach),Military / Government,United States of America,North America,0,0,0,0,0,0,0,Unknown
1931-07-31 00:00:00,Iona National Airways,Flight,Commercial,Ireland,Europe,2,1,0,1,0,0,2,Unknown
1931-08-01 00:00:00,Robert Henry Thomas,Flight,Business,United Kingdom,Europe,1,1,0,0,0,0,1,Unknown
1931-08-02 00:00:00,Kent Aircraft Services,Flight,Operational,United Kingdom,Europe,1,1,0,0,0,0,1,Human Factor
1931-08-04 00:00:00,KLM Royal Dutch Airlines - Koninklijke Luchtvaart Maatschappij,Landing (descent or approach),Commercial,Netherlands,Europe,15,2,0,13,0,0,15,Technical Failure
1931-08-07 00:00:00,Mexicana de Aviación,Landing (descent or approach),Commercial,United States of America,North America,0,0,0,0,0,0,0,Unknown
1931-08-09 00:00:00,De Havilland Aircraft UK,Landing (descent or approach),Operational,United Kingdom,Europe,2,2,0,0,0,0,2,Unknown
1931-08-10 00:00:00,United States Army Air Corps - USAAC,Flight,Military / Government,United States of America,North America,5,5,0,0,0,0,5,Technical Failure
1931-08-11 00:00:00,China National Aviation Corporation - CNAC,Landing (descent or approach),Commercial,China,Asia,4,1,0,3,0,0,4,Technical Failure
1931-08-12 00:00:00,Pan American World Airways - PAA,Landing (descent or approach),Commercial,Puerto Rico,Central America,9,2,0,7,0,0,9,Other
1931-08-14 00:00:00,Francis Charles Chichester,Takeoff (climb),Business,Japan,Asia,1,1,0,0,0,0,1,Unknown
1931-08-19 00:00:00,Transcontinental %26 Western Air - TWA,Landing (descent or approach),Commercial,United States of America,North America,8,2,0,6,0,0,8,Weather
1931-08-31 00:00:00,Selkhozaviatsiya,,Commercial,Russia,Asia,0,0,0,0,0,0,0,Unknown
1931-08-31 00:00:00,Selkhozaviatsiya,,Commercial,Russia,Asia,0,0,0,0,0,0,0,Unknown
1931-09-01 00:00:00,Swedish Air Force - Flygvapnet,Flight,Operational,Sweden,Europe,1,1,0,0,0,0,1,Human Factor
1931-09-02 00:00:00,"New York, Philadelphia and Washington Airway Corporation",,Commercial,United States of America,North America,0,0,0,0,0,0,0,Unknown
1931-09-03 00:00:00,Newcastle upon Tyne Light Aeroplane Club,Takeoff (climb),Business,United Kingdom,Europe,2,1,0,1,0,0,2,Other
1931-09-04 00:00:00,Norske Luftruter,Flight,Commercial,Norway,Europe,1,1,0,0,0,0,1,Unknown
1931-09-13 00:00:00,Wilhelm Rody,Flight,Business,Brazil,South America,3,3,0,0,0,0,3,Unknown
1931-09-13 00:00:00,Northern Air Transport,Flight,Commercial,United Kingdom,Europe,2,1,0,1,0,0,2,Unknown
1931-09-15 00:00:00,Belgian Air Force - Force Aérienne Belge - Belgische Luchtmacht,Flight,Operational,Belgium,Europe,2,2,0,0,0,0,2,Technical Failure
1931-09-24 00:00:00,Hans Bertram,Flight,Business,India,Asia,3,3,0,0,0,0,3,Weather
1931-09-28 00:00:00,Royal Canadian Air Force - RCAF,Flight,Operational,Canada,North America,1,1,0,0,0,0,1,Human Factor
1931-09-30 00:00:00,Air Orient,Flight,Commercial,Pakistan,Asia,4,2,0,2,0,0,4,Technical Failure
1931-09-30 00:00:00,Royal Netherlands East Indies Air Force - ML-KNIL,Flight,Military / Government,Indonesia,Asia,1,1,0,0,0,0,1,Technical Failure
1931-10-06 00:00:00,E. Kelley-Patterson,Flight,Business,South Africa,Africa,1,1,0,0,0,0,1,Unknown
1931-10-09 00:00:00,Australian Aero Club,Landing (descent or approach),Operational,Australia,Oceania,1,1,0,0,0,0,1,Human Factor
1931-10-10 00:00:00,Transaviatsiya,,Commercial,Russia,Asia,0,0,0,0,0,0,0,Unknown
1931-10-18 00:00:00,Regina Flying Club,Landing (descent or approach),Business,Canada,North America,2,1,0,1,0,0,2,Unknown
1931-10-25 00:00:00,L'Aéropostale,Flight,Operational,Morocco,Africa,1,1,0,0,0,0,1,Unknown
1931-10-27 00:00:00,National Air Transport - USA,Flight,Commercial,United States of America,North America,0,0,0,0,0,0,0,Unknown
1931-10-31 00:00:00,Selkhozaviatsiya,,Commercial,Russia,Asia,0,0,0,0,0,0,0,Unknown
1931-11-04 00:00:00,Border Cities Aero Club,Flight,Business,Canada,North America,1,1,0,0,0,0,1,Unknown
1931-11-04 00:00:00,Brazilian Air Force - Aviação Militar,Flight,Military / Government,Ecuador,South America,3,3,0,0,0,0,3,Unknown
1931-11-10 00:00:00,Swedish Air Force - Flygvapnet,Flight,Operational,Sweden,Europe,1,1,0,0,0,0,1,Human Factor
1931-11-10 00:00:00,Swedish Air Force - Flygvapnet,Flight,Operational,Sweden,Europe,1,1,0,0,0,0,1,Human Factor
1931-11-16 00:00:00,Francis W. Armitage,Landing (descent or approach),Business,United Kingdom,Europe,1,1,0,0,0,0,1,Technical Failure
1931-11-23 00:00:00,Deutsche Lufthansa,,Commercial,Germany,Europe,0,0,0,0,0,0,0,Unknown
1931-11-26 00:00:00,Australian National Airways - ANA,Takeoff (climb),Operational,Malaysia,Asia,4,3,0,1,0,0,4,Other
1931-11-28 00:00:00,Pennsylvania Airlines,Takeoff (climb),Operational,United States of America,North America,1,1,0,0,0,0,1,Technical Failure
1931-12-10 00:00:00,Canadian Airways,Landing (descent or approach),Operational,Canada,North America,2,2,0,0,0,0,2,Weather
1931-12-15 00:00:00,Canadian Airways,Takeoff (climb),Commercial,Canada,North America,0,0,0,0,0,0,0,Other
1931-12-16 00:00:00,London Flying Club,Landing (descent or approach),Operational,Canada,North America,2,2,0,0,0,0,2,Human Factor
1931-12-19 00:00:00,Canadian Airways,Flight,Operational,Canada,North America,1,1,0,0,0,0,1,Weather
1931-12-24 00:00:00,Bata Shoes,Flight,Operational,Austria,Europe,2,2,0,0,0,0,2,Weather
1931-12-24 00:00:00,National Air Transport - USA,Flight,Operational,United States of America,North America,1,1,0,0,0,0,1,Technical Failure
1931-12-28 00:00:00,Compagnie Générale TransSaharienne - CGT France,Flight,Operational,Algeria,Africa,2,1,0,1,0,0,2,Technical Failure
1931-12-31 00:00:00,Union Airways,Landing (descent or approach),Commercial,South Africa,Africa,3,3,0,0,0,0,3,Unknown
1932-01-14 00:00:00,Transcontinental %26 Western Air - TWA,Flight,Operational,United States of America,North America,1,1,0,0,0,0,1,Technical Failure
1932-01-18 00:00:00,Wilson Airways,Flight,Commercial,Zambia,Africa,5,1,0,4,0,0,5,Unknown
1932-01-22 00:00:00,Aero Service,Landing (descent or approach),Operational,United States of America,North America,1,1,0,0,0,0,1,Technical Failure
1932-02-08 00:00:00,New York Airways,Flight,Commercial,United States of America,North America,0,0,0,0,0,0,0,Unknown
1932-02-09 00:00:00,Western Air Express,,Commercial,United States of America,North America,0,0,0,0,0,0,0,Unknown
1932-02-10 00:00:00,United States Army Air Corps - USAAC,Flight,Operational,United States of America,North America,5,5,0,0,0,0,5,Technical Failure
1932-02-16 00:00:00,Societa Anonima di Navigazione Aerea - SANA,Flight,Commercial,Malta,Europe,9,4,0,5,0,0,9,Technical Failure
1932-02-17 00:00:00,United States Army Air Corps - USAAC,Flight,Operational,United States of America,North America,5,5,0,0,0,0,5,Unknown
1932-02-19 00:00:00,Leslie S. Hamilton,Flight,Business,Italy,Europe,2,2,0,0,0,0,2,Weather
1932-02-20 00:00:00,National Flying Services,Takeoff (climb),Operational,United Kingdom,Europe,1,1,0,0,0,0,1,Unknown
1932-02-21 00:00:00,L'Aéropostale,Flight,Operational,Spain,Europe,2,2,0,0,0,0,2,Technical Failure
1932-02-21 00:00:00,United States Army Air Corps - USAAC,Flight,Military / Government,United States of America,North America,4,4,0,0,0,0,4,Weather
1932-02-21 00:00:00,J. A. Kerr,Takeoff (climb),Business,Australia,Oceania,2,1,0,1,0,0,2,Unknown
1932-02-27 00:00:00,Aerocentro Ligure da Turismo,Landing (descent or approach),Business,Italy,Europe,2,1,0,1,0,0,2,Unknown
1932-02-29 00:00:00,H. Watt,Flight,Business,Canada,North America,0,0,0,0,0,0,0,Unknown
1932-03-04 00:00:00,Wairarapa Aero Club,Flight,Operational,New Zealand,Oceania,1,1,0,0,0,0,1,Unknown
1932-03-16 00:00:00,L'Aéropostale,Flight,Commercial,Spain,Europe,8,2,0,6,0,0,8,Technical Failure
1932-03-16 00:00:00,Leavens Brothers Air Services,Takeoff (climb),Commercial,Canada,North America,0,0,0,0,0,0,0,Weather
1932-03-18 00:00:00,Air Orient,Flight,Commercial,Syria,Asia,0,0,0,0,0,0,0,Unknown
1932-03-20 00:00:00,Bhaba Deb Mukerjee,Landing (descent or approach),Business,India,Asia,1,1,0,0,0,0,1,Human Factor
1932-03-23 00:00:00,National Flying Services,Landing (descent or approach),Business,United Kingdom,Europe,2,1,0,1,0,0,2,Technical Failure
1932-04-01 00:00:00,British Air Transport - BAT,Landing (descent or approach),Operational,United Kingdom,Europe,1,1,0,0,0,0,1,Unknown
1932-04-03 00:00:00,Pan American World Airways - PAA,,Commercial,Uruguay,South America,0,0,0,0,0,0,0,Unknown
1932-04-06 00:00:00,Century Airways,Takeoff (climb),Commercial,Canada,North America,2,1,0,1,0,0,2,Unknown
1932-04-17 00:00:00,Marga von Etzdorf,Takeoff (climb),Business,Thailand,Asia,1,1,0,0,0,0,1,Technical Failure
1932-04-28 00:00:00,Border Cities Aero Club,Flight,Business,United States of America,North America,2,1,0,1,0,0,2,Unknown
1932-04-30 00:00:00,Polyarnaya Aviatsiya,,Commercial,Russia,Asia,0,0,0,0,0,0,0,Unknown
1932-05-02 00:00:00,Deutsche Lufthansa,Flight,Commercial,Germany,Europe,5,1,0,4,0,0,5,Weather
1932-05-09 00:00:00,Northern Air Transport,Takeoff (climb),Commercial,United Kingdom,Europe,3,1,0,2,0,0,3,Unknown
1932-05-13 00:00:00,Macfadden Publications,Flight,Business,Ireland,Europe,1,1,0,0,0,0,1,Unknown
1932-05-26 00:00:00,Eastern Air Transport,Flight,Commercial,United Kingdom,Europe,2,1,0,1,0,0,2,Technical Failure
1932-05-28 00:00:00,Surrey Flying Services,Takeoff (climb),Operational,United Kingdom,Europe,1,1,0,0,0,0,1,Unknown
1932-05-30 00:00:00,Nathan C. Browne,Flight,Specialised Services,United States of America,North America,2,2,0,0,0,0,2,Technical Failure
1932-06-02 00:00:00,Pacific Air Transport,Landing (descent or approach),Operational,United States of America,North America,1,1,0,0,0,0,1,Technical Failure
1932-06-04 00:00:00,Stanley Hausner,Flight,Business,World,World,1,1,0,0,0,0,1,Technical Failure
1932-06-14 00:00:00,New York Airways,Takeoff (climb),Commercial,United States of America,North America,0,0,0,0,0,0,0,Unknown
1932-06-18 00:00:00,Delhi %26 United Provinces Flying Club,Takeoff (climb),Business,India,Asia,2,1,0,1,0,0,2,Unknown
1932-06-20 00:00:00,Bernard B. Wickstead,Landing (descent or approach),Business,United Kingdom,Europe,1,1,0,0,0,0,1,Unknown
1932-06-25 00:00:00,Modern Airways,Flight,Commercial,United Kingdom,Europe,3,1,0,2,0,0,3,Unknown
1932-06-26 00:00:00,Maidstone Aero Club,Flight,Business,United Kingdom,Europe,2,1,0,1,0,0,2,Unknown
1932-07-03 00:00:00,Transcontinental %26 Western Air - TWA,Takeoff (climb),Operational,United States of America,North America,1,1,0,0,0,0,1,Technical Failure
1932-07-06 00:00:00,James Joseph Mattern,Landing (descent or approach),Business,Belarus,Europe,2,2,0,0,0,0,2,Technical Failure
1932-07-10 00:00:00,Boeing Air Transport,Flight,Commercial,United States of America,North America,8,3,0,5,0,0,8,Weather
1932-07-10 00:00:00,Union Airways,Flight,Commercial,South Africa,Africa,2,1,0,1,0,0,2,Unknown
1932-07-16 00:00:00,Spence-McDonough Air Transport,Landing (descent or approach),Commercial,Canada,North America,0,0,0,0,0,0,0,Unknown
1932-07-17 00:00:00,R. Usher,Takeoff (climb),Business,Kenya,Africa,2,1,0,1,0,0,2,Unknown
1932-07-18 00:00:00,William F. Jennings,Flight,Business,United Kingdom,Europe,1,1,0,0,0,0,1,Unknown
1932-07-19 00:00:00,Scottish Eastern Aircraft Services,Landing (descent or approach),Commercial,United Kingdom,Europe,3,1,0,2,0,0,3,Unknown
1932-07-30 00:00:00,Western Canada Airways,Taxiing,Commercial,United States of America,North America,0,0,0,0,0,0,0,Technical Failure
1932-08-12 00:00:00,Air Orient,Landing (descent or approach),Commercial,Lebanon,Asia,7,4,0,3,0,0,7,Unknown
1932-08-15 00:00:00,Polyarnaya Aviatsiya,,Commercial,Russia,Asia,0,0,0,0,0,0,0,Unknown
1932-08-16 00:00:00,KNILM - Koninklijke Nederlandse Indies Luchtvaart Maatschappij,Flight,Commercial,Indonesia,Asia,4,3,0,1,0,0,4,Human Factor
1932-08-26 00:00:00,Eurasia Aviation Corporation,Flight,Specialised Services,China,Asia,2,2,0,0,0,0,2,Unknown
1932-08-26 00:00:00,Royal Air Force - RAF,Landing (descent or approach),Operational,United Kingdom,Europe,2,2,0,0,0,0,2,Human Factor
1932-08-29 00:00:00,Kohler Aviation,Takeoff (climb),Commercial,United States of America,North America,7,2,0,5,0,0,7,Technical Failure
1932-09-01 00:00:00,Eurasia Aviation Corporation,,Commercial,China,Asia,0,0,0,0,0,0,0,Unknown
1932-09-01 00:00:00,Toronto Flying Club,Flight,Operational,Canada,North America,1,1,0,0,0,0,1,Unknown
1932-09-02 00:00:00,Air Orient,Landing (descent or approach),Commercial,Italy,Europe,6,4,0,2,0,0,6,Unknown
1932-09-03 00:00:00,F. J. V. Holmes,Flight,Business,United Kingdom,Europe,0,0,0,0,0,0,0,Unknown
1932-09-04 00:00:00,"Berks, Bucks %26 Oxon Flying Club",Flight,Business,United Kingdom,Europe,1,1,0,0,0,0,1,Unknown
1932-09-08 00:00:00,Polyarnaya Aviatsiya,Landing (descent or approach),Commercial,Russia,Asia,0,0,0,0,0,0,0,Unknown
1932-09-12 00:00:00,John Miskelly,Takeoff (climb),Business,United Kingdom,Europe,2,1,0,1,0,0,2,Unknown
1932-09-13 00:00:00,George R. Hutchinson,Flight,Business,Greenland,Europe,9,2,0,7,0,0,9,Weather
1932-09-15 00:00:00,Royal Danish Air Force - Flyvevåbnet,Flight,Operational,Denmark,Europe,2,2,0,0,0,0,2,Unknown
1932-09-15 00:00:00,Asahi Shimbun,Flight,Business,Japan,Asia,1,1,0,0,0,0,1,Unknown
1932-09-16 00:00:00,F. L. Clarke,Flight,Business,Canada,North America,0,0,0,0,0,0,0,Technical Failure
1932-09-17 00:00:00,Air Orient,Flight,Commercial,Iraq,Asia,7,4,0,3,0,0,7,Weather
1932-09-18 00:00:00,United States Army Air Corps - USAAC,Flight,Operational,United States of America,North America,5,5,0,0,0,0,5,Unknown
1932-09-20 00:00:00,Marshalls' Flying School,Flight,Operational,United Kingdom,Europe,2,2,0,0,0,0,2,Unknown
1932-09-22 00:00:00,Wellington Aero Club,Flight,Business,New Zealand,Oceania,2,2,0,0,0,0,2,Technical Failure
1932-09-27 00:00:00,National Air Transport - USA,Flight,Operational,United States of America,North America,1,1,0,0,0,0,1,Human Factor
1932-09-27 00:00:00,Swedish Air Force - Flygvapnet,Flight,Operational,Sweden,Europe,2,2,0,0,0,0,2,Unknown
1932-09-30 00:00:00,Transaviatsiya,,Commercial,Russia,Asia,0,0,0,0,0,0,0,Unknown
1932-10-01 00:00:00,Maidstone Airport,Flight,Business,United Kingdom,Europe,3,1,0,2,0,0,3,Unknown
1932-10-02 00:00:00,Pan American World Airways - PAA,Flight,Commercial,Honduras,Central America,0,0,0,0,0,0,0,Weather
1932-10-02 00:00:00,Bjorn Andersen,Takeoff (climb),Business,Denmark,Europe,2,1,0,1,0,0,2,Unknown
1932-10-06 00:00:00,London Flying Club,Takeoff (climb),Operational,Canada,North America,2,2,0,0,0,0,2,Unknown
1932-10-09 00:00:00,Walter Kay,Landing (descent or approach),Business,United Kingdom,Europe,1,1,0,0,0,0,1,Unknown
1932-10-16 00:00:00,De Havilland Aeroplane Hire Service,Landing (descent or approach),Specialised Services,United Kingdom,Europe,1,1,0,0,0,0,1,Unknown
1932-10-16 00:00:00,Wilson Airways,Takeoff (climb),Commercial,Kenya,Africa,2,1,0,1,0,0,2,Unknown
1932-10-18 00:00:00,Pacific Aerial Transport,Landing (descent or approach),Operational,Papua New Guinea,Oceania,1,1,0,0,0,0,1,Unknown
1932-10-21 00:00:00,Pennsylvania Airlines,Flight,Operational,United States of America,North America,1,1,0,0,0,0,1,Technical Failure
1932-10-31 00:00:00,Babar Mirza,Flight,Business,Iran,Asia,1,1,0,0,0,0,1,Technical Failure
1932-11-03 00:00:00,Societa Anonima di Navigazione Aerea - SANA,Takeoff (climb),Commercial,Italy,Europe,18,4,0,14,0,0,18,Technical Failure
1932-11-04 00:00:00,Crosley Radio Corporation,Takeoff (climb),Business,United States of America,North America,1,1,0,0,0,0,1,Unknown
1932-11-04 00:00:00,Border Cities Aero Club,Takeoff (climb),Operational,Canada,North America,2,2,0,0,0,0,2,Unknown
1932-11-05 00:00:00,French Air Force - Armée de l'Air,Flight,Military / Government,France,Europe,4,4,0,0,0,0,4,Weather
1932-11-09 00:00:00,Wilhelm M. Omsted,Landing (descent or approach),Business,Norway,Europe,2,1,0,1,0,0,2,Unknown
1932-11-19 00:00:00,Eastern Air Transport,Flight,Operational,United States of America,North America,1,1,0,0,0,0,1,Other
1932-11-20 00:00:00,Marlborough Aero Club,Landing (descent or approach),Business,New Zealand,Oceania,2,1,0,1,0,0,2,Unknown
1932-11-21 00:00:00,Aeroflot - Russian International Airlines,,Commercial,Ukraine,Europe,0,0,0,0,0,0,0,Unknown
1932-11-30 00:00:00,Independent Airways,Takeoff (climb),Commercial,Canada,North America,0,0,0,0,0,0,0,Human Factor
1932-12-11 00:00:00,Western Air Express,Flight,Commercial,United States of America,North America,0,0,0,0,0,0,0,Unknown
1932-12-13 00:00:00,Boeing Air Transport,Flight,Operational,United States of America,North America,1,1,0,0,0,0,1,Technical Failure
1932-12-15 00:00:00,Eurasia Aviation Corporation,Flight,Commercial,China,Asia,0,0,0,0,0,0,0,Unknown
1932-12-28 00:00:00,American Airways,Flight,Commercial,United States of America,North America,0,0,0,0,0,0,0,Unknown
1932-12-31 00:00:00,SCADTA - Sociedad Colombo-Alemana de Transportes Aéreos,,Commercial,Colombia,South America,0,0,0,0,0,0,0,Unknown
1933-01-10 00:00:00,Transcontinental %26 Western Air - TWA,Takeoff (climb),Operational,United States of America,North America,1,1,0,0,0,0,1,Unknown
1933-01-13 00:00:00,Air Union France,Flight,Commercial,France,Europe,6,2,0,4,0,0,6,Technical Failure
1933-01-13 00:00:00,Deutsche Lufthansa,Flight,Operational,Greece,Europe,2,2,0,0,0,0,2,Weather
1933-01-14 00:00:00,Audrey Florence Durrell-Drummond Sale-Barker,Flight,Business,Kenya,Africa,2,1,0,1,0,0,2,Human Factor
1933-01-25 00:00:00,June Jewell James,Takeoff (climb),Business,Italy,Europe,3,2,0,1,0,0,3,Unknown
1933-01-26 00:00:00,Karl Ryman,Takeoff (climb),Business,Sweden,Europe,1,1,0,0,0,0,1,Unknown
1933-01-31 00:00:00,Canadian Airways,Flight,Commercial,Canada,North America,0,0,0,0,0,0,0,Unknown
1933-02-10 00:00:00,Transcontinental %26 Western Air - TWA,Landing (descent or approach),Commercial,United States of America,North America,9,2,0,7,0,0,9,Technical Failure
1933-02-14 00:00:00,E. Mauerhofer,Flight,Business,Switzerland,Europe,1,1,0,0,0,0,1,Unknown
1933-02-15 00:00:00,Boeing Air Transport,Flight,Operational,United States of America,North America,1,1,0,0,0,0,1,Unknown
1933-02-18 00:00:00,SCADTA - Sociedad Colombo-Alemana de Transportes Aéreos,Takeoff (climb),Commercial,Colombia,South America,4,2,0,2,0,0,4,Unknown
1933-02-25 00:00:00,National Air Transport - USA,Takeoff (climb),Operational,United States of America,North America,1,1,0,0,0,0,1,Unknown
1933-02-26 00:00:00,Transcontinental %26 Western Air - TWA,Flight,Operational,United States of America,North America,1,1,0,0,0,0,1,Technical Failure
1933-02-28 00:00:00,Ernst Udet,Takeoff (climb),Specialised Services,Germany,Europe,1,1,0,0,0,0,1,Unknown
1933-03-07 00:00:00,British Air Transport - BAT,Flight,Commercial,World,World,2,1,0,1,0,0,2,Technical Failure
1933-03-07 00:00:00,Surencha Chandulal Mehta,Flight,Business,United Kingdom,Europe,1,1,0,0,0,0,1,Unknown
1933-03-16 00:00:00,American Airways,Takeoff (climb),Commercial,United States of America,North America,3,1,0,2,0,0,3,Technical Failure
1933-03-21 00:00:00,United States Marine Corps,Takeoff (climb),Military / Government,United States of America,North America,14,2,0,12,0,0,14,Technical Failure
1933-03-22 00:00:00,American Airways,Flight,Operational,United States of America,North America,1,1,0,0,0,0,1,Technical Failure
1933-03-22 00:00:00,Union Airways,Takeoff (climb),Commercial,South Africa,Africa,2,1,0,1,0,0,2,Unknown
1933-03-26 00:00:00,Royal Air Force - RAF,Landing (descent or approach),Operational,United Kingdom,Europe,1,1,0,0,0,0,1,Unknown
1933-04-07 00:00:00,National Air Transport - USA,Flight,Operational,United States of America,North America,1,1,0,0,0,0,1,Unknown
1933-04-08 00:00:00,C. H. Ferris,Takeoff (climb),Business,Australia,Oceania,2,1,0,1,0,0,2,Unknown
1933-04-27 00:00:00,Shell Aviation,Taxiing,Business,United States of America,North America,2,1,0,1,0,0,2,Human Factor
1933-04-30 00:00:00,London Flying Club,Landing (descent or approach),Business,Canada,North America,2,1,0,1,0,0,2,Technical Failure
1933-05-03 00:00:00,Kent Flying Club,Flight,Business,United Kingdom,Europe,1,1,0,0,0,0,1,Human Factor
1933-05-04 00:00:00,United States Army Air Corps - USAAC,Landing (descent or approach),Military / Government,United States of America,North America,0,0,0,0,0,0,0,Unknown
1933-05-05 00:00:00,United States Army Air Corps - USAAC,Landing (descent or approach),Military / Government,United States of America,North America,0,0,0,0,0,0,0,Unknown
1933-05-07 00:00:00,Hillman's Airways,Landing (descent or approach),Commercial,United Kingdom,Europe,3,1,0,2,0,0,3,Unknown
1933-05-09 00:00:00,John Stark,Landing (descent or approach),Business,United Kingdom,Europe,1,1,0,0,0,0,1,Unknown
1933-05-12 00:00:00,National Air Transport - USA,Flight,Operational,United States of America,North America,2,2,0,0,0,0,2,Human Factor
1933-05-13 00:00:00,Pennsylvania Airlines,Flight,Operational,United States of America,North America,1,1,0,0,0,0,1,Technical Failure
1933-05-22 00:00:00,C. B. Field,Flight,Business,United Kingdom,Europe,1,1,0,0,0,0,1,Unknown
1933-05-22 00:00:00,United States Airways,Landing (descent or approach),Commercial,United States of America,North America,4,1,0,3,0,0,4,Weather
1933-05-24 00:00:00,LAN Chile - Linea Aérea Nacional de Chile,Flight,Commercial,Chile,South America,5,1,0,4,0,0,5,Technical Failure
1933-05-26 00:00:00,KLM Royal Dutch Airlines - Koninklijke Luchtvaart Maatschappij,Takeoff (climb),Operational,Netherlands,Europe,2,2,0,0,0,0,2,Unknown
1933-05-31 00:00:00,Armand Dufaux,Takeoff (climb),Business,Switzerland,Europe,1,1,0,0,0,0,1,Unknown
1933-06-01 00:00:00,United States Army Air Corps - USAAC,Takeoff (climb),Military / Government,United States of America,North America,0,0,0,0,0,0,0,Unknown
1933-06-02 00:00:00,Bowen Air Lines,Landing (descent or approach),Commercial,United States of America,North America,4,1,0,3,0,0,4,Unknown
1933-06-06 00:00:00,Brandon Aero Association,Takeoff (climb),Operational,Canada,North America,2,2,0,0,0,0,2,Unknown
1933-06-08 00:00:00,Swiss Air Force,Takeoff (climb),Operational,Switzerland,Europe,1,1,0,0,0,0,1,Unknown
1933-06-10 00:00:00,Great Bear Lake Airways,Landing (descent or approach),Commercial,Canada,North America,0,0,0,0,0,0,0,Technical Failure
1933-06-15 00:00:00,Paraguay Air Force - Fuerza Aérea Paraguaya,Flight,Military / Government,Paraguay,South America,1,1,0,0,0,0,1,Unknown
1933-06-15 00:00:00,James Joseph Mattern,Flight,Business,Russia,Asia,1,1,0,0,0,0,1,Technical Failure
1933-06-15 00:00:00,R. Ussher,Takeoff (climb),Business,Tanzania,Africa,2,1,0,1,0,0,2,Unknown
1933-06-15 00:00:00,Hamilton Aero Club,Landing (descent or approach),Business,Canada,North America,2,1,0,1,0,0,2,Unknown
1933-06-19 00:00:00,Colombian Air Force - Fuerza Aérea Colombiana,Flight,Military / Government,Colombia,South America,2,2,0,0,0,0,2,Weather
1933-06-28 00:00:00,United States Airways,Takeoff (climb),Commercial,United States of America,North America,5,1,0,4,0,0,5,Technical Failure
1933-07-01 00:00:00,Scottish Motor Traction Company,Flight,Business,United Kingdom,Europe,3,1,0,2,0,0,3,Unknown
1933-07-12 00:00:00,Royal Air Force - RAF,Takeoff (climb),Operational,United Kingdom,Europe,2,2,0,0,0,0,2,Human Factor
1933-07-15 00:00:00,Anglo American Oil Company,Flight,Business,United Kingdom,Europe,2,1,0,1,0,0,2,Unknown
1933-07-23 00:00:00,Jim %26 Amy Mollison,Flight,Business,United States of America,North America,2,2,0,0,0,0,2,Technical Failure
1933-07-23 00:00:00,V. Spencer,Takeoff (climb),Business,Canada,North America,4,2,0,2,0,0,4,Unknown
1933-08-03 00:00:00,Phillips %26 Powis Aircraft,Takeoff (climb),Operational,United Kingdom,Europe,2,1,0,1,0,0,2,Unknown
1933-08-11 00:00:00,Societa Anonima di Navigazione Aerea - SANA,Flight,Commercial,Spain,Europe,6,6,0,0,0,0,6,Technical Failure
1933-08-18 00:00:00,Aeroflot - Russian International Airlines,Landing (descent or approach),Specialised Services,Russia,Asia,11,2,0,9,0,0,11,Human Factor
1933-08-24 00:00:00,British Hospital Air Pageants,Landing (descent or approach),Business,United Kingdom,Europe,2,1,0,1,0,0,2,Technical Failure
1933-08-30 00:00:00,Samuel Perry Tyzack,Flight,Business,United Kingdom,Europe,1,1,0,0,0,0,1,Human Factor
1933-09-04 00:00:00,Regina Flying Club,Landing (descent or approach),Operational,Canada,North America,2,2,0,0,0,0,2,Unknown
1933-09-06 00:00:00,Liverpool %26 District Aero Club,Flight,Business,United Kingdom,Europe,2,1,0,1,0,0,2,Unknown
1933-09-11 00:00:00,National Air Transport - Canada,Landing (descent or approach),Commercial,Canada,North America,0,0,0,0,0,0,0,Technical Failure
1933-09-21 00:00:00,Eastern Air Transport,Takeoff (climb),Commercial,United States of America,North America,14,2,0,12,0,0,14,Unknown
1933-09-26 00:00:00,U.S. Department of Commerce,Flight,Military / Government,United States of America,North America,0,0,0,0,0,0,0,Unknown
1933-09-30 00:00:00,Holden's Air Transport Services,Landing (descent or approach),Operational,Papua New Guinea,Oceania,2,1,0,1,0,0,2,Unknown
1933-10-01 00:00:00,George Edward Archdale,Flight,Business,United Kingdom,Europe,1,1,0,0,0,0,1,Human Factor
1933-10-01 00:00:00,Charles Lloyd,Takeoff (climb),Business,United Kingdom,Europe,3,1,0,2,0,0,3,Unknown
1933-10-11 00:00:00,West Australian Airways,Takeoff (climb),Commercial,Australia,Oceania,12,1,0,11,0,0,12,Technical Failure
1933-10-15 00:00:00,Thomas P. Gleave,Flight,Business,Turkey,Asia,1,1,0,0,0,0,1,Unknown
1933-10-23 00:00:00,United States Army Air Corps - USAAC,Takeoff (climb),Military / Government,United States of America,North America,0,0,0,0,0,0,0,Unknown
1933-10-25 00:00:00,Selkhozaviatsiya,,Commercial,Russia,Asia,0,0,0,0,0,0,0,Unknown
1933-11-10 00:00:00,Asiatic Petroleum Company,Landing (descent or approach),Business,Iran,Asia,1,1,0,0,0,0,1,Unknown
1933-11-12 00:00:00,Transcontinental %26 Western Air - TWA,Flight,Operational,United States of America,North America,1,1,0,0,0,0,1,Technical Failure
1933-11-16 00:00:00,Air France,Flight,Operational,France,Europe,2,2,0,0,0,0,2,Technical Failure
1933-11-18 00:00:00,Air France,Flight,Operational,Spain,Europe,2,2,0,0,0,0,2,Unknown
1933-11-18 00:00:00,Lancashire Aero Club,Landing (descent or approach),Business,United Kingdom,Europe,1,1,0,0,0,0,1,Unknown
1933-11-21 00:00:00,American Airways,Takeoff (climb),Operational,United States of America,North America,1,1,0,0,0,0,1,Technical Failure
1933-11-21 00:00:00,Lucknow %26 Cawnpore Flying Club,Flight,Business,India,Asia,1,1,0,0,0,0,1,Human Factor
1933-11-24 00:00:00,China National Aviation Corporation - CNAC,Landing (descent or approach),Commercial,China,Asia,11,2,0,9,0,0,11,Human Factor
1933-11-24 00:00:00,Aerovias Centrales,Flight,Commercial,Mexico,Central America,0,0,0,0,0,0,0,Unknown
1933-11-25 00:00:00,Air France,Flight,Commercial,Switzerland,Europe,1,1,0,0,0,0,1,Weather
1933-11-28 00:00:00,National Parks Airways,Flight,Commercial,United States of America,North America,0,0,0,0,0,0,0,Unknown
1933-11-30 00:00:00,Pacific Alaska Airways - PAA,Flight,Commercial,United States of America,North America,0,0,0,0,0,0,0,Unknown
1933-12-02 00:00:00,Western Air Express,Flight,Commercial,United States of America,North America,0,0,0,0,0,0,0,Unknown
1933-12-03 00:00:00,Western Air Express,Flight,Operational,United States of America,North America,1,1,0,0,0,0,1,Technical Failure
1933-12-04 00:00:00,Aero Services - South Africa,Flight,Commercial,South Africa,Africa,3,1,0,2,0,0,3,Unknown
1933-12-08 00:00:00,Wilson Airways,Takeoff (climb),Commercial,Kenya,Africa,2,1,0,1,0,0,2,Technical Failure
1933-12-08 00:00:00,Selkhozaviatsiya,,Commercial,Russia,Asia,0,0,0,0,0,0,0,Unknown
1933-12-11 00:00:00,Transcontinental %26 Western Air - TWA,Flight,Operational,United States of America,North America,1,1,0,0,0,0,1,Weather
1933-12-11 00:00:00,Transcontinental %26 Western Air - TWA,Flight,Operational,United States of America,North America,1,1,0,0,0,0,1,Weather
1933-12-12 00:00:00,Canadian Airways,Takeoff (climb),Commercial,Canada,North America,0,0,0,0,0,0,0,Unknown
1933-12-17 00:00:00,Air France,Flight,Commercial,France,Europe,4,3,0,1,0,0,4,Technical Failure
1933-12-24 00:00:00,Aeroflot - Russian International Airlines,Flight,Operational,Russia,Asia,2,2,0,0,0,0,2,Human Factor
1933-12-28 00:00:00,Kohler Aviation,Flight,Commercial,United States of America,North America,2,2,0,0,0,0,2,Technical Failure
1933-12-31 00:00:00,Moravskoslezsky Aeroclub Brno,Flight,Operational,Czech Republic,Europe,0,0,0,0,0,0,0,Unknown
1933-12-31 00:00:00,Syndicato Condor,Flight,Commercial,Brazil,South America,0,0,0,0,0,0,0,Unknown
1933-12-31 00:00:00,Pacific Alaska Airways - PAA,,Commercial,United States of America,North America,0,0,0,0,0,0,0,Unknown
1933-12-31 00:00:00,Pacific Alaska Airways - PAA,,Commercial,United States of America,North America,0,0,0,0,0,0,0,Unknown
1933-12-31 00:00:00,Deruluft - Deutsch-Russische Luftverkehrs Gesellschaft,,Commercial,Russia,Asia,0,0,0,0,0,0,0,Unknown
1934-01-06 00:00:00,Pacific Alaska Airways - PAA,Flight,Commercial,United States of America,North America,0,0,0,0,0,0,0,Unknown
1934-01-11 00:00:00,United States Army Air Corps - USAAC,Takeoff (climb),Military / Government,Philippines,Asia,0,0,0,0,0,0,0,Unknown
1934-01-14 00:00:00,Escuela de Aviación Militar,Takeoff (climb),Operational,Argentina,South America,0,0,0,0,0,0,0,Unknown
1934-01-25 00:00:00,Swedish Air Force - Flygvapnet,Flight,Operational,Sweden,Europe,1,1,0,0,0,0,1,Unknown
1934-01-29 00:00:00,Ala Littoria,Flight,Operational,Brazil,South America,2,2,0,0,0,0,2,Technical Failure
1934-01-31 00:00:00,Transcontinental %26 Western Air - TWA,Flight,Commercial,United States of America,North America,0,0,0,0,0,0,0,Technical Failure
1934-01-31 00:00:00,Ethiopian Government,Flight,Military / Government,Ethiopia,Africa,0,0,0,0,0,0,0,Unknown
1934-02-09 00:00:00,Air France,Flight,Commercial,Tunisia,Africa,0,0,0,0,0,0,0,Technical Failure
1934-02-28 00:00:00,United States Army Air Corps - USAAC,Flight,Military / Government,United States of America,North America,5,5,0,0,0,0,5,Human Factor
1934-02-28 00:00:00,Pacific Alaska Airways - PAA,,Commercial,United States of America,North America,0,0,0,0,0,0,0,Unknown
1934-03-01 00:00:00,West Australian Airways,Landing (descent or approach),Commercial,Australia,Oceania,5,2,0,3,0,0,5,Human Factor
1934-03-04 00:00:00,Deutsche Luftsport-Verband,Landing (descent or approach),Operational,Germany,Europe,1,1,0,0,0,0,1,Unknown
1934-03-10 00:00:00,Deutsche Lufthansa,Flight,Operational,Poland,Europe,2,2,0,0,0,0,2,Unknown
1934-03-14 00:00:00,Royal Netherlands East Indies Air Force - ML-KNIL,Flight,Operational,Indonesia,Asia,1,1,0,0,0,0,1,Technical Failure
1934-03-14 00:00:00,Byrd Antarctic Expedition,Takeoff (climb),Specialised Services,Antarctica,Antarctica,0,0,0,0,0,0,0,Unknown
1934-03-20 00:00:00,Air France,Takeoff (climb),Operational,France,Europe,2,2,0,0,0,0,2,Unknown
1934-03-24 00:00:00,Cape Breton Flying Club,Landing (descent or approach),Operational,Canada,North America,2,2,0,0,0,0,2,Human Factor
1934-03-27 00:00:00,Wideroe - Wideroe's Flyveselskap,Flight,Commercial,Norway,Europe,2,1,0,1,0,0,2,Unknown
1934-03-28 00:00:00,Harold Leslie Brook,Flight,Business,France,Europe,1,1,0,0,0,0,1,Weather
1934-03-31 00:00:00,NKKK - Nippon Kaiji Kentei Kyokai,,Business,Japan,Asia,0,0,0,0,0,0,0,Unknown
1934-04-14 00:00:00,Madras Air Taxi Service,Takeoff (climb),Commercial,India,Asia,3,1,0,2,0,0,3,Unknown
1934-04-20 00:00:00,Mackenzie Air Service,Flight,Commercial,Canada,North America,0,0,0,0,0,0,0,Technical Failure
1934-04-22 00:00:00,Brooklands Flying Club,Flight,Business,United Kingdom,Europe,1,1,0,0,0,0,1,Unknown
1934-04-27 00:00:00,Swiftlite Aircraft Corporation,Flight,Operational,United States of America,North America,2,2,0,0,0,0,2,Technical Failure
1934-04-30 00:00:00,Lotsberg %26 Skappel,Flight,Business,Norway,Europe,2,2,0,0,0,0,2,Unknown
1934-05-07 00:00:00,Indian Air Survey %26 Transport,Takeoff (climb),Commercial,India,Asia,3,1,0,2,0,0,3,Unknown
1934-05-09 00:00:00,Lawrence Alfred Mervyn Dundas,Takeoff (climb),Business,United Kingdom,Europe,2,1,0,1,0,0,2,Unknown
1934-05-18 00:00:00,Manchurian Air Lines,Landing (descent or approach),Commercial,Japan,Asia,0,0,0,0,0,0,0,Unknown
1934-05-18 00:00:00,United States Army Air Corps - USAAC,Landing (descent or approach),Military / Government,United States of America,North America,2,2,0,0,0,0,2,Unknown
1934-05-19 00:00:00,Ralph Leigh Hare,Flight,Business,United Kingdom,Europe,1,1,0,0,0,0,1,Unknown
1934-05-21 00:00:00,Christopher Herbert Fleetwood Fuller,Flight,Business,United Kingdom,Europe,1,1,0,0,0,0,1,Unknown
1934-05-26 00:00:00,Vacuum Oil Company,,Business,South Africa,Africa,0,0,0,0,0,0,0,Unknown
1934-05-30 00:00:00,United Airlines,Landing (descent or approach),Commercial,United States of America,North America,12,3,0,9,0,0,12,Technical Failure
1934-05-31 00:00:00,French Air Force - Armée de l'Air,Flight,Military / Government,France,Europe,4,4,0,0,0,0,4,Technical Failure
1934-05-31 00:00:00,United States Army Air Corps - USAAC,Flight,Military / Government,Panama,Central America,0,0,0,0,0,0,0,Technical Failure
1934-06-01 00:00:00,Central Airlines,,Commercial,United States of America,North America,0,0,0,0,0,0,0,Unknown
1934-06-07 00:00:00,United Airlines,Flight,Commercial,United States of America,North America,9,3,0,6,0,0,9,Human Factor
1934-06-11 00:00:00,Air France,Flight,Commercial,Brazil,South America,0,0,0,0,0,0,0,Unknown
1934-06-11 00:00:00,United States Army Air Corps - USAAC,Takeoff (climb),Operational,United States of America,North America,3,3,0,0,0,0,3,Technical Failure
1934-06-12 00:00:00,Paraguay Air Force - Fuerza Aérea Paraguaya,Flight,Operational,Paraguay,South America,0,0,0,0,0,0,0,Unknown
1934-06-24 00:00:00,Paul F. Jones,Flight,Business,United States of America,North America,0,0,0,0,0,0,0,Technical Failure
1934-06-27 00:00:00,Nord-Norges Aero,,Commercial,Norway,Europe,0,0,0,0,0,0,0,Unknown
1934-06-30 00:00:00,Deutsche Verkehrsfliegerschule - DVS,,Operational,Germany,Europe,0,0,0,0,0,0,0,Unknown
1934-07-01 00:00:00,Ray Loomis,Flight,Business,United States of America,North America,0,0,0,0,0,0,0,Unknown
1934-07-02 00:00:00,Spanish Air Force - Aeronáutica Militar,Flight,Military / Government,Portugal,Europe,4,4,0,0,0,0,4,Technical Failure
1934-07-06 00:00:00,Aktiebolaget Aerotransport - ABA,Flight,Operational,Sweden,Europe,2,2,0,0,0,0,2,Technical Failure
1934-07-12 00:00:00,Universal Airways - UK,Takeoff (climb),Commercial,United Kingdom,Europe,3,1,0,2,0,0,3,Unknown
1934-07-12 00:00:00,Royal Air Force - RAF,Takeoff (climb),Operational,United Kingdom,Europe,2,2,0,0,0,0,2,Unknown
1934-07-13 00:00:00,Aberdeen Airways,Takeoff (climb),Commercial,United Kingdom,Europe,2,1,0,1,0,0,2,Unknown
1934-07-19 00:00:00,Chinook Flying Service,Takeoff (climb),Commercial,Canada,North America,0,0,0,0,0,0,0,Unknown
1934-07-20 00:00:00,Royal Netherlands Navy - Marineluchtvaartdienst,Landing (descent or approach),Military / Government,Indonesia,Asia,0,0,0,0,0,0,0,Unknown
1934-07-21 00:00:00,Lancelot John Rimmer,Flight,Business,United Kingdom,Europe,2,1,0,1,0,0,2,Unknown
1934-07-24 00:00:00,Deutsche Lufthansa,,Commercial,Germany,Europe,0,0,0,0,0,0,0,Unknown
1934-08-07 00:00:00,Northwest Airlines,Takeoff (climb),Commercial,United States of America,North America,8,2,0,6,0,0,8,Human Factor
1934-08-12 00:00:00,Leonard Gillespie Reid,Landing (descent or approach),Business,United Kingdom,Europe,2,1,0,1,0,0,2,Human Factor
1934-08-24 00:00:00,K. de Geus van den Heuvel,Takeoff (climb),Business,Netherlands,Europe,4,1,0,3,0,0,4,Technical Failure
1934-08-29 00:00:00,Highland Airways,Landing (descent or approach),Operational,United Kingdom,Europe,2,2,0,0,0,0,2,Unknown
1934-08-30 00:00:00,Lancelot John Rimmer,Flight,Business,United Kingdom,Europe,2,1,0,1,0,0,2,Unknown
1934-09-01 00:00:00,Atlantic Coast Airways,,Commercial,Nicaragua,Central America,0,0,0,0,0,0,0,Unknown
1934-09-02 00:00:00,Hanfords Tri-State Airlines,Flight,Commercial,United States of America,North America,0,0,0,0,0,0,0,Unknown
1934-09-02 00:00:00,National Flying Services,Takeoff (climb),Commercial,United Kingdom,Europe,2,1,0,1,0,0,2,Unknown
1934-09-03 00:00:00,SCADTA - Sociedad Colombo-Alemana de Transportes Aéreos,Landing (descent or approach),Commercial,Colombia,South America,5,1,0,4,0,0,5,Unknown
1934-09-08 00:00:00,Polyarnaya Aviatsiya,,Commercial,Russia,Asia,0,0,0,0,0,0,0,Unknown
1934-09-09 00:00:00,East Anglian Aero Club,Takeoff (climb),Business,United Kingdom,Europe,1,1,0,0,0,0,1,Unknown
1934-09-09 00:00:00,Air Service Training,Flight,Operational,United Kingdom,Europe,1,1,0,0,0,0,1,Unknown
1934-09-15 00:00:00,Aeronaves de Mexico,Landing (descent or approach),Commercial,Mexico,Central America,3,2,0,1,0,0,3,Unknown
1934-09-22 00:00:00,National Aviation Displays,Takeoff (climb),Operational,Malta,Europe,3,3,0,0,0,0,3,Unknown
1934-09-22 00:00:00,Transcontinental %26 Western Air - TWA,Flight,Operational,United States of America,North America,1,1,0,0,0,0,1,Technical Failure
1934-09-27 00:00:00,Mexicana de Aviación,,Commercial,Mexico,Central America,0,0,0,0,0,0,0,Unknown
1934-09-30 00:00:00,Richard Arthur Clinton Holme,Flight,Business,United Kingdom,Europe,1,1,0,0,0,0,1,Human Factor
1934-10-03 00:00:00,Aeroflot - Russian International Airlines,,Commercial,Russia,Asia,0,0,0,0,0,0,0,Unknown
1934-10-17 00:00:00,Air Taxis,Flight,Operational,France,Europe,1,1,0,0,0,0,1,Unknown
1934-10-18 00:00:00,Cyril Geoffrey Marmaduke Alington,Flight,Business,United Kingdom,Europe,2,1,0,1,0,0,2,Weather
1934-10-22 00:00:00,Deruluft - Deutsch-Russische Luftverkehrs Gesellschaft,Landing (descent or approach),Commercial,Russia,Asia,3,2,0,1,0,0,3,Human Factor
1934-10-23 00:00:00,Cirrus Hermes Engineering Company,Flight,Business,Italy,Europe,1,1,0,0,0,0,1,Unknown
1934-10-26 00:00:00,Studie-Comité Snelpost Nederland-Indië,Takeoff (climb),Business,India,Asia,3,3,0,0,0,0,3,Human Factor
1934-10-26 00:00:00,Ptarmigan Airlines,Landing (descent or approach),Operational,United States of America,North America,2,2,0,0,0,0,2,Weather
1934-11-03 00:00:00,Deutsche Lufthansa,Flight,Commercial,France,Europe,2,2,0,0,0,0,2,Technical Failure
1934-11-06 00:00:00,Central Airlines,Flight,Operational,United States of America,North America,1,1,0,0,0,0,1,Weather
1934-11-12 00:00:00,Marc Henry,Flight,Operational,France,Europe,2,1,0,1,0,0,2,Human Factor
1934-11-15 00:00:00,Transcontinental %26 Western Air - TWA,Flight,Operational,United States of America,North America,1,1,0,0,0,0,1,Unknown
1934-11-15 00:00:00,American Airlines,Landing (descent or approach),Operational,United States of America,North America,1,1,0,0,0,0,1,Unknown
1934-11-27 00:00:00,Colombian Air Force - Fuerza Aérea Colombiana,Landing (descent or approach),Military / Government,Colombia,South America,4,3,0,1,0,0,4,Technical Failure
1934-11-28 00:00:00,Eastern Air Transport,Flight,Operational,United States of America,North America,1,1,0,0,0,0,1,Technical Failure
1934-12-07 00:00:00,Air France,Landing (descent or approach),Commercial,Czech Republic,Europe,0,0,0,0,0,0,0,Unknown
1934-12-08 00:00:00,Malling Aviation,Flight,Operational,United Kingdom,Europe,2,1,0,1,0,0,2,Human Factor
1934-12-11 00:00:00,Paraguay Air Force - Fuerza Aérea Paraguaya,Flight,Military / Government,Paraguay,South America,2,2,0,0,0,0,2,Unknown
1934-12-16 00:00:00,WR Carpenter %26 Company,Flight,Operational,Papua New Guinea,Oceania,1,1,0,0,0,0,1,Human Factor
1934-12-19 00:00:00,American Airlines,Landing (descent or approach),Commercial,United States of America,North America,5,2,0,3,0,0,5,Technical Failure
1934-12-20 00:00:00,United Airlines,Flight,Operational,United States of America,North America,4,3,0,1,0,0,4,Weather
1934-12-22 00:00:00,Air France,Landing (descent or approach),Commercial,United Kingdom,Europe,10,3,0,7,0,0,10,Unknown
1934-12-22 00:00:00,Everson Flying Services,Takeoff (climb),Business,United Kingdom,Europe,1,1,0,0,0,0,1,Human Factor
1934-12-28 00:00:00,American Airlines,Flight,Commercial,United States of America,North America,4,2,0,2,0,0,4,Weather
1934-12-31 00:00:00,Polyarnaya Aviatsiya,,Commercial,Russia,Asia,0,0,0,0,0,0,0,Unknown
1934-12-31 00:00:00,Polyarnaya Aviatsiya,,Commercial,Russia,Asia,0,0,0,0,0,0,0,Unknown
1935-01-08 00:00:00,Highland Airways,Takeoff (climb),Commercial,United Kingdom,Europe,3,1,0,2,0,0,3,Unknown
1935-01-09 00:00:00,Royal Air Force - RAF,Landing (descent or approach),Operational,Egypt,Africa,2,2,0,0,0,0,2,Human Factor
1935-01-10 00:00:00,American Airlines,Flight,Operational,United States of America,North America,1,1,0,0,0,0,1,Technical Failure
1935-01-13 00:00:00,Surrey Flying Services,Takeoff (climb),Commercial,United Kingdom,Europe,2,1,0,1,0,0,2,Unknown
1935-01-13 00:00:00,Uppercu-Burnelli Corporation,Flight,Specialised Services,United States of America,North America,2,2,0,0,0,0,2,Unknown
1935-01-20 00:00:00,Air France,Flight,Commercial,Italy,Europe,6,3,0,3,0,0,6,Weather
1935-01-23 00:00:00,Eastern Airlines,,Commercial,United States of America,North America,0,0,0,0,0,0,0,Unknown
1935-01-23 00:00:00,Private South African,Landing (descent or approach),Business,Namibia,Africa,1,1,0,0,0,0,1,Unknown
1935-01-25 00:00:00,Compagnie Générale TransSaharienne - CGT France,Flight,Operational,Benin,Africa,2,2,0,0,0,0,2,Weather
1935-01-30 00:00:00,Private British,Flight,Business,United Kingdom,Europe,2,1,0,1,0,0,2,Unknown
1935-01-31 00:00:00,Transcontinental %26 Western Air - TWA,Flight,Operational,United States of America,North America,1,1,0,0,0,0,1,Technical Failure
1935-02-11 00:00:00,Chicago %26 Southern Air Lines,Flight,Commercial,United States of America,North America,0,0,0,0,0,0,0,Unknown
1935-02-22 00:00:00,Eurasia Aviation Corporation,Flight,Commercial,China,Asia,0,0,0,0,0,0,0,Unknown
1935-03-06 00:00:00,United States Army Air Corps - USAAC,Flight,Military / Government,United States of America,North America,5,5,0,0,0,0,5,Unknown
1935-03-07 00:00:00,Deruluft - Deutsch-Russische Luftverkehrs Gesellschaft,Flight,Commercial,Poland,Europe,3,3,0,0,0,0,3,Unknown
1935-03-12 00:00:00,French Air Force - Armée de l'Air,Taxiing,Operational,France,Europe,4,4,0,0,0,0,4,Unknown
1935-03-15 00:00:00,Aero Survey,Flight,Military / Government,China,Asia,0,0,0,0,0,0,0,Unknown
1935-03-28 00:00:00,Canadian Government,Landing (descent or approach),Military / Government,Canada,North America,1,1,0,0,0,0,1,Unknown
1935-03-28 00:00:00,Portsmouth Southsea %26 Isle of Wight Aviation,Takeoff (climb),Commercial,United Kingdom,Europe,2,1,0,1,0,0,2,Unknown
1935-03-31 00:00:00,Royal Air Force - RAF,Landing (descent or approach),Operational,United Kingdom,Europe,1,1,0,0,0,0,1,Unknown
1935-04-01 00:00:00,Royal Air Force - RAF,Landing (descent or approach),Operational,United Kingdom,Europe,1,1,0,0,0,0,1,Technical Failure
1935-04-18 00:00:00,Fornebo Flyveselskap,Flight,Commercial,Norway,Europe,1,1,0,0,0,0,1,Unknown
1935-04-19 00:00:00,Private Norwegian,,Business,Norway,Europe,0,0,0,0,0,0,0,Unknown
1935-04-21 00:00:00,SABENA - Société Anonyme Belge d'Exploitation de la Navigation Aérienne,Takeoff (climb),Commercial,France,Europe,0,0,0,0,0,0,0,Unknown
1935-04-25 00:00:00,Deutsche Lufthansa,Flight,Commercial,Germany,Europe,0,0,0,0,0,0,0,Unknown
1935-04-28 00:00:00,Private American,,Business,United States of America,North America,0,0,0,0,0,0,0,Unknown
1935-04-28 00:00:00,Private British,Flight,Business,United Kingdom,Europe,2,1,0,1,0,0,2,Unknown
1935-04-30 00:00:00,Deutsche Lufthansa,,Commercial,Germany,Europe,0,0,0,0,0,0,0,Unknown
1935-05-07 00:00:00,Petrol Oil Corporation of Los Angeles,Flight,Business,United States of America,North America,4,1,0,3,0,0,4,Human Factor
1935-05-08 00:00:00,Panagra - Pan American-Grace Airways,,Commercial,Peru,South America,0,0,0,0,0,0,0,Unknown
1935-05-11 00:00:00,Commercial Air Hire,Flight,Operational,World,World,2,2,0,0,0,0,2,Technical Failure
1935-05-11 00:00:00,Eurasia Aviation Corporation,,Commercial,China,Asia,0,0,0,0,0,0,0,Unknown
1935-05-23 00:00:00,French Air Force - Armée de l'Air,Flight,Operational,France,Europe,4,4,0,0,0,0,4,Weather
1935-05-24 00:00:00,Deutsche Lufthansa,Parking,Other,Germany,Europe,0,0,0,0,0,0,0,Unknown
1935-05-31 00:00:00,Private Indian,Landing (descent or approach),Business,India,Asia,1,1,0,0,0,0,1,Human Factor
1935-05-31 00:00:00,Giro Aviation,Takeoff (climb),Commercial,United Kingdom,Europe,2,1,0,1,0,0,2,Unknown
1935-06-05 00:00:00,Private American,Landing (descent or approach),Business,United States of America,North America,0,0,0,0,0,0,0,Unknown
1935-06-06 00:00:00,Private Canadian,Takeoff (climb),Business,Canada,North America,0,0,0,0,0,0,0,Unknown
1935-06-15 00:00:00,Aerogeodesia,,Other,Russia,Asia,0,0,0,0,0,0,0,Unknown
1935-06-22 00:00:00,Ala Littoria,Landing (descent or approach),Commercial,Malta,Europe,0,0,0,0,0,0,0,Weather
1935-07-01 00:00:00,Railway Air Services,Takeoff (climb),Commercial,United Kingdom,Europe,7,1,0,6,0,0,7,Unknown
1935-07-04 00:00:00,Eurasia Aviation Corporation,Flight,Commercial,China,Asia,0,0,0,0,0,0,0,Unknown
1935-07-13 00:00:00,Guinea Airways,Landing (descent or approach),Commercial,Papua New Guinea,Oceania,2,1,0,1,0,0,2,Technical Failure
1935-07-16 00:00:00,Blackpool %26 West Coast Air Service,Takeoff (climb),Commercial,United Kingdom,Europe,6,1,0,5,0,0,6,Unknown
1935-07-16 00:00:00,Private Canadian,,Business,Canada,North America,0,0,0,0,0,0,0,Unknown
1935-07-17 00:00:00,KLM Royal Dutch Airlines - Koninklijke Luchtvaart Maatschappij,Takeoff (climb),Commercial,Iran,Asia,11,4,0,7,0,0,11,Other
1935-07-18 00:00:00,Canadian Airways,Takeoff (climb),Commercial,Canada,North America,5,1,0,4,0,0,5,Unknown
1935-07-21 00:00:00,Brantford-Norfolk Aero Club,Landing (descent or approach),Operational,Canada,North America,2,2,0,0,0,0,2,Unknown
1935-07-23 00:00:00,Royal Air Force - RAF,Flight,Operational,United Kingdom,Europe,0,0,0,0,0,0,0,Unknown
1935-07-24 00:00:00,Royal Air Force - RAF,Landing (descent or approach),Operational,United Kingdom,Europe,0,0,0,0,0,0,0,Technical Failure
1935-07-25 00:00:00,Edmonton %26 Northern Alberta Aero Club,Flight,Operational,Canada,North America,2,2,0,0,0,0,2,Unknown
1935-07-27 00:00:00,American Airlines,Landing (descent or approach),Commercial,United States of America,North America,13,3,0,10,0,0,13,Human Factor
1935-08-02 00:00:00,Wideroe - Wideroe's Flyveselskap,Flight,Commercial,Norway,Europe,2,1,0,1,0,0,2,Unknown
1935-08-03 00:00:00,Transcontinental %26 Western Air - TWA,Flight,Commercial,United States of America,North America,11,2,0,9,0,0,11,Human Factor
1935-08-03 00:00:00,Royal Air Force - RAF,Taxiing,Operational,United Kingdom,Europe,1,1,0,0,0,0,1,Unknown
1935-08-04 00:00:00,Wilson Airways,Landing (descent or approach),Operational,Kenya,Africa,2,1,0,1,0,0,2,Unknown
1935-08-14 00:00:00,Royal Air Force - RAF,Takeoff (climb),Operational,United Kingdom,Europe,2,2,0,0,0,0,2,Unknown
1935-08-15 00:00:00,United States Coast Guard - USCG,Flight,Operational,United States of America,North America,0,0,0,0,0,0,0,Unknown
1935-08-20 00:00:00,Guinea Airways,Landing (descent or approach),Commercial,Papua New Guinea,Oceania,2,1,0,1,0,0,2,Technical Failure
1935-08-20 00:00:00,Edmonton %26 Northern Alberta Aero Club,Landing (descent or approach),Operational,Canada,North America,2,2,0,0,0,0,2,Human Factor
1935-08-21 00:00:00,Private Indian,Flight,Business,Tanzania,Africa,3,3,0,0,0,0,3,Unknown
1935-08-21 00:00:00,Royal Canadian Air Force - RCAF,Landing (descent or approach),Military / Government,Canada,North America,1,1,0,0,0,0,1,Unknown
1935-08-23 00:00:00,United States Army Air Corps - USAAC,,Military / Government,United States of America,North America,0,0,0,0,0,0,0,Unknown
1935-09-06 00:00:00,Australian Transcontinental Airways - ATA,Flight,Commercial,Australia,Oceania,4,2,0,2,0,0,4,Technical Failure
1935-09-08 00:00:00,United States Army Air Corps - USAAC,Flight,Operational,United States of America,North America,4,4,0,0,0,0,4,Unknown
1935-09-08 00:00:00,Compania Nacional de Aviacion de Guatemala,Takeoff (climb),Commercial,Guatemala,Central America,0,0,0,0,0,0,0,Technical Failure
1935-09-10 00:00:00,Tata Sons,Flight,Operational,India,Asia,3,1,0,2,0,0,3,Unknown
1935-09-21 00:00:00,Malcolm %26 Farquharson,Landing (descent or approach),Business,United Kingdom,Europe,1,1,0,0,0,0,1,Unknown
1935-09-27 00:00:00,Lloyd Aéreo Boliviano - LAB Airlines,Flight,Operational,Bolivia,South America,2,2,0,0,0,0,2,Technical Failure
1935-09-28 00:00:00,Private Swedish,Flight,Business,Sweden,Europe,0,0,0,0,0,0,0,Unknown
1935-10-01 00:00:00,AB Flygtrafik,Flight,Operational,Sweden,Europe,1,1,0,0,0,0,1,Human Factor
1935-10-03 00:00:00,Madras Flying Club,Landing (descent or approach),Operational,India,Asia,1,1,0,0,0,0,1,Unknown
1935-10-09 00:00:00,United Airways - UK,Flight,Commercial,United Kingdom,Europe,1,1,0,0,0,0,1,Technical Failure
1935-10-10 00:00:00,Imperial Airways,Taxiing,Commercial,Belgium,Europe,0,0,0,0,0,0,0,Weather
1935-10-21 00:00:00,Royal Air Force - RAF,Takeoff (climb),Operational,United Kingdom,Europe,5,5,0,0,0,0,5,Unknown
1935-10-22 00:00:00,Imperial Airways,Flight,Commercial,Austria,Europe,0,0,0,0,0,0,0,Weather
1935-10-23 00:00:00,WR Carpenter %26 Company,Takeoff (climb),Operational,Papua New Guinea,Oceania,1,1,0,0,0,0,1,Other
1935-10-24 00:00:00,Ceskoslovenska Letecka Spolecnost - CLS,Flight,Commercial,Czech Republic,Europe,9,2,0,7,0,0,9,Weather
1935-10-24 00:00:00,American Airlines,Flight,Operational,United States of America,North America,1,1,0,0,0,0,1,Technical Failure
1935-10-24 00:00:00,Starratt Airways %26 Transportation,Flight,Commercial,Canada,North America,0,0,0,0,0,0,0,Technical Failure
1935-10-25 00:00:00,Imperial Airways,Landing (descent or approach),Commercial,Belgium,Europe,15,3,0,12,0,0,15,Unknown
1935-10-31 00:00:00,Haus Bergmann,Flight,Business,Germany,Europe,1,1,0,0,0,0,1,Unknown
1935-11-02 00:00:00,Deutsche Lufthansa,Flight,Specialised Services,Germany,Europe,5,5,0,0,0,0,5,Unknown
1935-11-02 00:00:00,Durban Light Plane Club,Takeoff (climb),Business,South Africa,Africa,1,1,0,0,0,0,1,Unknown
1935-11-07 00:00:00,SABENA - Société Anonyme Belge d'Exploitation de la Navigation Aérienne,Landing (descent or approach),Commercial,United Kingdom,Europe,4,4,0,0,0,0,4,Unknown
1935-11-09 00:00:00,TACA International Airlines - Transportes Aéreos Centro Americanos,Flight,Commercial,Honduras,Central America,14,3,0,11,0,0,14,Unknown
1935-11-15 00:00:00,Syndicato Condor,,Commercial,Brazil,South America,0,0,0,0,0,0,0,Unknown
1935-11-15 00:00:00,Air Taxis,Flight,Operational,United Kingdom,Europe,1,1,0,0,0,0,1,Unknown
1935-11-16 00:00:00,Central Airlines,Takeoff (climb),Operational,United States of America,North America,3,2,0,1,0,0,3,Human Factor
1935-11-23 00:00:00,Imperial Airways,Takeoff (climb),Commercial,Uganda,Africa,0,0,0,0,0,0,0,Unknown
1935-11-23 00:00:00,Compagnie Internationale de Navigation Aérienne - CIDNA,Flight,Commercial,Austria,Europe,0,0,0,0,0,0,0,Unknown
1935-11-27 00:00:00,Eurasia Aviation Corporation,Flight,Commercial,China,Asia,0,0,0,0,0,0,0,Unknown
1935-11-28 00:00:00,Airlines of Australia,Landing (descent or approach),Commercial,Australia,Oceania,8,2,0,6,0,0,8,Technical Failure
1935-11-29 00:00:00,Rand Flying Club,Flight,Business,South Africa,Africa,1,1,0,0,0,0,1,Unknown
1935-12-08 00:00:00,Rockhampton Aerial Services,Flight,Humanitarian,Australia,Oceania,4,2,0,2,0,0,4,Technical Failure
1935-12-10 00:00:00,Air France,Landing (descent or approach),Commercial,France,Europe,7,4,0,3,0,0,7,Technical Failure
1935-12-15 00:00:00,Air France,Landing (descent or approach),Commercial,France,Europe,6,3,0,3,0,0,6,Unknown
1935-12-21 00:00:00,Hamilton Aero Club,Flight,Operational,Canada,North America,2,2,0,0,0,0,2,Technical Failure
1935-12-24 00:00:00,Panagra - Pan American-Grace Airways,Landing (descent or approach),Operational,Peru,South America,2,2,0,0,0,0,2,Unknown
1935-12-24 00:00:00,Delta Airlines,Landing (descent or approach),Operational,United States of America,North America,1,1,0,0,0,0,1,Unknown
1935-12-25 00:00:00,Eurasia Aviation Corporation,,Commercial,China,Asia,0,0,0,0,0,0,0,Unknown
1935-12-29 00:00:00,Private French,Flight,Business,Libya,Africa,2,2,0,0,0,0,2,Human Factor
1935-12-31 00:00:00,Inland Airlines,,Commercial,United States of America,North America,0,0,0,0,0,0,0,Unknown
1935-12-31 00:00:00,Aeroflot - Russian International Airlines,,Commercial,Russia,Asia,0,0,0,0,0,0,0,Unknown
1935-12-31 00:00:00,Transaviatsiya,,Commercial,Russia,Asia,0,0,0,0,0,0,0,Unknown
1935-12-31 00:00:00,Transaviatsiya,,Commercial,Russia,Asia,0,0,0,0,0,0,0,Unknown
1935-12-31 00:00:00,Transaviatsiya,,Commercial,Russia,Asia,0,0,0,0,0,0,0,Unknown
1935-12-31 00:00:00,Transaviatsiya,,Commercial,Russia,Asia,0,0,0,0,0,0,0,Unknown
1935-12-31 00:00:00,Transaviatsiya,,Commercial,Russia,Asia,0,0,0,0,0,0,0,Unknown
1935-12-31 00:00:00,Transaviatsiya,,Commercial,Russia,Asia,0,0,0,0,0,0,0,Unknown
1935-12-31 00:00:00,Serbian Air Force - Ratno Vazduhoplovstvo i Protivvazdušna Odbrana,Takeoff (climb),Operational,Montenegro,Europe,2,2,0,0,0,0,2,Human Factor
1936-01-09 00:00:00,United States Army Air Corps - USAAC,Takeoff (climb),Operational,United States of America,North America,5,5,0,0,0,0,5,Technical Failure
1936-01-22 00:00:00,Commercial Air Hire,Flight,Commercial,United Kingdom,Europe,6,1,0,5,0,0,6,Unknown
1936-01-24 00:00:00,Royal Air Force - RAF,Landing (descent or approach),Operational,Egypt,Africa,1,1,0,0,0,0,1,Unknown
1936-01-27 00:00:00,Royal Air Force - RAF,Landing (descent or approach),Operational,Egypt,Africa,1,1,0,0,0,0,1,Unknown
1936-01-29 00:00:00,South African Airways -SAA - Suid Afrikaanse Lugdiens - SAL,,Commercial,South Africa,Africa,0,0,0,0,0,0,0,Unknown
1936-01-30 00:00:00,Royal Air Force - RAF,Landing (descent or approach),Operational,United Kingdom,Europe,1,1,0,0,0,0,1,Weather
1936-02-06 00:00:00,American Airlines,Takeoff (climb),Commercial,United States of America,North America,0,0,0,0,0,0,0,Unknown
1936-02-11 00:00:00,Regina Flying Club,Landing (descent or approach),Operational,Canada,North America,2,2,0,0,0,0,2,Unknown
1936-02-12 00:00:00,United States Army Air Corps - USAAC,Flight,Military / Government,United States of America,North America,5,5,0,0,0,0,5,Unknown
1936-02-17 00:00:00,United Air Services - USA,,Commercial,United States of America,North America,1,1,0,0,0,0,1,Unknown
1936-02-23 00:00:00,Royal Air Force - RAF,Flight,Operational,United Kingdom,Europe,1,1,0,0,0,0,1,Weather
1936-02-24 00:00:00,Ethiopian Government,Takeoff (climb),Humanitarian,Ethiopia,Africa,2,2,0,0,0,0,2,Unknown
1936-02-28 00:00:00,Swissair,Takeoff (climb),Commercial,Switzerland,Europe,8,4,0,4,0,0,8,Weather
1936-03-04 00:00:00,Royal Air Force - RAF,Flight,Operational,United Kingdom,Europe,0,0,0,0,0,0,0,Unknown
1936-03-05 00:00:00,China National Aviation Corporation - CNAC,Flight,Commercial,China,Asia,6,3,0,3,0,0,6,Weather
1936-03-05 00:00:00,Royal Air Force - RAF,Landing (descent or approach),Operational,United Kingdom,Europe,1,1,0,0,0,0,1,Human Factor
1936-03-07 00:00:00,Nederlandse Nieuw Guinea Petroleum Maatschappij,Landing (descent or approach),Military / Government,Indonesia,Asia,3,3,0,0,0,0,3,Unknown
1936-03-10 00:00:00,Iraq Petroleum Transport Company,Flight,Business,Iraq,Asia,6,1,0,5,0,0,6,Unknown
1936-03-12 00:00:00,Canadian Airways,Flight,Commercial,Canada,North America,0,0,0,0,0,0,0,Unknown
1936-03-16 00:00:00,Ölag - Österreichische Luftverkehrs AG,,Commercial,Austria,Europe,0,0,0,0,0,0,0,Unknown
1936-03-17 00:00:00,Royal Air Force - RAF,Landing (descent or approach),Operational,United Kingdom,Europe,1,1,0,0,0,0,1,Human Factor
1936-03-22 00:00:00,Regina Flying Club,Landing (descent or approach),Operational,Canada,North America,2,2,0,0,0,0,2,Unknown
1936-03-23 00:00:00,British Airways,Landing (descent or approach),Commercial,United Kingdom,Europe,3,1,0,2,0,0,3,Unknown
1936-03-27 00:00:00,French Air Force - Armée de l'Air,Taxiing,Operational,France,Europe,4,4,0,0,0,0,4,Unknown
1936-03-29 00:00:00,Wideroe - Wideroe's Flyveselskap,Landing (descent or approach),Commercial,Norway,Europe,2,1,0,1,0,0,2,Unknown
1936-03-31 00:00:00,China National Aviation Corporation - CNAC,Landing (descent or approach),Operational,China,Asia,2,2,0,0,0,0,2,Technical Failure
1936-04-06 00:00:00,Inner Circle Air Lines,Flight,Commercial,United Kingdom,Europe,2,1,0,1,0,0,2,Unknown
1936-04-07 00:00:00,Wideroe - Wideroe's Flyveselskap,Takeoff (climb),Commercial,Norway,Europe,0,0,0,0,0,0,0,Unknown
1936-04-08 00:00:00,Central Vermont Airways,,Commercial,United States of America,North America,0,0,0,0,0,0,0,Unknown
1936-04-10 00:00:00,Private Canadian,Flight,Business,Canada,North America,1,1,0,0,0,0,1,Technical Failure
1936-04-20 00:00:00,Ceskoslovenska Letecka Spolecnost - CLS,Flight,Commercial,Netherlands,Europe,12,3,0,9,0,0,12,Technical Failure
1936-04-22 00:00:00,Saskatoon Aero Club,Landing (descent or approach),Operational,Canada,North America,2,2,0,0,0,0,2,Human Factor
1936-04-27 00:00:00,Deutsche Lufthansa,,Commercial,Germany,Europe,0,0,0,0,0,0,0,Unknown
1936-04-30 00:00:00,Reale Unione Nazionale Aeronautica,Takeoff (climb),Operational,Italy,Europe,2,2,0,0,0,0,2,Unknown
1936-05-01 00:00:00,Regina Flying Club,Takeoff (climb),Operational,Canada,North America,2,2,0,0,0,0,2,Technical Failure
1936-05-01 00:00:00,Real Aero Club de España,Landing (descent or approach),Business,Spain,Europe,2,1,0,1,0,0,2,Unknown
1936-05-03 00:00:00,Polyarnaya Aviatsiya,,Commercial,Russia,Asia,0,0,0,0,0,0,0,Unknown
1936-05-03 00:00:00,Ethiopian Government,Flight,Operational,Sudan,Africa,1,1,0,0,0,0,1,Technical Failure
1936-05-10 00:00:00,Air Trips,Takeoff (climb),Business,United Kingdom,Europe,1,1,0,0,0,0,1,Unknown
1936-05-15 00:00:00,Reichsluftfahrtministerium,Flight,Military / Government,Germany,Europe,0,0,0,0,0,0,0,Unknown
1936-05-16 00:00:00,British Airways,Landing (descent or approach),Commercial,United Kingdom,Europe,8,1,0,7,0,0,8,Unknown
1936-05-16 00:00:00,Commercial Air Hire,Takeoff (climb),Commercial,United Kingdom,Europe,2,1,0,1,0,0,2,Unknown
1936-05-16 00:00:00,Deruluft - Deutsch-Russische Luftverkehrs Gesellschaft,,Commercial,Russia,Asia,0,0,0,0,0,0,0,Unknown
1936-05-23 00:00:00,Ontario Provincial Air Service,Landing (descent or approach),Commercial,Canada,North America,0,0,0,0,0,0,0,Unknown
1936-05-26 00:00:00,Deutsche Lufthansa,Takeoff (climb),Specialised Services,Germany,Europe,7,7,0,0,0,0,7,Human Factor
1936-05-26 00:00:00,Deutsche Lufthansa,Takeoff (climb),Specialised Services,Germany,Europe,7,7,0,0,0,0,7,Human Factor
1936-05-28 00:00:00,Pacific Aerial Transport,Landing (descent or approach),Commercial,Papua New Guinea,Oceania,0,0,0,0,0,0,0,Unknown
1936-05-31 00:00:00,Transcontinental %26 Western Air - TWA,Landing (descent or approach),Commercial,United States of America,North America,15,3,0,12,0,0,15,Technical Failure
1936-06-07 00:00:00,York County Aviation Club,Flight,Business,United Kingdom,Europe,2,1,0,1,0,0,2,Unknown
1936-06-10 00:00:00,Deutsche Lufthansa,,Commercial,Germany,Europe,0,0,0,0,0,0,0,Unknown
1936-06-10 00:00:00,Marlborough Aero Club,Flight,Operational,New Zealand,Oceania,0,0,0,0,0,0,0,Unknown
1936-06-12 00:00:00,United Gas Public Service Company,Flight,Business,United States of America,North America,0,0,0,0,0,0,0,Unknown
1936-06-13 00:00:00,Brooklands Air Taxis,Flight,Commercial,United Kingdom,Europe,3,1,0,2,0,0,3,Unknown
1936-06-19 00:00:00,Universal Air Industries,Takeoff (climb),Business,Canada,North America,0,0,0,0,0,0,0,Unknown
1936-06-20 00:00:00,Private British,Takeoff (climb),Business,United Kingdom,Europe,2,1,0,1,0,0,2,Unknown
1936-06-21 00:00:00,Wideroe - Wideroe's Flyveselskap,Takeoff (climb),Commercial,Norway,Europe,2,1,0,1,0,0,2,Unknown
1936-06-23 00:00:00,Aeroposta Argentina,Flight,Operational,Argentina,South America,0,0,0,0,0,0,0,Unknown
1936-06-24 00:00:00,Deutsche Lufthansa,,Commercial,Germany,Europe,0,0,0,0,0,0,0,Unknown
1936-06-25 00:00:00,Royal Air Force - RAF,Flight,Military / Government,United Kingdom,Europe,4,4,0,0,0,0,4,Technical Failure
1936-06-28 00:00:00,Private Canadian,Landing (descent or approach),Business,Canada,North America,3,1,0,2,0,0,3,Technical Failure
1936-06-28 00:00:00,Private British,Landing (descent or approach),Business,Tanzania,Africa,2,1,0,1,0,0,2,Human Factor
1936-06-30 00:00:00,Newcastle upon Tyne Light Aeroplane Club,Flight,Business,United Kingdom,Europe,1,1,0,0,0,0,1,Human Factor
1936-07-03 00:00:00,Nord-Norges Aero,Landing (descent or approach),Commercial,Norway,Europe,0,0,0,0,0,0,0,Unknown
1936-07-15 00:00:00,KLM Royal Dutch Airlines - Koninklijke Luchtvaart Maatschappij,Taxiing,Operational,Netherlands,Europe,3,3,0,0,0,0,3,Weather
1936-07-15 00:00:00,Aeroflot - Russian International Airlines,,Commercial,Russia,Asia,0,0,0,0,0,0,0,Unknown
1936-07-19 00:00:00,Deutsche Lufthansa,,Commercial,Germany,Europe,0,0,0,0,0,0,0,Unknown
1936-07-19 00:00:00,Rockhampton Aerial Services,Flight,Operational,Australia,Oceania,1,1,0,0,0,0,1,Technical Failure
1936-07-26 00:00:00,Pobjoy Airmotors %26 Aircraft,Flight,Business,United Kingdom,Europe,0,0,0,0,0,0,0,Unknown
1936-07-29 00:00:00,LAN Chile - Linea Aérea Nacional de Chile,Parking,Commercial,Chile,South America,14,2,0,12,0,0,14,Technical Failure
1936-07-31 00:00:00,Saint John Flying Club,Landing (descent or approach),Operational,Canada,North America,2,2,0,0,0,0,2,Human Factor
1936-08-01 00:00:00,Spanish Nationalist Air Force,Landing (descent or approach),Military / Government,Spain,Europe,0,0,0,0,0,0,0,Unknown
1936-08-06 00:00:00,United States Army Air Corps - USAAC,Flight,Operational,United States of America,North America,5,5,0,0,0,0,5,Unknown
1936-08-06 00:00:00,Swedish Air Force - Flygvapnet,Flight,Operational,Sweden,Europe,1,1,0,0,0,0,1,Human Factor
1936-08-06 00:00:00,SCADTA - Sociedad Colombo-Alemana de Transportes Aéreos,,Commercial,Colombia,South America,0,0,0,0,0,0,0,Unknown
1936-08-08 00:00:00,Private American,Flight,Business,United States of America,North America,0,0,0,0,0,0,0,Unknown
1936-08-11 00:00:00,Ala Littoria,Landing (descent or approach),Commercial,France,Europe,18,3,0,15,0,0,18,Weather
1936-08-12 00:00:00,Ontario Provincial Air Service,Flight,Commercial,Canada,North America,2,1,0,1,0,0,2,Technical Failure
1936-08-16 00:00:00,British Airways,Landing (descent or approach),Operational,France,Europe,2,2,0,0,0,0,2,Technical Failure
1936-08-16 00:00:00,Goodwin Chichester Aviation Company,,Business,New Zealand,Oceania,0,0,0,0,0,0,0,Unknown
1936-08-19 00:00:00,Harita,Landing (descent or approach),Commercial,Turkey,Asia,0,0,0,0,0,0,0,Unknown
1936-08-27 00:00:00,Delta Airlines,,Commercial,United States of America,North America,0,0,0,0,0,0,0,Unknown
1936-08-30 00:00:00,Club Aéreo de Bahía Blanca,Flight,Operational,Argentina,South America,1,1,0,0,0,0,1,Unknown
1936-08-31 00:00:00,Royal Air Force - RAF,Flight,Operational,United Kingdom,Europe,2,2,0,0,0,0,2,Technical Failure
1936-09-03 00:00:00,Spanish Nationalist Air Force,Takeoff (climb),Military / Government,Spain,Europe,2,2,0,0,0,0,2,Unknown
1936-09-04 00:00:00,United States Army Air Corps - USAAC,Takeoff (climb),Operational,United States of America,North America,5,5,0,0,0,0,5,Unknown
1936-09-09 00:00:00,SABENA - Société Anonyme Belge d'Exploitation de la Navigation Aérienne,Flight,Commercial,Democratic Republic of Congo,Africa,0,0,0,0,0,0,0,Technical Failure
1936-09-15 00:00:00,Royal Air Force - RAF,Flight,Military / Government,United Kingdom,Europe,1,1,0,0,0,0,1,Human Factor
1936-09-19 00:00:00,Deutsche Lufthansa,Flight,Commercial,Germany,Europe,0,0,0,0,0,0,0,Unknown
1936-09-23 00:00:00,French Government,Flight,Military / Government,France,Europe,2,1,0,1,0,0,2,Technical Failure
1936-09-26 00:00:00,Air France,Landing (descent or approach),Commercial,France,Europe,9,2,0,7,0,0,9,Weather
1936-09-29 00:00:00,Swedish Air Force - Flygvapnet,Flight,Operational,Sweden,Europe,1,1,0,0,0,0,1,Human Factor
1936-09-30 00:00:00,Private British,Flight,Business,Tanzania,Africa,2,2,0,0,0,0,2,Weather
1936-10-07 00:00:00,Private British,Flight,Business,Australia,Oceania,4,2,0,2,0,0,4,Technical Failure
1936-10-16 00:00:00,Private Canadian,Flight,Business,Canada,North America,2,2,0,0,0,0,2,Technical Failure
1936-10-18 00:00:00,Colombian Air Force - Fuerza Aérea Colombiana,Takeoff (climb),Military / Government,Colombia,South America,5,1,0,4,0,0,5,Unknown
1936-10-18 00:00:00,North Queensland Airways,Takeoff (climb),Commercial,Australia,Oceania,3,1,0,2,0,0,3,Unknown
1936-10-22 00:00:00,Private British,Flight,Business,United Kingdom,Europe,2,1,0,1,0,0,2,Unknown
1936-10-24 00:00:00,Wyoming Air Service,Flight,Operational,United States of America,North America,0,0,0,0,0,0,0,Unknown
1936-10-26 00:00:00,Air Bleu,Landing (descent or approach),Operational,Pakistan,Asia,3,3,0,0,0,0,3,Unknown
1936-10-26 00:00:00,Aero Club Argentino,,Operational,Argentina,South America,0,0,0,0,0,0,0,Unknown
1936-11-02 00:00:00,Northern %26 Scottish Airways,Takeoff (climb),Commercial,United Kingdom,Europe,8,1,0,7,0,0,8,Unknown
1936-11-05 00:00:00,United States Army Air Corps - USAAC,Flight,Operational,United States of America,North America,5,5,0,0,0,0,5,Unknown
1936-11-21 00:00:00,Transcontinental Airways,Landing (descent or approach),Commercial,Australia,Oceania,8,1,0,7,0,0,8,Weather
1936-11-23 00:00:00,United Airlines,Landing (descent or approach),Commercial,United States of America,North America,0,0,0,0,0,0,0,Unknown
1936-11-28 00:00:00,Deutsche Lufthansa,Flight,Commercial,Germany,Europe,0,0,0,0,0,0,0,Weather
1936-12-08 00:00:00,French Air Force - Armée de l'Air,Landing (descent or approach),Military / Government,Spain,Europe,6,3,0,3,0,0,6,Terrorism
1936-12-19 00:00:00,Eastern Airlines,Flight,Commercial,United States of America,North America,11,3,0,8,0,0,11,Human Factor
1936-12-22 00:00:00,Airlines WA,Flight,Commercial,Australia,Oceania,0,0,0,0,0,0,0,Technical Failure
1936-12-23 00:00:00,Private Swedish,Landing (descent or approach),Business,Sweden,Europe,1,1,0,0,0,0,1,Human Factor
1936-12-23 00:00:00,Royal Victorian Aero Club,Landing (descent or approach),Business,Australia,Oceania,2,1,0,1,0,0,2,Human Factor
1936-12-25 00:00:00,China National Aviation Corporation - CNAC,Flight,Commercial,China,Asia,0,0,0,0,0,0,0,Unknown
1936-12-30 00:00:00,Lawrence Aircraft Hire,Flight,Business,France,Europe,1,1,0,0,0,0,1,Unknown
1937-01-08 00:00:00,Royal Air Force - RAF,Taxiing,Operational,United Kingdom,Europe,0,0,0,0,0,0,0,Other
1937-01-15 00:00:00,Private American,Flight,Business,Brazil,South America,1,1,0,0,0,0,1,Technical Failure
1937-02-01 00:00:00,Royal Air Force - RAF,Landing (descent or approach),Operational,United Kingdom,Europe,2,2,0,0,0,0,2,Human Factor
1937-02-03 00:00:00,Royal Air Force - RAF,Flight,Military / Government,United Kingdom,Europe,4,4,0,0,0,0,4,Human Factor
1937-02-05 00:00:00,Royal Air Force - RAF,Landing (descent or approach),Operational,United Kingdom,Europe,2,2,0,0,0,0,2,Unknown
1937-02-08 00:00:00,Panair do Brasil,,Commercial,Brazil,South America,0,0,0,0,0,0,0,Unknown
1937-02-12 00:00:00,New Zealand Airways,Takeoff (climb),Specialised Services,New Zealand,Oceania,2,1,0,1,0,0,2,Unknown
1937-02-14 00:00:00,Royal Air Force - RAF,Landing (descent or approach),Operational,United Kingdom,Europe,2,2,0,0,0,0,2,Unknown
1937-02-18 00:00:00,Eastern Airlines,Flight,Commercial,United States of America,North America,0,0,0,0,0,0,0,Unknown
1937-02-19 00:00:00,Indian National Airways - INA,Takeoff (climb),Commercial,Pakistan,Asia,4,1,0,3,0,0,4,Unknown
1937-03-13 00:00:00,Lloyd Aéreo Boliviano - LAB Airlines,Landing (descent or approach),Commercial,Bolivia,South America,0,0,0,0,0,0,0,Unknown
1937-03-21 00:00:00,Holden's Air Transport Services,Landing (descent or approach),Operational,Papua New Guinea,Oceania,1,1,0,0,0,0,1,Other
1937-03-21 00:00:00,Canadian Airways,Takeoff (climb),Commercial,Canada,North America,0,0,0,0,0,0,0,Weather
1937-03-25 00:00:00,Royal Air Force - RAF,Landing (descent or approach),Operational,United Kingdom,Europe,5,5,0,0,0,0,5,Human Factor
1937-03-26 00:00:00,Deutsche Lufthansa,Flight,Commercial,Germany,Europe,6,2,0,4,0,0,6,Technical Failure
1937-03-27 00:00:00,Private Canadian,Takeoff (climb),Business,Canada,North America,2,1,0,1,0,0,2,Weather
1937-04-04 00:00:00,Kingston Flying Club,Landing (descent or approach),Operational,Canada,North America,2,2,0,0,0,0,2,Weather
1937-04-06 00:00:00,German Air Force - Deutsche Luftwaffe,Takeoff (climb),Military / Government,Poland,Europe,0,0,0,0,0,0,0,Unknown
1937-04-12 00:00:00,Mainichi Shinbun,Landing (descent or approach),Operational,Japan,Asia,1,1,0,0,0,0,1,Unknown
1937-04-14 00:00:00,Wilson Airways,Takeoff (climb),Commercial,Kenya,Africa,2,1,0,1,0,0,2,Unknown
1937-04-15 00:00:00,Deutsche Lufthansa,,Commercial,Germany,Europe,0,0,0,0,0,0,0,Unknown
1937-04-17 00:00:00,Royal Air Force - RAF,Flight,Operational,United Kingdom,Europe,1,1,0,0,0,0,1,Unknown
1937-04-23 00:00:00,Linea Aeropostal Venezolana - LAV,Flight,Commercial,Venezuela,South America,0,0,0,0,0,0,0,Unknown
1937-04-27 00:00:00,Varney Air Transport - VAT,Flight,Operational,United States of America,North America,1,1,0,0,0,0,1,Unknown
1937-04-29 00:00:00,Liniile Aeriene Române Exploatate cu Statul - LARES,Takeoff (climb),Operational,Romania,Europe,2,2,0,0,0,0,2,Unknown
1937-05-07 00:00:00,North Queensland Airways,Takeoff (climb),Commercial,Australia,Oceania,4,1,0,3,0,0,4,Unknown
1937-05-07 00:00:00,United States Army Air Corps - USAAC,Flight,Operational,United States of America,North America,1,1,0,0,0,0,1,Technical Failure
1937-05-07 00:00:00,United States Army Air Corps - USAAC,Flight,Military / Government,United States of America,North America,3,3,0,0,0,0,3,Technical Failure
1937-05-12 00:00:00,Airlines of Australia,Parking,Commercial,Australia,Oceania,7,2,0,5,0,0,7,Technical Failure
1937-05-15 00:00:00,Private American,,Business,United States of America,North America,0,0,0,0,0,0,0,Unknown
1937-05-15 00:00:00,Lineas Aéreas Occidentales,Flight,Commercial,United States of America,North America,0,0,0,0,0,0,0,Unknown
1937-05-15 00:00:00,Skyways - Australia,Flight,Commercial,Australia,Oceania,1,1,0,0,0,0,1,Unknown
1937-05-22 00:00:00,Rhodesian %26 Nyasaland Airways,Landing (descent or approach),Commercial,Nigeria,Africa,5,1,0,4,0,0,5,Unknown
1937-05-24 00:00:00,Kuala Lumpur Flying Club,Landing (descent or approach),Operational,Malaysia,Asia,1,1,0,0,0,0,1,Unknown
1937-05-26 00:00:00,Private American,Flight,Business,United States of America,North America,1,1,0,0,0,0,1,Unknown
1937-05-27 00:00:00,Royal Norwegian Air Force - Kongelige Norske Luftforsvaret,Flight,Operational,Norway,Europe,1,1,0,0,0,0,1,Weather
1937-05-29 00:00:00,Private American,Flight,Business,United States of America,North America,0,0,0,0,0,0,0,Unknown
1937-05-31 00:00:00,Irrawaddy Flotilla %26 Airways,Takeoff (climb),Military / Government,Myanmar,Asia,3,1,0,2,0,0,3,Other
1937-06-09 00:00:00,Australian National Airways - ANA,Flight,Commercial,Australia,Oceania,2,1,0,1,0,0,2,Human Factor
1937-06-10 00:00:00,Cape Breton Flying Club,Landing (descent or approach),Operational,Canada,North America,2,2,0,0,0,0,2,Technical Failure
1937-06-12 00:00:00,United States Army Air Corps - USAAC,Takeoff (climb),Military / Government,United States of America,North America,0,0,0,0,0,0,0,Unknown
1937-06-14 00:00:00,Deutsche Lufthansa,,Commercial,Germany,Europe,0,0,0,0,0,0,0,Unknown
1937-06-16 00:00:00,Starratt Airways %26 Transportation,Landing (descent or approach),Commercial,Canada,North America,0,0,0,0,0,0,0,Unknown
1937-06-19 00:00:00,Northern Aerial Minerals Exploration,Takeoff (climb),Commercial,Canada,North America,0,0,0,0,0,0,0,Technical Failure
1937-06-28 00:00:00,Cape Breton Flying Club,Landing (descent or approach),Operational,Canada,North America,2,2,0,0,0,0,2,Unknown
1937-06-29 00:00:00,Yapton Aero Club,Landing (descent or approach),Business,United Kingdom,Europe,2,2,0,0,0,0,2,Unknown
1937-07-04 00:00:00,AB Ahrenbergsflyg,Takeoff (climb),Commercial,Sweden,Europe,0,0,0,0,0,0,0,Unknown
1937-07-06 00:00:00,Herts %26 Essex Aero Club,Landing (descent or approach),Business,United Kingdom,Europe,2,1,0,1,0,0,2,Unknown
1937-07-21 00:00:00,Royal Air Force - RAF,Landing (descent or approach),Military / Government,United Kingdom,Europe,4,4,0,0,0,0,4,Human Factor
1937-07-21 00:00:00,Norsk Lufttrafik,Flight,Operational,Sweden,Europe,1,1,0,0,0,0,1,Unknown
1937-07-23 00:00:00,Cape Cod Airlines,Flight,Business,United States of America,North America,5,1,0,4,0,0,5,Human Factor
1937-07-29 00:00:00,South African Airways -SAA - Suid Afrikaanse Lugdiens - SAL,Flight,Operational,South Sudan,Africa,2,2,0,0,0,0,2,Unknown
1937-07-30 00:00:00,Royal Air Force - RAF,Landing (descent or approach),Operational,United Kingdom,Europe,1,1,0,0,0,0,1,Human Factor
1937-08-01 00:00:00,Eurasia Aviation Corporation,Flight,Commercial,China,Asia,0,0,0,0,0,0,0,Technical Failure
1937-08-03 00:00:00,United States Army Air Corps - USAAC,Flight,Military / Government,Panama,Central America,2,2,0,0,0,0,2,Unknown
1937-08-12 00:00:00,Witney %26 Oxford Aero Club,Flight,Operational,United Kingdom,Europe,2,2,0,0,0,0,2,Unknown
1937-08-13 00:00:00,Deutsche Lufthansa,Takeoff (climb),Specialised Services,Germany,Europe,3,2,0,1,0,0,3,Unknown
1937-08-15 00:00:00,Cape Breton Flying Club,Landing (descent or approach),Operational,Canada,North America,1,1,0,0,0,0,1,Human Factor
1937-08-15 00:00:00,Spanish Nationalist Air Force,Takeoff (climb),Operational,France,Europe,2,2,0,0,0,0,2,Unknown
1937-08-17 00:00:00,Private British,Landing (descent or approach),Business,United Kingdom,Europe,2,2,0,0,0,0,2,Human Factor
1937-08-21 00:00:00,Republic Oil Company,Flight,Military / Government,United States of America,North America,3,3,0,0,0,0,3,Weather
1937-08-27 00:00:00,Guinea Airways,Takeoff (climb),Operational,Papua New Guinea,Oceania,1,1,0,0,0,0,1,Human Factor
1937-09-11 00:00:00,CSA Czech Airlines - Československé Státní Aerolinie,Takeoff (climb),Operational,Slovakia,Europe,2,2,0,0,0,0,2,Technical Failure
1937-09-15 00:00:00,Faucett,Takeoff (climb),Commercial,Peru,South America,0,0,0,0,0,0,0,Unknown
1937-09-18 00:00:00,Private Canadian,Flight,Business,Canada,North America,1,1,0,0,0,0,1,Technical Failure
1937-09-28 00:00:00,TACA International Airlines - Transportes Aéreos Centro Americanos,Flight,Commercial,Nicaragua,Central America,8,2,0,6,0,0,8,Unknown
1937-10-16 00:00:00,Mandated Airlines,Flight,Operational,Papua New Guinea,Oceania,1,1,0,0,0,0,1,Unknown
1937-10-25 00:00:00,German Air Force - Deutsche Luftwaffe,,Military / Government,Germany,Europe,0,0,0,0,0,0,0,Unknown
1937-10-26 00:00:00,Royal Air Force - RAF,Landing (descent or approach),Operational,United Kingdom,Europe,2,2,0,0,0,0,2,Human Factor
1937-10-28 00:00:00,Royal Air Force - RAF,Landing (descent or approach),Operational,United Kingdom,Europe,2,2,0,0,0,0,2,Human Factor
1937-11-09 00:00:00,Royal Air Force - RAF,Takeoff (climb),Military / Government,United Kingdom,Europe,0,0,0,0,0,0,0,Technical Failure
1937-11-15 00:00:00,Private German,Flight,Specialised Services,Germany,Europe,3,3,0,0,0,0,3,Weather
1937-12-01 00:00:00,North Queensland Airways,Landing (descent or approach),Humanitarian,Australia,Oceania,0,0,0,0,0,0,0,Unknown
1937-12-06 00:00:00,SAAF Aero Club,Flight,Operational,South Africa,Africa,2,2,0,0,0,0,2,Unknown
1937-12-13 00:00:00,British Airways,Landing (descent or approach),Commercial,United Kingdom,Europe,0,0,0,0,0,0,0,Weather
1937-12-17 00:00:00,KLM Royal Dutch Airlines - Koninklijke Luchtvaart Maatschappij,Takeoff (climb),Operational,Netherlands,Europe,2,2,0,0,0,0,2,Human Factor
1937-12-17 00:00:00,Arabian Airways,,Commercial,Yemen,Asia,0,0,0,0,0,0,0,Unknown
1937-12-20 00:00:00,Canadian Airways,Landing (descent or approach),Commercial,Canada,North America,0,0,0,0,0,0,0,Other
1937-12-22 00:00:00,Spanish Air Force - Ejército del Aire,Landing (descent or approach),Operational,France,Europe,2,2,0,0,0,0,2,Unknown
1937-12-30 00:00:00,Wideroe - Wideroe's Flyveselskap,,Commercial,Norway,Europe,0,0,0,0,0,0,0,Unknown
1938-01-08 00:00:00,Private Mexican,,Business,United States of America,North America,0,0,0,0,0,0,0,Unknown
1938-01-12 00:00:00,LOT Polish Airlines - Polskie Linie Lotnicze,Landing (descent or approach),Military / Government,Finland,Europe,0,0,0,0,0,0,0,Unknown
1938-01-13 00:00:00,Royal Air Force - RAF,Landing (descent or approach),Military / Government,United Kingdom,Europe,4,4,0,0,0,0,4,Unknown
1938-01-14 00:00:00,Northern %26 Scottish Airways,Flight,Operational,United Kingdom,Europe,2,2,0,0,0,0,2,Technical Failure
1938-01-15 00:00:00,Private Dutch,Flight,Business,Netherlands,Europe,1,1,0,0,0,0,1,Weather
1938-01-19 00:00:00,Halifax Aero Club,Flight,Operational,Canada,North America,1,1,0,0,0,0,1,Human Factor
1938-01-19 00:00:00,Halifax Aero Club,Flight,Operational,Canada,North America,2,2,0,0,0,0,2,Human Factor
1938-01-22 00:00:00,Air Bleu,Landing (descent or approach),Commercial,France,Europe,3,3,0,0,0,0,3,Weather
1938-02-03 00:00:00,United States Army Air Corps - USAAC,Takeoff (climb),Military / Government,United States of America,North America,0,0,0,0,0,0,0,Technical Failure
1938-02-03 00:00:00,Royal Australian Air Force - RAAF,Landing (descent or approach),Operational,Australia,Oceania,3,3,0,0,0,0,3,Human Factor
1938-02-04 00:00:00,KNILM - Koninklijke Nederlandse Indies Luchtvaart Maatschappij,Flight,Commercial,Indonesia,Asia,0,0,0,0,0,0,0,Unknown
1938-02-11 00:00:00,Nippon Air Transport,Landing (descent or approach),Commercial,Japan,Asia,0,0,0,0,0,0,0,Unknown
1938-02-15 00:00:00,Lineas Aéreas Postales Espanolas - LAPE,,Commercial,Spain,Europe,0,0,0,0,0,0,0,Unknown
1938-02-16 00:00:00,Private French,Takeoff (climb),Business,Guatemala,Central America,2,2,0,0,0,0,2,Human Factor
1938-02-24 00:00:00,Examiner Printing Company,Flight,Business,United States of America,North America,0,0,0,0,0,0,0,Unknown
1938-02-25 00:00:00,Private American,Landing (descent or approach),Business,United States of America,North America,0,0,0,0,0,0,0,Unknown
1938-02-25 00:00:00,Royal Air Force - RAF,Landing (descent or approach),Operational,United Kingdom,Europe,2,2,0,0,0,0,2,Human Factor
1938-02-26 00:00:00,Air Travel %26 Survey,Landing (descent or approach),Operational,United Kingdom,Europe,3,3,0,0,0,0,3,Human Factor
1938-02-28 00:00:00,Air Afrique,,Commercial,Tunisia,Africa,0,0,0,0,0,0,0,Unknown
1938-03-05 00:00:00,Guinea Airways,Takeoff (climb),Commercial,Papua New Guinea,Oceania,1,1,0,0,0,0,1,Unknown
1938-03-07 00:00:00,French Air Force - Armée de l'Air,Flight,Operational,France,Europe,2,2,0,0,0,0,2,Unknown
1938-03-10 00:00:00,Spanish Nationalist Air Force,Flight,Military / Government,Spain,Europe,4,4,0,0,0,0,4,Terrorism
1938-03-12 00:00:00,Auckland Aero Club,Flight,Operational,New Zealand,Oceania,0,0,0,0,0,0,0,Unknown
1938-03-15 00:00:00,Colombian Air Force - Fuerza Aérea Colombiana,,Military / Government,Colombia,South America,0,0,0,0,0,0,0,Unknown
1938-03-17 00:00:00,Polyarnaya Aviatsiya,Landing (descent or approach),Specialised Services,Russia,Asia,7,4,0,3,0,0,7,Human Factor
1938-03-23 00:00:00,Japan Air Transport,,Operational,Japan,Asia,1,1,0,0,0,0,1,Unknown
1938-03-28 00:00:00,Malert - Magyar-Szoviet Legiforgalmi Tarseaag,,Commercial,Hungary,Europe,0,0,0,0,0,0,0,Unknown
1938-03-30 00:00:00,United States Coast Guard - USCG,,Military / Government,United States of America,North America,6,6,0,0,0,0,6,Unknown
1938-03-30 00:00:00,Ala Littoria,Flight,Operational,Italy,Europe,2,2,0,0,0,0,2,Human Factor
1938-04-01 00:00:00,Romanian Air Force - Fortele Aeriene Române,Flight,Military / Government,Croatia,Europe,0,0,0,0,0,0,0,Unknown
1938-04-06 00:00:00,Royal Air Force - RAF,Landing (descent or approach),Operational,United Kingdom,Europe,2,2,0,0,0,0,2,Human Factor
1938-04-09 00:00:00,Royal Air Force - RAF,Takeoff (climb),Operational,United Kingdom,Europe,2,2,0,0,0,0,2,Technical Failure
1938-04-18 00:00:00,Royal Victorian Aero Club,Flight,Business,Australia,Oceania,2,1,0,1,0,0,2,Technical Failure
1938-04-19 00:00:00,Royal Air Force - RAF,Takeoff (climb),Operational,China,Asia,0,0,0,0,0,0,0,Unknown
1938-04-25 00:00:00,Pan American World Airways - PAA,Landing (descent or approach),Commercial,Jamaica,Central America,18,6,0,12,0,0,18,Technical Failure
1938-04-25 00:00:00,Wrightways,Takeoff (climb),Operational,United Kingdom,Europe,2,2,0,0,0,0,2,Unknown
1938-04-27 00:00:00,Nicaraguayan Air Force - Fuerza Aérea - Ejercito de Nicaragua,Flight,Military / Government,Nicaragua,Central America,0,0,0,0,0,0,0,Unknown
1938-05-03 00:00:00,Royal Air Force - RAF,Takeoff (climb),Operational,China,Asia,0,0,0,0,0,0,0,Unknown
1938-05-09 00:00:00,Stephens Aviation,Flight,Commercial,Papua New Guinea,Oceania,9,2,0,7,0,0,9,Unknown
1938-05-10 00:00:00,LAN Chile - Linea Aérea Nacional de Chile,Flight,Commercial,Chile,South America,0,0,0,0,0,0,0,Unknown
1938-05-11 00:00:00,Royal Air Force - RAF,Takeoff (climb),Operational,United Kingdom,Europe,2,2,0,0,0,0,2,Technical Failure
1938-05-12 00:00:00,SCADTA - Sociedad Colombo-Alemana de Transportes Aéreos,Flight,Commercial,Colombia,South America,3,2,0,1,0,0,3,Unknown
1938-05-13 00:00:00,SCADTA - Sociedad Colombo-Alemana de Transportes Aéreos,Landing (descent or approach),Military / Government,Colombia,South America,6,6,0,0,0,0,6,Unknown
1938-05-16 00:00:00,Hungarian Air Force - Magyar Honvédség Repülö Csapatai MHRC,Landing (descent or approach),Military / Government,Hungary,Europe,0,0,0,0,0,0,0,Unknown
1938-06-02 00:00:00,SABENA - Société Anonyme Belge d'Exploitation de la Navigation Aérienne,Flight,Commercial,United Kingdom,Europe,0,0,0,0,0,0,0,Unknown
1938-06-13 00:00:00,Air Afrique,,Commercial,Algeria,Africa,6,2,0,4,0,0,6,Weather
1938-06-26 00:00:00,Deutsche Lufthansa Sucursal,Flight,Commercial,Peru,South America,7,2,0,5,0,0,7,Unknown
1938-07-02 00:00:00,United States Army Air Corps - USAAC,Landing (descent or approach),Operational,United States of America,North America,0,0,0,0,0,0,0,Unknown
1938-07-07 00:00:00,French Air Force - Armée de l'Air,Flight,Operational,France,Europe,4,4,0,0,0,0,4,Technical Failure
1938-07-07 00:00:00,French Air Force - Armée de l'Air,Takeoff (climb),Operational,France,Europe,5,5,0,0,0,0,5,Technical Failure
1938-07-11 00:00:00,Hungarian Air Force - Magyar Honvédség Repülö Csapatai MHRC,Flight,Military / Government,Hungary,Europe,0,0,0,0,0,0,0,Human Factor
1938-07-14 00:00:00,Royal Air Force - RAF,Landing (descent or approach),Operational,United Kingdom,Europe,2,2,0,0,0,0,2,Human Factor
1938-07-15 00:00:00,Pan American World Airways - PAA,Takeoff (climb),Commercial,Argentina,South America,13,5,0,8,0,0,13,Technical Failure
1938-07-16 00:00:00,Eurasia Aviation Corporation,Landing (descent or approach),Commercial,China,Asia,0,0,0,0,0,0,0,Weather
1938-07-20 00:00:00,French Air Force - Armée de l'Air,Flight,Operational,France,Europe,2,2,0,0,0,0,2,Unknown
1938-07-23 00:00:00,Royal Air Force - RAF,Landing (descent or approach),Operational,United Kingdom,Europe,3,3,0,0,0,0,3,Human Factor
1938-08-07 00:00:00,Royal Air Force - RAF,Flight,Operational,United Kingdom,Europe,3,3,0,0,0,0,3,Unknown
1938-08-14 00:00:00,United Air Transport,Takeoff (climb),Commercial,Canada,North America,2,1,0,1,0,0,2,Unknown
1938-08-14 00:00:00,Kingston Flying Club,Flight,Operational,Canada,North America,2,2,0,0,0,0,2,Unknown
1938-08-16 00:00:00,Nederlandse Nieuw Guinea Petroleum Maatschappij,Flight,Specialised Services,Indonesia,Asia,2,1,0,1,0,0,2,Technical Failure
1938-08-18 00:00:00,LOT Polish Airlines - Polskie Linie Lotnicze,Taxiing,Commercial,Romania,Europe,7,3,0,4,0,0,7,Technical Failure
1938-08-19 00:00:00,Aeroflot - Russian International Airlines,Takeoff (climb),Commercial,Sweden,Europe,0,0,0,0,0,0,0,Unknown
1938-08-24 00:00:00,Transcontinental %26 Western Air - TWA,Takeoff (climb),Commercial,United States of America,North America,11,3,0,8,0,0,11,Technical Failure
1938-08-24 00:00:00,Romford Flying Club,Landing (descent or approach),Business,United Kingdom,Europe,1,1,0,0,0,0,1,Unknown
1938-09-03 00:00:00,Mayflower Airlines,,Commercial,United States of America,North America,0,0,0,0,0,0,0,Unknown
1938-09-03 00:00:00,Johnson Flying Service,Landing (descent or approach),Commercial,United States of America,North America,0,0,0,0,0,0,0,Unknown
1938-09-11 00:00:00,Royal Australian Air Force - RAAF,Landing (descent or approach),Military / Government,Australia,Oceania,4,4,0,0,0,0,4,Unknown
1938-09-17 00:00:00,Transportes Aéreos Gelabert,Takeoff (climb),Commercial,Panama,Central America,0,0,0,0,0,0,0,Unknown
1938-09-19 00:00:00,Royal Air Force - RAF,Flight,Operational,United Kingdom,Europe,4,4,0,0,0,0,4,Human Factor
1938-09-21 00:00:00,United States Army Air Corps - USAAC,Takeoff (climb),Military / Government,United States of America,North America,0,0,0,0,0,0,0,Unknown
1938-09-22 00:00:00,Royal Air Force - RAF,Flight,Operational,United Kingdom,Europe,3,3,0,0,0,0,3,Technical Failure
1938-09-29 00:00:00,Royal Air Force - RAF,Flight,Military / Government,United Kingdom,Europe,0,0,0,0,0,0,0,Technical Failure
1938-10-03 00:00:00,Private Canadian,Flight,Business,Canada,North America,0,0,0,0,0,0,0,Unknown
1938-10-06 00:00:00,Royal Air Force - RAF,Flight,Operational,United Kingdom,Europe,6,6,0,0,0,0,6,Weather
1938-10-06 00:00:00,Royal Air Force - RAF,Flight,Operational,United Kingdom,Europe,5,5,0,0,0,0,5,Weather
1938-10-07 00:00:00,Spanish Nationalist Air Force,Flight,Military / Government,Spain,Europe,0,0,0,0,0,0,0,Terrorism
1938-10-09 00:00:00,Graffo Flight Services,Landing (descent or approach),Commercial,Canada,North America,0,0,0,0,0,0,0,Unknown
1938-10-15 00:00:00,Syndicato Condor,,Commercial,Brazil,South America,0,0,0,0,0,0,0,Unknown
1938-10-16 00:00:00,Airlines WA,Flight,Commercial,Australia,Oceania,2,1,0,1,0,0,2,Weather
1938-10-18 00:00:00,Eastern Airlines,Takeoff (climb),Commercial,United States of America,North America,14,3,0,11,0,0,14,Technical Failure
1938-10-21 00:00:00,Royal Air Force - RAF,Flight,Operational,United Kingdom,Europe,5,5,0,0,0,0,5,Technical Failure
1938-11-07 00:00:00,Northern Airways,Takeoff (climb),Commercial,Canada,North America,0,0,0,0,0,0,0,Unknown
1938-11-10 00:00:00,Japan Air Transport,,Commercial,Japan,Asia,0,0,0,0,0,0,0,Unknown
1938-11-11 00:00:00,Royal Air Force - RAF,Landing (descent or approach),Operational,United Kingdom,Europe,0,0,0,0,0,0,0,Human Factor
1938-11-16 00:00:00,Air Afrique,Flight,Commercial,Democratic Republic of Congo,Africa,3,3,0,0,0,0,3,Unknown
1938-11-17 00:00:00,Canadian Airways,Landing (descent or approach),Commercial,Canada,North America,0,0,0,0,0,0,0,Weather
1938-11-18 00:00:00,Royal Air Force - RAF,Landing (descent or approach),Operational,United Kingdom,Europe,2,2,0,0,0,0,2,Unknown
1938-11-24 00:00:00,Royal Australian Air Force - RAAF,Flight,Operational,Australia,Oceania,2,2,0,0,0,0,2,Unknown
1938-11-24 00:00:00,Royal Air Force - RAF,Landing (descent or approach),Operational,United Kingdom,Europe,4,4,0,0,0,0,4,Human Factor
1938-11-28 00:00:00,Royal Air Force - RAF,Flight,Operational,United Kingdom,Europe,0,0,0,0,0,0,0,Technical Failure
1938-12-01 00:00:00,Royal Air Force - RAF,Flight,Operational,United Kingdom,Europe,0,0,0,0,0,0,0,Technical Failure
1938-12-02 00:00:00,Deutsche Lufthansa,Landing (descent or approach),Commercial,Austria,Europe,8,3,0,5,0,0,8,Human Factor
1938-12-06 00:00:00,Deutsche Lufthansa,Flight,Commercial,Philippines,Asia,8,8,0,0,0,0,8,Technical Failure
1938-12-10 00:00:00,Japan Air Transport,Taxiing,Commercial,China,Asia,0,0,0,0,0,0,0,Unknown
1938-12-10 00:00:00,Sociedad Ecuatoriana de Transportes Aéreos - SEDTA,Landing (descent or approach),Commercial,Ecuador,South America,5,2,0,3,0,0,5,Unknown
1938-12-12 00:00:00,Royal Air Force - RAF,Landing (descent or approach),Operational,United Kingdom,Europe,4,4,0,0,0,0,4,Human Factor
1938-12-16 00:00:00,Royal Air Force - RAF,Landing (descent or approach),Operational,United Kingdom,Europe,2,2,0,0,0,0,2,Human Factor
1938-12-17 00:00:00,The Plymouth %26 District Aero Club,Flight,Business,United Kingdom,Europe,3,1,0,2,0,0,3,Unknown
1938-12-20 00:00:00,KNILM - Koninklijke Nederlandse Indies Luchtvaart Maatschappij,Flight,Commercial,Indonesia,Asia,0,0,0,0,0,0,0,Unknown
1938-12-20 00:00:00,Rhodesian %26 Nyasaland Airways,Flight,Commercial,Zimbabwe,Africa,0,0,0,0,0,0,0,Unknown
1938-12-20 00:00:00,Royal Air Force - RAF,Flight,Operational,United Kingdom,Europe,0,0,0,0,0,0,0,Technical Failure
1938-12-31 00:00:00,Panair do Brasil,,Commercial,Brazil,South America,0,0,0,0,0,0,0,Unknown
1939-01-01 00:00:00,Rhodesian %26 Nyasaland Airways,,Commercial,Zambia,Africa,0,0,0,0,0,0,0,Unknown
1939-01-07 00:00:00,Private Australian,Takeoff (climb),Business,Australia,Oceania,1,1,0,0,0,0,1,Technical Failure
1939-01-13 00:00:00,Commercial Aviation Company - Palestine,Landing (descent or approach),Operational,Palestine,Asia,2,2,0,0,0,0,2,Unknown
1939-01-19 00:00:00,Royal Air Force - RAF,Takeoff (climb),Operational,United Kingdom,Europe,0,0,0,0,0,0,0,Technical Failure
1939-01-24 00:00:00,Royal Air Force - RAF,Landing (descent or approach),Operational,United Kingdom,Europe,3,3,0,0,0,0,3,Human Factor
1939-01-25 00:00:00,Wilson Airways,Takeoff (climb),Commercial,Tanzania,Africa,3,1,0,2,0,0,3,Unknown
1939-02-01 00:00:00,Wilson Airways,Landing (descent or approach),Commercial,Kenya,Africa,3,1,0,2,0,0,3,Unknown
1939-02-05 00:00:00,De Havilland Aircraft UK,Flight,Business,United Kingdom,Europe,2,1,0,1,0,0,2,Unknown
1939-02-13 00:00:00,Royal Air Force - RAF,Landing (descent or approach),Operational,United Kingdom,Europe,3,3,0,0,0,0,3,Unknown
1939-02-22 00:00:00,Private French,Flight,Business,Chad,Africa,2,2,0,0,0,0,2,Unknown
1939-02-24 00:00:00,LAN Chile - Linea Aérea Nacional de Chile,Flight,Commercial,Chile,South America,2,1,0,1,0,0,2,Technical Failure
1939-02-26 00:00:00,Private British,Flight,Business,United Kingdom,Europe,0,0,0,0,0,0,0,Unknown
1939-02-27 00:00:00,Kingston Flying Club,Landing (descent or approach),Business,Canada,North America,2,1,0,1,0,0,2,Human Factor
1939-02-28 00:00:00,Auckland Aero Club,Landing (descent or approach),Operational,New Zealand,Oceania,2,2,0,0,0,0,2,Unknown
1939-03-06 00:00:00,Reale Unione Nazionale Aeronautica,Flight,Commercial,Italy,Europe,0,0,0,0,0,0,0,Unknown
1939-03-11 00:00:00,Royal Air Force - RAF,Flight,Operational,United Kingdom,Europe,0,0,0,0,0,0,0,Unknown
1939-03-12 00:00:00,Eurasia Aviation Corporation,Flight,Commercial,China,Asia,0,0,0,0,0,0,0,Unknown
1939-03-12 00:00:00,Imperial Airways,Taxiing,Commercial,Indonesia,Asia,8,5,0,3,0,0,8,Other
1939-03-14 00:00:00,LAN Chile - Linea Aérea Nacional de Chile,Flight,Commercial,Chile,South America,6,1,0,5,0,0,6,Technical Failure
1939-03-22 00:00:00,Royal Air Force - RAF,Flight,Operational,United Kingdom,Europe,0,0,0,0,0,0,0,Technical Failure
1939-04-01 00:00:00,Royal Air Force - RAF,Landing (descent or approach),Operational,United Kingdom,Europe,0,0,0,0,0,0,0,Human Factor
1939-04-01 00:00:00,Royal Air Force - RAF,Landing (descent or approach),Military / Government,Yemen,Asia,0,0,0,0,0,0,0,Unknown
1939-04-03 00:00:00,Lloyd Aéreo Boliviano - LAB Airlines,Flight,Commercial,Bolivia,South America,0,0,0,0,0,0,0,Unknown
1939-04-04 00:00:00,Royal Air Force - RAF,Takeoff (climb),Operational,United Kingdom,Europe,1,1,0,0,0,0,1,Unknown
1939-04-05 00:00:00,Royal Air Force - RAF,Landing (descent or approach),Operational,United Kingdom,Europe,3,3,0,0,0,0,3,Human Factor
1939-04-12 00:00:00,Lloyd Aéreo Boliviano - LAB Airlines,Landing (descent or approach),Commercial,Colombia,South America,0,0,0,0,0,0,0,Unknown
1939-04-15 00:00:00,Venezuelan Government,Landing (descent or approach),Military / Government,Venezuela,South America,4,2,0,2,0,0,4,Weather
1939-04-17 00:00:00,Royal Air Force - RAF,Taxiing,Operational,United Kingdom,Europe,0,0,0,0,0,0,0,Unknown
1939-04-17 00:00:00,Royal Air Force - RAF,Landing (descent or approach),Operational,United Kingdom,Europe,0,0,0,0,0,0,0,Human Factor
1939-04-17 00:00:00,Royal Air Force - RAF,Landing (descent or approach),Operational,United Kingdom,Europe,0,0,0,0,0,0,0,Human Factor
1939-04-22 00:00:00,Royal Air Force - RAF,Landing (descent or approach),Operational,United Kingdom,Europe,2,2,0,0,0,0,2,Human Factor
1939-05-03 00:00:00,United States Navy - USN,Landing (descent or approach),Operational,United States of America,North America,0,0,0,0,0,0,0,Unknown
1939-05-09 00:00:00,Royal Air Force - RAF,Flight,Operational,United Kingdom,Europe,2,2,0,0,0,0,2,Technical Failure
1939-05-11 00:00:00,Royal Air Force - RAF,Takeoff (climb),Operational,Egypt,Africa,0,0,0,0,0,0,0,Unknown
1939-05-14 00:00:00,Royal Air Force - RAF,Landing (descent or approach),Specialised Services,United Kingdom,Europe,0,0,0,0,0,0,0,Other
1939-05-15 00:00:00,Royal Air Force - RAF,Flight,Operational,United Kingdom,Europe,0,0,0,0,0,0,0,Technical Failure
1939-05-17 00:00:00,Dai Nippon Airlines,Flight,Commercial,Japan,Asia,0,0,0,0,0,0,0,Unknown
1939-05-19 00:00:00,Royal Air Force - RAF,Landing (descent or approach),Operational,United Kingdom,Europe,0,0,0,0,0,0,0,Unknown
1939-05-19 00:00:00,Royal Air Force - RAF,Landing (descent or approach),Operational,United Kingdom,Europe,0,0,0,0,0,0,0,Unknown
1939-05-20 00:00:00,Royal Air Force - RAF,Landing (descent or approach),Operational,United Kingdom,Europe,0,0,0,0,0,0,0,Technical Failure
1939-05-20 00:00:00,Royal Air Force - RAF,Landing (descent or approach),Military / Government,United States of America,North America,3,3,0,0,0,0,3,Unknown
1939-05-28 00:00:00,Royal Air Force - RAF,Landing (descent or approach),Operational,United Kingdom,Europe,0,0,0,0,0,0,0,Technical Failure
1939-06-02 00:00:00,Royal Air Force - RAF,Flight,Operational,United Kingdom,Europe,0,0,0,0,0,0,0,Unknown
1939-06-06 00:00:00,Royal Air Force - RAF,Landing (descent or approach),Operational,United Kingdom,Europe,0,0,0,0,0,0,0,Technical Failure
1939-06-11 00:00:00,Australian National Airways - ANA,Takeoff (climb),Business,Australia,Oceania,2,1,0,1,0,0,2,Human Factor
1939-06-12 00:00:00,Imperial Airways,Landing (descent or approach),Commercial,India,Asia,8,4,0,4,0,0,8,Weather
1939-06-21 00:00:00,Wairarapa Aero Club,Landing (descent or approach),Operational,New Zealand,Oceania,2,2,0,0,0,0,2,Human Factor
1939-07-02 00:00:00,Rhodesian %26 Nyasaland Airways,Flight,Commercial,Mozambique,Africa,3,1,0,2,0,0,3,Unknown
1939-07-08 00:00:00,Royal Air Force - RAF,Flight,Operational,United Kingdom,Europe,0,0,0,0,0,0,0,Unknown
1939-07-13 00:00:00,Royal Air Force - RAF,Landing (descent or approach),Military / Government,China,Asia,0,0,0,0,0,0,0,Unknown
1939-07-20 00:00:00,Private Canadian,Flight,Business,Canada,North America,1,1,0,0,0,0,1,Unknown
1939-07-21 00:00:00,Mutual Finance,Flight,Commercial,United Kingdom,Europe,4,1,0,3,0,0,4,Unknown
1939-07-29 00:00:00,Royal Air Force - RAF,Flight,Military / Government,United Kingdom,Europe,3,2,0,1,0,0,3,Technical Failure
1939-07-29 00:00:00,French Air Force - Armée de l'Air,Landing (descent or approach),Operational,France,Europe,5,5,0,0,0,0,5,Human Factor
1939-08-03 00:00:00,Deutsche Lufthansa,Landing (descent or approach),Commercial,Myanmar,Asia,0,0,0,0,0,0,0,Unknown
1939-08-11 00:00:00,British Airways,Flight,Commercial,France,Europe,12,3,0,9,0,0,12,Technical Failure
1939-08-11 00:00:00,Royal Air Force - RAF,Landing (descent or approach),Operational,United Kingdom,Europe,2,2,0,0,0,0,2,Human Factor
1939-08-12 00:00:00,Aéromaritime,Flight,Commercial,Nigeria,Africa,0,0,0,0,0,0,0,Unknown
1939-08-19 00:00:00,Private American,Takeoff (climb),Business,United States of America,North America,1,1,0,0,0,0,1,Unknown
1939-08-25 00:00:00,Royal Air Force - RAF,Landing (descent or approach),Operational,United Kingdom,Europe,2,2,0,0,0,0,2,Human Factor
1939-08-28 00:00:00,Royal Air Force - RAF,Takeoff (climb),Operational,United Kingdom,Europe,6,6,0,0,0,0,6,Technical Failure
1939-08-28 00:00:00,Royal Air Force - RAF,Takeoff (climb),Operational,United Kingdom,Europe,6,6,0,0,0,0,6,Technical Failure
1939-08-28 00:00:00,Royal Air Force - RAF,Landing (descent or approach),Military / Government,United Kingdom,Europe,2,2,0,0,0,0,2,Unknown
1939-08-29 00:00:00,Royal Air Force - RAF,Flight,Military / Government,United Kingdom,Europe,5,5,0,0,0,0,5,Unknown
1939-09-01 00:00:00,Canadian Airways,Flight,Commercial,Canada,North America,0,0,0,0,0,0,0,Unknown
1939-09-04 00:00:00,Royal Air Force - RAF,Flight,Military / Government,France,Europe,5,5,0,0,0,0,5,Technical Failure
1939-09-05 00:00:00,Royal Air Force - RAF,Flight,Military / Government,United Kingdom,Europe,2,2,0,0,0,0,2,Terrorism
1939-09-07 00:00:00,Royal Air Force - RAF,Landing (descent or approach),Military / Government,United Kingdom,Europe,0,0,0,0,0,0,0,Human Factor
1939-09-08 00:00:00,Dai Nippon Airlines,Flight,Commercial,Japan,Asia,0,0,0,0,0,0,0,Unknown
1939-09-08 00:00:00,Royal Air Force - RAF,Takeoff (climb),Military / Government,United Kingdom,Europe,0,0,0,0,0,0,0,Technical Failure
1939-09-08 00:00:00,Royal Air Force - RAF,,Operational,United Kingdom,Europe,0,0,0,0,0,0,0,Unknown
1939-09-09 00:00:00,Royal Air Force - RAF,Taxiing,Military / Government,France,Europe,5,5,0,0,0,0,5,Weather
1939-09-09 00:00:00,Deutsche Lufthansa,,Commercial,Germany,Europe,0,0,0,0,0,0,0,Unknown
1939-09-09 00:00:00,Royal Air Force - RAF,Flight,Military / Government,Germany,Europe,5,5,0,0,0,0,5,Unknown
1939-09-09 00:00:00,Royal Air Force - RAF,Flight,Military / Government,France,Europe,4,4,0,0,0,0,4,Technical Failure
1939-09-10 00:00:00,Royal Air Force - RAF,Flight,Military / Government,United Kingdom,Europe,4,4,0,0,0,0,4,Unknown
1939-09-11 00:00:00,Royal Air Force - RAF,Takeoff (climb),Military / Government,France,Europe,5,5,0,0,0,0,5,Unknown
1939-09-13 00:00:00,German Air Force - Deutsche Luftwaffe,Landing (descent or approach),Military / Government,Netherlands,Europe,4,4,0,0,0,0,4,Unknown
1939-09-19 00:00:00,Royal Air Force - RAF,Flight,Operational,United Kingdom,Europe,5,5,0,0,0,0,5,Technical Failure
1939-09-19 00:00:00,Royal Air Force - RAF,Takeoff (climb),Operational,United Kingdom,Europe,6,6,0,0,0,0,6,Human Factor
1939-10-07 00:00:00,Dai Nippon Airlines,Landing (descent or approach),Commercial,Taiwan,Asia,0,0,0,0,0,0,0,Unknown
1939-10-08 00:00:00,German Air Force - Deutsche Luftwaffe,Flight,Military / Government,Denmark,Europe,4,4,0,0,0,0,4,Technical Failure
1939-10-10 00:00:00,German Air Force - Deutsche Luftwaffe,Flight,Military / Government,Germany,Europe,0,0,0,0,0,0,0,Human Factor
1939-10-10 00:00:00,Royal Air Force - RAF,Flight,Operational,United Kingdom,Europe,3,3,0,0,0,0,3,Human Factor
1939-10-13 00:00:00,Ala Littoria,Landing (descent or approach),Commercial,Djibouti,Africa,6,2,0,4,0,0,6,Technical Failure
1939-10-13 00:00:00,Royal Air Force - RAF,Landing (descent or approach),Operational,United Kingdom,Europe,2,2,0,0,0,0,2,Human Factor
1939-10-14 00:00:00,Royal Air Force - RAF,Flight,Military / Government,World,World,0,0,0,0,0,0,0,Unknown
1939-10-16 00:00:00,Royal Air Force - RAF,Landing (descent or approach),Operational,United Kingdom,Europe,3,3,0,0,0,0,3,Unknown
1939-10-20 00:00:00,Royal Air Force - RAF,Flight,Operational,United Kingdom,Europe,2,2,0,0,0,0,2,Technical Failure
1939-10-26 00:00:00,KNILM - Koninklijke Nederlandse Indies Luchtvaart Maatschappij,Landing (descent or approach),Commercial,Papua New Guinea,Oceania,0,0,0,0,0,0,0,Unknown
1939-10-28 00:00:00,Royal Air Force - RAF,Flight,Military / Government,France,Europe,5,5,0,0,0,0,5,Weather
1939-10-28 00:00:00,Royal Air Force - RAF,Flight,Military / Government,France,Europe,5,5,0,0,0,0,5,Unknown
1939-10-28 00:00:00,Royal Air Force - RAF,Flight,Military / Government,France,Europe,5,5,0,0,0,0,5,Weather
1939-10-30 00:00:00,RCMP - GRC Air Services,Landing (descent or approach),Military / Government,Canada,North America,0,0,0,0,0,0,0,Technical Failure
1939-10-31 00:00:00,Private New Zealand,Landing (descent or approach),Business,New Zealand,Oceania,1,1,0,0,0,0,1,Weather
1939-11-02 00:00:00,Royal Norwegian Air Force - Kongelige Norske Luftforsvaret,Flight,Operational,Norway,Europe,1,1,0,0,0,0,1,Unknown
1939-11-05 00:00:00,Royal Air Force - RAF,Landing (descent or approach),Military / Government,United Kingdom,Europe,0,0,0,0,0,0,0,Unknown
1939-11-06 00:00:00,Private Australian,Flight,Operational,Papua New Guinea,Oceania,1,1,0,0,0,0,1,Human Factor
1939-11-06 00:00:00,Royal Air Force - RAF,Landing (descent or approach),Operational,United Kingdom,Europe,2,2,0,0,0,0,2,Human Factor
1939-11-06 00:00:00,Royal Air Force - RAF,Landing (descent or approach),Operational,United Kingdom,Europe,2,2,0,0,0,0,2,Human Factor
1939-11-06 00:00:00,Royal Air Force - RAF,Flight,Operational,United Kingdom,Europe,1,1,0,0,0,0,1,Unknown
1939-11-07 00:00:00,Imperial Airways,Flight,Operational,United Kingdom,Europe,3,3,0,0,0,0,3,Weather
1939-11-09 00:00:00,Royal Air Force - RAF,Takeoff (climb),Operational,United Kingdom,Europe,2,2,0,0,0,0,2,Human Factor
1939-11-10 00:00:00,Private Australian,Landing (descent or approach),Business,Australia,Oceania,1,1,0,0,0,0,1,Unknown
1939-11-11 00:00:00,Private Canadian,Takeoff (climb),Business,Canada,North America,1,1,0,0,0,0,1,Human Factor
1939-11-15 00:00:00,Royal Air Force - RAF,Takeoff (climb),Operational,United Kingdom,Europe,1,1,0,0,0,0,1,Technical Failure
1939-11-28 00:00:00,Royal Air Force - RAF,Landing (descent or approach),Military / Government,United Kingdom,Europe,0,0,0,0,0,0,0,Unknown
1939-11-29 00:00:00,Royal Air Force - RAF,Landing (descent or approach),Operational,United Kingdom,Europe,2,2,0,0,0,0,2,Unknown
1939-11-29 00:00:00,Royal Air Force - RAF,Parking,Military / Government,United Kingdom,Europe,0,0,0,0,0,0,0,Unknown
1939-12-04 00:00:00,Royal Air Force - RAF,Flight,Operational,United Kingdom,Europe,2,2,0,0,0,0,2,Technical Failure
1939-12-12 00:00:00,United States Army Air Corps - USAAC,Landing (descent or approach),Military / Government,Panama,Central America,0,0,0,0,0,0,0,Unknown
1939-12-15 00:00:00,French Air Force - Armée de l'Air,Flight,Operational,France,Europe,3,3,0,0,0,0,3,Weather
1939-12-15 00:00:00,French Air Force - Armée de l'Air,Flight,Military / Government,France,Europe,2,2,0,0,0,0,2,Weather
1939-12-15 00:00:00,French Air Force - Armée de l'Air,Flight,Operational,France,Europe,3,3,0,0,0,0,3,Weather
1939-12-17 00:00:00,United Air Transport,Takeoff (climb),Operational,Canada,North America,1,1,0,0,0,0,1,Unknown
1939-12-18 00:00:00,Guinea Airways,Landing (descent or approach),Military / Government,Australia,Oceania,12,2,0,10,0,0,12,Technical Failure
1939-12-20 00:00:00,Royal Australian Air Force - RAAF,Flight,Military / Government,Australia,Oceania,4,4,0,0,0,0,4,Unknown
1939-12-20 00:00:00,Western Airways,Takeoff (climb),Commercial,United Kingdom,Europe,6,1,0,5,0,0,6,Unknown
1940-01-03 00:00:00,Royal Air Force - RAF,Takeoff (climb),Military / Government,United Kingdom,Europe,4,4,0,0,0,0,4,Weather
1940-01-10 00:00:00,Royal Air Force - RAF,Landing (descent or approach),Military / Government,United Kingdom,Europe,2,2,0,0,0,0,2,Human Factor
1940-01-10 00:00:00,Utility Airways,Flight,Commercial,United Kingdom,Europe,0,0,0,0,0,0,0,Unknown
1940-01-10 00:00:00,Royal Air Force - RAF,Landing (descent or approach),Operational,United Kingdom,Europe,2,2,0,0,0,0,2,Human Factor
1940-01-12 00:00:00,Royal Air Force - RAF,Landing (descent or approach),Military / Government,United Kingdom,Europe,4,4,0,0,0,0,4,Human Factor
1940-01-15 00:00:00,British Airways,Landing (descent or approach),Commercial,United Kingdom,Europe,9,3,0,6,0,0,9,Unknown
1940-01-15 00:00:00,Royal Air Force - RAF,Flight,Operational,United Kingdom,Europe,2,2,0,0,0,0,2,Technical Failure
1940-01-15 00:00:00,Royal Air Force - RAF,Flight,Operational,United Kingdom,Europe,0,0,0,0,0,0,0,Technical Failure
1940-01-15 00:00:00,Royal Air Force - RAF,Flight,Operational,United Kingdom,Europe,0,0,0,0,0,0,0,Unknown
1940-01-16 00:00:00,Royal Air Force - RAF,Flight,Military / Government,United Kingdom,Europe,0,0,0,0,0,0,0,Unknown
1940-01-17 00:00:00,Royal Air Force - RAF,Flight,Operational,United Kingdom,Europe,2,2,0,0,0,0,2,Unknown
1940-01-22 00:00:00,Royal Air Force - RAF,Takeoff (climb),Operational,United Kingdom,Europe,2,2,0,0,0,0,2,Human Factor
1940-01-23 00:00:00,Royal Air Force - RAF,Flight,Operational,United Kingdom,Europe,2,2,0,0,0,0,2,Unknown
1940-01-30 00:00:00,White Pass Airways,Landing (descent or approach),Commercial,Canada,North America,1,1,0,0,0,0,1,Unknown
1940-02-02 00:00:00,Royal Air Force - RAF,Flight,Military / Government,United Kingdom,Europe,4,4,0,0,0,0,4,Technical Failure
1940-02-03 00:00:00,Royal Air Force - RAF,Taxiing,Military / Government,United Kingdom,Europe,0,0,0,0,0,0,0,Technical Failure
1940-02-03 00:00:00,German Air Force - Deutsche Luftwaffe,Flight,Military / Government,United Kingdom,Europe,4,4,0,0,0,0,4,Terrorism
1940-02-03 00:00:00,German Air Force - Deutsche Luftwaffe,Flight,Military / Government,United Kingdom,Europe,4,4,0,0,0,0,4,Terrorism
1940-02-05 00:00:00,Dai Nippon Airlines,Flight,Commercial,Japan,Asia,0,0,0,0,0,0,0,Unknown
1940-02-07 00:00:00,Royal Air Force - RAF,Flight,Military / Government,United Kingdom,Europe,4,4,0,0,0,0,4,Unknown
1940-02-12 00:00:00,Royal Air Force - RAF,Landing (descent or approach),Military / Government,France,Europe,5,1,0,4,0,0,5,Weather
1940-02-13 00:00:00,Lundy %26 Atlantic Coast Air Lines,,Commercial,United Kingdom,Europe,0,0,0,0,0,0,0,Unknown
1940-02-13 00:00:00,British American Air Services - BAAS,Flight,Commercial,United Kingdom,Europe,0,0,0,0,0,0,0,Unknown
1940-02-14 00:00:00,Scottish Airways,Landing (descent or approach),Commercial,United Kingdom,Europe,8,1,0,7,0,0,8,Unknown
1940-02-17 00:00:00,Private Australian,,Business,Australia,Oceania,0,0,0,0,0,0,0,Unknown
1940-02-19 00:00:00,Great Western %26 Southern Air Lines,Flight,Commercial,United Kingdom,Europe,5,1,0,4,0,0,5,Weather
1940-02-20 00:00:00,TACA International Airlines - Transportes Aéreos Centro Americanos,Flight,Operational,Nicaragua,Central America,2,2,0,0,0,0,2,Unknown
1940-02-20 00:00:00,Aéroclub de Guinée,Landing (descent or approach),Operational,Guinea,Africa,1,1,0,0,0,0,1,Unknown
1940-02-21 00:00:00,Royal Air Force - RAF,Flight,Military / Government,United Kingdom,Europe,6,6,0,0,0,0,6,Technical Failure
1940-02-21 00:00:00,Royal Air Force - RAF,Flight,Military / Government,United Kingdom,Europe,7,7,0,0,0,0,7,Unknown
1940-02-21 00:00:00,Royal Air Force - RAF,Takeoff (climb),Military / Government,United Kingdom,Europe,2,2,0,0,0,0,2,Unknown
1940-02-22 00:00:00,German Air Force - Deutsche Luftwaffe,Flight,Military / Government,United Kingdom,Europe,4,4,0,0,0,0,4,Terrorism
1940-02-24 00:00:00,Royal Air Force - RAF,Takeoff (climb),Operational,United Kingdom,Europe,3,3,0,0,0,0,3,Unknown
1940-02-24 00:00:00,Royal Air Force - RAF,Flight,Operational,United Kingdom,Europe,4,4,0,0,0,0,4,Technical Failure
1940-02-24 00:00:00,Royal Air Force - RAF,Flight,Military / Government,Belgium,Europe,6,6,0,0,0,0,6,Unknown
1940-02-25 00:00:00,TACA International Airlines - Transportes Aéreos Centro Americanos,,Commercial,Costa Rica,Central America,0,0,0,0,0,0,0,Unknown
1940-02-26 00:00:00,Private French,Flight,Operational,France,Europe,1,1,0,0,0,0,1,Weather
1940-02-27 00:00:00,German Air Force - Deutsche Luftwaffe,Flight,Military / Government,United Kingdom,Europe,4,4,0,0,0,0,4,Terrorism
1940-03-02 00:00:00,Royal Air Force - RAF,Landing (descent or approach),Military / Government,United Kingdom,Europe,5,5,0,0,0,0,5,Unknown
1940-03-02 00:00:00,Royal Air Force - RAF,Takeoff (climb),Operational,United Kingdom,Europe,2,2,0,0,0,0,2,Technical Failure
1940-03-03 00:00:00,Royal Air Force - RAF,Landing (descent or approach),Operational,United Kingdom,Europe,2,2,0,0,0,0,2,Human Factor
1940-03-05 00:00:00,Mexicana de Aviación,Flight,Commercial,Mexico,Central America,12,5,0,7,0,0,12,Weather
1940-03-06 00:00:00,Royal Air Force - RAF,Landing (descent or approach),Military / Government,United Kingdom,Europe,2,2,0,0,0,0,2,Human Factor
1940-03-10 00:00:00,Soviet Air Force - Voyenno-vozdushnye sily CCCP,Flight,Military / Government,Finland,Europe,8,8,0,0,0,0,8,Terrorism
1940-03-13 00:00:00,Compañia Aeronautica Francisco Sarabia SA - CAFSSA,Flight,Commercial,Mexico,Central America,0,0,0,0,0,0,0,Unknown
1940-03-13 00:00:00,Royal Air Force - RAF,Flight,Military / Government,United Kingdom,Europe,2,2,0,0,0,0,2,Technical Failure
1940-03-13 00:00:00,Radium Hot Springs Flying Service,Flight,Commercial,Canada,North America,1,1,0,0,0,0,1,Technical Failure
1940-03-14 00:00:00,Royal Air Force - RAF,Landing (descent or approach),Operational,United Kingdom,Europe,2,2,0,0,0,0,2,Human Factor
1940-03-15 00:00:00,WR Carpenter %26 Company,Flight,Commercial,Papua New Guinea,Oceania,0,0,0,0,0,0,0,Unknown
1940-03-18 00:00:00,Scottish Airways,Landing (descent or approach),Commercial,United Kingdom,Europe,6,1,0,5,0,0,6,Human Factor
1940-03-23 00:00:00,Royal Air Force - RAF,Takeoff (climb),Operational,United Kingdom,Europe,5,5,0,0,0,0,5,Technical Failure
1940-03-24 00:00:00,Royal Air Force - RAF,Flight,Military / Government,France,Europe,6,6,0,0,0,0,6,Terrorism
1940-03-28 00:00:00,Wideroe - Wideroe's Flyveselskap,,Commercial,Norway,Europe,0,0,0,0,0,0,0,Unknown
1940-03-30 00:00:00,Royal Air Force - RAF,Landing (descent or approach),Operational,United Kingdom,Europe,6,6,0,0,0,0,6,Technical Failure
1940-04-01 00:00:00,Royal Air Force - RAF,Takeoff (climb),Operational,United Kingdom,Europe,3,3,0,0,0,0,3,Human Factor
1940-04-02 00:00:00,Royal Air Force - RAF,Landing (descent or approach),Operational,United Kingdom,Europe,0,0,0,0,0,0,0,Unknown
1940-04-03 00:00:00,British Overseas Airways Corporation - BOAC,Takeoff (climb),Military / Government,Egypt,Africa,0,0,0,0,0,0,0,Unknown
1940-04-03 00:00:00,Transcontinental %26 Western Air - TWA,Landing (descent or approach),Commercial,United States of America,North America,0,0,0,0,0,0,0,Weather
1940-04-05 00:00:00,Royal Air Force - RAF,Flight,Military / Government,United Kingdom,Europe,2,2,0,0,0,0,2,Technical Failure
1940-04-07 00:00:00,Royal Air Force - RAF,Flight,Operational,United Kingdom,Europe,5,5,0,0,0,0,5,Technical Failure
1940-04-13 00:00:00,Royal Air Force - RAF,Flight,Military / Government,United Kingdom,Europe,4,4,0,0,0,0,4,Technical Failure
1940-04-13 00:00:00,German Air Force - Deutsche Luftwaffe,Flight,Military / Government,Norway,Europe,7,7,0,0,0,0,7,Terrorism
1940-04-13 00:00:00,German Air Force - Deutsche Luftwaffe,Landing (descent or approach),Military / Government,Norway,Europe,0,0,0,0,0,0,0,Weather
1940-04-14 00:00:00,Royal Air Force - RAF,Flight,Operational,United Kingdom,Europe,6,6,0,0,0,0,6,Technical Failure
1940-04-14 00:00:00,German Air Force - Deutsche Luftwaffe,Flight,Military / Government,Norway,Europe,4,4,0,0,0,0,4,Terrorism
1940-04-14 00:00:00,German Air Force - Deutsche Luftwaffe,Flight,Military / Government,Norway,Europe,4,4,0,0,0,0,4,Terrorism
1940-04-14 00:00:00,German Air Force - Deutsche Luftwaffe,Flight,Military / Government,Norway,Europe,6,6,0,0,0,0,6,Terrorism
1940-04-15 00:00:00,Imperial Airways,Landing (descent or approach),Commercial,Canada,North America,0,0,0,0,0,0,0,Unknown
1940-04-15 00:00:00,Royal Air Force - RAF,Taxiing,Military / Government,United Kingdom,Europe,4,4,0,0,0,0,4,Unknown
1940-04-17 00:00:00,Royal Air Force - RAF,Flight,Military / Government,United Kingdom,Europe,5,5,0,0,0,0,5,Technical Failure
1940-04-17 00:00:00,Royal Air Force - RAF,Takeoff (climb),Military / Government,United Kingdom,Europe,6,6,0,0,0,0,6,Technical Failure
1940-04-19 00:00:00,Scottish Airways,Landing (descent or approach),Commercial,United Kingdom,Europe,9,1,0,8,0,0,9,Unknown
1940-04-21 00:00:00,Royal Air Force - RAF,Landing (descent or approach),Operational,United Kingdom,Europe,0,0,0,0,0,0,0,Unknown
1940-04-22 00:00:00,Royal Air Force - RAF,Flight,Military / Government,Denmark,Europe,6,6,0,0,0,0,6,Terrorism
1940-04-22 00:00:00,German Air Force - Deutsche Luftwaffe,Flight,Military / Government,Norway,Europe,0,0,0,0,0,0,0,Unknown
1940-04-26 00:00:00,Arabian Airways,Takeoff (climb),Business,Yemen,Asia,2,1,0,1,0,0,2,Unknown
1940-04-29 00:00:00,Royal Air Force - RAF,Flight,Operational,United Kingdom,Europe,4,4,0,0,0,0,4,Technical Failure
1940-05-02 00:00:00,Finnish Government,Takeoff (climb),Operational,Finland,Europe,1,1,0,0,0,0,1,Human Factor
1940-05-05 00:00:00,SABENA - Société Anonyme Belge d'Exploitation de la Navigation Aérienne,,Commercial,Democratic Republic of Congo,Africa,0,0,0,0,0,0,0,Unknown
1940-05-07 00:00:00,Royal Air Force - RAF,Landing (descent or approach),Operational,United Kingdom,Europe,3,3,0,0,0,0,3,Human Factor
1940-05-08 00:00:00,German Air Force - Deutsche Luftwaffe,Flight,Military / Government,Norway,Europe,22,4,0,18,0,0,22,Terrorism
1940-05-10 00:00:00,German Air Force - Deutsche Luftwaffe,Flight,Military / Government,France,Europe,5,5,0,0,0,0,5,Terrorism
1940-05-10 00:00:00,German Air Force - Deutsche Luftwaffe,Flight,Military / Government,Netherlands,Europe,4,4,0,0,0,0,4,Terrorism
1940-05-12 00:00:00,Royal Air Force - RAF,Landing (descent or approach),Military / Government,United Kingdom,Europe,0,0,0,0,0,0,0,Technical Failure
1940-05-12 00:00:00,French Air Force - Armée de l'Air,Takeoff (climb),Operational,France,Europe,3,3,0,0,0,0,3,Technical Failure
1940-05-13 00:00:00,Royal Air Force - RAF,Takeoff (climb),Military / Government,United Kingdom,Europe,0,0,0,0,0,0,0,Technical Failure
1940-05-15 00:00:00,German Air Force - Deutsche Luftwaffe,Flight,Military / Government,Sweden,Europe,3,3,0,0,0,0,3,Terrorism
1940-05-17 00:00:00,Royal Air Force - RAF,Flight,Military / Government,France,Europe,6,6,0,0,0,0,6,Unknown
1940-05-17 00:00:00,South African Air Force,Flight,Military / Government,South Africa,Africa,0,0,0,0,0,0,0,Unknown
1940-05-19 00:00:00,Royal Air Force - RAF,Flight,Military / Government,World,World,5,5,0,0,0,0,5,Terrorism
1940-05-20 00:00:00,Royal Air Force - RAF,Flight,Military / Government,Germany,Europe,5,5,0,0,0,0,5,Terrorism
1940-05-21 00:00:00,Royal Air Force - RAF,Flight,Military / Government,France,Europe,5,5,0,0,0,0,5,Unknown
1940-05-21 00:00:00,Scottish Airways,Takeoff (climb),Operational,United Kingdom,Europe,4,4,0,0,0,0,4,Unknown
1940-05-22 00:00:00,Royal Air Force - RAF,Flight,Military / Government,France,Europe,5,5,0,0,0,0,5,Unknown
1940-05-22 00:00:00,Royal Air Force - RAF,Flight,Military / Government,France,Europe,6,6,0,0,0,0,6,Unknown
1940-05-22 00:00:00,Royal Air Force - RAF,Flight,Military / Government,Germany,Europe,5,5,0,0,0,0,5,Unknown
1940-05-23 00:00:00,Royal Air Force - RAF,Landing (descent or approach),Military / Government,United Kingdom,Europe,6,6,0,0,0,0,6,Unknown
1940-05-23 00:00:00,British Overseas Airways Corporation - BOAC,Landing (descent or approach),Commercial,France,Europe,0,0,0,0,0,0,0,Terrorism
1940-05-26 00:00:00,Royal Air Force - RAF,Flight,Military / Government,Belgium,Europe,5,5,0,0,0,0,5,Unknown
1940-05-29 00:00:00,Royal Air Force - RAF,Flight,Military / Government,United Kingdom,Europe,4,4,0,0,0,0,4,Terrorism
1940-05-29 00:00:00,Royal Air Force - RAF,Takeoff (climb),Operational,United Kingdom,Europe,0,0,0,0,0,0,0,Unknown
1940-06-01 00:00:00,Royal Air Force - RAF,Landing (descent or approach),Operational,United Kingdom,Europe,2,2,0,0,0,0,2,Human Factor
1940-06-04 00:00:00,Royal Air Force - RAF,Landing (descent or approach),Military / Government,United Kingdom,Europe,4,4,0,0,0,0,4,Human Factor
1940-06-05 00:00:00,Royal Air Force - RAF,Flight,Operational,United Kingdom,Europe,4,4,0,0,0,0,4,Technical Failure
1940-06-07 00:00:00,Royal Air Force - RAF,Landing (descent or approach),Military / Government,United Kingdom,Europe,5,5,0,0,0,0,5,Technical Failure
1940-06-08 00:00:00,German Air Force - Deutsche Luftwaffe,Flight,Military / Government,Norway,Europe,3,3,0,0,0,0,3,Unknown
1940-06-08 00:00:00,Royal Air Force - RAF,Landing (descent or approach),Operational,United Kingdom,Europe,2,2,0,0,0,0,2,Human Factor
1940-06-14 00:00:00,Royal Canadian Air Force - RCAF,Flight,Military / Government,Canada,North America,5,5,0,0,0,0,5,Unknown
1940-06-17 00:00:00,Cape Breton Flying Club,Landing (descent or approach),Business,Canada,North America,2,1,0,1,0,0,2,Unknown
1940-06-20 00:00:00,Royal Air Force - RAF,Flight,Military / Government,France,Europe,0,0,0,0,0,0,0,Unknown
1940-06-21 00:00:00,Royal Air Force - RAF,Flight,Military / Government,United Kingdom,Europe,0,0,0,0,0,0,0,Technical Failure
1940-06-22 00:00:00,Royal Air Force - RAF,Flight,Military / Government,World,World,6,6,0,0,0,0,6,Terrorism
1940-06-22 00:00:00,Royal Air Force - RAF,Landing (descent or approach),Operational,United Kingdom,Europe,3,3,0,0,0,0,3,Human Factor
1940-06-25 00:00:00,Royal Air Force - RAF,Landing (descent or approach),Operational,United Kingdom,Europe,4,4,0,0,0,0,4,Human Factor
1940-06-27 00:00:00,German Air Force - Deutsche Luftwaffe,Flight,Military / Government,United Kingdom,Europe,4,4,0,0,0,0,4,Terrorism
1940-06-29 00:00:00,Royal Air Force - RAF,Landing (descent or approach),Military / Government,United Kingdom,Europe,9,9,0,0,0,0,9,Weather
1940-07-01 00:00:00,German Air Force - Deutsche Luftwaffe,Flight,Military / Government,United Kingdom,Europe,4,4,0,0,0,0,4,Terrorism
1940-07-07 00:00:00,Royal Air Force - RAF,Landing (descent or approach),Military / Government,United Kingdom,Europe,0,0,0,0,0,0,0,Technical Failure
1940-07-08 00:00:00,Royal Air Force - RAF,Takeoff (climb),Operational,United Kingdom,Europe,2,2,0,0,0,0,2,Technical Failure
1940-07-09 00:00:00,Royal Air Force - RAF,Landing (descent or approach),Operational,United Kingdom,Europe,2,2,0,0,0,0,2,Unknown
1940-07-10 00:00:00,Royal Air Force - RAF,Landing (descent or approach),Military / Government,United Kingdom,Europe,0,0,0,0,0,0,0,Human Factor
1940-07-16 00:00:00,Royal Air Force - RAF,Flight,Operational,United Kingdom,Europe,2,2,0,0,0,0,2,Technical Failure
1940-07-18 00:00:00,Royal Air Force - RAF,Landing (descent or approach),Military / Government,Egypt,Africa,5,5,0,0,0,0,5,Technical Failure
1940-07-18 00:00:00,Royal Air Force - RAF,Flight,Operational,United Kingdom,Europe,2,2,0,0,0,0,2,Unknown
1940-07-22 00:00:00,Royal Air Force - RAF,Takeoff (climb),Military / Government,United Kingdom,Europe,5,5,0,0,0,0,5,Human Factor
1940-07-23 00:00:00,Connellan Airways,Takeoff (climb),Humanitarian,Australia,Oceania,4,2,0,2,0,0,4,Unknown
1940-07-24 00:00:00,LOT Polish Airlines - Polskie Linie Lotnicze,Landing (descent or approach),Commercial,Romania,Europe,0,0,0,0,0,0,0,Unknown
1940-07-25 00:00:00,Royal Air Force - RAF,Flight,Operational,United Kingdom,Europe,2,2,0,0,0,0,2,Unknown
1940-07-27 00:00:00,Royal Air Force - RAF,Flight,Military / Government,Netherlands,Europe,5,5,0,0,0,0,5,Terrorism
1940-07-30 00:00:00,Royal Air Force - RAF,Flight,Military / Government,United Kingdom,Europe,4,4,0,0,0,0,4,Unknown
1940-07-30 00:00:00,Royal Air Force - RAF,Landing (descent or approach),Military / Government,Egypt,Africa,6,6,0,0,0,0,6,Unknown
1940-07-31 00:00:00,United States Army Air Corps - USAAC,Flight,Military / Government,Panama,Central America,0,0,0,0,0,0,0,Unknown
1940-07-31 00:00:00,Royal Air Force - RAF,Landing (descent or approach),Military / Government,United Kingdom,Europe,3,3,0,0,0,0,3,Unknown
1940-08-02 00:00:00,Royal Air Force - RAF,Flight,Military / Government,United Kingdom,Europe,3,3,0,0,0,0,3,Technical Failure
1940-08-03 00:00:00,German Air Force - Deutsche Luftwaffe,Flight,Military / Government,United Kingdom,Europe,5,5,0,0,0,0,5,Terrorism
1940-08-07 00:00:00,Royal Air Force - RAF,Flight,Operational,United Kingdom,Europe,0,0,0,0,0,0,0,Technical Failure
1940-08-09 00:00:00,German Air Force - Deutsche Luftwaffe,Flight,Military / Government,United Kingdom,Europe,4,4,0,0,0,0,4,Terrorism
1940-08-11 00:00:00,Royal Air Force - RAF,Landing (descent or approach),Operational,Iceland,Europe,5,5,0,0,0,0,5,Unknown
1940-08-14 00:00:00,German Air Force - Deutsche Luftwaffe,Flight,Military / Government,United Kingdom,Europe,5,5,0,0,0,0,5,Terrorism
1940-08-15 00:00:00,German Air Force - Deutsche Luftwaffe,Flight,Military / Government,United Kingdom,Europe,5,5,0,0,0,0,5,Terrorism
1940-08-15 00:00:00,German Air Force - Deutsche Luftwaffe,Flight,Military / Government,United Kingdom,Europe,5,5,0,0,0,0,5,Terrorism
1940-08-15 00:00:00,German Air Force - Deutsche Luftwaffe,Flight,Military / Government,United Kingdom,Europe,4,4,0,0,0,0,4,Terrorism
1940-08-20 00:00:00,Royal Air Force - RAF,Landing (descent or approach),Military / Government,United Kingdom,Europe,5,5,0,0,0,0,5,Human Factor
1940-08-21 00:00:00,Royal Air Force - RAF,Landing (descent or approach),Military / Government,United Kingdom,Europe,0,0,0,0,0,0,0,Unknown
1940-08-29 00:00:00,Royal Air Force - RAF,Landing (descent or approach),Military / Government,United Kingdom,Europe,0,0,0,0,0,0,0,Unknown
1940-09-02 00:00:00,Royal Air Force - RAF,Landing (descent or approach),Military / Government,United Kingdom,Europe,6,6,0,0,0,0,6,Human Factor
1940-09-04 00:00:00,Royal Air Force - RAF,Landing (descent or approach),Military / Government,United Kingdom,Europe,5,5,0,0,0,0,5,Technical Failure
1940-09-07 00:00:00,Royal Australian Air Force - RAAF,Takeoff (climb),Military / Government,Australia,Oceania,4,4,0,0,0,0,4,Technical Failure
1940-09-09 00:00:00,Royal Air Force - RAF,Landing (descent or approach),Military / Government,United Kingdom,Europe,5,5,0,0,0,0,5,Human Factor
1940-09-11 00:00:00,Royal Air Force - RAF,Landing (descent or approach),Military / Government,United Kingdom,Europe,5,5,0,0,0,0,5,Unknown
1940-09-12 00:00:00,Royal Air Force - RAF,Flight,Military / Government,World,World,10,5,0,5,0,0,10,Unknown
1940-09-12 00:00:00,Royal Air Force - RAF,Takeoff (climb),Military / Government,United Kingdom,Europe,6,6,0,0,0,0,6,Technical Failure
1940-09-14 00:00:00,Royal Air Force - RAF,Takeoff (climb),Military / Government,Egypt,Africa,0,0,0,0,0,0,0,Unknown
1940-09-15 00:00:00,Royal Air Force - RAF,Flight,Military / Government,United Kingdom,Europe,5,5,0,0,0,0,5,Technical Failure
1940-09-19 00:00:00,Royal Air Force - RAF,Landing (descent or approach),Operational,United Kingdom,Europe,2,2,0,0,0,0,2,Unknown
1940-09-21 00:00:00,British Overseas Airways Corporation - BOAC,Landing (descent or approach),Operational,United Kingdom,Europe,4,4,0,0,0,0,4,Weather
1940-09-24 00:00:00,Royal Air Force - RAF,Landing (descent or approach),Operational,United Kingdom,Europe,4,4,0,0,0,0,4,Human Factor
1940-09-25 00:00:00,Royal Air Force - RAF,Flight,Operational,United Kingdom,Europe,1,1,0,0,0,0,1,Human Factor
1940-09-26 00:00:00,Royal Air Force - RAF,Takeoff (climb),Military / Government,United Kingdom,Europe,6,6,0,0,0,0,6,Unknown
1940-10-03 00:00:00,Canadian Airways,Takeoff (climb),Commercial,Canada,North America,0,0,0,0,0,0,0,Other
1940-10-04 00:00:00,Iberia - Lineas Aéreas de Espana,Takeoff (climb),Commercial,Spain,Europe,0,0,0,0,0,0,0,Technical Failure
1940-10-06 00:00:00,British Overseas Airways Corporation - BOAC,Landing (descent or approach),Commercial,United Kingdom,Europe,12,5,0,7,0,0,12,Technical Failure
1940-10-08 00:00:00,Royal Air Force - RAF,Takeoff (climb),Military / Government,United Kingdom,Europe,0,0,0,0,0,0,0,Unknown
1940-10-08 00:00:00,Royal Air Force - RAF,Takeoff (climb),Military / Government,United Kingdom,Europe,0,0,0,0,0,0,0,Unknown
1940-10-09 00:00:00,Royal Air Force - RAF,Flight,Operational,United Kingdom,Europe,1,1,0,0,0,0,1,Unknown
1940-10-10 00:00:00,Royal Air Force - RAF,Landing (descent or approach),Operational,Iraq,Asia,2,2,0,0,0,0,2,Technical Failure
1940-10-12 00:00:00,Royal Air Force - RAF,Flight,Military / Government,United Kingdom,Europe,4,4,0,0,0,0,4,Technical Failure
1940-10-15 00:00:00,Royal Air Force - RAF,Flight,Military / Government,United Kingdom,Europe,5,5,0,0,0,0,5,Technical Failure
1940-10-15 00:00:00,Royal Air Force - RAF,Landing (descent or approach),Military / Government,United Kingdom,Europe,5,5,0,0,0,0,5,Technical Failure
1940-10-17 00:00:00,Royal Air Force - RAF,Flight,Military / Government,United Kingdom,Europe,6,6,0,0,0,0,6,Unknown
1940-10-17 00:00:00,Royal Air Force - RAF,Landing (descent or approach),Operational,United Kingdom,Europe,2,2,0,0,0,0,2,Technical Failure
1940-10-19 00:00:00,Royal Air Force - RAF,Flight,Military / Government,United Kingdom,Europe,5,5,0,0,0,0,5,Technical Failure
1940-10-20 00:00:00,Royal Air Force - RAF,Landing (descent or approach),Operational,United Kingdom,Europe,0,0,0,0,0,0,0,Unknown
1940-10-21 00:00:00,Royal Air Force - RAF,Flight,Military / Government,United Kingdom,Europe,5,5,0,0,0,0,5,Technical Failure
1940-10-23 00:00:00,Toronto Flying Club,Landing (descent or approach),Operational,Canada,North America,1,1,0,0,0,0,1,Unknown
1940-10-26 00:00:00,Royal Air Force - RAF,Flight,Military / Government,United Kingdom,Europe,5,5,0,0,0,0,5,Technical Failure
1940-10-29 00:00:00,Ginger Coote Airways,Flight,Commercial,Canada,North America,4,1,0,3,0,0,4,Technical Failure
1940-10-30 00:00:00,Royal Air Force - RAF,Flight,Operational,United Kingdom,Europe,5,5,0,0,0,0,5,Unknown
1940-11-03 00:00:00,Royal Air Force - RAF,Takeoff (climb),Military / Government,United Kingdom,Europe,1,1,0,0,0,0,1,Unknown
1940-11-04 00:00:00,Royal Air Force - RAF,Landing (descent or approach),Military / Government,United Kingdom,Europe,5,5,0,0,0,0,5,Technical Failure
1940-11-06 00:00:00,Royal Air Force - RAF,Flight,Military / Government,United Kingdom,Europe,5,5,0,0,0,0,5,Weather
1940-11-14 00:00:00,Royal Air Force - RAF,Landing (descent or approach),Military / Government,United Kingdom,Europe,6,6,0,0,0,0,6,Human Factor
1940-11-15 00:00:00,Royal Air Force - RAF,Flight,Military / Government,United Kingdom,Europe,5,5,0,0,0,0,5,Technical Failure
1940-11-15 00:00:00,Royal Air Force - RAF,Flight,Military / Government,Netherlands,Europe,6,6,0,0,0,0,6,Terrorism
1940-11-18 00:00:00,Royal Air Force - RAF,Landing (descent or approach),Military / Government,United Kingdom,Europe,5,5,0,0,0,0,5,Weather
1940-11-26 00:00:00,Nucleo Comunicazioni Avio Linee,Landing (descent or approach),Commercial,Italy,Europe,0,0,0,0,0,0,0,Unknown
1940-11-26 00:00:00,Royal Air Force - RAF,Landing (descent or approach),Operational,United Kingdom,Europe,2,2,0,0,0,0,2,Human Factor
1940-11-27 00:00:00,Royal Air Force - RAF,Landing (descent or approach),Operational,United Kingdom,Europe,0,0,0,0,0,0,0,Unknown
1940-11-28 00:00:00,Royal Air Force - RAF,Landing (descent or approach),Operational,United Kingdom,Europe,1,1,0,0,0,0,1,Technical Failure
1940-11-29 00:00:00,Royal Air Force - RAF,Landing (descent or approach),Operational,United Kingdom,Europe,1,1,0,0,0,0,1,Human Factor
1940-11-29 00:00:00,Northern Airways,Flight,Commercial,Canada,North America,0,0,0,0,0,0,0,Technical Failure
1940-12-02 00:00:00,Royal Air Force - RAF,Takeoff (climb),Military / Government,United Kingdom,Europe,5,5,0,0,0,0,5,Technical Failure
1940-12-02 00:00:00,Royal Air Force - RAF,Landing (descent or approach),Military / Government,United Kingdom,Europe,2,2,0,0,0,0,2,Human Factor
1940-12-03 00:00:00,Royal Air Force - RAF,Landing (descent or approach),Military / Government,United Kingdom,Europe,5,5,0,0,0,0,5,Human Factor
1940-12-04 00:00:00,TACA International Airlines - Transportes Aéreos Centro Americanos,,Commercial,Costa Rica,Central America,0,0,0,0,0,0,0,Unknown
1940-12-07 00:00:00,United States Army Air Corps - USAAC,Flight,Military / Government,Costa Rica,Central America,0,0,0,0,0,0,0,Technical Failure
1940-12-08 00:00:00,Royal Air Force - RAF,Landing (descent or approach),Operational,United Kingdom,Europe,1,1,0,0,0,0,1,Unknown
1940-12-08 00:00:00,Royal Air Force - RAF,Landing (descent or approach),Military / Government,United Kingdom,Europe,2,2,0,0,0,0,2,Unknown
1940-12-09 00:00:00,United States Army Air Corps - USAAC,,Military / Government,United States of America,North America,0,0,0,0,0,0,0,Unknown
1940-12-13 00:00:00,Royal Air Force - RAF,Flight,Operational,United Kingdom,Europe,5,5,0,0,0,0,5,Technical Failure
1940-12-15 00:00:00,Nucleo Comunicazioni Avio Linee,Taxiing,Commercial,Italy,Europe,0,0,0,0,0,0,0,Human Factor
1940-12-16 00:00:00,Royal Air Force - RAF,Flight,Military / Government,United Kingdom,Europe,5,5,0,0,0,0,5,Technical Failure
1940-12-21 00:00:00,Linee Aeree Transcontinentali Italiane - LATI,Landing (descent or approach),Commercial,Western Sahara,Africa,0,0,0,0,0,0,0,Other
1940-12-21 00:00:00,Royal Air Force - RAF,Flight,Military / Government,Egypt,Africa,5,5,0,0,0,0,5,Technical Failure
1940-12-22 00:00:00,Royal Air Force - RAF,Flight,Operational,United Kingdom,Europe,1,1,0,0,0,0,1,Technical Failure
1940-12-24 00:00:00,Sociedad Argentina de Navegacion Aérea,,Commercial,Argentina,South America,0,0,0,0,0,0,0,Unknown
1940-12-24 00:00:00,Private Australian,Flight,Business,Australia,Oceania,1,1,0,0,0,0,1,Unknown
1940-12-26 00:00:00,Royal Air Force - RAF,Takeoff (climb),Military / Government,Tunisia,Africa,0,0,0,0,0,0,0,Unknown
1940-12-26 00:00:00,Panair do Brasil,Takeoff (climb),Commercial,Brazil,South America,17,4,0,13,0,0,17,Unknown
1940-12-28 00:00:00,Royal Air Force - RAF,Landing (descent or approach),Military / Government,United Kingdom,Europe,5,5,0,0,0,0,5,Technical Failure
1940-12-31 00:00:00,Air France,,Commercial,Vietnam,Asia,0,0,0,0,0,0,0,Unknown
1941-01-02 00:00:00,Royal Air Force - RAF,Landing (descent or approach),Military / Government,Sudan,Africa,0,0,0,0,0,0,0,Unknown
1941-01-02 00:00:00,Private Canadian,Landing (descent or approach),Business,Canada,North America,1,1,0,0,0,0,1,Unknown
1941-01-07 00:00:00,Royal Air Force - RAF,Landing (descent or approach),Military / Government,United Kingdom,Europe,0,0,0,0,0,0,0,Unknown
1941-01-10 00:00:00,Royal Air Force - RAF,Flight,Military / Government,United Kingdom,Europe,0,0,0,0,0,0,0,Unknown
1941-01-11 00:00:00,Royal Air Force - RAF,Flight,Military / Government,France,Europe,6,6,0,0,0,0,6,Technical Failure
1941-01-17 00:00:00,Linee Aeree Transcontinentali Italiane - LATI,Landing (descent or approach),Commercial,Italy,Europe,17,4,0,13,0,0,17,Technical Failure
1941-01-19 00:00:00,British Overseas Airways Corporation - BOAC,,Commercial,Sudan,Africa,0,0,0,0,0,0,0,Unknown
1941-01-19 00:00:00,French Air Force - Armée de l'Air,Landing (descent or approach),Military / Government,Lebanon,Asia,4,4,0,0,0,0,4,Unknown
1941-01-31 00:00:00,United States Navy - USN,,Military / Government,United States of America,North America,0,0,0,0,0,0,0,Unknown
1941-02-01 00:00:00,Royal Air Force - RAF,Takeoff (climb),Operational,United Kingdom,Europe,2,2,0,0,0,0,2,Unknown
1941-02-02 00:00:00,Leavens Brothers Air Services,Takeoff (climb),Commercial,Canada,North America,0,0,0,0,0,0,0,Unknown
1941-02-12 00:00:00,Royal Air Force - RAF,Flight,Military / Government,United Kingdom,Europe,6,6,0,0,0,0,6,Technical Failure
1941-02-15 00:00:00,Royal Air Force - RAF,Landing (descent or approach),Operational,United Kingdom,Europe,4,4,0,0,0,0,4,Unknown
1941-02-15 00:00:00,Royal Air Force - RAF,Takeoff (climb),Military / Government,United Kingdom,Europe,3,3,0,0,0,0,3,Unknown
1941-02-26 00:00:00,Royal Air Force - RAF,Landing (descent or approach),Military / Government,United Kingdom,Europe,6,6,0,0,0,0,6,Technical Failure
1941-03-01 00:00:00,Iberia - Lineas Aéreas de Espana,Landing (descent or approach),Commercial,Spain,Europe,9,3,0,6,0,0,9,Unknown
1941-03-09 00:00:00,Air Services of India,Takeoff (climb),Operational,India,Asia,1,1,0,0,0,0,1,Unknown
1941-03-15 00:00:00,Compañia Aeronautica Francisco Sarabia SA - CAFSSA,,Commercial,Mexico,Central America,0,0,0,0,0,0,0,Unknown
1941-03-21 00:00:00,Royal Air Force - RAF,Landing (descent or approach),Military / Government,Libya,Africa,0,0,0,0,0,0,0,Unknown
1941-03-24 00:00:00,Royal Air Force - RAF,Flight,Operational,United Kingdom,Europe,2,2,0,0,0,0,2,Unknown
1941-03-25 00:00:00,Royal Air Force - RAF,Flight,Operational,United Kingdom,Europe,2,2,0,0,0,0,2,Unknown
1941-03-25 00:00:00,Royal Air Force - RAF,Flight,Operational,United Kingdom,Europe,2,2,0,0,0,0,2,Unknown
1941-03-26 00:00:00,Royal Air Force - RAF,Landing (descent or approach),Military / Government,United Kingdom,Europe,2,2,0,0,0,0,2,Unknown
1941-03-26 00:00:00,United States Army Air Corps - USAAC,Takeoff (climb),Military / Government,Puerto Rico,Central America,0,0,0,0,0,0,0,Technical Failure
1941-03-26 00:00:00,Royal Air Force - RAF,Flight,Operational,United Kingdom,Europe,1,1,0,0,0,0,1,Technical Failure
1941-03-31 00:00:00,Royal Air Force - RAF,Flight,Operational,United Kingdom,Europe,4,4,0,0,0,0,4,Unknown
1941-04-01 00:00:00,Royal Air Force - RAF,Landing (descent or approach),Operational,United Kingdom,Europe,4,4,0,0,0,0,4,Technical Failure
1941-04-01 00:00:00,Royal Air Force - RAF,Flight,Military / Government,United Kingdom,Europe,0,0,0,0,0,0,0,Unknown
1941-04-03 00:00:00,Eastern Airlines,Flight,Commercial,United States of America,North America,16,3,0,13,0,0,16,Weather
1941-04-05 00:00:00,Aeroput,Flight,Commercial,Serbia,Europe,0,0,0,0,0,0,0,Unknown
1941-04-06 00:00:00,Royal Air Force - RAF,Landing (descent or approach),Operational,United Kingdom,Europe,2,2,0,0,0,0,2,Unknown
1941-04-07 00:00:00,Aeroput,Flight,Commercial,Greece,Europe,9,2,0,7,0,0,9,Terrorism
1941-04-08 00:00:00,Royal Air Force - RAF,Flight,Military / Government,Egypt,Africa,0,0,0,0,0,0,0,Technical Failure
1941-04-09 00:00:00,Royal Air Force - RAF,Flight,Military / Government,Germany,Europe,6,6,0,0,0,0,6,Terrorism
1941-04-10 00:00:00,Royal Air Force - RAF,Landing (descent or approach),Operational,United Kingdom,Europe,3,3,0,0,0,0,3,Technical Failure
1941-04-14 00:00:00,Royal Air Force - RAF,Takeoff (climb),Military / Government,Nigeria,Africa,0,0,0,0,0,0,0,Technical Failure
1941-04-16 00:00:00,Pennsylvania Central Air Lines,Takeoff (climb),Commercial,United States of America,North America,9,3,0,6,0,0,9,Technical Failure
1941-04-18 00:00:00,Royal Air Force - RAF,Landing (descent or approach),Operational,United Kingdom,Europe,3,3,0,0,0,0,3,Unknown
1941-04-21 00:00:00,Royal Air Force - RAF,Takeoff (climb),Operational,Iraq,Asia,2,2,0,0,0,0,2,Unknown
1941-04-22 00:00:00,Royal Air Force - RAF,Landing (descent or approach),Military / Government,Sudan,Africa,0,0,0,0,0,0,0,Unknown
1941-04-25 00:00:00,Aeroflot - Russian International Airlines,Takeoff (climb),Operational,Russia,Asia,3,3,0,0,0,0,3,Weather
1941-04-26 00:00:00,Royal Air Force - RAF,Landing (descent or approach),Operational,United Kingdom,Europe,4,4,0,0,0,0,4,Unknown
1941-04-26 00:00:00,South African Airways -SAA - Suid Afrikaanse Lugdiens - SAL,Landing (descent or approach),Operational,South Africa,Africa,3,3,0,0,0,0,3,Unknown
1941-05-03 00:00:00,Royal Air Force - RAF,Flight,Military / Government,Germany,Europe,6,6,0,0,0,0,6,Terrorism
1941-05-05 00:00:00,Private Swedish,Flight,Business,Sweden,Europe,2,1,0,1,0,0,2,Unknown
1941-05-06 00:00:00,Royal Air Force - RAF,Landing (descent or approach),Military / Government,Nigeria,Africa,0,0,0,0,0,0,0,Weather
1941-05-11 00:00:00,Royal Air Force - RAF,Flight,Military / Government,Norway,Europe,6,6,0,0,0,0,6,Technical Failure
1941-05-16 00:00:00,Royal Air Force - RAF,Landing (descent or approach),Military / Government,United Kingdom,Europe,0,0,0,0,0,0,0,Technical Failure
1941-05-18 00:00:00,Royal Air Force - RAF,Flight,Specialised Services,United Kingdom,Europe,8,8,0,0,0,0,8,Technical Failure
1941-05-21 00:00:00,Allied Airways,Flight,Commercial,United Kingdom,Europe,7,1,0,6,0,0,7,Unknown
1941-05-29 00:00:00,Royal Air Force - RAF,Landing (descent or approach),Military / Government,Greece,Europe,6,6,0,0,0,0,6,Technical Failure
1941-06-03 00:00:00,Royal Air Force - RAF,Takeoff (climb),Operational,United Kingdom,Europe,6,6,0,0,0,0,6,Unknown
1941-06-07 00:00:00,Royal Air Force - RAF,Landing (descent or approach),Operational,United Kingdom,Europe,1,1,0,0,0,0,1,Technical Failure
1941-06-09 00:00:00,Royal Air Force - RAF,Flight,Military / Government,United Kingdom,Europe,4,4,0,0,0,0,4,Unknown
1941-06-14 00:00:00,Hangar 6,Landing (descent or approach),Business,United States of America,North America,0,0,0,0,0,0,0,Unknown
1941-06-14 00:00:00,South African Air Force,Flight,Military / Government,Nigeria,Africa,0,0,0,0,0,0,0,Technical Failure
1941-06-15 00:00:00,German Air Force - Deutsche Luftwaffe,Taxiing,Military / Government,Denmark,Europe,0,0,0,0,0,0,0,Technical Failure
1941-06-16 00:00:00,Royal Air Force - RAF,Taxiing,Military / Government,United Kingdom,Europe,6,6,0,0,0,0,6,Unknown
1941-06-17 00:00:00,British Overseas Airways Corporation - BOAC,Flight,Commercial,Nigeria,Africa,0,0,0,0,0,0,0,Unknown
1941-06-18 00:00:00,Royal Air Force - RAF,Flight,Operational,United Kingdom,Europe,5,5,0,0,0,0,5,Technical Failure
1941-06-18 00:00:00,Liniile Aeriene Române Exploatate cu Statul - LARES,Takeoff (climb),Commercial,Romania,Europe,0,0,0,0,0,0,0,Unknown
1941-06-18 00:00:00,Royal Air Force - RAF,Landing (descent or approach),Military / Government,United Kingdom,Europe,1,1,0,0,0,0,1,Unknown
1941-06-19 00:00:00,Liniile Aeriene Române Exploatate cu Statul - LARES,Takeoff (climb),Commercial,Romania,Europe,18,3,0,15,0,0,18,Unknown
1941-06-23 00:00:00,Royal Air Force - RAF,Taxiing,Military / Government,United Kingdom,Europe,4,4,0,0,0,0,4,Unknown
1941-06-26 00:00:00,Panagra - Pan American-Grace Airways,Landing (descent or approach),Operational,Brazil,South America,4,4,0,0,0,0,4,Human Factor
1941-06-29 00:00:00,Royal Air Force - RAF,Landing (descent or approach),Operational,United Kingdom,Europe,3,3,0,0,0,0,3,Unknown
1941-07-02 00:00:00,Toronto Flying Club,Landing (descent or approach),Operational,Canada,North America,0,0,0,0,0,0,0,Unknown
1941-07-06 00:00:00,Royal Air Force - RAF,Flight,Military / Government,World,World,0,0,0,0,0,0,0,Technical Failure
1941-07-07 00:00:00,Panair do Brasil,Flight,Operational,Brazil,South America,2,2,0,0,0,0,2,Unknown
1941-07-12 00:00:00,Royal Air Force - RAF,Takeoff (climb),Military / Government,United Kingdom,Europe,1,1,0,0,0,0,1,Unknown
1941-07-14 00:00:00,Royal Australian Air Force - RAAF,Landing (descent or approach),Operational,Australia,Oceania,2,2,0,0,0,0,2,Unknown
1941-07-23 00:00:00,German Air Force - Deutsche Luftwaffe,Flight,Military / Government,World,World,0,0,0,0,0,0,0,Terrorism
1941-07-24 00:00:00,United States Army Air Forces - USAAF,Landing (descent or approach),Military / Government,United States of America,North America,0,0,0,0,0,0,0,Technical Failure
1941-08-04 00:00:00,British Overseas Airways Corporation - BOAC,Flight,Commercial,Sudan,Africa,0,0,0,0,0,0,0,Unknown
1941-08-07 00:00:00,Provincial Air Service of Lands %26 Forests,Takeoff (climb),Military / Government,Canada,North America,2,2,0,0,0,0,2,Unknown
1941-08-11 00:00:00,Private American,Landing (descent or approach),Business,United States of America,North America,1,1,0,0,0,0,1,Technical Failure
1941-08-13 00:00:00,Royal Air Force - RAF,Takeoff (climb),Military / Government,Malta,Europe,0,0,0,0,0,0,0,Unknown
1941-08-13 00:00:00,Royal Air Force - RAF,Flight,Military / Government,Germany,Europe,7,7,0,0,0,0,7,Unknown
1941-08-13 00:00:00,Royal Air Force - RAF,Flight,Operational,United Kingdom,Europe,6,6,0,0,0,0,6,Technical Failure
1941-08-17 00:00:00,Royal Air Force - RAF,Flight,Military / Government,Germany,Europe,6,6,0,0,0,0,6,Terrorism
1941-08-21 00:00:00,Royal Air Force - RAF,Landing (descent or approach),Military / Government,United Kingdom,Europe,0,0,0,0,0,0,0,Unknown
1941-08-24 00:00:00,Royal Air Force - RAF,Landing (descent or approach),Military / Government,United Kingdom,Europe,2,2,0,0,0,0,2,Technical Failure
1941-08-26 00:00:00,Royal Air Force - RAF,Flight,Military / Government,United Kingdom,Europe,0,0,0,0,0,0,0,Unknown
1941-08-26 00:00:00,Royal Air Force - RAF,Landing (descent or approach),Military / Government,Iraq,Asia,0,0,0,0,0,0,0,Technical Failure
1941-08-29 00:00:00,Royal Air Force - RAF,Landing (descent or approach),Military / Government,United Kingdom,Europe,0,0,0,0,0,0,0,Human Factor
1941-09-02 00:00:00,Royal Air Force - RAF,Flight,Military / Government,United Kingdom,Europe,0,0,0,0,0,0,0,Unknown
1941-09-04 00:00:00,Royal Air Force - RAF,Landing (descent or approach),Operational,United Kingdom,Europe,1,1,0,0,0,0,1,Unknown
1941-09-07 00:00:00,Guinea Airways,Landing (descent or approach),Operational,Papua New Guinea,Oceania,1,1,0,0,0,0,1,Unknown
1941-09-07 00:00:00,Royal Air Force - RAF,Landing (descent or approach),Operational,Sierra Leone,Africa,3,3,0,0,0,0,3,Unknown
1941-09-11 00:00:00,British Yukon Navigation Company - BYNC,Flight,Operational,Canada,North America,2,2,0,0,0,0,2,Unknown
1941-09-13 00:00:00,Royal Air Force - RAF,Takeoff (climb),Operational,United Kingdom,Europe,7,7,0,0,0,0,7,Technical Failure
1941-09-16 00:00:00,Royal Air Force - RAF,Takeoff (climb),Operational,United Kingdom,Europe,4,4,0,0,0,0,4,Unknown
1941-09-17 00:00:00,Royal Canadian Air Force - RCAF,Landing (descent or approach),Military / Government,United States of America,North America,5,5,0,0,0,0,5,Unknown
1941-09-18 00:00:00,Eastern Air Transport,Landing (descent or approach),Commercial,Australia,Oceania,2,1,0,1,0,0,2,Unknown
1941-09-21 00:00:00,Royal Air Force - RAF,Flight,Military / Government,United Kingdom,Europe,6,6,0,0,0,0,6,Technical Failure
1941-09-23 00:00:00,Royal Air Force - RAF,Landing (descent or approach),Military / Government,Egypt,Africa,0,0,0,0,0,0,0,Unknown
1941-09-27 00:00:00,Finnish Air Force - Suomen Ilmavoimat,Takeoff (climb),Humanitarian,Finland,Europe,4,3,0,1,0,0,4,Technical Failure
1941-09-28 00:00:00,Royal Air Force - RAF,Flight,Specialised Services,United Kingdom,Europe,2,2,0,0,0,0,2,Technical Failure
1941-09-29 00:00:00,Royal Air Force - RAF,Landing (descent or approach),Operational,United Kingdom,Europe,4,4,0,0,0,0,4,Unknown
1941-09-30 00:00:00,Aircraft Exportation Corporation,Landing (descent or approach),Operational,United States of America,North America,1,1,0,0,0,0,1,Unknown
1941-10-03 00:00:00,Royal Canadian Air Force - RCAF,Takeoff (climb),Military / Government,Canada,North America,0,0,0,0,0,0,0,Unknown
1941-10-05 00:00:00,United States Army Air Forces - USAAF,,Military / Government,United States of America,North America,0,0,0,0,0,0,0,Unknown
1941-10-08 00:00:00,German Air Force - Deutsche Luftwaffe,Takeoff (climb),Military / Government,Norway,Europe,4,4,0,0,0,0,4,Other
1941-10-09 00:00:00,Misrair,Landing (descent or approach),Commercial,Sudan,Africa,6,1,0,5,0,0,6,Unknown
1941-10-10 00:00:00,Lloyd Aéreo Boliviano - LAB Airlines,,Commercial,Bolivia,South America,0,0,0,0,0,0,0,Unknown
1941-10-11 00:00:00,United States Army Air Forces - USAAF,,Military / Government,United States of America,North America,0,0,0,0,0,0,0,Unknown
1941-10-16 00:00:00,Royal Air Force - RAF,Taxiing,Military / Government,United Kingdom,Europe,0,0,0,0,0,0,0,Unknown
1941-10-23 00:00:00,Guinea Airways,Takeoff (climb),Operational,Papua New Guinea,Oceania,1,1,0,0,0,0,1,Technical Failure
1941-10-23 00:00:00,Royal Air Force - RAF,Takeoff (climb),Military / Government,Pakistan,Asia,0,0,0,0,0,0,0,Other
1941-10-30 00:00:00,TACA International Airlines - Transportes Aéreos Centro Americanos,Takeoff (climb),Commercial,Honduras,Central America,14,3,0,11,0,0,14,Unknown
1941-10-30 00:00:00,Mandated Airlines,Flight,Commercial,Papua New Guinea,Oceania,3,1,0,2,0,0,3,Unknown
1941-11-06 00:00:00,Royal Air Force - RAF,Landing (descent or approach),Military / Government,United Kingdom,Europe,9,9,0,0,0,0,9,Unknown
1941-11-06 00:00:00,Private American,,Business,United States of America,North America,0,0,0,0,0,0,0,Unknown
1941-11-08 00:00:00,Royal Air Force - RAF,Flight,Military / Government,Libya,Africa,8,8,0,0,0,0,8,Technical Failure
1941-11-14 00:00:00,DETA Mozambique Airlines - Direcção de Exploração dos Transportes Aéreos,Landing (descent or approach),Commercial,Mozambique,Africa,0,0,0,0,0,0,0,Unknown
1941-11-15 00:00:00,Private American,Takeoff (climb),Business,United States of America,North America,0,0,0,0,0,0,0,Unknown
1941-11-20 00:00:00,Royal Air Force - RAF,Flight,Military / Government,Nigeria,Africa,0,0,0,0,0,0,0,Weather
1941-11-25 00:00:00,Royal Air Force - RAF,Taxiing,Operational,United Kingdom,Europe,3,3,0,0,0,0,3,Human Factor
1941-11-26 00:00:00,Royal Air Force - RAF,Flight,Military / Government,United Kingdom,Europe,0,0,0,0,0,0,0,Technical Failure
1941-11-26 00:00:00,Royal Air Force - RAF,Landing (descent or approach),Military / Government,Palestine,Asia,0,0,0,0,0,0,0,Technical Failure
1941-12-07 00:00:00,United States Army Air Forces - USAAF,Landing (descent or approach),Military / Government,United States of America,North America,8,8,0,0,0,0,8,Terrorism
1941-12-08 00:00:00,Royal Australian Air Force - RAAF,Flight,Humanitarian,Egypt,Africa,3,3,0,0,0,0,3,Terrorism
1941-12-15 00:00:00,KNILM - Koninklijke Nederlandse Indies Luchtvaart Maatschappij,Landing (descent or approach),Commercial,Indonesia,Asia,0,0,0,0,0,0,0,Technical Failure
1941-12-21 00:00:00,British Overseas Airways Corporation - BOAC,Landing (descent or approach),Military / Government,Libya,Africa,0,0,0,0,0,0,0,Unknown
1941-12-23 00:00:00,Royal Air Force - RAF,Flight,Military / Government,Egypt,Africa,0,0,0,0,0,0,0,Unknown
1941-12-27 00:00:00,United States Army Air Forces - USAAF,Landing (descent or approach),Military / Government,Guatemala,Central America,10,10,0,0,0,0,10,Unknown
1941-12-31 00:00:00,Deutsche Lufthansa,,Commercial,Germany,Europe,0,0,0,0,0,0,0,Unknown
1942-01-01 00:00:00,Royal Air Force - RAF,Flight,Military / Government,United Kingdom,Europe,0,0,0,0,0,0,0,Weather
1942-01-05 00:00:00,United States Army Air Forces - USAAF,Landing (descent or approach),Military / Government,United States of America,North America,0,0,0,0,0,0,0,Unknown
1942-01-07 00:00:00,MacRobertson Miller Airlines,Takeoff (climb),Commercial,Australia,Oceania,4,1,0,3,0,0,4,Unknown
1942-01-08 00:00:00,Royal Air Force - RAF,Takeoff (climb),Operational,United Kingdom,Europe,7,7,0,0,0,0,7,Terrorism
1942-01-09 00:00:00,United States Army Air Forces - USAAF,Landing (descent or approach),Military / Government,Canada,North America,0,0,0,0,0,0,0,Unknown
1942-01-10 00:00:00,Royal Air Force - RAF,Flight,Military / Government,Egypt,Africa,8,8,0,0,0,0,8,Technical Failure
1942-01-10 00:00:00,Royal Air Force - RAF,Flight,Military / Government,Libya,Africa,0,0,0,0,0,0,0,Technical Failure
1942-01-16 00:00:00,Royal Air Force - RAF,Flight,Military / Government,United Kingdom,Europe,7,7,0,0,0,0,7,Technical Failure
1942-01-16 00:00:00,United States Army Air Forces - USAAF,Takeoff (climb),Military / Government,Canada,North America,0,0,0,0,0,0,0,Unknown
1942-01-17 00:00:00,United States Army Air Forces - USAAF,Landing (descent or approach),Military / Government,Indonesia,Asia,7,7,0,0,0,0,7,Human Factor
1942-01-17 00:00:00,United States Army Air Forces - USAAF,Flight,Military / Government,United States of America,North America,0,0,0,0,0,0,0,Unknown
1942-01-23 00:00:00,United States Army Air Forces - USAAF,Takeoff (climb),Military / Government,Indonesia,Asia,8,8,0,0,0,0,8,Unknown
1942-01-23 00:00:00,Royal Air Force - RAF,Flight,Military / Government,Libya,Africa,0,0,0,0,0,0,0,Terrorism
1942-01-24 00:00:00,KNILM - Koninklijke Nederlandse Indies Luchtvaart Maatschappij,Flight,Operational,Indonesia,Asia,3,3,0,0,0,0,3,Terrorism
1942-01-25 00:00:00,Aeroflot - Russian International Airlines,Landing (descent or approach),Commercial,Russia,Asia,9,5,0,4,0,0,9,Weather
1942-01-25 00:00:00,United States Army Air Forces - USAAF,Flight,Military / Government,Indonesia,Asia,8,8,0,0,0,0,8,Unknown
1942-01-28 00:00:00,Royal Australian Air Force - RAAF,Flight,Military / Government,Indonesia,Asia,4,4,0,0,0,0,4,Terrorism
1942-01-28 00:00:00,United States Army Air Forces - USAAF,Takeoff (climb),Military / Government,Australia,Oceania,5,5,0,0,0,0,5,Unknown
1942-01-31 00:00:00,Colombian Air Force - Fuerza Aérea Colombiana,Flight,Military / Government,Colombia,South America,14,5,0,9,0,0,14,Technical Failure
1942-01-31 00:00:00,Royal Air Force - RAF,Flight,Military / Government,World,World,0,0,0,0,0,0,0,Technical Failure
1942-02-03 00:00:00,United States Army Air Forces - USAAF,Flight,Military / Government,Indonesia,Asia,8,8,0,0,0,0,8,Unknown
1942-02-04 00:00:00,Airlines of Australia,Takeoff (climb),Commercial,Australia,Oceania,5,1,0,4,0,0,5,Technical Failure
1942-02-05 00:00:00,Royal Air Force - RAF,Flight,Operational,United Kingdom,Europe,5,5,0,0,0,0,5,Technical Failure
1942-02-06 00:00:00,Royal Air Force - RAF,Flight,Military / Government,United Kingdom,Europe,6,6,0,0,0,0,6,Weather
1942-02-07 00:00:00,Royal Air Force - RAF,Landing (descent or approach),Operational,United Kingdom,Europe,8,8,0,0,0,0,8,Human Factor
1942-02-08 00:00:00,United States Army Air Forces - USAAF,Landing (descent or approach),Military / Government,Indonesia,Asia,0,0,0,0,0,0,0,Unknown
1942-02-09 00:00:00,United States Army Air Forces - USAAF,Flight,Operational,United States of America,North America,6,6,0,0,0,0,6,Technical Failure
1942-02-10 00:00:00,Royal Air Force - RAF,Landing (descent or approach),Operational,United Kingdom,Europe,6,6,0,0,0,0,6,Technical Failure
1942-02-15 00:00:00,Aeroflot - Russian International Airlines,Landing (descent or approach),Commercial,Kyrgyzstan,Asia,0,0,0,0,0,0,0,Technical Failure
1942-02-16 00:00:00,Royal Air Force - RAF,Flight,Military / Government,United Kingdom,Europe,7,7,0,0,0,0,7,Technical Failure
1942-02-16 00:00:00,Airlines of Australia,Landing (descent or approach),Commercial,Australia,Oceania,4,1,0,3,0,0,4,Unknown
1942-02-19 00:00:00,United States Navy - USN,Flight,Military / Government,Australia,Oceania,18,4,0,14,0,0,18,Terrorism
1942-02-19 00:00:00,United States Army Air Forces - USAAF,Flight,Operational,Indonesia,Asia,4,4,0,0,0,0,4,Terrorism
1942-02-20 00:00:00,United States Army Air Forces - USAAF,Flight,Military / Government,World,World,0,0,0,0,0,0,0,Unknown
1942-02-22 00:00:00,German Air Force - Deutsche Luftwaffe,Landing (descent or approach),Military / Government,Norway,Europe,6,6,0,0,0,0,6,Technical Failure
1942-02-22 00:00:00,Royal Air Force - RAF,Landing (descent or approach),Operational,United Kingdom,Europe,2,2,0,0,0,0,2,Unknown
1942-02-23 00:00:00,United States Army Air Forces - USAAF,Flight,Military / Government,Papua New Guinea,Oceania,8,8,0,0,0,0,8,Technical Failure
1942-02-24 00:00:00,Royal Air Force - RAF,Takeoff (climb),Operational,United Kingdom,Europe,6,6,0,0,0,0,6,Technical Failure
1942-02-25 00:00:00,Royal Netherlands Navy - Marineluchtvaartdienst,Flight,Military / Government,Indonesia,Asia,6,6,0,0,0,0,6,Terrorism
1942-02-26 00:00:00,United States Army Air Forces - USAAF,Landing (descent or approach),Military / Government,Australia,Oceania,6,4,0,2,0,0,6,Technical Failure
1942-02-26 00:00:00,German Air Force - Deutsche Luftwaffe,Flight,Military / Government,Norway,Europe,3,3,0,0,0,0,3,Unknown
1942-02-27 00:00:00,KNILM - Koninklijke Nederlandse Indies Luchtvaart Maatschappij,Flight,Operational,Indonesia,Asia,4,4,0,0,0,0,4,Technical Failure
1942-03-02 00:00:00,Royal Air Force - RAF,Flight,Operational,United Kingdom,Europe,1,1,0,0,0,0,1,Technical Failure
1942-03-02 00:00:00,United States Army Air Forces - USAAF,Flight,Military / Government,United States of America,North America,0,0,0,0,0,0,0,Unknown
1942-03-08 00:00:00,Royal Netherlands Navy - Marineluchtvaartdienst,Flight,Military / Government,Indonesia,Asia,7,7,0,0,0,0,7,Terrorism
1942-03-10 00:00:00,Royal Air Force - RAF,Landing (descent or approach),Operational,United Kingdom,Europe,6,6,0,0,0,0,6,Unknown
1942-03-12 00:00:00,Royal Air Force - RAF,Flight,Military / Government,United Kingdom,Europe,6,6,0,0,0,0,6,Unknown
1942-03-14 00:00:00,Royal Air Force - RAF,Flight,Military / Government,United Kingdom,Europe,7,7,0,0,0,0,7,Technical Failure
1942-03-15 00:00:00,Royal Air Force - RAF,Landing (descent or approach),Operational,United Kingdom,Europe,2,2,0,0,0,0,2,Unknown
1942-03-17 00:00:00,Panair do Brasil,Takeoff (climb),Commercial,Brazil,South America,0,0,0,0,0,0,0,Technical Failure
1942-03-19 00:00:00,Royal Air Force - RAF,Landing (descent or approach),Operational,Canada,North America,2,2,0,0,0,0,2,Human Factor
1942-03-21 00:00:00,United States Army Air Forces - USAAF,Landing (descent or approach),Operational,United States of America,North America,6,6,0,0,0,0,6,Unknown
1942-03-22 00:00:00,Indian National Airways - INA,Flight,Commercial,India,Asia,0,0,0,0,0,0,0,Unknown
1942-03-24 00:00:00,Royal Air Force - RAF,Takeoff (climb),Military / Government,United Kingdom,Europe,7,7,0,0,0,0,7,Technical Failure
1942-03-25 00:00:00,Royal Air Force - RAF,Landing (descent or approach),Military / Government,United Kingdom,Europe,0,0,0,0,0,0,0,Unknown
1942-03-25 00:00:00,United States Army Air Forces - USAAF,Landing (descent or approach),Military / Government,United States of America,North America,0,0,0,0,0,0,0,Unknown
1942-03-25 00:00:00,United States Army Air Forces - USAAF,Landing (descent or approach),Military / Government,Australia,Oceania,0,0,0,0,0,0,0,Unknown
1942-03-26 00:00:00,KNILM - Koninklijke Nederlandse Indies Luchtvaart Maatschappij,Flight,Commercial,Australia,Oceania,12,2,0,10,0,0,12,Technical Failure
1942-03-28 00:00:00,United States Army Air Forces - USAAF,Landing (descent or approach),Operational,United States of America,North America,0,0,0,0,0,0,0,Unknown
1942-03-28 00:00:00,United States Army Air Forces - USAAF,Landing (descent or approach),Operational,United States of America,North America,0,0,0,0,0,0,0,Unknown
1942-03-29 00:00:00,United States Army Air Forces - USAAF,Takeoff (climb),Military / Government,United States of America,North America,0,0,0,0,0,0,0,Unknown
1942-03-30 00:00:00,Royal Air Force - RAF,Flight,Operational,United Kingdom,Europe,1,1,0,0,0,0,1,Technical Failure
1942-04-01 00:00:00,United States Army Air Forces - USAAF,Flight,Specialised Services,United States of America,North America,0,0,0,0,0,0,0,Unknown
1942-04-02 00:00:00,Mexican Air Force - Fuerza Aérea Mexicana,Landing (descent or approach),Operational,Mexico,Central America,1,1,0,0,0,0,1,Unknown
1942-04-03 00:00:00,United States Army Air Forces - USAAF,Flight,Military / Government,United States of America,North America,6,6,0,0,0,0,6,Technical Failure
1942-04-07 00:00:00,Royal Air Force - RAF,Landing (descent or approach),Military / Government,Iceland,Europe,4,4,0,0,0,0,4,Technical Failure
1942-04-08 00:00:00,United States Army Air Forces - USAAF,Flight,Military / Government,Papua New Guinea,Oceania,8,8,0,0,0,0,8,Technical Failure
1942-04-11 00:00:00,Royal Air Force - RAF,Taxiing,Military / Government,United Kingdom,Europe,6,1,0,5,0,0,6,Technical Failure
1942-04-11 00:00:00,United States Army Air Forces - USAAF,Landing (descent or approach),Military / Government,Australia,Oceania,6,6,0,0,0,0,6,Unknown
1942-04-11 00:00:00,United States Army Air Forces - USAAF,Flight,Military / Government,Papua New Guinea,Oceania,7,7,0,0,0,0,7,Terrorism
1942-04-15 00:00:00,Royal Air Force - RAF,Landing (descent or approach),Military / Government,United Kingdom,Europe,7,7,0,0,0,0,7,Technical Failure
1942-04-15 00:00:00,Private Papuan,Flight,Humanitarian,Papua New Guinea,Oceania,0,0,0,0,0,0,0,Unknown
1942-04-17 00:00:00,Consolidated Mining %26 Smelting Company of Canada,Takeoff (climb),Business,Canada,North America,3,1,0,2,0,0,3,Other
1942-04-17 00:00:00,Private American,Flight,Operational,United States of America,North America,1,1,0,0,0,0,1,Technical Failure
1942-04-17 00:00:00,Royal Air Force - RAF,Flight,Military / Government,France,Europe,7,7,0,0,0,0,7,Terrorism
1942-04-18 00:00:00,United States Navy - USN,Landing (descent or approach),Military / Government,Australia,Oceania,7,7,0,0,0,0,7,Unknown
1942-04-18 00:00:00,United States Army Air Forces - USAAF,Landing (descent or approach),Military / Government,United States of America,North America,0,0,0,0,0,0,0,Unknown
1942-04-19 00:00:00,United States Army Air Forces - USAAF,Takeoff (climb),Military / Government,Sierra Leone,Africa,0,0,0,0,0,0,0,Unknown
1942-04-20 00:00:00,Royal Air Force - RAF,Flight,Military / Government,United Kingdom,Europe,8,1,0,7,0,0,8,Technical Failure
1942-04-20 00:00:00,United States Army Air Forces - USAAF,Landing (descent or approach),Military / Government,United States of America,North America,0,0,0,0,0,0,0,Unknown
1942-04-22 00:00:00,Royal Air Force - RAF,Flight,Operational,United Kingdom,Europe,7,7,0,0,0,0,7,Human Factor
1942-04-23 00:00:00,United States Navy - USN,Takeoff (climb),Military / Government,United States of America,North America,0,0,0,0,0,0,0,Unknown
1942-04-24 00:00:00,Royal Air Force - RAF,Flight,Operational,Zimbabwe,Africa,2,2,0,0,0,0,2,Other
1942-04-27 00:00:00,United States Army Air Forces - USAAF,Landing (descent or approach),Military / Government,United States of America,North America,0,0,0,0,0,0,0,Unknown
1942-04-28 00:00:00,Royal Air Force - RAF,Takeoff (climb),Military / Government,Canada,North America,0,0,0,0,0,0,0,Technical Failure
1942-05-01 00:00:00,Aeroplane %26 Armament Experimental Establishment - A%26AEE,Takeoff (climb),Operational,United Kingdom,Europe,7,7,0,0,0,0,7,Unknown
1942-05-03 00:00:00,United States Army Air Forces - USAAF,Landing (descent or approach),Military / Government,United States of America,North America,0,0,0,0,0,0,0,Technical Failure
1942-05-04 00:00:00,Royal Australian Air Force - RAAF,Flight,Military / Government,Papua New Guinea,Oceania,9,9,0,0,0,0,9,Terrorism
1942-05-05 00:00:00,United States Army Air Forces - USAAF,Flight,Military / Government,Indonesia,Asia,8,8,0,0,0,0,8,Technical Failure
1942-05-06 00:00:00,South African Air Force,Takeoff (climb),Military / Government,South Africa,Africa,0,0,0,0,0,0,0,Unknown
1942-05-07 00:00:00,United States Army Air Forces - USAAF,Landing (descent or approach),Military / Government,Australia,Oceania,6,6,0,0,0,0,6,Technical Failure
1942-05-07 00:00:00,United States Army Air Forces - USAAF,Flight,Military / Government,Australia,Oceania,0,0,0,0,0,0,0,Unknown
1942-05-10 00:00:00,Royal Australian Air Force - RAAF,Landing (descent or approach),Military / Government,Australia,Oceania,3,3,0,0,0,0,3,Unknown
1942-05-11 00:00:00,Regia Aeronautica,Landing (descent or approach),Operational,Italy,Europe,4,4,0,0,0,0,4,Unknown
1942-05-12 00:00:00,Swedish Air Force - Flygvapnet,Flight,Military / Government,Sweden,Europe,4,4,0,0,0,0,4,Technical Failure
1942-05-13 00:00:00,British Overseas Airways Corporation - BOAC,Takeoff (climb),Commercial,Malta,Europe,0,0,0,0,0,0,0,Unknown
1942-05-14 00:00:00,United States Army Air Forces - USAAF,Landing (descent or approach),Military / Government,Papua New Guinea,Oceania,8,8,0,0,0,0,8,Terrorism
1942-05-15 00:00:00,United States Army Air Forces - USAAF,Flight,Operational,United States of America,North America,0,0,0,0,0,0,0,Technical Failure
1942-05-16 00:00:00,United States Army Air Forces - USAAF,Landing (descent or approach),Military / Government,United States of America,North America,0,0,0,0,0,0,0,Unknown
1942-05-17 00:00:00,United States Army Air Forces - USAAF,Landing (descent or approach),Military / Government,United States of America,North America,7,7,0,0,0,0,7,Technical Failure
1942-05-19 00:00:00,United States Army Air Forces - USAAF,Flight,Operational,United States of America,North America,0,0,0,0,0,0,0,Unknown
1942-05-20 00:00:00,Royal Air Force - RAF,Takeoff (climb),Specialised Services,United Kingdom,Europe,3,3,0,0,0,0,3,Technical Failure
1942-05-21 00:00:00,United States Army Air Forces - USAAF,Takeoff (climb),Military / Government,United States of America,North America,0,0,0,0,0,0,0,Unknown
1942-05-26 00:00:00,United States Navy - USN,Landing (descent or approach),Military / Government,United States of America,North America,8,8,0,0,0,0,8,Unknown
1942-05-27 00:00:00,Royal Air Force - RAF,Landing (descent or approach),Military / Government,United Kingdom,Europe,0,0,0,0,0,0,0,Human Factor
1942-05-28 00:00:00,United States Army Air Forces - USAAF,Flight,Operational,France,Europe,0,0,0,0,0,0,0,Unknown
1942-05-30 00:00:00,United States Army Air Forces - USAAF,Flight,Military / Government,Jamaica,Central America,0,0,0,0,0,0,0,Unknown
1942-05-30 00:00:00,Royal Netherlands Navy - Marineluchtvaartdienst,Flight,Military / Government,Netherlands,Europe,4,4,0,0,0,0,4,Unknown
1942-05-31 00:00:00,Royal Air Force - RAF,Flight,Military / Government,Germany,Europe,6,6,0,0,0,0,6,Terrorism
1942-06-01 00:00:00,United States Army Air Forces - USAAF,Flight,Operational,Australia,Oceania,2,2,0,0,0,0,2,Unknown
1942-06-02 00:00:00,United States Army Air Forces - USAAF,Landing (descent or approach),Military / Government,United States of America,North America,0,0,0,0,0,0,0,Unknown
1942-06-02 00:00:00,United States Army Air Forces - USAAF,Landing (descent or approach),Military / Government,United States of America,North America,0,0,0,0,0,0,0,Unknown
1942-06-04 00:00:00,United States Army Air Forces - USAAF,Landing (descent or approach),Military / Government,United States of America,North America,8,8,0,0,0,0,8,Technical Failure
1942-06-10 00:00:00,Royal Canadian Air Force - RCAF,Flight,Operational,Canada,North America,4,4,0,0,0,0,4,Weather
1942-06-13 00:00:00,United States Army Air Forces - USAAF,Landing (descent or approach),Military / Government,United States of America,North America,0,0,0,0,0,0,0,Technical Failure
1942-06-14 00:00:00,Royal Air Force - RAF,Flight,Military / Government,India,Asia,0,0,0,0,0,0,0,Unknown
1942-06-15 00:00:00,Royal Australian Air Force - RAAF,Takeoff (climb),Operational,Australia,Oceania,11,3,0,8,0,0,11,Unknown
1942-06-17 00:00:00,United States Army Air Forces - USAAF,Flight,Operational,United States of America,North America,0,0,0,0,0,0,0,Unknown
1942-06-23 00:00:00,British Overseas Airways Corporation - BOAC,Flight,Commercial,Sweden,Europe,10,2,0,8,0,0,10,Technical Failure
1942-06-24 00:00:00,Royal Air Force - RAF,Landing (descent or approach),Humanitarian,Egypt,Africa,0,0,0,0,0,0,0,Technical Failure
1942-06-26 00:00:00,Royal Air Force - RAF,Flight,Military / Government,United Kingdom,Europe,0,0,0,0,0,0,0,Unknown
1942-06-26 00:00:00,Royal Air Force - RAF,Flight,Military / Government,Kuwait,Asia,3,3,0,0,0,0,3,Unknown
1942-06-26 00:00:00,Royal Air Force - RAF,Flight,Military / Government,Kuwait,Asia,3,3,0,0,0,0,3,Unknown
1942-06-28 00:00:00,Regia Aeronautica,Flight,Military / Government,Spain,Europe,7,7,0,0,0,0,7,Technical Failure
1942-06-28 00:00:00,Royal Air Force - RAF,Flight,Military / Government,France,Europe,3,3,0,0,0,0,3,Unknown
1942-06-28 00:00:00,United States Army Air Forces - USAAF,Flight,Military / Government,Greenland,Europe,0,0,0,0,0,0,0,Unknown
1942-07-02 00:00:00,Air France,Takeoff (climb),Operational,Mauritania,Africa,3,3,0,0,0,0,3,Unknown
1942-07-04 00:00:00,Royal Canadian Air Force - RCAF,Landing (descent or approach),Operational,Canada,North America,5,5,0,0,0,0,5,Unknown
1942-07-04 00:00:00,United States Army Air Forces - USAAF,Landing (descent or approach),Military / Government,United States of America,North America,0,0,0,0,0,0,0,Unknown
1942-07-05 00:00:00,Royal Air Force - RAF,Takeoff (climb),Operational,United Kingdom,Europe,7,7,0,0,0,0,7,Technical Failure
1942-07-06 00:00:00,Royal Air Force - RAF,Flight,Military / Government,United Kingdom,Europe,6,6,0,0,0,0,6,Technical Failure
1942-07-10 00:00:00,Royal Air Force - RAF,Landing (descent or approach),Operational,United Kingdom,Europe,7,7,0,0,0,0,7,Unknown
1942-07-12 00:00:00,United States Army Air Forces - USAAF,Landing (descent or approach),Military / Government,Puerto Rico,Central America,0,0,0,0,0,0,0,Unknown
1942-07-17 00:00:00,Liniile Aeriene Române Exploatate cu Statul - LARES,,Commercial,Romania,Europe,4,1,0,3,0,0,4,Unknown
1942-07-17 00:00:00,Royal Air Force - RAF,Flight,Operational,United Kingdom,Europe,5,5,0,0,0,0,5,Unknown
1942-07-21 00:00:00,United States Army Air Forces - USAAF,Landing (descent or approach),Operational,United States of America,North America,0,0,0,0,0,0,0,Unknown
1942-07-23 00:00:00,United States Army Air Forces - USAAF,Takeoff (climb),Military / Government,United States of America,North America,0,0,0,0,0,0,0,Unknown
1942-07-24 00:00:00,Royal Air Force - RAF,Flight,Military / Government,Egypt,Africa,0,0,0,0,0,0,0,Terrorism
1942-07-25 00:00:00,United States Army Air Forces - USAAF,Landing (descent or approach),Operational,United States of America,North America,2,2,0,0,0,0,2,Technical Failure
1942-07-27 00:00:00,Royal Air Force - RAF,Flight,Military / Government,Egypt,Africa,0,0,0,0,0,0,0,Terrorism
1942-08-01 00:00:00,Royal Air Force - RAF,Takeoff (climb),Military / Government,United Kingdom,Europe,2,2,0,0,0,0,2,Unknown
1942-08-02 00:00:00,United States Army Air Forces - USAAF,Landing (descent or approach),Military / Government,United States of America,North America,0,0,0,0,0,0,0,Unknown
1942-08-02 00:00:00,United States Army Air Forces - USAAF,Takeoff (climb),Military / Government,United States of America,North America,0,0,0,0,0,0,0,Unknown
1942-08-04 00:00:00,Rhodesian %26 Nyasaland Airways,Takeoff (climb),Commercial,Zimbabwe,Africa,3,1,0,2,0,0,3,Unknown
1942-08-04 00:00:00,United States Army Air Forces - USAAF,Landing (descent or approach),Military / Government,Palestine,Asia,0,0,0,0,0,0,0,Unknown
1942-08-06 00:00:00,Royal Air Force - RAF,Landing (descent or approach),Military / Government,United Kingdom,Europe,0,0,0,0,0,0,0,Unknown
1942-08-09 00:00:00,United States Army Air Forces - USAAF,Flight,Military / Government,Papua New Guinea,Oceania,10,10,0,0,0,0,10,Technical Failure
1942-08-09 00:00:00,United States Army Air Forces - USAAF,Landing (descent or approach),Military / Government,United States of America,North America,0,0,0,0,0,0,0,Unknown
1942-08-10 00:00:00,United States Army Air Forces - USAAF,Takeoff (climb),Military / Government,United States of America,North America,0,0,0,0,0,0,0,Unknown
1942-08-10 00:00:00,Royal Air Force - RAF,Landing (descent or approach),Military / Government,United Kingdom,Europe,7,7,0,0,0,0,7,Human Factor
1942-08-11 00:00:00,Royal Air Force - RAF,Landing (descent or approach),Military / Government,Palestine,Asia,0,0,0,0,0,0,0,Human Factor
1942-08-13 00:00:00,Royal Air Force - RAF,Landing (descent or approach),Operational,United Kingdom,Europe,2,2,0,0,0,0,2,Unknown
1942-08-13 00:00:00,Royal Air Force - RAF,Landing (descent or approach),Operational,United Kingdom,Europe,7,7,0,0,0,0,7,Human Factor
1942-08-16 00:00:00,Royal Air Force - RAF,Flight,Military / Government,Netherlands,Europe,7,7,0,0,0,0,7,Unknown
1942-08-16 00:00:00,Royal Air Force - RAF,Takeoff (climb),Military / Government,United Kingdom,Europe,7,7,0,0,0,0,7,Technical Failure
1942-08-20 00:00:00,Royal Air Force - RAF,Flight,Operational,United Kingdom,Europe,5,5,0,0,0,0,5,Human Factor
1942-08-20 00:00:00,United States Army Air Forces - USAAF,Landing (descent or approach),Military / Government,United States of America,North America,0,0,0,0,0,0,0,Unknown
1942-08-22 00:00:00,Royal Canadian Air Force - RCAF,Flight,Operational,Canada,North America,5,5,0,0,0,0,5,Technical Failure
1942-08-23 00:00:00,United States Army Air Forces - USAAF,Landing (descent or approach),Military / Government,United States of America,North America,0,0,0,0,0,0,0,Unknown
1942-08-24 00:00:00,Royal Air Force - RAF,Flight,Operational,Canada,North America,5,5,0,0,0,0,5,Unknown
1942-08-26 00:00:00,United States Army Air Forces - USAAF,Landing (descent or approach),Military / Government,Australia,Oceania,3,3,0,0,0,0,3,Terrorism
1942-08-28 00:00:00,Royal Air Force - RAF,Takeoff (climb),Military / Government,United Kingdom,Europe,1,1,0,0,0,0,1,Unknown
1942-08-30 00:00:00,Royal Air Force - RAF,Landing (descent or approach),Military / Government,United Kingdom,Europe,0,0,0,0,0,0,0,Technical Failure
1942-08-31 00:00:00,United States Army Air Forces - USAAF,,Military / Government,United States of America,North America,0,0,0,0,0,0,0,Unknown
1942-09-01 00:00:00,Royal Air Force - RAF,Landing (descent or approach),Military / Government,United Kingdom,Europe,6,6,0,0,0,0,6,Technical Failure
1942-09-05 00:00:00,United States Army Air Forces - USAAF,,Military / Government,United States of America,North America,0,0,0,0,0,0,0,Unknown
1942-09-07 00:00:00,Mexicana de Aviación,,Commercial,Mexico,Central America,0,0,0,0,0,0,0,Unknown
1942-09-10 00:00:00,Royal Air Force - RAF,Landing (descent or approach),Operational,United Kingdom,Europe,3,3,0,0,0,0,3,Human Factor
1942-09-12 00:00:00,Dominion Airways - Canada,Takeoff (climb),Commercial,Canada,North America,0,0,0,0,0,0,0,Unknown
1942-09-13 00:00:00,British Overseas Airways Corporation - BOAC,Landing (descent or approach),Commercial,Turkey,Asia,0,0,0,0,0,0,0,Unknown
1942-09-15 00:00:00,Royal Air Force - RAF,Takeoff (climb),Military / Government,India,Asia,0,0,0,0,0,0,0,Unknown
1942-09-15 00:00:00,Royal Air Force - RAF,Takeoff (climb),Military / Government,United Kingdom,Europe,8,8,0,0,0,0,8,Unknown
1942-09-16 00:00:00,United States Army Air Forces - USAAF,Landing (descent or approach),Military / Government,United States of America,North America,0,0,0,0,0,0,0,Unknown
1942-09-17 00:00:00,Royal Air Force - RAF,Flight,Military / Government,World,World,7,7,0,0,0,0,7,Unknown
1942-09-18 00:00:00,Royal Air Force - RAF,Flight,Operational,Egypt,Africa,2,2,0,0,0,0,2,Human Factor
1942-09-21 00:00:00,Royal Air Force - RAF,Flight,Operational,United Kingdom,Europe,3,3,0,0,0,0,3,Human Factor
1942-09-21 00:00:00,United States Navy - USN,Landing (descent or approach),Military / Government,Bahamas,Central America,0,0,0,0,0,0,0,Unknown
1942-09-24 00:00:00,Royal Air Force - RAF,Landing (descent or approach),Operational,United Kingdom,Europe,0,0,0,0,0,0,0,Human Factor
1942-09-24 00:00:00,Royal Canadian Air Force - RCAF,Landing (descent or approach),Military / Government,Canada,North America,0,0,0,0,0,0,0,Weather
1942-09-26 00:00:00,United States Army Air Forces - USAAF,Takeoff (climb),Military / Government,Papua New Guinea,Oceania,8,8,0,0,0,0,8,Human Factor
1942-09-27 00:00:00,Royal Air Force - RAF,Landing (descent or approach),Military / Government,Pakistan,Asia,0,0,0,0,0,0,0,Unknown
1942-09-28 00:00:00,Royal New Zealand Air Force - RNZAF,Takeoff (climb),Operational,New Zealand,Oceania,4,4,0,0,0,0,4,Unknown
1942-09-30 00:00:00,United States Army Air Forces - USAAF,Taxiing,Military / Government,Australia,Oceania,8,8,0,0,0,0,8,Human Factor
1942-10-01 00:00:00,United States Navy - USN,Landing (descent or approach),Operational,United States of America,North America,3,3,0,0,0,0,3,Technical Failure
1942-10-01 00:00:00,United States Army Air Forces - USAAF,Takeoff (climb),Military / Government,United States of America,North America,0,0,0,0,0,0,0,Unknown
1942-10-02 00:00:00,Royal Air Force - RAF,Flight,Operational,Canada,North America,5,5,0,0,0,0,5,Unknown
1942-10-02 00:00:00,Royal Air Force - RAF,Flight,Operational,United Kingdom,Europe,0,0,0,0,0,0,0,Unknown
1942-10-05 00:00:00,Royal Air Force - RAF,Landing (descent or approach),Operational,United Kingdom,Europe,4,4,0,0,0,0,4,Technical Failure
1942-10-06 00:00:00,Royal Air Force - RAF,Takeoff (climb),Military / Government,United Kingdom,Europe,0,0,0,0,0,0,0,Technical Failure
1942-10-07 00:00:00,Royal Air Force - RAF,Flight,Military / Government,United Kingdom,Europe,4,4,0,0,0,0,4,Technical Failure
1942-10-08 00:00:00,Royal Air Force - RAF,Landing (descent or approach),Operational,Canada,North America,5,5,0,0,0,0,5,Technical Failure
1942-10-10 00:00:00,United States Army Air Forces - USAAF,Flight,Military / Government,Canada,North America,3,3,0,0,0,0,3,Technical Failure
1942-10-10 00:00:00,China National Aviation Corporation - CNAC,Takeoff (climb),Operational,India,Asia,2,2,0,0,0,0,2,Human Factor
1942-10-11 00:00:00,Ansett Airways Ltd.,Landing (descent or approach),Military / Government,Australia,Oceania,0,0,0,0,0,0,0,Unknown
1942-10-13 00:00:00,United States Army Air Forces - USAAF,Landing (descent or approach),Military / Government,United States of America,North America,0,0,0,0,0,0,0,Unknown
1942-10-14 00:00:00,Royal Australian Air Force - RAAF,Takeoff (climb),Military / Government,Australia,Oceania,5,5,0,0,0,0,5,Technical Failure
1942-10-18 00:00:00,Royal Air Force - RAF,Taxiing,Military / Government,United Kingdom,Europe,7,7,0,0,0,0,7,Technical Failure
1942-10-19 00:00:00,United States Army Air Forces - USAAF,Landing (descent or approach),Military / Government,United States of America,North America,0,0,0,0,0,0,0,Unknown
1942-10-20 00:00:00,United States Army Air Forces - USAAF,Flight,Operational,United States of America,North America,0,0,0,0,0,0,0,Unknown
1942-10-20 00:00:00,Royal Air Force - RAF,Landing (descent or approach),Military / Government,United Kingdom,Europe,10,10,0,0,0,0,10,Other
1942-10-21 00:00:00,United States Army Air Forces - USAAF,Flight,Military / Government,France,Europe,0,0,0,0,0,0,0,Terrorism
1942-10-23 00:00:00,United States Army Air Forces - USAAF,Landing (descent or approach),Operational,United States of America,North America,0,0,0,0,0,0,0,Human Factor
1942-10-29 00:00:00,Royal Air Force - RAF,Landing (descent or approach),Military / Government,United Kingdom,Europe,0,0,0,0,0,0,0,Human Factor
1942-10-30 00:00:00,United States Army Air Forces - USAAF,Flight,Military / Government,Australia,Oceania,5,5,0,0,0,0,5,Unknown
1942-10-30 00:00:00,United States Army Air Forces - USAAF,Landing (descent or approach),Military / Government,United States of America,North America,0,0,0,0,0,0,0,Unknown
1942-10-31 00:00:00,Royal Australian Air Force - RAAF,Takeoff (climb),Specialised Services,Australia,Oceania,1,1,0,0,0,0,1,Technical Failure
1942-11-02 00:00:00,Canadian Pacific Airlines - CP Air,Takeoff (climb),Commercial,Canada,North America,0,0,0,0,0,0,0,Technical Failure
1942-11-02 00:00:00,United States Army Air Forces - USAAF,Flight,Military / Government,Papua New Guinea,Oceania,8,8,0,0,0,0,8,Technical Failure
1942-11-04 00:00:00,Transcontinental %26 Western Air - TWA,Flight,Operational,United States of America,North America,6,6,0,0,0,0,6,Human Factor
1942-11-05 00:00:00,United States Army Air Forces - USAAF,Flight,Military / Government,Greenland,Europe,5,5,0,0,0,0,5,Unknown
1942-11-06 00:00:00,Allied Directorate of Air Transport,Flight,Military / Government,Australia,Oceania,22,2,0,20,0,0,22,Technical Failure
1942-11-06 00:00:00,United States Army Air Forces - USAAF,Takeoff (climb),Military / Government,United States of America,North America,0,0,0,0,0,0,0,Unknown
1942-11-09 00:00:00,Linee Aeree Transcontinentali Italiane - LATI,Flight,Commercial,Greece,Europe,0,0,0,0,0,0,0,Technical Failure
1942-11-11 00:00:00,Royal Australian Air Force - RAAF,Flight,Operational,Australia,Oceania,3,3,0,0,0,0,3,Technical Failure
1942-11-12 00:00:00,Royal Australian Air Force - RAAF,Flight,Military / Government,World,World,4,4,0,0,0,0,4,Unknown
1942-11-13 00:00:00,United States Army Air Forces - USAAF,Landing (descent or approach),Operational,United States of America,North America,6,6,0,0,0,0,6,Technical Failure
1942-11-14 00:00:00,Royal Air Force - RAF,Flight,Military / Government,United Kingdom,Europe,4,4,0,0,0,0,4,Unknown
1942-11-15 00:00:00,Royal Air Force - RAF,Landing (descent or approach),Specialised Services,United Kingdom,Europe,4,4,0,0,0,0,4,Technical Failure
1942-11-16 00:00:00,Avio Linee Italiane - ALI,Flight,Specialised Services,Italy,Europe,3,3,0,0,0,0,3,Technical Failure
1942-11-16 00:00:00,Lineas Aéreas Mineras - LAMSA,Flight,Commercial,Mexico,Central America,0,0,0,0,0,0,0,Unknown
1942-11-17 00:00:00,United States Army Air Forces - USAAF,Landing (descent or approach),Military / Government,United States of America,North America,0,0,0,0,0,0,0,Unknown
1942-11-17 00:00:00,Colombian Air Force - Fuerza Aérea Colombiana,,Military / Government,Colombia,South America,0,0,0,0,0,0,0,Unknown
1942-11-18 00:00:00,Royal Air Force - RAF,Landing (descent or approach),Operational,Canada,North America,7,7,0,0,0,0,7,Unknown
1942-11-18 00:00:00,British Overseas Airways Corporation - BOAC,Takeoff (climb),Commercial,Ethiopia,Africa,0,0,0,0,0,0,0,Unknown
1942-11-18 00:00:00,United States Army Air Forces - USAAF,,Military / Government,United States of America,North America,0,0,0,0,0,0,0,Unknown
1942-11-18 00:00:00,Royal Air Force - RAF,Takeoff (climb),Military / Government,United Kingdom,Europe,7,7,0,0,0,0,7,Human Factor
1942-11-23 00:00:00,United States Army Air Forces - USAAF,Flight,Operational,United States of America,North America,2,2,0,0,0,0,2,Technical Failure
1942-11-24 00:00:00,Royal Australian Air Force - RAAF,Landing (descent or approach),Military / Government,Australia,Oceania,0,0,0,0,0,0,0,Unknown
1942-11-25 00:00:00,Royal Australian Air Force - RAAF,Takeoff (climb),Military / Government,Australia,Oceania,6,2,0,4,0,0,6,Technical Failure
1942-11-26 00:00:00,Compañia Aeronautica Francisco Sarabia SA - CAFSSA,,Commercial,Mexico,Central America,0,0,0,0,0,0,0,Unknown
1942-11-29 00:00:00,United States Army Air Forces - USAAF,Flight,Operational,United States of America,North America,6,6,0,0,0,0,6,Technical Failure
1942-11-30 00:00:00,Australian National Airways - ANA,Landing (descent or approach),Military / Government,Papua New Guinea,Oceania,0,0,0,0,0,0,0,Terrorism
1942-12-02 00:00:00,Royal Air Force - RAF,Flight,Operational,United Kingdom,Europe,0,0,0,0,0,0,0,Technical Failure
1942-12-07 00:00:00,Royal Air Force - RAF,Taxiing,Military / Government,Sudan,Africa,0,0,0,0,0,0,0,Unknown
1942-12-09 00:00:00,Deutsche Lufthansa,Landing (descent or approach),Commercial,Spain,Europe,24,3,0,21,0,0,24,Weather
1942-12-09 00:00:00,Royal Air Force - RAF,Flight,Operational,United Kingdom,Europe,6,6,0,0,0,0,6,Unknown
1942-12-11 00:00:00,United States Army Air Forces - USAAF,Landing (descent or approach),Military / Government,United States of America,North America,0,0,0,0,0,0,0,Unknown
1942-12-12 00:00:00,United States Army Air Forces - USAAF,Flight,Operational,United States of America,North America,0,0,0,0,0,0,0,Technical Failure
1942-12-13 00:00:00,Royal Air Force - RAF,Flight,Operational,United Kingdom,Europe,4,4,0,0,0,0,4,Technical Failure
1942-12-14 00:00:00,United States Navy - USN,Flight,Military / Government,World,World,8,8,0,0,0,0,8,Unknown
1942-12-15 00:00:00,Kenya Air Force,Landing (descent or approach),Military / Government,Tanzania,Africa,2,2,0,0,0,0,2,Unknown
1942-12-19 00:00:00,United States Army Air Forces - USAAF,Flight,Military / Government,Papua New Guinea,Oceania,8,8,0,0,0,0,8,Technical Failure
1942-12-22 00:00:00,Royal Air Force - RAF,Takeoff (climb),Military / Government,Egypt,Africa,0,0,0,0,0,0,0,Unknown
1942-12-23 00:00:00,United States Army Air Forces - USAAF,Takeoff (climb),Military / Government,Australia,Oceania,7,7,0,0,0,0,7,Unknown
1942-12-28 00:00:00,United States Army Air Forces - USAAF,Flight,Military / Government,United States of America,North America,0,0,0,0,0,0,0,Unknown
1942-12-28 00:00:00,Royal Air Force - RAF,Landing (descent or approach),Operational,Canada,North America,5,5,0,0,0,0,5,Human Factor
1942-12-31 00:00:00,Panagra - Pan American-Grace Airways,Landing (descent or approach),Commercial,Peru,South America,5,2,0,3,0,0,5,Unknown
1943-01-01 00:00:00,SABENA - Société Anonyme Belge d'Exploitation de la Navigation Aérienne,Flight,Commercial,Central African Republic,Africa,0,0,0,0,0,0,0,Unknown
1943-01-02 00:00:00,Royal Air Force - RAF,Flight,Military / Government,United Kingdom,Europe,7,7,0,0,0,0,7,Weather
1943-01-03 00:00:00,United States Army Air Forces - USAAF,Flight,Military / Government,Papua New Guinea,Oceania,8,8,0,0,0,0,8,Terrorism
1943-01-05 00:00:00,United States Army Air Forces - USAAF,Takeoff (climb),Military / Government,United States of America,North America,0,0,0,0,0,0,0,Unknown
1943-01-06 00:00:00,United States Army Air Forces - USAAF,Takeoff (climb),Military / Government,India,Asia,0,0,0,0,0,0,0,Unknown
1943-01-08 00:00:00,Royal Australian Air Force - RAAF,Landing (descent or approach),Military / Government,Australia,Oceania,10,4,0,6,0,0,10,Unknown
1943-01-08 00:00:00,Royal Air Force - RAF,Flight,Operational,United Kingdom,Europe,2,2,0,0,0,0,2,Unknown
1943-01-11 00:00:00,United Airlines,Landing (descent or approach),Operational,United States of America,North America,2,2,0,0,0,0,2,Technical Failure
1943-01-12 00:00:00,Royal Air Force - RAF,Flight,Operational,United States of America,North America,0,0,0,0,0,0,0,Unknown
1943-01-12 00:00:00,Royal Air Force - RAF,Landing (descent or approach),Operational,United Kingdom,Europe,3,3,0,0,0,0,3,Technical Failure
1943-01-12 00:00:00,Royal Air Force - RAF,Flight,Operational,Canada,North America,0,0,0,0,0,0,0,Unknown
1943-01-13 00:00:00,United States Navy - USN,Takeoff (climb),Military / Government,Iceland,Europe,0,0,0,0,0,0,0,Unknown
1943-01-15 00:00:00,Royal Canadian Air Force - RCAF,Flight,Military / Government,Canada,North America,0,0,0,0,0,0,0,Unknown
1943-01-16 00:00:00,United States Army Air Forces - USAAF,Flight,Operational,United States of America,North America,8,8,0,0,0,0,8,Unknown
1943-01-16 00:00:00,Royal Air Force - RAF,Landing (descent or approach),Operational,United Kingdom,Europe,0,0,0,0,0,0,0,Unknown
1943-01-17 00:00:00,United States Army Air Forces - USAAF,Flight,Military / Government,United States of America,North America,0,0,0,0,0,0,0,Unknown
1943-01-19 00:00:00,Royal Air Force - RAF,Takeoff (climb),Military / Government,Libya,Africa,0,0,0,0,0,0,0,Technical Failure
1943-01-21 00:00:00,Royal Air Force - RAF,Flight,Military / Government,United Kingdom,Europe,4,4,0,0,0,0,4,Technical Failure
1943-01-21 00:00:00,United States Army Air Forces - USAAF,Flight,Operational,United States of America,North America,0,0,0,0,0,0,0,Technical Failure
1943-01-22 00:00:00,United States Army Air Forces - USAAF,Takeoff (climb),Military / Government,United States of America,North America,7,7,0,0,0,0,7,Technical Failure
1943-01-23 00:00:00,United States Army Air Forces - USAAF,Takeoff (climb),Operational,United States of America,North America,0,0,0,0,0,0,0,Unknown
1943-01-24 00:00:00,Royal Air Force - RAF,Takeoff (climb),Operational,United Kingdom,Europe,7,7,0,0,0,0,7,Technical Failure
1943-01-26 00:00:00,Royal Air Force - RAF,Flight,Military / Government,United Kingdom,Europe,6,6,0,0,0,0,6,Unknown
1943-01-27 00:00:00,United States Navy - USN,Flight,Military / Government,Greenland,Europe,7,7,0,0,0,0,7,Human Factor
1943-01-29 00:00:00,United States Army Air Forces - USAAF,Flight,Operational,United States of America,North America,8,8,0,0,0,0,8,Unknown
1943-01-31 00:00:00,United States Army Air Forces - USAAF,Flight,Military / Government,Italy,Europe,0,0,0,0,0,0,0,Terrorism
1943-02-01 00:00:00,Royal Air Force - RAF,Landing (descent or approach),Military / Government,United Kingdom,Europe,0,0,0,0,0,0,0,Unknown
1943-02-02 00:00:00,Scottish Airways,Takeoff (climb),Commercial,United Kingdom,Europe,6,2,0,4,0,0,6,Unknown
1943-02-02 00:00:00,United States Army Air Forces - USAAF,Flight,Operational,United States of America,North America,10,10,0,0,0,0,10,Unknown
1943-02-03 00:00:00,Royal Air Force - RAF,Flight,Military / Government,France,Europe,4,4,0,0,0,0,4,Terrorism
1943-02-04 00:00:00,Royal Air Force - RAF,Landing (descent or approach),Military / Government,United Kingdom,Europe,4,4,0,0,0,0,4,Unknown
1943-02-11 00:00:00,Royal Air Force - RAF,Flight,Operational,United Kingdom,Europe,6,6,0,0,0,0,6,Technical Failure
1943-02-14 00:00:00,Royal Air Force - RAF,Landing (descent or approach),Operational,United Kingdom,Europe,7,7,0,0,0,0,7,Technical Failure
1943-02-18 00:00:00,Royal Air Force - RAF,Flight,Operational,United Kingdom,Europe,5,5,0,0,0,0,5,Human Factor
1943-02-20 00:00:00,Royal Air Force - RAF,Landing (descent or approach),Military / Government,United Kingdom,Europe,7,7,0,0,0,0,7,Human Factor
1943-02-21 00:00:00,Royal Air Force - RAF,Landing (descent or approach),Operational,United Kingdom,Europe,0,0,0,0,0,0,0,Unknown
1943-02-24 00:00:00,German Air Force - Deutsche Luftwaffe,Flight,Military / Government,Norway,Europe,9,4,0,5,0,0,9,Weather
1943-02-24 00:00:00,United States Army Air Forces - USAAF,Landing (descent or approach),Specialised Services,United States of America,North America,2,2,0,0,0,0,2,Unknown
1943-02-26 00:00:00,Australian National Airways - ANA,Takeoff (climb),Military / Government,Australia,Oceania,0,0,0,0,0,0,0,Technical Failure
1943-02-26 00:00:00,Royal Air Force - RAF,Flight,Operational,Bahamas,Central America,4,4,0,0,0,0,4,Unknown
1943-02-28 00:00:00,Royal Air Force - RAF,Flight,Operational,United Kingdom,Europe,8,8,0,0,0,0,8,Human Factor
1943-02-28 00:00:00,Royal Air Force - RAF,Flight,Operational,United States of America,North America,0,0,0,0,0,0,0,Unknown
1943-03-02 00:00:00,Royal Air Force - RAF,Flight,Military / Government,United Kingdom,Europe,0,0,0,0,0,0,0,Technical Failure
1943-03-07 00:00:00,United States Army Air Forces - USAAF,Landing (descent or approach),Military / Government,United States of America,North America,0,0,0,0,0,0,0,Unknown
1943-03-07 00:00:00,Royal Air Force - RAF,Landing (descent or approach),Military / Government,United Kingdom,Europe,0,0,0,0,0,0,0,Unknown
1943-03-08 00:00:00,United States Army Air Forces - USAAF,Flight,Military / Government,Myanmar,Asia,0,0,0,0,0,0,0,Unknown
1943-03-10 00:00:00,Royal Air Force - RAF,Takeoff (climb),Military / Government,United Kingdom,Europe,7,7,0,0,0,0,7,Unknown
1943-03-11 00:00:00,Royal Australian Air Force - RAAF,Landing (descent or approach),Military / Government,Papua New Guinea,Oceania,3,3,0,0,0,0,3,Unknown
1943-03-15 00:00:00,Royal Australian Air Force - RAAF,,Military / Government,Papua New Guinea,Oceania,0,0,0,0,0,0,0,Unknown
1943-03-17 00:00:00,United States Army Air Forces - USAAF,Takeoff (climb),Military / Government,United States of America,North America,0,0,0,0,0,0,0,Unknown
1943-03-17 00:00:00,United States Army Air Forces - USAAF,,Military / Government,United States of America,North America,0,0,0,0,0,0,0,Human Factor
1943-03-18 00:00:00,Royal Air Force - RAF,Landing (descent or approach),Military / Government,Iceland,Europe,0,0,0,0,0,0,0,Human Factor
1943-03-18 00:00:00,United States Army Air Forces - USAAF,Flight,Military / Government,Australia,Oceania,0,0,0,0,0,0,0,Unknown
1943-03-19 00:00:00,Australian National Airways - ANA,Takeoff (climb),Commercial,Australia,Oceania,15,3,0,12,0,0,15,Technical Failure
1943-03-20 00:00:00,United States Army Air Forces - USAAF,Flight,Military / Government,Solomon Islands,Oceania,0,0,0,0,0,0,0,Unknown
1943-03-20 00:00:00,United States Army Air Forces - USAAF,Flight,Military / Government,Solomon Islands,Oceania,0,0,0,0,0,0,0,Unknown
1943-03-23 00:00:00,United States Navy - USN,Takeoff (climb),Operational,United States of America,North America,8,8,0,0,0,0,8,Weather
1943-03-24 00:00:00,United States Navy - USN,Landing (descent or approach),Military / Government,United States of America,North America,4,4,0,0,0,0,4,Unknown
1943-03-24 00:00:00,United States Navy - USN,Takeoff (climb),Military / Government,Solomon Islands,Oceania,9,9,0,0,0,0,9,Human Factor
1943-03-24 00:00:00,Royal Air Force - RAF,Takeoff (climb),Military / Government,United Kingdom,Europe,7,7,0,0,0,0,7,Technical Failure
1943-03-25 00:00:00,Royal Air Force - RAF,Takeoff (climb),Military / Government,India,Asia,0,0,0,0,0,0,0,Unknown
1943-03-29 00:00:00,Royal Air Force - RAF,Flight,Military / Government,United Kingdom,Europe,10,10,0,0,0,0,10,Technical Failure
1943-03-30 00:00:00,Royal Netherlands East Indies Air Force - ML-KNIL,Flight,Military / Government,Australia,Oceania,5,5,0,0,0,0,5,Terrorism
1943-04-01 00:00:00,United States Army Air Forces - USAAF,Takeoff (climb),Military / Government,United States of America,North America,0,0,0,0,0,0,0,Unknown
1943-04-04 00:00:00,Royal Air Force - RAF,Landing (descent or approach),Military / Government,United Kingdom,Europe,7,7,0,0,0,0,7,Human Factor
1943-04-13 00:00:00,South African Air Force,,Military / Government,Sudan,Africa,0,0,0,0,0,0,0,Unknown
1943-04-14 00:00:00,Royal Air Force - RAF,Landing (descent or approach),Operational,United Kingdom,Europe,4,4,0,0,0,0,4,Technical Failure
1943-04-15 00:00:00,Royal Air Force - RAF,Landing (descent or approach),Operational,United Kingdom,Europe,7,7,0,0,0,0,7,Technical Failure
1943-04-16 00:00:00,United States Army Air Forces - USAAF,Flight,Operational,United States of America,North America,0,0,0,0,0,0,0,Unknown
1943-04-23 00:00:00,United States Army Air Forces - USAAF,Takeoff (climb),Military / Government,India,Asia,0,0,0,0,0,0,0,Unknown
1943-04-26 00:00:00,United States Army Air Forces - USAAF,,Military / Government,United States of America,North America,0,0,0,0,0,0,0,Unknown
1943-04-29 00:00:00,Royal Air Force - RAF,Flight,Operational,United Kingdom,Europe,5,5,0,0,0,0,5,Human Factor
1943-04-29 00:00:00,United States Army Air Forces - USAAF,Flight,Operational,United States of America,North America,22,4,0,18,0,0,22,Technical Failure
1943-05-01 00:00:00,Soviet Air Force - Voyenno-vozdushnye sily CCCP,Takeoff (climb),Military / Government,Russia,Asia,5,5,0,0,0,0,5,Technical Failure
1943-05-01 00:00:00,Royal Air Force - RAF,Landing (descent or approach),Military / Government,United Kingdom,Europe,7,7,0,0,0,0,7,Technical Failure
1943-05-03 00:00:00,United States Army Air Forces - USAAF,Landing (descent or approach),Military / Government,United States of America,North America,0,0,0,0,0,0,0,Technical Failure
1943-05-03 00:00:00,United States Army Air Forces - USAAF,Takeoff (climb),Military / Government,India,Asia,0,0,0,0,0,0,0,Unknown
1943-05-07 00:00:00,United States Army Air Forces - USAAF,Flight,Military / Government,Bahamas,Central America,0,0,0,0,0,0,0,Unknown
1943-05-08 00:00:00,United States Army Air Forces - USAAF,Takeoff (climb),Operational,United States of America,North America,4,4,0,0,0,0,4,Human Factor
1943-05-11 00:00:00,Royal Air Force - RAF,Landing (descent or approach),Military / Government,United Kingdom,Europe,0,0,0,0,0,0,0,Unknown
1943-05-12 00:00:00,United States Army Air Forces - USAAF,Landing (descent or approach),Military / Government,Australia,Oceania,0,0,0,0,0,0,0,Other
1943-05-17 00:00:00,United States Army Air Forces - USAAF,Flight,Military / Government,Netherlands,Europe,6,6,0,0,0,0,6,Unknown
1943-05-17 00:00:00,United States Army Air Forces - USAAF,Flight,Military / Government,Netherlands,Europe,6,6,0,0,0,0,6,Unknown
1943-05-17 00:00:00,Royal Air Force - RAF,Landing (descent or approach),Military / Government,United Kingdom,Europe,3,1,0,2,0,0,3,Unknown
1943-05-17 00:00:00,Royal Air Force - RAF,Takeoff (climb),Military / Government,United Kingdom,Europe,0,0,0,0,0,0,0,Unknown
1943-05-18 00:00:00,United States Navy - USN,Takeoff (climb),Military / Government,United States of America,North America,13,7,0,6,0,0,13,Human Factor
1943-05-19 00:00:00,Royal Air Force - RAF,Takeoff (climb),Military / Government,United Kingdom,Europe,0,0,0,0,0,0,0,Technical Failure
1943-05-20 00:00:00,United States Army Air Forces - USAAF,Flight,Military / Government,Suriname,South America,0,0,0,0,0,0,0,Technical Failure
1943-05-22 00:00:00,Royal Netherlands East Indies Air Force - ML-KNIL,Takeoff (climb),Military / Government,Australia,Oceania,5,5,0,0,0,0,5,Human Factor
1943-05-23 00:00:00,Royal Air Force - RAF,Takeoff (climb),Military / Government,United Kingdom,Europe,0,0,0,0,0,0,0,Technical Failure
1943-05-23 00:00:00,United States Army Air Forces - USAAF,Landing (descent or approach),Military / Government,United States of America,North America,0,0,0,0,0,0,0,Unknown
1943-05-24 00:00:00,Royal Australian Air Force - RAAF,Landing (descent or approach),Military / Government,Australia,Oceania,0,0,0,0,0,0,0,Unknown
1943-05-26 00:00:00,Royal Air Force - RAF,Landing (descent or approach),Military / Government,Algeria,Africa,8,8,0,0,0,0,8,Technical Failure
1943-05-26 00:00:00,Royal Air Force - RAF,Landing (descent or approach),Military / Government,United Kingdom,Europe,0,0,0,0,0,0,0,Unknown
1943-05-26 00:00:00,United States Army Air Forces - USAAF,Flight,Military / Government,Pakistan,Asia,0,0,0,0,0,0,0,Unknown
1943-05-27 00:00:00,Royal Air Force - RAF,Landing (descent or approach),Operational,United Kingdom,Europe,2,2,0,0,0,0,2,Human Factor
1943-05-27 00:00:00,United States Army Air Forces - USAAF,Flight,Military / Government,Ghana,Africa,0,0,0,0,0,0,0,Unknown
1943-05-30 00:00:00,United States Army Air Forces - USAAF,Landing (descent or approach),Military / Government,China,Asia,0,0,0,0,0,0,0,Unknown
1943-05-31 00:00:00,SABENA - Société Anonyme Belge d'Exploitation de la Navigation Aérienne,,Commercial,Democratic Republic of Congo,Africa,0,0,0,0,0,0,0,Unknown
1943-05-31 00:00:00,Royal Air Force - RAF,Takeoff (climb),Operational,United Kingdom,Europe,2,2,0,0,0,0,2,Weather
1943-06-02 00:00:00,Royal Air Force - RAF,Flight,Military / Government,United Kingdom,Europe,0,0,0,0,0,0,0,Unknown
1943-06-05 00:00:00,Royal Air Force - RAF,Landing (descent or approach),Military / Government,Algeria,Africa,8,8,0,0,0,0,8,Technical Failure
1943-06-05 00:00:00,United States Army Air Forces - USAAF,Takeoff (climb),Military / Government,United States of America,North America,0,0,0,0,0,0,0,Technical Failure
1943-06-09 00:00:00,United States Army Air Forces - USAAF,Landing (descent or approach),Operational,Canada,North America,1,1,0,0,0,0,1,Unknown
1943-06-10 00:00:00,United States Army Air Forces - USAAF,Landing (descent or approach),Military / Government,United States of America,North America,0,0,0,0,0,0,0,Unknown
1943-06-11 00:00:00,Royal Air Force - RAF,Flight,Military / Government,World,World,8,8,0,0,0,0,8,Terrorism
1943-06-11 00:00:00,Royal Air Force - RAF,Flight,Operational,United Kingdom,Europe,6,6,0,0,0,0,6,Technical Failure
1943-06-14 00:00:00,Soviet Air Force - Voyenno-vozdushnye sily CCCP,Flight,Military / Government,Russia,Asia,0,0,0,0,0,0,0,Technical Failure
1943-06-18 00:00:00,Royal Air Force - RAF,Landing (descent or approach),Military / Government,Iceland,Europe,0,0,0,0,0,0,0,Technical Failure
1943-06-20 00:00:00,United States Army Air Forces - USAAF,Flight,Military / Government,United States of America,North America,10,10,0,0,0,0,10,Technical Failure
1943-06-22 00:00:00,Royal Air Force - RAF,Flight,Military / Government,Puerto Rico,Central America,0,0,0,0,0,0,0,Unknown
1943-06-22 00:00:00,United States Army Air Forces - USAAF,Takeoff (climb),Military / Government,United States of America,North America,0,0,0,0,0,0,0,Unknown
1943-06-23 00:00:00,Lineas Aéreas Mineras - LAMSA,Takeoff (climb),Commercial,Mexico,Central America,2,1,0,1,0,0,2,Technical Failure
1943-06-26 00:00:00,Aeroflot - Russian International Airlines,Flight,Commercial,Azerbaijan,Asia,7,4,0,3,0,0,7,Technical Failure
1943-06-28 00:00:00,Royal Air Force - RAF,Takeoff (climb),Operational,United Kingdom,Europe,5,5,0,0,0,0,5,Technical Failure
1943-07-02 00:00:00,United States Army Air Forces - USAAF,Flight,Military / Government,Vietnam,Asia,0,0,0,0,0,0,0,Technical Failure
1943-07-08 00:00:00,Royal Air Force - RAF,Landing (descent or approach),Military / Government,United Kingdom,Europe,0,0,0,0,0,0,0,Unknown
1943-07-08 00:00:00,Royal Air Force - RAF,Landing (descent or approach),Military / Government,Libya,Africa,8,8,0,0,0,0,8,Technical Failure
1943-07-10 00:00:00,Royal Air Force - RAF,Flight,Military / Government,Tunisia,Africa,0,0,0,0,0,0,0,Technical Failure
1943-07-16 00:00:00,Royal Australian Air Force - RAAF,Flight,Operational,Australia,Oceania,4,4,0,0,0,0,4,Technical Failure
1943-07-17 00:00:00,United States Navy - USN,Flight,Military / Government,Solomon Islands,Oceania,13,13,0,0,0,0,13,Technical Failure
1943-07-21 00:00:00,Royal Air Force - RAF,Landing (descent or approach),Military / Government,United Kingdom,Europe,2,2,0,0,0,0,2,Unknown
1943-07-23 00:00:00,United States Army Air Forces - USAAF,Landing (descent or approach),Military / Government,United States of America,North America,0,0,0,0,0,0,0,Unknown
1943-07-24 00:00:00,Royal Air Force - RAF,Flight,Operational,United Kingdom,Europe,1,1,0,0,0,0,1,Technical Failure
1943-07-26 00:00:00,Royal Air Force - RAF,Landing (descent or approach),Military / Government,France,Europe,4,4,0,0,0,0,4,Unknown
1943-07-27 00:00:00,Pan American World Airways - PAA,Parking,Commercial,Brazil,South America,0,0,0,0,0,0,0,Human Factor
1943-07-27 00:00:00,Royal Air Force - RAF,Landing (descent or approach),Humanitarian,Algeria,Africa,0,0,0,0,0,0,0,Human Factor
1943-07-30 00:00:00,United States Army Air Forces - USAAF,Landing (descent or approach),Military / Government,United States of America,North America,5,5,0,0,0,0,5,Technical Failure
1943-07-31 00:00:00,Royal Air Force - RAF,Takeoff (climb),Military / Government,Italy,Europe,0,0,0,0,0,0,0,Technical Failure
1943-08-01 00:00:00,United States Army Air Forces - USAAF,Flight,Military / Government,Cyprus,Europe,10,10,0,0,0,0,10,Unknown
1943-08-01 00:00:00,United States Army Air Forces - USAAF,Flight,Military / Government,Bulgaria,Europe,10,10,0,0,0,0,10,Unknown
1943-08-03 00:00:00,United States Army Air Forces - USAAF,Takeoff (climb),Military / Government,China,Asia,0,0,0,0,0,0,0,Technical Failure
1943-08-05 00:00:00,German Air Force - Deutsche Luftwaffe,Flight,Military / Government,Iceland,Europe,7,7,0,0,0,0,7,Terrorism
1943-08-05 00:00:00,Royal Air Force - RAF,Flight,Operational,United Kingdom,Europe,6,6,0,0,0,0,6,Unknown
1943-08-06 00:00:00,Aero Clube de Moçambique,Flight,Operational,Mozambique,Africa,1,1,0,0,0,0,1,Unknown
1943-08-09 00:00:00,Royal Air Force - RAF,Flight,Operational,United Kingdom,Europe,5,5,0,0,0,0,5,Weather
1943-08-13 00:00:00,United States Army Air Forces - USAAF,Flight,Military / Government,Switzerland,Europe,10,10,0,0,0,0,10,Unknown
1943-08-18 00:00:00,Australian National Airways - ANA,Landing (descent or approach),Commercial,Australia,Oceania,4,1,0,3,0,0,4,Unknown
1943-08-19 00:00:00,United States Army Air Forces - USAAF,Flight,Operational,China,Asia,4,4,0,0,0,0,4,Technical Failure
1943-08-21 00:00:00,Aeroflot - Russian International Airlines,Flight,Military / Government,Ukraine,Europe,0,0,0,0,0,0,0,Unknown
1943-08-21 00:00:00,United States Army Air Forces - USAAF,Takeoff (climb),Military / Government,United States of America,North America,0,0,0,0,0,0,0,Unknown
1943-08-21 00:00:00,United States Army Air Forces - USAAF,Takeoff (climb),Military / Government,United States of America,North America,0,0,0,0,0,0,0,Unknown
1943-08-23 00:00:00,Royal Air Force - RAF,Flight,Operational,United Kingdom,Europe,5,5,0,0,0,0,5,Human Factor
1943-08-23 00:00:00,Royal Canadian Air Force - RCAF,Flight,Operational,World,World,3,3,0,0,0,0,3,Technical Failure
1943-08-25 00:00:00,Royal Netherlands Navy - Marineluchtvaartdienst,Flight,Military / Government,South Africa,Africa,0,0,0,0,0,0,0,Technical Failure
1943-08-28 00:00:00,United States Army Air Forces - USAAF,Takeoff (climb),Military / Government,Papua New Guinea,Oceania,10,10,0,0,0,0,10,Technical Failure
1943-08-31 00:00:00,Royal Air Force - RAF,Landing (descent or approach),Military / Government,United Kingdom,Europe,4,4,0,0,0,0,4,Unknown
1943-09-02 00:00:00,Royal Air Force - RAF,Flight,Military / Government,World,World,0,0,0,0,0,0,0,Terrorism
1943-09-07 00:00:00,United States Army Air Forces - USAAF,Flight,Military / Government,China,Asia,0,0,0,0,0,0,0,Technical Failure
1943-09-08 00:00:00,United States Army Air Forces - USAAF,Takeoff (climb),Military / Government,Papua New Guinea,Oceania,0,0,0,0,0,0,0,Unknown
1943-09-09 00:00:00,Royal Air Force - RAF,Flight,Military / Government,United Kingdom,Europe,2,2,0,0,0,0,2,Weather
1943-09-09 00:00:00,Royal Netherlands East Indies Air Force - ML-KNIL,Landing (descent or approach),Military / Government,Australia,Oceania,8,8,0,0,0,0,8,Technical Failure
1943-09-13 00:00:00,Royal Air Force - RAF,Takeoff (climb),Military / Government,United Kingdom,Europe,0,0,0,0,0,0,0,Unknown
1943-09-14 00:00:00,United States Army Air Forces - USAAF,Takeoff (climb),Military / Government,India,Asia,0,0,0,0,0,0,0,Unknown
1943-09-15 00:00:00,United States Army Air Forces - USAAF,Flight,Military / Government,Myanmar,Asia,0,0,0,0,0,0,0,Technical Failure
1943-09-15 00:00:00,American Airlines,Takeoff (climb),Operational,United States of America,North America,2,2,0,0,0,0,2,Unknown
1943-09-16 00:00:00,United States Army Air Forces - USAAF,Flight,Operational,China,Asia,3,3,0,0,0,0,3,Technical Failure
1943-09-16 00:00:00,United States Army Air Forces - USAAF,Flight,Operational,United States of America,North America,10,10,0,0,0,0,10,Technical Failure
1943-09-16 00:00:00,Portuguese Air Force - Aeronáutica Militar,Landing (descent or approach),Military / Government,Portugal,Europe,0,0,0,0,0,0,0,Technical Failure
1943-09-16 00:00:00,Royal Air Force - RAF,Flight,Operational,United Kingdom,Europe,0,0,0,0,0,0,0,Unknown
1943-09-16 00:00:00,Portuguese Air Force - Aeronáutica Militar,Landing (descent or approach),Military / Government,Portugal,Europe,0,0,0,0,0,0,0,Technical Failure
1943-09-21 00:00:00,United States Army Air Forces - USAAF,Takeoff (climb),Operational,India,Asia,3,3,0,0,0,0,3,Unknown
1943-09-25 00:00:00,Royal Air Force - RAF,Flight,Military / Government,Italy,Europe,2,2,0,0,0,0,2,Unknown
1943-09-27 00:00:00,Royal Air Force - RAF,Landing (descent or approach),Military / Government,Tunisia,Africa,0,0,0,0,0,0,0,Terrorism
1943-09-27 00:00:00,United States Army Air Forces - USAAF,Flight,Military / Government,United States of America,North America,1,1,0,0,0,0,1,Technical Failure
1943-09-28 00:00:00,United States Navy - USN,Landing (descent or approach),Military / Government,United States of America,North America,7,7,0,0,0,0,7,Weather
1943-10-03 00:00:00,Royal Air Force - RAF,Flight,Military / Government,United Kingdom,Europe,3,3,0,0,0,0,3,Human Factor
1943-10-05 00:00:00,United States Army Air Forces - USAAF,Takeoff (climb),Military / Government,United States of America,North America,0,0,0,0,0,0,0,Unknown
1943-10-06 00:00:00,China National Aviation Corporation - CNAC,Landing (descent or approach),Operational,China,Asia,2,2,0,0,0,0,2,Technical Failure
1943-10-15 00:00:00,Royal Air Force - RAF,Landing (descent or approach),Military / Government,United Kingdom,Europe,0,0,0,0,0,0,0,Unknown
1943-10-16 00:00:00,China National Aviation Corporation - CNAC,Takeoff (climb),Operational,China,Asia,2,2,0,0,0,0,2,Technical Failure
1943-10-18 00:00:00,Royal Netherlands East Indies Air Force - ML-KNIL,Landing (descent or approach),Military / Government,Australia,Oceania,0,0,0,0,0,0,0,Human Factor
1943-10-22 00:00:00,Royal Air Force - RAF,Landing (descent or approach),Operational,United Kingdom,Europe,5,5,0,0,0,0,5,Technical Failure
1943-10-25 00:00:00,United States Army Air Forces - USAAF,Landing (descent or approach),Military / Government,Australia,Oceania,0,0,0,0,0,0,0,Technical Failure
1943-10-25 00:00:00,Royal Air Force - RAF,Flight,Military / Government,Portugal,Europe,0,0,0,0,0,0,0,Unknown
1943-10-30 00:00:00,Royal Air Force - RAF,Flight,Military / Government,Ghana,Africa,0,0,0,0,0,0,0,Unknown
1943-11-04 00:00:00,Trans-Canada Air Lines - TCAL,Takeoff (climb),Commercial,Canada,North America,0,0,0,0,0,0,0,Technical Failure
1943-11-07 00:00:00,United States Army Air Forces - USAAF,Flight,Operational,Myanmar,Asia,5,5,0,0,0,0,5,Unknown
1943-11-13 00:00:00,United States Army Air Forces - USAAF,Takeoff (climb),Specialised Services,United States of America,North America,4,4,0,0,0,0,4,Other
1943-11-16 00:00:00,United States Army Air Forces - USAAF,Flight,Operational,China,Asia,4,4,0,0,0,0,4,Technical Failure
1943-11-18 00:00:00,United States Army Air Forces - USAAF,,Military / Government,China,Asia,0,0,0,0,0,0,0,Unknown
1943-11-19 00:00:00,British Overseas Airways Corporation - BOAC,,Commercial,Egypt,Africa,0,0,0,0,0,0,0,Unknown
1943-11-19 00:00:00,United States Army Air Forces - USAAF,Flight,Military / Government,United States of America,North America,4,1,0,3,0,0,4,Unknown
1943-11-22 00:00:00,Royal Air Force - RAF,Takeoff (climb),Military / Government,United Kingdom,Europe,7,7,0,0,0,0,7,Technical Failure
1943-11-25 00:00:00,Royal Air Force - RAF,Flight,Operational,United Kingdom,Europe,2,2,0,0,0,0,2,Unknown
1943-11-26 00:00:00,Royal Air Force - RAF,Takeoff (climb),Military / Government,United Kingdom,Europe,4,1,0,3,0,0,4,Weather
1943-11-27 00:00:00,Southern Rhodesia Air Services,Takeoff (climb),Commercial,Zimbabwe,Africa,6,1,0,5,0,0,6,Unknown
1943-11-27 00:00:00,United States Army Air Forces - USAAF,Flight,Military / Government,India,Asia,0,0,0,0,0,0,0,Technical Failure
1943-11-29 00:00:00,Royal Air Force - RAF,Landing (descent or approach),Military / Government,United Kingdom,Europe,10,10,0,0,0,0,10,Unknown
1943-11-30 00:00:00,Royal Air Force - RAF,Flight,Operational,United Kingdom,Europe,4,4,0,0,0,0,4,Human Factor
1943-12-01 00:00:00,United States Army Air Forces - USAAF,Landing (descent or approach),Military / Government,Papua New Guinea,Oceania,4,4,0,0,0,0,4,Technical Failure
1943-12-01 00:00:00,Royal Australian Air Force - RAAF,Landing (descent or approach),Operational,Australia,Oceania,4,4,0,0,0,0,4,Unknown
1943-12-01 00:00:00,United States Army Air Forces - USAAF,Landing (descent or approach),Military / Government,Australia,Oceania,0,0,0,0,0,0,0,Unknown
1943-12-02 00:00:00,United States Army Air Forces - USAAF,Takeoff (climb),Military / Government,China,Asia,0,0,0,0,0,0,0,Unknown
1943-12-03 00:00:00,United States Army Air Forces - USAAF,Flight,Military / Government,United Kingdom,Europe,0,0,0,0,0,0,0,Unknown
1943-12-04 00:00:00,Royal Air Force - RAF,Takeoff (climb),Military / Government,Portugal,Europe,8,8,0,0,0,0,8,Unknown
1943-12-08 00:00:00,United States Army Air Forces - USAAF,Flight,Military / Government,Papua New Guinea,Oceania,4,4,0,0,0,0,4,Technical Failure
1943-12-09 00:00:00,Royal Air Force - RAF,Flight,Military / Government,United Kingdom,Europe,2,2,0,0,0,0,2,Technical Failure
1943-12-09 00:00:00,Royal Netherlands Navy - Marineluchtvaartdienst,Flight,Military / Government,World,World,11,11,0,0,0,0,11,Technical Failure
1943-12-10 00:00:00,United States Army Air Forces - USAAF,Flight,Military / Government,Myanmar,Asia,0,0,0,0,0,0,0,Terrorism
1943-12-13 00:00:00,United States Army Air Forces - USAAF,Flight,Military / Government,Canada,North America,1,1,0,0,0,0,1,Technical Failure
1943-12-14 00:00:00,Royal Australian Air Force - RAAF,Flight,Military / Government,Australia,Oceania,14,3,0,11,0,0,14,Other
1943-12-16 00:00:00,United States Army Air Forces - USAAF,Flight,Military / Government,India,Asia,0,0,0,0,0,0,0,Unknown
1943-12-18 00:00:00,United States Navy - USN,Flight,Military / Government,United Kingdom,Europe,10,10,0,0,0,0,10,Weather
1943-12-18 00:00:00,United States Navy - USN,Flight,Military / Government,United Kingdom,Europe,10,10,0,0,0,0,10,Weather
1943-12-21 00:00:00,Royal Air Force - RAF,Flight,Military / Government,Portugal,Europe,10,10,0,0,0,0,10,Unknown
1943-12-22 00:00:00,Royal Air Force - RAF,Takeoff (climb),Operational,United Kingdom,Europe,7,7,0,0,0,0,7,Other
1943-12-24 00:00:00,Royal Air Force - RAF,Flight,Operational,United Kingdom,Europe,1,1,0,0,0,0,1,Human Factor
1943-12-27 00:00:00,Royal Air Force - RAF,Takeoff (climb),Military / Government,Canada,North America,0,0,0,0,0,0,0,Unknown
1943-12-29 00:00:00,United States Army Air Forces - USAAF,Takeoff (climb),Military / Government,Italy,Europe,0,0,0,0,0,0,0,Unknown
1943-12-31 00:00:00,German Air Force - Deutsche Luftwaffe,Flight,Military / Government,Germany,Europe,0,0,0,0,0,0,0,Unknown
1944-01-01 00:00:00,United States Army Air Forces - USAAF,Flight,Operational,China,Asia,4,4,0,0,0,0,4,Technical Failure
1944-01-01 00:00:00,United States Army Air Forces - USAAF,Flight,Military / Government,India,Asia,0,0,0,0,0,0,0,Technical Failure
1944-01-09 00:00:00,United States Army Air Forces - USAAF,Flight,Military / Government,United States of America,North America,8,8,0,0,0,0,8,Technical Failure
1944-01-11 00:00:00,United States Army Air Forces - USAAF,Landing (descent or approach),Military / Government,Algeria,Africa,0,0,0,0,0,0,0,Unknown
1944-01-12 00:00:00,United States Army Air Forces - USAAF,Flight,Military / Government,China,Asia,10,10,0,0,0,0,10,Unknown
1944-01-12 00:00:00,United States Army Air Forces - USAAF,Landing (descent or approach),Military / Government,Vanuatu,Oceania,0,0,0,0,0,0,0,Unknown
1944-01-13 00:00:00,United States Army Air Forces - USAAF,Flight,Military / Government,United Kingdom,Europe,9,9,0,0,0,0,9,Technical Failure
1944-01-13 00:00:00,United States Army Air Forces - USAAF,Flight,Operational,Vietnam,Asia,5,5,0,0,0,0,5,Technical Failure
1944-01-15 00:00:00,United States Navy - USN,Landing (descent or approach),Operational,United States of America,North America,4,4,0,0,0,0,4,Unknown
1944-01-18 00:00:00,Qantas Airways - Queensland and Northern Territory Aerial Services,Landing (descent or approach),Operational,Australia,Oceania,2,2,0,0,0,0,2,Unknown
1944-01-18 00:00:00,United States Army Air Forces - USAAF,Landing (descent or approach),Military / Government,India,Asia,0,0,0,0,0,0,0,Unknown
1944-01-19 00:00:00,United States Navy - USN,Landing (descent or approach),Operational,United States of America,North America,0,0,0,0,0,0,0,Unknown
1944-01-22 00:00:00,United States Army Air Forces - USAAF,Takeoff (climb),Military / Government,Italy,Europe,0,0,0,0,0,0,0,Unknown
1944-01-26 00:00:00,Deutsche Lufthansa,Flight,Commercial,Poland,Europe,0,0,0,0,0,0,0,Technical Failure
1944-01-26 00:00:00,Australian National Airways - ANA,Flight,Commercial,Australia,Oceania,6,2,0,4,0,0,6,Unknown
1944-01-27 00:00:00,United States Army Air Forces - USAAF,Takeoff (climb),Military / Government,Ghana,Africa,0,0,0,0,0,0,0,Unknown
1944-01-30 00:00:00,United States Army Air Forces - USAAF,Flight,Military / Government,India,Asia,0,0,0,0,0,0,0,Unknown
1944-01-31 00:00:00,United States Army Air Forces - USAAF,Flight,Military / Government,United States of America,North America,0,0,0,0,0,0,0,Unknown
1944-01-31 00:00:00,United States Army Air Forces - USAAF,Flight,Operational,China,Asia,4,4,0,0,0,0,4,Unknown
1944-02-02 00:00:00,United States Navy - USN,Flight,Military / Government,United States of America,North America,0,0,0,0,0,0,0,Unknown
1944-02-02 00:00:00,United States Army Air Forces - USAAF,,Military / Government,India,Asia,0,0,0,0,0,0,0,Unknown
1944-02-03 00:00:00,United States Army Air Forces - USAAF,Flight,Military / Government,India,Asia,0,0,0,0,0,0,0,Unknown
1944-02-03 00:00:00,Royal Air Force - RAF,Landing (descent or approach),Military / Government,France,Europe,0,0,0,0,0,0,0,Unknown
1944-02-07 00:00:00,Royal Australian Air Force - RAAF,Flight,Military / Government,Papua New Guinea,Oceania,10,10,0,0,0,0,10,Other
1944-02-07 00:00:00,United States Army Air Forces - USAAF,,Military / Government,India,Asia,0,0,0,0,0,0,0,Unknown
1944-02-08 00:00:00,Royal Air Force - RAF,Flight,Military / Government,World,World,0,0,0,0,0,0,0,Unknown
1944-02-09 00:00:00,United States Army Air Forces - USAAF,Landing (descent or approach),Military / Government,India,Asia,0,0,0,0,0,0,0,Unknown
1944-02-09 00:00:00,Royal Air Force - RAF,Takeoff (climb),Military / Government,United Kingdom,Europe,0,0,0,0,0,0,0,Weather
1944-02-09 00:00:00,Royal Air Force - RAF,Flight,Military / Government,France,Europe,8,7,0,1,0,0,8,Technical Failure
1944-02-11 00:00:00,Deutsche Lufthansa,Landing (descent or approach),Commercial,Germany,Europe,0,0,0,0,0,0,0,Technical Failure
1944-02-12 00:00:00,United States Navy - USN,Flight,Military / Government,World,World,5,5,0,0,0,0,5,Human Factor
1944-02-13 00:00:00,United States Army Air Forces - USAAF,Takeoff (climb),Military / Government,Australia,Oceania,13,3,0,10,0,0,13,Unknown
1944-02-15 00:00:00,Royal Air Force - RAF,Flight,Military / Government,Denmark,Europe,7,7,0,0,0,0,7,Terrorism
1944-02-17 00:00:00,China National Aviation Corporation - CNAC,Takeoff (climb),Operational,India,Asia,3,3,0,0,0,0,3,Human Factor
1944-02-19 00:00:00,United States Army Air Forces - USAAF,Takeoff (climb),Military / Government,India,Asia,0,0,0,0,0,0,0,Unknown
1944-02-22 00:00:00,United States Army Air Forces - USAAF,Flight,Military / Government,Netherlands,Europe,10,10,0,0,0,0,10,Unknown
1944-02-23 00:00:00,United States Army Air Forces - USAAF,Takeoff (climb),Military / Government,United States of America,North America,0,0,0,0,0,0,0,Unknown
1944-02-25 00:00:00,United States Army Air Forces - USAAF,Flight,Military / Government,United Kingdom,Europe,0,0,0,0,0,0,0,Technical Failure
1944-02-25 00:00:00,Royal Air Force - RAF,Takeoff (climb),Military / Government,United Kingdom,Europe,8,8,0,0,0,0,8,Other
1944-02-27 00:00:00,United States Army Air Forces - USAAF,Landing (descent or approach),Military / Government,United States of America,North America,0,0,0,0,0,0,0,Unknown
1944-02-27 00:00:00,Avianca,Flight,Commercial,Colombia,South America,0,0,0,0,0,0,0,Technical Failure
1944-03-01 00:00:00,Royal Air Force - RAF,Landing (descent or approach),Military / Government,United Kingdom,Europe,2,2,0,0,0,0,2,Weather
1944-03-02 00:00:00,United States Army Air Forces - USAAF,Flight,Military / Government,United Kingdom,Europe,0,0,0,0,0,0,0,Technical Failure
1944-03-02 00:00:00,United States Army Air Forces - USAAF,Flight,Military / Government,China,Asia,0,0,0,0,0,0,0,Technical Failure
1944-03-03 00:00:00,United States Army Air Forces - USAAF,Landing (descent or approach),Military / Government,China,Asia,0,0,0,0,0,0,0,Unknown
1944-03-04 00:00:00,Aeroflot - Russian International Airlines,Landing (descent or approach),Operational,Russia,Asia,5,5,0,0,0,0,5,Human Factor
1944-03-06 00:00:00,United States Army Air Forces - USAAF,Flight,Military / Government,Netherlands,Europe,10,10,0,0,0,0,10,Terrorism
1944-03-06 00:00:00,United States Army Air Forces - USAAF,Flight,Military / Government,Netherlands,Europe,10,10,0,0,0,0,10,Terrorism
1944-03-06 00:00:00,United States Army Air Forces - USAAF,Flight,Military / Government,Netherlands,Europe,10,10,0,0,0,0,10,Terrorism
1944-03-06 00:00:00,United States Army Air Forces - USAAF,Takeoff (climb),Military / Government,India,Asia,0,0,0,0,0,0,0,Unknown
1944-03-07 00:00:00,United States Army Air Forces - USAAF,Flight,Military / Government,Cuba,Central America,3,3,0,0,0,0,3,Unknown
1944-03-07 00:00:00,Royal Air Force - RAF,Taxiing,Military / Government,United Kingdom,Europe,0,0,0,0,0,0,0,Technical Failure
1944-03-07 00:00:00,United States Army Air Forces - USAAF,Landing (descent or approach),Operational,China,Asia,4,4,0,0,0,0,4,Technical Failure
1944-03-08 00:00:00,United States Army Air Forces - USAAF,Flight,Military / Government,United Kingdom,Europe,0,0,0,0,0,0,0,Technical Failure
1944-03-09 00:00:00,United States Army Air Forces - USAAF,Flight,Military / Government,Australia,Oceania,17,3,0,14,0,0,17,Weather
1944-03-10 00:00:00,United States Army Air Forces - USAAF,Flight,Military / Government,Canada,North America,0,0,0,0,0,0,0,Technical Failure
1944-03-11 00:00:00,United States Army Air Forces - USAAF,Landing (descent or approach),Operational,United States of America,North America,3,3,0,0,0,0,3,Unknown
1944-03-11 00:00:00,Superior Oil Corporation,Flight,Business,United States of America,North America,0,0,0,0,0,0,0,Unknown
1944-03-11 00:00:00,United States Army Air Forces - USAAF,Takeoff (climb),Military / Government,Senegal,Africa,0,0,0,0,0,0,0,Unknown
1944-03-12 00:00:00,United States Army Air Forces - USAAF,,Military / Government,India,Asia,0,0,0,0,0,0,0,Unknown
1944-03-14 00:00:00,Royal Air Force - RAF,Takeoff (climb),Military / Government,Egypt,Africa,0,0,0,0,0,0,0,Unknown
1944-03-14 00:00:00,Canadian Pacific Airlines - CP Air,Flight,Commercial,Canada,North America,3,1,0,2,0,0,3,Technical Failure
1944-03-16 00:00:00,Royal Air Force - RAF,Flight,Military / Government,United Kingdom,Europe,7,7,0,0,0,0,7,Terrorism
1944-03-18 00:00:00,Canadian Pacific Airlines - CP Air,Takeoff (climb),Commercial,Canada,North America,0,0,0,0,0,0,0,Unknown
1944-03-22 00:00:00,United States Army Air Forces - USAAF,Flight,Operational,China,Asia,4,4,0,0,0,0,4,Technical Failure
1944-03-22 00:00:00,United States Army Air Forces - USAAF,Landing (descent or approach),Military / Government,United States of America,North America,1,1,0,0,0,0,1,Unknown
1944-03-22 00:00:00,United States Army Air Forces - USAAF,Takeoff (climb),Military / Government,United States of America,North America,0,0,0,0,0,0,0,Unknown
1944-03-23 00:00:00,United States Army Air Forces - USAAF,Flight,Military / Government,Canada,North America,0,0,0,0,0,0,0,Unknown
1944-03-24 00:00:00,Royal Air Force - RAF,Flight,Military / Government,Netherlands,Europe,7,7,0,0,0,0,7,Terrorism
1944-03-24 00:00:00,China National Aviation Corporation - CNAC,Flight,Operational,China,Asia,3,3,0,0,0,0,3,Technical Failure
1944-03-25 00:00:00,SABENA - Société Anonyme Belge d'Exploitation de la Navigation Aérienne,,Commercial,Democratic Republic of Congo,Africa,0,0,0,0,0,0,0,Unknown
1944-03-27 00:00:00,Royal Australian Air Force - RAAF,Flight,Military / Government,Indonesia,Asia,5,5,0,0,0,0,5,Terrorism
1944-03-28 00:00:00,United States Army Air Forces - USAAF,Takeoff (climb),Military / Government,Senegal,Africa,0,0,0,0,0,0,0,Unknown
1944-03-29 00:00:00,United States Army Air Forces - USAAF,Landing (descent or approach),Military / Government,United Kingdom,Europe,5,5,0,0,0,0,5,Technical Failure
1944-04-03 00:00:00,SABENA - Société Anonyme Belge d'Exploitation de la Navigation Aérienne,Flight,Commercial,Democratic Republic of Congo,Africa,0,0,0,0,0,0,0,Unknown
1944-04-03 00:00:00,United States Army Air Forces - USAAF,Landing (descent or approach),Military / Government,Bangladesh,Asia,0,0,0,0,0,0,0,Unknown
1944-04-08 00:00:00,Royal Air Force - RAF,Landing (descent or approach),Military / Government,United Kingdom,Europe,0,0,0,0,0,0,0,Human Factor
1944-04-11 00:00:00,United States Army Air Forces - USAAF,Flight,Military / Government,Germany,Europe,10,10,0,0,0,0,10,Terrorism
1944-04-11 00:00:00,United States Army Air Forces - USAAF,Flight,Military / Government,Sweden,Europe,10,10,0,0,0,0,10,Terrorism
1944-04-11 00:00:00,Aeroflot - Russian International Airlines,Landing (descent or approach),Military / Government,Ukraine,Europe,0,0,0,0,0,0,0,Human Factor
1944-04-11 00:00:00,United States Army Air Forces - USAAF,Flight,Military / Government,Germany,Europe,10,10,0,0,0,0,10,Terrorism
1944-04-14 00:00:00,United States Army Air Forces - USAAF,Landing (descent or approach),Military / Government,United Kingdom,Europe,3,3,0,0,0,0,3,Human Factor
1944-04-14 00:00:00,British Overseas Airways Corporation - BOAC,,Commercial,Egypt,Africa,0,0,0,0,0,0,0,Unknown
1944-04-14 00:00:00,Aeroflot - Russian International Airlines,Flight,Commercial,Belarus,Europe,0,0,0,0,0,0,0,Terrorism
1944-04-15 00:00:00,United States Army Air Forces - USAAF,Flight,Military / Government,World,World,0,0,0,0,0,0,0,Unknown
1944-04-15 00:00:00,Royal Air Force - RAF,Landing (descent or approach),Military / Government,United Kingdom,Europe,0,0,0,0,0,0,0,Human Factor
1944-04-16 00:00:00,United States Army Air Forces - USAAF,Flight,Military / Government,Papua New Guinea,Oceania,6,6,0,0,0,0,6,Technical Failure
1944-04-16 00:00:00,United States Army Air Forces - USAAF,Flight,Military / Government,Papua New Guinea,Oceania,3,3,0,0,0,0,3,Unknown
1944-04-18 00:00:00,United States Army Air Forces - USAAF,Landing (descent or approach),Operational,Egypt,Africa,0,0,0,0,0,0,0,Unknown
1944-04-19 00:00:00,United States Navy - USN,Landing (descent or approach),Military / Government,United States of America,North America,0,0,0,0,0,0,0,Unknown
1944-04-21 00:00:00,United States Army Air Forces - USAAF,Flight,Operational,Pakistan,Asia,0,0,0,0,0,0,0,Weather
1944-04-21 00:00:00,British Overseas Airways Corporation - BOAC,Landing (descent or approach),Commercial,Sweden,Europe,0,0,0,0,0,0,0,Unknown
1944-04-21 00:00:00,Royal Air Force - RAF,Takeoff (climb),Operational,Algeria,Africa,0,0,0,0,0,0,0,Unknown
1944-04-22 00:00:00,Australian National Airways - ANA,Landing (descent or approach),Commercial,Australia,Oceania,0,0,0,0,0,0,0,Unknown
1944-04-22 00:00:00,United States Army Air Forces - USAAF,,Military / Government,Oman,Asia,0,0,0,0,0,0,0,Unknown
1944-04-23 00:00:00,United States Army Air Forces - USAAF,Landing (descent or approach),Operational,China,Asia,4,4,0,0,0,0,4,Unknown
1944-04-25 00:00:00,United States Army Air Forces - USAAF,Landing (descent or approach),Operational,United States of America,North America,3,3,0,0,0,0,3,Unknown
1944-04-26 00:00:00,United States Army Air Forces - USAAF,Taxiing,Military / Government,India,Asia,0,0,0,0,0,0,0,Unknown
1944-04-28 00:00:00,United States Army Air Forces - USAAF,Takeoff (climb),Military / Government,India,Asia,0,0,0,0,0,0,0,Unknown
1944-04-28 00:00:00,Royal Air Force - RAF,Takeoff (climb),Military / Government,Iceland,Europe,0,0,0,0,0,0,0,Unknown
1944-05-06 00:00:00,United States Army Air Forces - USAAF,Flight,Military / Government,France,Europe,8,8,0,0,0,0,8,Terrorism
1944-05-06 00:00:00,Royal Air Force - RAF,Flight,Military / Government,Sri Lanka,Asia,0,0,0,0,0,0,0,Other
1944-05-06 00:00:00,Royal Air Force - RAF,Landing (descent or approach),Military / Government,United Kingdom,Europe,4,4,0,0,0,0,4,Unknown
1944-05-11 00:00:00,United States Army Air Forces - USAAF,Flight,Military / Government,United Kingdom,Europe,8,8,0,0,0,0,8,Terrorism
1944-05-11 00:00:00,Lineas Aéreas Mineras - LAMSA,,Commercial,Mexico,Central America,0,0,0,0,0,0,0,Unknown
1944-05-12 00:00:00,Royal Air Force - RAF,Flight,Operational,United Kingdom,Europe,9,9,0,0,0,0,9,Human Factor
1944-05-12 00:00:00,Royal Air Force - RAF,Landing (descent or approach),Military / Government,United Kingdom,Europe,0,0,0,0,0,0,0,Technical Failure
1944-05-13 00:00:00,United States Army Air Forces - USAAF,Takeoff (climb),Military / Government,Canada,North America,0,0,0,0,0,0,0,Unknown
1944-05-15 00:00:00,United States Army Air Forces - USAAF,Takeoff (climb),Military / Government,United States of America,North America,1,1,0,0,0,0,1,Unknown
1944-05-16 00:00:00,United States Army Air Forces - USAAF,Landing (descent or approach),Military / Government,United Kingdom,Europe,4,4,0,0,0,0,4,Human Factor
1944-05-18 00:00:00,China National Aviation Corporation - CNAC,Landing (descent or approach),Operational,India,Asia,3,3,0,0,0,0,3,Technical Failure
1944-05-20 00:00:00,United States Army Air Forces - USAAF,Landing (descent or approach),Military / Government,Myanmar,Asia,0,0,0,0,0,0,0,Unknown
1944-05-20 00:00:00,China National Aviation Corporation - CNAC,,Commercial,China,Asia,0,0,0,0,0,0,0,Unknown
1944-05-25 00:00:00,Royal Air Force - RAF,Landing (descent or approach),Military / Government,United Kingdom,Europe,0,0,0,0,0,0,0,Unknown
1944-05-26 00:00:00,Royal Air Force - RAF,Landing (descent or approach),Military / Government,United Kingdom,Europe,2,2,0,0,0,0,2,Human Factor
1944-05-31 00:00:00,Royal Australian Air Force - RAAF,Takeoff (climb),Military / Government,Australia,Oceania,3,3,0,0,0,0,3,Technical Failure
1944-06-01 00:00:00,United States Army Air Forces - USAAF,Landing (descent or approach),Military / Government,Myanmar,Asia,0,0,0,0,0,0,0,Unknown
1944-06-02 00:00:00,Morrison-Knudsen Corporation,Flight,Military / Government,United States of America,North America,0,0,0,0,0,0,0,Unknown
1944-06-03 00:00:00,Southern Rhodesia Air Services,,Commercial,Zimbabwe,Africa,0,0,0,0,0,0,0,Unknown
1944-06-03 00:00:00,United States Army Air Forces - USAAF,Takeoff (climb),Military / Government,Oman,Asia,0,0,0,0,0,0,0,Technical Failure
1944-06-04 00:00:00,United States Army Air Forces - USAAF,Takeoff (climb),Military / Government,Bangladesh,Asia,0,0,0,0,0,0,0,Technical Failure
1944-06-05 00:00:00,United States Army Air Forces - USAAF,Landing (descent or approach),Military / Government,United Kingdom,Europe,1,1,0,0,0,0,1,Unknown
1944-06-06 00:00:00,Royal Air Force - RAF,Flight,Military / Government,France,Europe,8,8,0,0,0,0,8,Terrorism
1944-06-06 00:00:00,United States Army Air Forces - USAAF,Flight,Military / Government,World,World,4,4,0,0,0,0,4,Unknown
1944-06-06 00:00:00,United States Army Air Forces - USAAF,Flight,Military / Government,France,Europe,4,4,0,0,0,0,4,Terrorism
1944-06-06 00:00:00,United States Army Air Forces - USAAF,Flight,Military / Government,France,Europe,5,5,0,0,0,0,5,Terrorism
1944-06-07 00:00:00,United States Army Air Forces - USAAF,Flight,Military / Government,France,Europe,7,7,0,0,0,0,7,Unknown
1944-06-07 00:00:00,United States Army Air Forces - USAAF,Flight,Military / Government,World,World,4,4,0,0,0,0,4,Terrorism
1944-06-08 00:00:00,United States Army Air Forces - USAAF,Takeoff (climb),Military / Government,United States of America,North America,0,0,0,0,0,0,0,Unknown
1944-06-10 00:00:00,United States Army Air Forces - USAAF,Flight,Humanitarian,Papua New Guinea,Oceania,21,3,0,18,0,0,21,Technical Failure
1944-06-11 00:00:00,Royal Air Force - RAF,Taxiing,Military / Government,United Kingdom,Europe,0,0,0,0,0,0,0,Unknown
1944-06-14 00:00:00,United States Navy - USN,Landing (descent or approach),Operational,United States of America,North America,0,0,0,0,0,0,0,Unknown
1944-06-15 00:00:00,NKAP - Narodnyy Komissariat Aviatsionnoy Promyshlennosti,Flight,Military / Government,Russia,Asia,0,0,0,0,0,0,0,Unknown
1944-06-17 00:00:00,United States Army Air Forces - USAAF,Flight,Operational,Liberia,Africa,0,0,0,0,0,0,0,Technical Failure
1944-06-20 00:00:00,United States Army Air Forces - USAAF,Flight,Military / Government,United Kingdom,Europe,1,1,0,0,0,0,1,Unknown
1944-06-21 00:00:00,Royal Air Force - RAF,Flight,Military / Government,United Kingdom,Europe,10,10,0,0,0,0,10,Human Factor
1944-06-23 00:00:00,Labrador Mining %26 Exploration Company,Takeoff (climb),Business,Canada,North America,0,0,0,0,0,0,0,Weather
1944-06-25 00:00:00,United States Army Air Forces - USAAF,,Military / Government,India,Asia,0,0,0,0,0,0,0,Unknown
1944-06-29 00:00:00,United States Army Air Forces - USAAF,Flight,Military / Government,Belgium,Europe,10,10,0,0,0,0,10,Unknown
1944-06-30 00:00:00,United States Army Air Forces - USAAF,,Military / Government,Egypt,Africa,0,0,0,0,0,0,0,Unknown
1944-06-30 00:00:00,German Air Force - Deutsche Luftwaffe,Flight,Military / Government,Slovakia,Europe,4,4,0,0,0,0,4,Unknown
1944-06-30 00:00:00,United States Army Air Forces - USAAF,Takeoff (climb),Military / Government,United Kingdom,Europe,0,0,0,0,0,0,0,Unknown
1944-07-05 00:00:00,Royal Air Force - RAF,Landing (descent or approach),Military / Government,United Kingdom,Europe,0,0,0,0,0,0,0,Human Factor
1944-07-15 00:00:00,Aeroflot - Russian International Airlines,Flight,Commercial,Ukraine,Europe,0,0,0,0,0,0,0,Terrorism
1944-07-16 00:00:00,United States Army Air Forces - USAAF,Flight,Military / Government,France,Europe,9,9,0,0,0,0,9,Terrorism
1944-07-16 00:00:00,Aero Clube de Moçambique,Flight,Operational,Mozambique,Africa,2,2,0,0,0,0,2,Unknown
1944-07-17 00:00:00,United States Army Air Forces - USAAF,,Military / Government,China,Asia,0,0,0,0,0,0,0,Unknown
1944-07-18 00:00:00,Royal Air Force - RAF,Flight,Operational,United Kingdom,Europe,5,5,0,0,0,0,5,Technical Failure
1944-07-18 00:00:00,United States Army Air Forces - USAAF,,Military / Government,India,Asia,0,0,0,0,0,0,0,Unknown
1944-07-22 00:00:00,United States Army Air Forces - USAAF,Taxiing,Military / Government,United Kingdom,Europe,0,0,0,0,0,0,0,Unknown
1944-07-25 00:00:00,United States Army Air Forces - USAAF,Landing (descent or approach),Military / Government,India,Asia,0,0,0,0,0,0,0,Unknown
1944-07-26 00:00:00,Royal Air Force - RAF,Landing (descent or approach),Military / Government,United Kingdom,Europe,0,0,0,0,0,0,0,Human Factor
1944-07-26 00:00:00,Royal Air Force - RAF,Takeoff (climb),Military / Government,Portugal,Europe,0,0,0,0,0,0,0,Technical Failure
1944-07-30 00:00:00,United States Army Air Forces - USAAF,Landing (descent or approach),Military / Government,China,Asia,0,0,0,0,0,0,0,Unknown
1944-08-02 00:00:00,Alaska Airlines,Flight,Commercial,United States of America,North America,5,1,0,4,0,0,5,Unknown
1944-08-03 00:00:00,United States Army Air Forces - USAAF,Flight,Military / Government,Austria,Europe,10,10,0,0,0,0,10,Terrorism
1944-08-07 00:00:00,United States Army Air Forces - USAAF,Flight,Military / Government,Iceland,Europe,0,0,0,0,0,0,0,Unknown
1944-08-10 00:00:00,United States Army Air Forces - USAAF,,Military / Government,India,Asia,0,0,0,0,0,0,0,Unknown
1944-08-11 00:00:00,United States Army Air Forces - USAAF,Flight,Military / Government,France,Europe,10,10,0,0,0,0,10,Terrorism
1944-08-11 00:00:00,United States Army Air Forces - USAAF,Takeoff (climb),Military / Government,United Kingdom,Europe,0,0,0,0,0,0,0,Unknown
1944-08-13 00:00:00,United States Army Air Forces - USAAF,Flight,Military / Government,United Kingdom,Europe,0,0,0,0,0,0,0,Technical Failure
1944-08-14 00:00:00,Royal Air Force - RAF,Landing (descent or approach),Operational,United Kingdom,Europe,4,4,0,0,0,0,4,Unknown
1944-08-14 00:00:00,United States Army Air Forces - USAAF,Landing (descent or approach),Military / Government,United Kingdom,Europe,8,1,0,7,0,0,8,Unknown
1944-08-14 00:00:00,Royal Air Force - RAF,Flight,Operational,World,World,0,0,0,0,0,0,0,Technical Failure
1944-08-14 00:00:00,Royal New Zealand Air Force - RNZAF,Flight,Operational,New Zealand,Oceania,4,4,0,0,0,0,4,Unknown
1944-08-15 00:00:00,United States Army Air Forces - USAAF,Flight,Operational,United Kingdom,Europe,6,5,0,1,0,0,6,Technical Failure
1944-08-16 00:00:00,Royal Air Force - RAF,Taxiing,Military / Government,United Kingdom,Europe,0,0,0,0,0,0,0,Unknown
1944-08-18 00:00:00,United States Army Air Forces - USAAF,Taxiing,Military / Government,Morocco,Africa,0,0,0,0,0,0,0,Unknown
1944-08-24 00:00:00,United States Army Air Forces - USAAF,Flight,Military / Government,Myanmar,Asia,0,0,0,0,0,0,0,Technical Failure
1944-08-24 00:00:00,United States Army Air Forces - USAAF,Flight,Military / Government,United Kingdom,Europe,1,1,0,0,0,0,1,Technical Failure
1944-08-25 00:00:00,United States Army Air Forces - USAAF,,Military / Government,Taiwan,Asia,0,0,0,0,0,0,0,Unknown
1944-08-25 00:00:00,United States Army Air Forces - USAAF,,Military / Government,China,Asia,0,0,0,0,0,0,0,Unknown
1944-08-25 00:00:00,Royal Air Force - RAF,Landing (descent or approach),Military / Government,Egypt,Africa,0,0,0,0,0,0,0,Unknown
1944-08-27 00:00:00,United States Navy - USN,Flight,Operational,Brazil,South America,5,5,0,0,0,0,5,Technical Failure
1944-08-28 00:00:00,British Overseas Airways Corporation - BOAC,Flight,Commercial,Morocco,Africa,0,0,0,0,0,0,0,Unknown
1944-08-28 00:00:00,Royal Air Force - RAF,Takeoff (climb),Military / Government,India,Asia,0,0,0,0,0,0,0,Technical Failure
1944-09-01 00:00:00,United States Army Air Forces - USAAF,Landing (descent or approach),Military / Government,Taiwan,Asia,0,0,0,0,0,0,0,Unknown
1944-09-02 00:00:00,United States Army Air Forces - USAAF,Flight,Operational,China,Asia,4,4,0,0,0,0,4,Technical Failure
1944-09-05 00:00:00,United States Army Air Forces - USAAF,Landing (descent or approach),Military / Government,India,Asia,0,0,0,0,0,0,0,Unknown
1944-09-13 00:00:00,Royal Air Force - RAF,Landing (descent or approach),Military / Government,Italy,Europe,8,8,0,0,0,0,8,Terrorism
1944-09-13 00:00:00,Royal Air Force - RAF,Landing (descent or approach),Military / Government,France,Europe,0,0,0,0,0,0,0,Technical Failure
1944-09-17 00:00:00,United States Army Air Forces - USAAF,Flight,Military / Government,Netherlands,Europe,4,4,0,0,0,0,4,Terrorism
1944-09-18 00:00:00,United States Army Air Forces - USAAF,Flight,Military / Government,World,World,4,4,0,0,0,0,4,Terrorism
1944-09-18 00:00:00,United States Army Air Forces - USAAF,Landing (descent or approach),Military / Government,India,Asia,0,0,0,0,0,0,0,Unknown
1944-09-19 00:00:00,United States Army Air Forces - USAAF,Flight,Military / Government,Belgium,Europe,5,5,0,0,0,0,5,Terrorism
1944-09-20 00:00:00,United States Army Air Forces - USAAF,Landing (descent or approach),Military / Government,China,Asia,0,0,0,0,0,0,0,Unknown
1944-09-23 00:00:00,United States Army Air Forces - USAAF,Flight,Military / Government,Netherlands,Europe,4,4,0,0,0,0,4,Terrorism
1944-09-25 00:00:00,United States Army Air Forces - USAAF,Flight,Military / Government,India,Asia,0,0,0,0,0,0,0,Unknown
1944-09-28 00:00:00,United States Army Air Forces - USAAF,Flight,Operational,India,Asia,5,5,0,0,0,0,5,Technical Failure
1944-09-29 00:00:00,United States Army Air Forces - USAAF,Flight,Military / Government,United Kingdom,Europe,1,1,0,0,0,0,1,Unknown
1944-10-09 00:00:00,United States Army Air Forces - USAAF,Flight,Military / Government,China,Asia,4,4,0,0,0,0,4,Technical Failure
1944-10-09 00:00:00,Qantas Airways - Queensland and Northern Territory Aerial Services,Landing (descent or approach),Commercial,Australia,Oceania,0,0,0,0,0,0,0,Unknown
1944-10-10 00:00:00,United States Army Air Forces - USAAF,Flight,Military / Government,China,Asia,0,0,0,0,0,0,0,Human Factor
1944-10-10 00:00:00,United States Army Air Forces - USAAF,Flight,Military / Government,China,Asia,0,0,0,0,0,0,0,Human Factor
1944-10-11 00:00:00,Navegação Aérea Brasileira - NAB,Landing (descent or approach),Commercial,Brazil,South America,0,0,0,0,0,0,0,Unknown
1944-10-11 00:00:00,United States Army Air Forces - USAAF,Flight,Operational,United Kingdom,Europe,2,2,0,0,0,0,2,Human Factor
1944-10-16 00:00:00,United States Army Air Forces - USAAF,,Military / Government,China,Asia,0,0,0,0,0,0,0,Unknown
1944-10-16 00:00:00,United States Army Air Forces - USAAF,Landing (descent or approach),Military / Government,India,Asia,0,0,0,0,0,0,0,Unknown
1944-10-16 00:00:00,Royal Australian Air Force - RAAF,Flight,Operational,New Zealand,Oceania,3,3,0,0,0,0,3,Technical Failure
1944-10-18 00:00:00,United States Army Air Forces - USAAF,Flight,Military / Government,China,Asia,0,0,0,0,0,0,0,Technical Failure
1944-10-18 00:00:00,United States Army Air Forces - USAAF,Flight,Military / Government,United Kingdom,Europe,9,7,0,2,0,0,9,Human Factor
1944-10-18 00:00:00,United States Army Air Forces - USAAF,Flight,Military / Government,United Kingdom,Europe,9,7,0,2,0,0,9,Human Factor
1944-10-19 00:00:00,United States Army Air Forces - USAAF,,Military / Government,China,Asia,0,0,0,0,0,0,0,Unknown
1944-10-19 00:00:00,German Air Force - Deutsche Luftwaffe,Flight,Military / Government,Finland,Europe,3,3,0,0,0,0,3,Terrorism
1944-10-21 00:00:00,United States Army Air Forces - USAAF,,Military / Government,India,Asia,0,0,0,0,0,0,0,Unknown
1944-10-23 00:00:00,United States Army Air Forces - USAAF,Landing (descent or approach),Military / Government,China,Asia,0,0,0,0,0,0,0,Unknown
1944-10-23 00:00:00,German Air Force - Deutsche Luftwaffe,Flight,Military / Government,Finland,Europe,3,3,0,0,0,0,3,Terrorism
1944-10-23 00:00:00,German Air Force - Deutsche Luftwaffe,Flight,Military / Government,Finland,Europe,5,3,0,2,0,0,5,Terrorism
1944-10-24 00:00:00,United States Navy - USN,Flight,Operational,United States of America,North America,4,4,0,0,0,0,4,Technical Failure
1944-10-30 00:00:00,United States Army Air Forces - USAAF,Takeoff (climb),Military / Government,India,Asia,0,0,0,0,0,0,0,Unknown
1944-10-31 00:00:00,United States Army Air Forces - USAAF,Takeoff (climb),Operational,China,Asia,4,4,0,0,0,0,4,Unknown
1944-11-01 00:00:00,United States Army Air Forces - USAAF,Landing (descent or approach),Military / Government,France,Europe,25,3,0,22,0,0,25,Unknown
1944-11-03 00:00:00,Royal Air Force - RAF,Flight,Operational,United Kingdom,Europe,3,3,0,0,0,0,3,Unknown
1944-11-04 00:00:00,United States Army Air Forces - USAAF,,Military / Government,India,Asia,0,0,0,0,0,0,0,Unknown
1944-11-04 00:00:00,United States Army Air Forces - USAAF,,Military / Government,India,Asia,0,0,0,0,0,0,0,Unknown
1944-11-07 00:00:00,United States Army Air Forces - USAAF,Landing (descent or approach),Military / Government,France,Europe,2,1,0,1,0,0,2,Human Factor
1944-11-12 00:00:00,Royal Air Force - RAF,Landing (descent or approach),Military / Government,United Kingdom,Europe,9,9,0,0,0,0,9,Human Factor
1944-11-16 00:00:00,United States Army Air Forces - USAAF,,Military / Government,Libya,Africa,0,0,0,0,0,0,0,Unknown
1944-11-17 00:00:00,Royal Air Force - RAF,Flight,Operational,United Kingdom,Europe,3,3,0,0,0,0,3,Weather
1944-11-18 00:00:00,United States Army Air Forces - USAAF,Landing (descent or approach),Military / Government,China,Asia,0,0,0,0,0,0,0,Unknown
1944-11-18 00:00:00,United States Army Air Forces - USAAF,Takeoff (climb),Military / Government,China,Asia,0,0,0,0,0,0,0,Unknown
1944-11-20 00:00:00,United States Army Air Forces - USAAF,Flight,Military / Government,China,Asia,0,0,0,0,0,0,0,Terrorism
1944-11-23 00:00:00,United States Army Air Forces - USAAF,Landing (descent or approach),Military / Government,Nigeria,Africa,0,0,0,0,0,0,0,Unknown
1944-11-23 00:00:00,United States Army Air Forces - USAAF,Takeoff (climb),Military / Government,India,Asia,0,0,0,0,0,0,0,Technical Failure
1944-11-24 00:00:00,China National Aviation Corporation - CNAC,Landing (descent or approach),Operational,China,Asia,3,3,0,0,0,0,3,Human Factor
1944-11-25 00:00:00,United States Army Air Forces - USAAF,,Military / Government,China,Asia,0,0,0,0,0,0,0,Unknown
1944-11-25 00:00:00,Royal Air Force - RAF,Landing (descent or approach),Military / Government,United Kingdom,Europe,0,0,0,0,0,0,0,Technical Failure
1944-11-26 00:00:00,United States Army Air Forces - USAAF,Takeoff (climb),Military / Government,Yemen,Asia,0,0,0,0,0,0,0,Unknown
1944-11-26 00:00:00,United States Army Air Forces - USAAF,Takeoff (climb),Military / Government,Marshall Islands,Oceania,0,0,0,0,0,0,0,Unknown
1944-11-28 00:00:00,United States Army Air Forces - USAAF,Landing (descent or approach),Military / Government,China,Asia,0,0,0,0,0,0,0,Unknown
1944-12-08 00:00:00,United States Army Air Forces - USAAF,,Military / Government,India,Asia,0,0,0,0,0,0,0,Unknown
1944-12-11 00:00:00,Royal Air Force - RAF,Flight,Operational,United Kingdom,Europe,5,2,0,3,0,0,5,Human Factor
1944-12-15 00:00:00,Royal Air Force - RAF,Takeoff (climb),Operational,Egypt,Africa,4,4,0,0,0,0,4,Other
1944-12-16 00:00:00,United States Army Air Forces - USAAF,Landing (descent or approach),Military / Government,India,Asia,0,0,0,0,0,0,0,Unknown
1944-12-19 00:00:00,Royal Australian Air Force - RAAF,Takeoff (climb),Military / Government,Australia,Oceania,0,0,0,0,0,0,0,Unknown
1944-12-19 00:00:00,United States Army Air Forces - USAAF,Takeoff (climb),Military / Government,India,Asia,0,0,0,0,0,0,0,Technical Failure
1944-12-19 00:00:00,United States Army Air Forces - USAAF,Flight,Military / Government,China,Asia,0,0,0,0,0,0,0,Unknown
1944-12-19 00:00:00,United States Army Air Forces - USAAF,Takeoff (climb),Military / Government,Myanmar,Asia,0,0,0,0,0,0,0,Unknown
1944-12-26 00:00:00,Royal Air Force - RAF,Takeoff (climb),Military / Government,Italy,Europe,0,0,0,0,0,0,0,Weather
1944-12-27 00:00:00,United States Army Air Forces - USAAF,Flight,Military / Government,Belgium,Europe,4,4,0,0,0,0,4,Terrorism
1944-12-27 00:00:00,United States Army Air Forces - USAAF,Flight,Military / Government,Belgium,Europe,5,5,0,0,0,0,5,Terrorism
1944-12-27 00:00:00,United States Army Air Forces - USAAF,Flight,Military / Government,Belgium,Europe,4,4,0,0,0,0,4,Terrorism
1944-12-28 00:00:00,Royal Air Force - RAF,Landing (descent or approach),Military / Government,United Kingdom,Europe,0,0,0,0,0,0,0,Unknown
1944-12-31 00:00:00,Liniile Aeriene Române Exploatate cu Statul - LARES,,Commercial,Romania,Europe,0,0,0,0,0,0,0,Unknown
1945-01-01 00:00:00,Royal Air Force - RAF,Flight,Military / Government,United Kingdom,Europe,8,8,0,0,0,0,8,Human Factor
1945-01-01 00:00:00,Royal Air Force - RAF,Flight,Military / Government,Netherlands,Europe,8,8,0,0,0,0,8,Unknown
1945-01-03 00:00:00,Royal Air Force - RAF,Flight,Military / Government,United Kingdom,Europe,2,2,0,0,0,0,2,Weather
1945-01-06 00:00:00,United States Army Air Forces - USAAF,Flight,Operational,China,Asia,3,3,0,0,0,0,3,Technical Failure
1945-01-08 00:00:00,United States Army Air Forces - USAAF,Flight,Military / Government,China,Asia,0,0,0,0,0,0,0,Technical Failure
1945-01-08 00:00:00,United States Army Air Forces - USAAF,Flight,Military / Government,China,Asia,0,0,0,0,0,0,0,Technical Failure
1945-01-10 00:00:00,United States Army Air Forces - USAAF,Flight,Military / Government,China,Asia,0,0,0,0,0,0,0,Technical Failure
1945-01-15 00:00:00,United States Army Air Forces - USAAF,Landing (descent or approach),Military / Government,China,Asia,0,0,0,0,0,0,0,Unknown
1945-01-19 00:00:00,French Air Force - Armée de l'Air,Takeoff (climb),Operational,France,Europe,5,5,0,0,0,0,5,Technical Failure
1945-01-20 00:00:00,Royal Air Force - RAF,Takeoff (climb),Military / Government,Bangladesh,Asia,0,0,0,0,0,0,0,Technical Failure
1945-01-22 00:00:00,United States Army Air Forces - USAAF,Flight,Military / Government,Senegal,Africa,1,1,0,0,0,0,1,Technical Failure
1945-01-22 00:00:00,Aeroflot - Russian International Airlines,Landing (descent or approach),Operational,Belarus,Europe,6,5,0,1,0,0,6,Technical Failure
1945-01-22 00:00:00,Royal Air Force - RAF,Landing (descent or approach),Military / Government,United Kingdom,Europe,0,0,0,0,0,0,0,Unknown
1945-01-22 00:00:00,United States Army Air Forces - USAAF,Takeoff (climb),Military / Government,Morocco,Africa,0,0,0,0,0,0,0,Unknown
1945-01-26 00:00:00,Royal Australian Air Force - RAAF,Takeoff (climb),Military / Government,Indonesia,Asia,0,0,0,0,0,0,0,Technical Failure
1945-02-02 00:00:00,Royal Air Force - RAF,Landing (descent or approach),Military / Government,United Kingdom,Europe,8,8,0,0,0,0,8,Technical Failure
1945-02-03 00:00:00,Canadian Pacific Airlines - CP Air,Landing (descent or approach),Commercial,Canada,North America,0,0,0,0,0,0,0,Other
1945-02-08 00:00:00,Royal Air Force - RAF,Landing (descent or approach),Military / Government,Pakistan,Asia,0,0,0,0,0,0,0,Technical Failure
1945-02-08 00:00:00,Royal Canadian Air Force - RCAF,Takeoff (climb),Military / Government,Canada,North America,12,12,0,0,0,0,12,Technical Failure
1945-02-10 00:00:00,United States Army Air Forces - USAAF,Landing (descent or approach),Military / Government,Philippines,Asia,12,4,0,8,0,0,12,Terrorism
1945-02-10 00:00:00,Björkvallsflyg,Flight,Military / Government,Sweden,Europe,1,1,0,0,0,0,1,Weather
1945-02-11 00:00:00,Royal Air Force - RAF,Takeoff (climb),Military / Government,Bosnia and Herzegovina,Europe,0,0,0,0,0,0,0,Unknown
1945-02-13 00:00:00,United States Army Air Forces - USAAF,Flight,Military / Government,China,Asia,0,0,0,0,0,0,0,Technical Failure
1945-02-14 00:00:00,United States Army Air Forces - USAAF,Flight,Military / Government,Myanmar,Asia,0,0,0,0,0,0,0,Unknown
1945-02-16 00:00:00,China National Aviation Corporation - CNAC,Flight,Operational,Myanmar,Asia,3,3,0,0,0,0,3,Human Factor
1945-02-19 00:00:00,Amazonia Comercio e Industria,Flight,Business,Nicaragua,Central America,0,0,0,0,0,0,0,Unknown
1945-02-21 00:00:00,United States Army Air Forces - USAAF,Landing (descent or approach),Military / Government,China,Asia,0,0,0,0,0,0,0,Unknown
1945-02-22 00:00:00,Lineas Aéreas Mexicanas - LAMSA,Landing (descent or approach),Commercial,Mexico,Central America,5,1,0,4,0,0,5,Unknown
1945-02-26 00:00:00,United States Army Air Forces - USAAF,Landing (descent or approach),Military / Government,China,Asia,0,0,0,0,0,0,0,Human Factor
1945-02-27 00:00:00,United States Army Air Forces - USAAF,Flight,Military / Government,China,Asia,0,0,0,0,0,0,0,Technical Failure
1945-02-27 00:00:00,United States Army Air Forces - USAAF,Landing (descent or approach),Military / Government,China,Asia,0,0,0,0,0,0,0,Human Factor
1945-03-02 00:00:00,Royal Air Force - RAF,Landing (descent or approach),Military / Government,United Kingdom,Europe,0,0,0,0,0,0,0,Unknown
1945-03-03 00:00:00,Eldorado Mining %26 Refining Company,Flight,Commercial,Canada,North America,0,0,0,0,0,0,0,Weather
1945-03-04 00:00:00,United States Army Air Forces - USAAF,Landing (descent or approach),Military / Government,United States of America,North America,7,7,0,0,0,0,7,Unknown
1945-03-04 00:00:00,Royal Air Force - RAF,Flight,Operational,United Kingdom,Europe,4,4,0,0,0,0,4,Human Factor
1945-03-05 00:00:00,United States Army Air Forces - USAAF,Takeoff (climb),Military / Government,China,Asia,0,0,0,0,0,0,0,Weather
1945-03-15 00:00:00,Aeroflot - Russian International Airlines,Landing (descent or approach),Operational,Turkmenistan,Asia,7,4,0,3,0,0,7,Human Factor
1945-03-15 00:00:00,United States Army Air Forces - USAAF,Takeoff (climb),Military / Government,Myanmar,Asia,0,0,0,0,0,0,0,Unknown
1945-03-16 00:00:00,United States Army Air Forces - USAAF,Landing (descent or approach),Military / Government,China,Asia,0,0,0,0,0,0,0,Unknown
1945-03-19 00:00:00,Royal Air Force - RAF,Takeoff (climb),Military / Government,Italy,Europe,0,0,0,0,0,0,0,Human Factor
1945-03-19 00:00:00,Royal Air Force - RAF,Flight,Military / Government,World,World,28,4,0,24,0,0,28,Technical Failure
1945-03-19 00:00:00,United States Army Air Forces - USAAF,Flight,Military / Government,China,Asia,4,4,0,0,0,0,4,Technical Failure
1945-03-19 00:00:00,United States Army Air Forces - USAAF,Flight,Military / Government,Myanmar,Asia,0,0,0,0,0,0,0,Unknown
1945-03-19 00:00:00,United States Army Air Forces - USAAF,Takeoff (climb),Military / Government,Bangladesh,Asia,0,0,0,0,0,0,0,Unknown
1945-03-20 00:00:00,Royal Australian Air Force - RAAF,Flight,Military / Government,Australia,Oceania,1,1,0,0,0,0,1,Unknown
1945-03-23 00:00:00,Royal Air Force - RAF,Takeoff (climb),Military / Government,Bangladesh,Asia,0,0,0,0,0,0,0,Technical Failure
1945-03-24 00:00:00,United States Army Air Forces - USAAF,Flight,Military / Government,Myanmar,Asia,0,0,0,0,0,0,0,Technical Failure
1945-03-25 00:00:00,United States Army Air Forces - USAAF,Flight,Military / Government,China,Asia,0,0,0,0,0,0,0,Technical Failure
1945-03-25 00:00:00,Royal Air Force - RAF,Landing (descent or approach),Military / Government,United Kingdom,Europe,0,0,0,0,0,0,0,Technical Failure
1945-03-25 00:00:00,United States Army Air Forces - USAAF,Flight,Military / Government,China,Asia,0,0,0,0,0,0,0,Technical Failure
1945-03-27 00:00:00,United States Army Air Forces - USAAF,Flight,Military / Government,Myanmar,Asia,4,4,0,0,0,0,4,Unknown
1945-03-29 00:00:00,United States Army Air Forces - USAAF,Landing (descent or approach),Military / Government,China,Asia,0,0,0,0,0,0,0,Human Factor
1945-03-31 00:00:00,United States Army Air Forces - USAAF,Landing (descent or approach),Military / Government,China,Asia,0,0,0,0,0,0,0,Unknown
1945-04-03 00:00:00,United States Army Air Forces - USAAF,Takeoff (climb),Military / Government,India,Asia,2,2,0,0,0,0,2,Technical Failure
1945-04-04 00:00:00,United States Army Air Forces - USAAF,Takeoff (climb),Military / Government,China,Asia,0,0,0,0,0,0,0,Unknown
1945-04-06 00:00:00,United States Army Air Forces - USAAF,Flight,Specialised Services,United Kingdom,Europe,5,5,0,0,0,0,5,Unknown
1945-04-08 00:00:00,United States Army Air Forces - USAAF,Flight,Military / Government,India,Asia,2,2,0,0,0,0,2,Technical Failure
1945-04-09 00:00:00,United States Navy - USN,Landing (descent or approach),Military / Government,Japan,Asia,0,0,0,0,0,0,0,Unknown
1945-04-12 00:00:00,Royal Australian Air Force - RAAF,Taxiing,Military / Government,Papua New Guinea,Oceania,15,3,0,12,0,0,15,Technical Failure
1945-04-14 00:00:00,Brazilian Air Force - Força Aérea Brasileira,,Military / Government,Brazil,South America,0,0,0,0,0,0,0,Unknown
1945-04-16 00:00:00,Royal Air Force - RAF,Takeoff (climb),Military / Government,Egypt,Africa,0,0,0,0,0,0,0,Unknown
1945-04-19 00:00:00,Royal Norwegian Air Force - Kongelige Norske Luftforsvaret,Landing (descent or approach),Military / Government,Norway,Europe,0,0,0,0,0,0,0,Unknown
1945-04-20 00:00:00,Royal Canadian Air Force - RCAF,Flight,Military / Government,Canada,North America,4,4,0,0,0,0,4,Technical Failure
1945-04-21 00:00:00,American Export Airlines,Takeoff (climb),Operational,Bermuda,North America,4,4,0,0,0,0,4,Technical Failure
1945-04-23 00:00:00,United States Marine Corps,Flight,Military / Government,China,Asia,0,0,0,0,0,0,0,Unknown
1945-04-26 00:00:00,Polyarnaya Aviatsiya,Flight,Commercial,Russia,Asia,3,3,0,0,0,0,3,Human Factor
1945-04-30 00:00:00,United States Navy - USN,Landing (descent or approach),Military / Government,Guam Island,Asia,0,0,0,0,0,0,0,Technical Failure
1945-05-01 00:00:00,British Overseas Airways Corporation - BOAC,Flight,Commercial,Iraq,Asia,0,0,0,0,0,0,0,Weather
1945-05-01 00:00:00,United States Army Air Forces - USAAF,,Military / Government,United States of America,North America,0,0,0,0,0,0,0,Unknown
1945-05-02 00:00:00,British Overseas Airways Corporation - BOAC,Flight,Commercial,Sweden,Europe,9,3,0,6,0,0,9,Technical Failure
1945-05-07 00:00:00,United States Army Air Forces - USAAF,Flight,Military / Government,Myanmar,Asia,0,0,0,0,0,0,0,Unknown
1945-05-08 00:00:00,German Air Force - Deutsche Luftwaffe,Flight,Military / Government,Norway,Europe,3,3,0,0,0,0,3,Human Factor
1945-05-09 00:00:00,United States Army Air Forces - USAAF,Takeoff (climb),Military / Government,France,Europe,5,5,0,0,0,0,5,Unknown
1945-05-13 00:00:00,Union Airways,Takeoff (climb),Other,New Zealand,Oceania,1,1,0,0,0,0,1,Human Factor
1945-05-14 00:00:00,United States Army Air Forces - USAAF,Takeoff (climb),Military / Government,France,Europe,1,1,0,0,0,0,1,Unknown
1945-05-21 00:00:00,United States Army Air Forces - USAAF,,Military / Government,China,Asia,0,0,0,0,0,0,0,Unknown
1945-05-30 00:00:00,United States Navy - USN,Landing (descent or approach),Military / Government,Italy,Europe,0,0,0,0,0,0,0,Unknown
1945-06-01 00:00:00,Royal Australian Air Force - RAAF,Landing (descent or approach),Military / Government,Australia,Oceania,4,4,0,0,0,0,4,Human Factor
1945-06-01 00:00:00,Cruzeiro do Sul,Flight,Commercial,Brazil,South America,0,0,0,0,0,0,0,Unknown
1945-06-03 00:00:00,United States Army Air Forces - USAAF,Takeoff (climb),Military / Government,Colombia,South America,3,2,0,1,0,0,3,Unknown
1945-06-03 00:00:00,Aerovias Brasil,Flight,Operational,Brazil,South America,4,4,0,0,0,0,4,Technical Failure
1945-06-04 00:00:00,Pan American World Airways - PAA,Takeoff (climb),Commercial,Trinidad and Tobago,Central America,12,3,0,9,0,0,12,Unknown
1945-06-07 00:00:00,Royal Air Force - RAF,Landing (descent or approach),Military / Government,United Kingdom,Europe,0,0,0,0,0,0,0,Unknown
1945-06-10 00:00:00,Royal Australian Air Force - RAAF,Landing (descent or approach),Military / Government,Australia,Oceania,3,3,0,0,0,0,3,Technical Failure
1945-06-12 00:00:00,TACA International Airlines - Transportes Aéreos Centro Americanos,Takeoff (climb),Commercial,Nicaragua,Central America,0,0,0,0,0,0,0,Unknown
1945-06-15 00:00:00,United States Army Air Forces - USAAF,Landing (descent or approach),Military / Government,China,Asia,0,0,0,0,0,0,0,Human Factor
1945-06-16 00:00:00,United States Army Air Forces - USAAF,Landing (descent or approach),Military / Government,China,Asia,0,0,0,0,0,0,0,Unknown
1945-06-18 00:00:00,United States Army Air Forces - USAAF,Takeoff (climb),Military / Government,Belgium,Europe,1,1,0,0,0,0,1,Unknown
1945-06-19 00:00:00,Royal New Zealand Air Force - RNZAF,Takeoff (climb),Operational,New Zealand,Oceania,2,2,0,0,0,0,2,Human Factor
1945-06-22 00:00:00,Royal Air Force - RAF,Landing (descent or approach),Military / Government,United Kingdom,Europe,0,0,0,0,0,0,0,Technical Failure
1945-06-27 00:00:00,Royal Australian Air Force - RAAF,Takeoff (climb),Military / Government,Australia,Oceania,17,3,0,14,0,0,17,Weather
1945-06-27 00:00:00,Royal Air Force - RAF,Takeoff (climb),Operational,United Kingdom,Europe,1,1,0,0,0,0,1,Unknown
1945-06-30 00:00:00,United States Navy - USN,Landing (descent or approach),Military / Government,United States of America,North America,0,0,0,0,0,0,0,Unknown
1945-06-30 00:00:00,United States Army Air Forces - USAAF,Landing (descent or approach),Military / Government,India,Asia,0,0,0,0,0,0,0,Unknown
1945-07-02 00:00:00,United States Army Air Forces - USAAF,Takeoff (climb),Military / Government,France,Europe,1,1,0,0,0,0,1,Unknown
1945-07-04 00:00:00,United States Marine Corps,Takeoff (climb),Military / Government,Guam Island,Asia,0,0,0,0,0,0,0,Unknown
1945-07-06 00:00:00,Royal New Zealand Air Force - RNZAF,Takeoff (climb),Military / Government,Vanuatu,Oceania,0,0,0,0,0,0,0,Unknown
1945-07-09 00:00:00,United States Army Air Forces - USAAF,Landing (descent or approach),Military / Government,Austria,Europe,1,1,0,0,0,0,1,Unknown
1945-07-12 00:00:00,Royal New Zealand Air Force - RNZAF,Flight,Military / Government,Solomon Islands,Oceania,0,0,0,0,0,0,0,Unknown
1945-07-14 00:00:00,United States Army Air Forces - USAAF,Landing (descent or approach),Military / Government,United Kingdom,Europe,1,1,0,0,0,0,1,Unknown
1945-07-16 00:00:00,Royal Air Force - RAF,Takeoff (climb),Military / Government,Pakistan,Asia,4,4,0,0,0,0,4,Technical Failure
1945-07-16 00:00:00,Cuban Air Force - Cuerpo de Aviación del Ejército de Cuba,Landing (descent or approach),Military / Government,United States of America,North America,3,2,0,1,0,0,3,Unknown
1945-07-16 00:00:00,Royal Air Force - RAF,Landing (descent or approach),Operational,United Kingdom,Europe,0,0,0,0,0,0,0,Technical Failure
1945-07-18 00:00:00,Royal Air Force - RAF,Flight,Military / Government,France,Europe,2,2,0,0,0,0,2,Technical Failure
1945-07-21 00:00:00,Royal Air Force - RAF,Flight,Military / Government,Myanmar,Asia,5,5,0,0,0,0,5,Weather
1945-07-21 00:00:00,Royal Air Force - RAF,Takeoff (climb),Military / Government,India,Asia,4,4,0,0,0,0,4,Technical Failure
1945-07-24 00:00:00,United States Army Air Forces - USAAF,Flight,Military / Government,Myanmar,Asia,4,4,0,0,0,0,4,Technical Failure
1945-07-24 00:00:00,Royal Air Force - RAF,Landing (descent or approach),Operational,United Kingdom,Europe,4,4,0,0,0,0,4,Human Factor
1945-07-30 00:00:00,United States Army Air Forces - USAAF,Flight,Military / Government,Myanmar,Asia,0,0,0,0,0,0,0,Unknown
1945-08-05 00:00:00,United States Navy - USN,Flight,Specialised Services,United States of America,North America,10,10,0,0,0,0,10,Technical Failure
1945-08-11 00:00:00,Cruzeiro do Sul,Flight,Commercial,Brazil,South America,0,0,0,0,0,0,0,Unknown
1945-08-14 00:00:00,Royal Air Force - RAF,Landing (descent or approach),Military / Government,United Kingdom,Europe,0,0,0,0,0,0,0,Unknown
1945-08-17 00:00:00,Royal Australian Air Force - RAAF,Landing (descent or approach),Operational,Indonesia,Asia,3,3,0,0,0,0,3,Human Factor
1945-08-18 00:00:00,Canadian Pacific Airlines - CP Air,Landing (descent or approach),Commercial,Canada,North America,4,1,0,3,0,0,4,Unknown
1945-08-25 00:00:00,Royal Air Force - RAF,Landing (descent or approach),Military / Government,United Kingdom,Europe,0,0,0,0,0,0,0,Technical Failure
1945-08-28 00:00:00,French Air Force - Armée de l'Air,Landing (descent or approach),Military / Government,France,Europe,20,4,0,16,0,0,20,Technical Failure
1945-08-30 00:00:00,Royal Australian Air Force - RAAF,Takeoff (climb),Military / Government,Australia,Oceania,0,0,0,0,0,0,0,Human Factor
1945-09-03 00:00:00,United States Army Air Forces - USAAF,Takeoff (climb),Military / Government,Pakistan,Asia,1,1,0,0,0,0,1,Unknown
1945-09-10 00:00:00,United States Army Air Forces - USAAF,Flight,Military / Government,Puerto Rico,Central America,0,0,0,0,0,0,0,Unknown
1945-09-12 00:00:00,Royal Australian Air Force - RAAF,Takeoff (climb),Operational,Papua New Guinea,Oceania,2,2,0,0,0,0,2,Unknown
1945-09-13 00:00:00,Servicio Aéreo Panini,Flight,Commercial,Mexico,Central America,7,1,0,6,0,0,7,Weather
1945-09-13 00:00:00,National Airlines,Landing (descent or approach),Commercial,United States of America,North America,14,3,0,11,0,0,14,Weather
1945-09-15 00:00:00,Royal Air Force - RAF,Takeoff (climb),Military / Government,Myanmar,Asia,0,0,0,0,0,0,0,Technical Failure
1945-09-16 00:00:00,Royal Air Force - RAF,Flight,Military / Government,World,World,0,0,0,0,0,0,0,Technical Failure
1945-09-18 00:00:00,United States Army Air Forces - USAAF,Landing (descent or approach),Operational,United States of America,North America,3,3,0,0,0,0,3,Unknown
1945-09-19 00:00:00,Royal Australian Air Force - RAAF,Flight,Military / Government,World,World,23,3,0,20,0,0,23,Unknown
1945-09-19 00:00:00,Royal Air Force - RAF,Landing (descent or approach),Military / Government,India,Asia,0,0,0,0,0,0,0,Technical Failure
1945-09-25 00:00:00,Royal Air Force - RAF,Flight,Military / Government,Thailand,Asia,0,0,0,0,0,0,0,Technical Failure
1945-09-26 00:00:00,United States Army Air Forces - USAAF,Flight,Military / Government,World,World,0,0,0,0,0,0,0,Unknown
1945-09-27 00:00:00,Royal Air Force - RAF,Takeoff (climb),Operational,Bangladesh,Asia,4,4,0,0,0,0,4,Technical Failure
1945-09-28 00:00:00,Royal Air Force - RAF,Taxiing,Operational,Indonesia,Asia,4,4,0,0,0,0,4,Unknown
1945-09-30 00:00:00,United States Army Air Forces - USAAF,Takeoff (climb),Military / Government,Papua New Guinea,Oceania,0,0,0,0,0,0,0,Unknown
1945-10-01 00:00:00,Royal Air Force - RAF,Takeoff (climb),Operational,Myanmar,Asia,4,4,0,0,0,0,4,Technical Failure
1945-10-02 00:00:00,Royal Air Force - RAF,Takeoff (climb),Military / Government,Canada,North America,0,0,0,0,0,0,0,Weather
1945-10-03 00:00:00,Royal Air Force - RAF,Takeoff (climb),Operational,India,Asia,4,4,0,0,0,0,4,Technical Failure
1945-10-03 00:00:00,Royal Air Force - RAF,Landing (descent or approach),Military / Government,Malaysia,Asia,12,8,0,4,0,0,12,Other
1945-10-07 00:00:00,Royal Air Force - RAF,Takeoff (climb),Military / Government,Norway,Europe,0,0,0,0,0,0,0,Human Factor
1945-10-09 00:00:00,Royal New Zealand Air Force - RNZAF,Landing (descent or approach),Operational,New Zealand,Oceania,2,2,0,0,0,0,2,Unknown
1945-10-09 00:00:00,Royal Air Force - RAF,Takeoff (climb),Military / Government,Libya,Africa,0,0,0,0,0,0,0,Unknown
1945-10-11 00:00:00,National Airlines,Landing (descent or approach),Commercial,United States of America,North America,16,2,0,14,0,0,16,Human Factor
1945-10-11 00:00:00,Royal Air Force - RAF,Landing (descent or approach),Military / Government,United Kingdom,Europe,4,4,0,0,0,0,4,Technical Failure
1945-10-15 00:00:00,Royal Air Force - RAF,Landing (descent or approach),Military / Government,United Kingdom,Europe,0,0,0,0,0,0,0,Technical Failure
1945-10-15 00:00:00,Royal Air Force - RAF,Takeoff (climb),Military / Government,Myanmar,Asia,0,0,0,0,0,0,0,Unknown
1945-10-15 00:00:00,Royal Canadian Air Force - RCAF,Flight,Military / Government,Canada,North America,6,1,0,5,0,0,6,Unknown
1945-10-15 00:00:00,United States Army Air Forces - USAAF,Flight,Military / Government,Germany,Europe,1,1,0,0,0,0,1,Technical Failure
1945-10-16 00:00:00,Royal Air Force - RAF,Takeoff (climb),Military / Government,Myanmar,Asia,0,0,0,0,0,0,0,Unknown
1945-10-17 00:00:00,Royal Air Force - RAF,Landing (descent or approach),Military / Government,United Kingdom,Europe,0,0,0,0,0,0,0,Technical Failure
1945-10-17 00:00:00,Royal Air Force - RAF,Flight,Military / Government,Thailand,Asia,0,0,0,0,0,0,0,Technical Failure
1945-10-17 00:00:00,Royal Air Force - RAF,Landing (descent or approach),Military / Government,United Kingdom,Europe,0,0,0,0,0,0,0,Technical Failure
1945-10-19 00:00:00,Royal Air Force - RAF,Takeoff (climb),Military / Government,Thailand,Asia,0,0,0,0,0,0,0,Technical Failure
1945-10-21 00:00:00,Private Canadian,Takeoff (climb),Business,Canada,North America,0,0,0,0,0,0,0,Unknown
1945-10-24 00:00:00,Royal Air Force - RAF,Takeoff (climb),Military / Government,India,Asia,0,0,0,0,0,0,0,Unknown
1945-10-26 00:00:00,Royal Air Force - RAF,Takeoff (climb),Military / Government,Palestine,Asia,3,3,0,0,0,0,3,Unknown
1945-10-31 00:00:00,Aero Oy,Landing (descent or approach),Commercial,Finland,Europe,14,3,0,11,0,0,14,Human Factor
1945-11-01 00:00:00,Royal Air Force - RAF,Flight,Military / Government,Cambodia,Asia,0,0,0,0,0,0,0,Technical Failure
1945-11-04 00:00:00,Pan American World Airways - PAA,Flight,Commercial,World,World,23,10,0,13,0,0,23,Technical Failure
1945-11-04 00:00:00,Royal Air Force - RAF,Takeoff (climb),Military / Government,Myanmar,Asia,0,0,0,0,0,0,0,Technical Failure
1945-11-05 00:00:00,Linha Aérea Transcontinental Brasileira - LATB,,Commercial,Brazil,South America,0,0,0,0,0,0,0,Unknown
1945-11-15 00:00:00,Royal Navy,Flight,Operational,United Kingdom,Europe,1,1,0,0,0,0,1,Technical Failure
1945-11-15 00:00:00,Polyarnaya Aviatsiya,Landing (descent or approach),Commercial,Russia,Asia,0,0,0,0,0,0,0,Technical Failure
1945-11-16 00:00:00,United States Army Air Forces - USAAF,Flight,Military / Government,France,Europe,1,1,0,0,0,0,1,Unknown
1945-11-17 00:00:00,Royal Canadian Air Force - RCAF,Landing (descent or approach),Military / Government,Austria,Europe,0,0,0,0,0,0,0,Human Factor
1945-11-26 00:00:00,United States Army Air Forces - USAAF,Flight,Military / Government,France,Europe,1,1,0,0,0,0,1,Technical Failure
1945-11-30 00:00:00,United States Navy - USN,Landing (descent or approach),Military / Government,Philippines,Asia,0,0,0,0,0,0,0,Human Factor
1945-12-04 00:00:00,International Airways of Canada,Flight,Commercial,Canada,North America,2,1,0,1,0,0,2,Human Factor
1945-12-10 00:00:00,Royal Air Force - RAF,Taxiing,Military / Government,Sri Lanka,Asia,0,0,0,0,0,0,0,Technical Failure
1945-12-12 00:00:00,Royal Australian Air Force - RAAF,Parking,Military / Government,Indonesia,Asia,0,0,0,0,0,0,0,Technical Failure
1945-12-13 00:00:00,South African Air Force,Flight,Specialised Services,South Africa,Africa,4,4,0,0,0,0,4,Technical Failure
1945-12-14 00:00:00,SABENA - Société Anonyme Belge d'Exploitation de la Navigation Aérienne,Flight,Commercial,Benin,Africa,0,0,0,0,0,0,0,Technical Failure
1945-12-14 00:00:00,United States Army Air Forces - USAAF,Flight,Military / Government,France,Europe,15,3,0,12,0,0,15,Technical Failure
1945-12-15 00:00:00,Royal Air Force - RAF,Flight,Military / Government,Thailand,Asia,0,0,0,0,0,0,0,Human Factor
1945-12-15 00:00:00,United States Army Air Forces - USAAF,Flight,Military / Government,Germany,Europe,1,1,0,0,0,0,1,Unknown
1945-12-16 00:00:00,Royal Air Force - RAF,Takeoff (climb),Military / Government,Indonesia,Asia,0,0,0,0,0,0,0,Unknown
1945-12-17 00:00:00,Det Danske Luftfartselskab - DDL,,Commercial,Denmark,Europe,0,0,0,0,0,0,0,Unknown
1945-12-17 00:00:00,Royal Air Force - RAF,Takeoff (climb),Operational,United Kingdom,Europe,3,3,0,0,0,0,3,Human Factor
1945-12-18 00:00:00,Polyarnaya Aviatsiya,Takeoff (climb),Operational,Russia,Asia,6,6,0,0,0,0,6,Human Factor
1945-12-27 00:00:00,Allied Airways,Takeoff (climb),Commercial,United Kingdom,Europe,6,1,0,5,0,0,6,Technical Failure
1945-12-28 00:00:00,Misrair,,Commercial,Iraq,Asia,0,0,0,0,0,0,0,Unknown
1945-12-28 00:00:00,Royal Air Force - RAF,Flight,Operational,United Kingdom,Europe,3,3,0,0,0,0,3,Human Factor
1945-12-29 00:00:00,Canadian Pacific Airlines - CP Air,Landing (descent or approach),Commercial,Canada,North America,0,0,0,0,0,0,0,Human Factor
1945-12-30 00:00:00,Indian National Airways - INA,Landing (descent or approach),Commercial,India,Asia,6,1,0,5,0,0,6,Unknown
1945-12-31 00:00:00,Royal Air Force - RAF,Landing (descent or approach),Military / Government,United Kingdom,Europe,3,3,0,0,0,0,3,Human Factor
1946-01-01 00:00:00,National Skyway Freight,Flight,Operational,United States of America,North America,8,2,0,6,0,0,8,Weather
1946-01-02 00:00:00,United States Army Air Forces - USAAF,Flight,Military / Government,China,Asia,3,3,0,0,0,0,3,Weather
1946-01-07 00:00:00,United States Marine Corps,Landing (descent or approach),Military / Government,Northern Mariana Islands,Oceania,0,0,0,0,0,0,0,Unknown
1946-01-09 00:00:00,Royal Air Force - RAF,Landing (descent or approach),Military / Government,Indonesia,Asia,0,0,0,0,0,0,0,Unknown
1946-01-14 00:00:00,Golfo y Pacífico Aerotransportes,Flight,Commercial,Mexico,Central America,12,2,0,10,0,0,12,Technical Failure
1946-01-14 00:00:00,Royal Air Force - RAF,Takeoff (climb),Operational,United Kingdom,Europe,3,3,0,0,0,0,3,Human Factor
1946-01-16 00:00:00,United States Army Air Forces - USAAF,Flight,Military / Government,United States of America,North America,0,0,0,0,0,0,0,Technical Failure
1946-01-16 00:00:00,Royal Air Force - RAF,Landing (descent or approach),Military / Government,Canada,North America,0,0,0,0,0,0,0,Unknown
1946-01-17 00:00:00,Royal Air Force - RAF,Landing (descent or approach),Military / Government,Malaysia,Asia,0,0,0,0,0,0,0,Human Factor
1946-01-23 00:00:00,British Overseas Airways Corporation - BOAC,Landing (descent or approach),Commercial,Libya,Africa,0,0,0,0,0,0,0,Unknown
1946-01-24 00:00:00,Royal Air Force - RAF,Flight,Military / Government,India,Asia,0,0,0,0,0,0,0,Technical Failure
1946-01-25 00:00:00,Royal Air Force - RAF,Landing (descent or approach),Military / Government,Myanmar,Asia,0,0,0,0,0,0,0,Technical Failure
1946-01-26 00:00:00,Central Air Transport - China,Flight,Commercial,China,Asia,0,0,0,0,0,0,0,Weather
1946-01-28 00:00:00,Royal Air Force - RAF,Takeoff (climb),Military / Government,United Kingdom,Europe,3,3,0,0,0,0,3,Unknown
1946-01-29 00:00:00,Royal Air Force - RAF,Landing (descent or approach),Military / Government,Ghana,Africa,0,0,0,0,0,0,0,Human Factor
1946-01-30 00:00:00,Det Danske Luftfartselskab - DDL,Landing (descent or approach),Commercial,Denmark,Europe,0,0,0,0,0,0,0,Unknown
1946-01-30 00:00:00,Royal Air Force - RAF,Landing (descent or approach),Military / Government,Indonesia,Asia,0,0,0,0,0,0,0,Unknown
1946-02-02 00:00:00,Air France,Takeoff (climb),Commercial,Madagascar,Africa,0,0,0,0,0,0,0,Unknown
1946-02-02 00:00:00,Aerotransportes del Sureste,,Commercial,Mexico,Central America,0,0,0,0,0,0,0,Unknown
1946-02-04 00:00:00,Air France,Landing (descent or approach),Operational,Spain,Europe,3,3,0,0,0,0,3,Technical Failure
1946-02-05 00:00:00,Cruzeiro do Sul,Landing (descent or approach),Operational,Brazil,South America,2,2,0,0,0,0,2,Unknown
1946-02-07 00:00:00,Royal Air Force - RAF,Flight,Military / Government,Pakistan,Asia,0,0,0,0,0,0,0,Technical Failure
1946-02-10 00:00:00,Royal Air Force - RAF,Landing (descent or approach),Operational,United Kingdom,Europe,5,5,0,0,0,0,5,Technical Failure
1946-02-11 00:00:00,Royal Air Force - RAF,Takeoff (climb),Military / Government,Vietnam,Asia,23,4,0,19,0,0,23,Technical Failure
1946-02-12 00:00:00,Linea Aeropostal Venezolana - LAV,Landing (descent or approach),Commercial,Venezuela,South America,0,0,0,0,0,0,0,Technical Failure
1946-02-15 00:00:00,Royal Australian Air Force - RAAF,Landing (descent or approach),Military / Government,Papua New Guinea,Oceania,4,4,0,0,0,0,4,Unknown
1946-02-18 00:00:00,BWIA - British West Indies Airways,Takeoff (climb),Commercial,Dominican Republic,Central America,9,2,0,7,0,0,9,Unknown
1946-02-20 00:00:00,Aeroflot - Russian International Airlines,Takeoff (climb),Operational,Belarus,Europe,5,5,0,0,0,0,5,Human Factor
1946-02-22 00:00:00,Royal Air Force - RAF,Landing (descent or approach),Military / Government,Indonesia,Asia,0,0,0,0,0,0,0,Unknown
1946-02-22 00:00:00,Royal Air Force - RAF,Takeoff (climb),Operational,Myanmar,Asia,3,3,0,0,0,0,3,Human Factor
1946-02-23 00:00:00,Royal Air Force - RAF,Takeoff (climb),Military / Government,Italy,Europe,4,2,0,2,0,0,4,Technical Failure
1946-02-23 00:00:00,Royal Air Force - RAF,Flight,Military / Government,France,Europe,3,3,0,0,0,0,3,Human Factor
1946-02-25 00:00:00,Royal Australian Air Force - RAAF,Landing (descent or approach),Military / Government,Philippines,Asia,0,0,0,0,0,0,0,Unknown
1946-02-25 00:00:00,Air Carrier Transport,Takeoff (climb),Operational,United States of America,North America,2,2,0,0,0,0,2,Unknown
1946-03-01 00:00:00,TACA International Airlines - Transportes Aéreos Centro Americanos,,Commercial,Colombia,South America,0,0,0,0,0,0,0,Unknown
1946-03-01 00:00:00,Royal Air Force - RAF,Flight,Military / Government,Italy,Europe,0,0,0,0,0,0,0,Technical Failure
1946-03-03 00:00:00,Central Air Transport - China,Flight,Commercial,China,Asia,0,0,0,0,0,0,0,Unknown
1946-03-04 00:00:00,British Overseas Airways Corporation - BOAC,Landing (descent or approach),Commercial,United Kingdom,Europe,20,5,0,15,0,0,20,Human Factor
1946-03-06 00:00:00,Royal Air Force - RAF,Landing (descent or approach),Military / Government,Indonesia,Asia,0,0,0,0,0,0,0,Weather
1946-03-08 00:00:00,Companha Meridional de Transportes Aéreos,Landing (descent or approach),Commercial,Brazil,South America,0,0,0,0,0,0,0,Unknown
1946-03-09 00:00:00,Canadian Pacific Airlines - CP Air,Flight,Commercial,Canada,North America,1,1,0,0,0,0,1,Technical Failure
1946-03-12 00:00:00,Royal Air Force - RAF,Flight,Operational,United Kingdom,Europe,3,3,0,0,0,0,3,Human Factor
1946-03-15 00:00:00,Royal Air Force - RAF,Landing (descent or approach),Military / Government,Myanmar,Asia,0,0,0,0,0,0,0,Technical Failure
1946-03-15 00:00:00,Royal Air Force - RAF,Takeoff (climb),Military / Government,Singapore,Asia,0,0,0,0,0,0,0,Technical Failure
1946-03-18 00:00:00,Royal Air Force - RAF,Flight,Military / Government,Iran,Asia,0,0,0,0,0,0,0,Human Factor
1946-03-22 00:00:00,United States Army Air Forces - USAAF,Takeoff (climb),Military / Government,Bangladesh,Asia,0,0,0,0,0,0,0,Unknown
1946-03-22 00:00:00,Aeroflot - Russian International Airlines,Flight,Commercial,Russia,Asia,0,0,0,0,0,0,0,Human Factor
1946-03-28 00:00:00,Royal Air Force - RAF,Takeoff (climb),Operational,United Kingdom,Europe,3,3,0,0,0,0,3,Unknown
1946-03-29 00:00:00,Trans World Airlines - TWA,Landing (descent or approach),Commercial,United States of America,North America,12,3,0,9,0,0,12,Human Factor
1946-03-29 00:00:00,Royal Canadian Air Force - RCAF,Landing (descent or approach),Military / Government,Canada,North America,0,0,0,0,0,0,0,Unknown
1946-03-31 00:00:00,Central Air Transport - China,Flight,Operational,China,Asia,3,3,0,0,0,0,3,Unknown
1946-04-05 00:00:00,Shell Company of Ecuador,Landing (descent or approach),Business,Ecuador,South America,0,0,0,0,0,0,0,Unknown
1946-04-08 00:00:00,United States Army Air Forces - USAAF,Takeoff (climb),Military / Government,China,Asia,0,0,0,0,0,0,0,Technical Failure
1946-04-08 00:00:00,Royal Air Force - RAF,Landing (descent or approach),Operational,Malta,Europe,2,2,0,0,0,0,2,Unknown
1946-04-11 00:00:00,Royal Air Force - RAF,Takeoff (climb),Operational,United Kingdom,Europe,4,4,0,0,0,0,4,Human Factor
1946-04-11 00:00:00,Iberia - Lineas Aéreas de Espana,,Commercial,Spain,Europe,0,0,0,0,0,0,0,Unknown
1946-04-15 00:00:00,Loftleidir Icelandic Airlines,Landing (descent or approach),Commercial,Iceland,Europe,0,0,0,0,0,0,0,Unknown
1946-04-17 00:00:00,British Overseas Airways Corporation - BOAC,Landing (descent or approach),Commercial,Spain,Europe,13,4,0,9,0,0,13,Technical Failure
1946-04-17 00:00:00,Royal Air Force - RAF,Flight,Military / Government,United Kingdom,Europe,0,0,0,0,0,0,0,Technical Failure
1946-04-20 00:00:00,United States Army Air Forces - USAAF,Landing (descent or approach),Military / Government,Costa Rica,Central America,0,0,0,0,0,0,0,Unknown
1946-04-21 00:00:00,Cruzeiro do Sul,,Commercial,Brazil,South America,0,0,0,0,0,0,0,Unknown
1946-04-21 00:00:00,Linha Aérea Transcontinental Brasileira - LATB,Landing (descent or approach),Commercial,Brazil,South America,0,0,0,0,0,0,0,Unknown
1946-04-21 00:00:00,Royal Air Force - RAF,Landing (descent or approach),Military / Government,China,Asia,0,0,0,0,0,0,0,Unknown
1946-04-22 00:00:00,Royal Air Force - RAF,Landing (descent or approach),Operational,Egypt,Africa,3,3,0,0,0,0,3,Technical Failure
1946-04-23 00:00:00,Vickers-Armstrongs Ltd,Flight,Specialised Services,United Kingdom,Europe,4,4,0,0,0,0,4,Technical Failure
1946-04-28 00:00:00,Royal Air Force - RAF,Landing (descent or approach),Operational,United Kingdom,Europe,5,5,0,0,0,0,5,Human Factor
1946-04-28 00:00:00,Cruzeiro do Sul,Flight,Commercial,Brazil,South America,21,3,0,18,0,0,21,Unknown
1946-04-30 00:00:00,Aeroflot - Russian International Airlines,Takeoff (climb),Commercial,Russia,Asia,0,0,0,0,0,0,0,Technical Failure
1946-05-02 00:00:00,British Overseas Airways Corporation - BOAC,Landing (descent or approach),Commercial,Australia,Oceania,0,0,0,0,0,0,0,Technical Failure
1946-05-04 00:00:00,Royal Air Force - RAF,Landing (descent or approach),Military / Government,India,Asia,0,0,0,0,0,0,0,Human Factor
1946-05-06 00:00:00,United States Army Air Forces - USAAF,Flight,Military / Government,Germany,Europe,0,0,0,0,0,0,0,Unknown
1946-05-07 00:00:00,Royal Air Force - RAF,Landing (descent or approach),Military / Government,Nepal,Asia,16,2,0,14,0,0,16,Human Factor
1946-05-07 00:00:00,Royal Air Force - RAF,Landing (descent or approach),Military / Government,United Kingdom,Europe,0,0,0,0,0,0,0,Human Factor
1946-05-07 00:00:00,United States Army Air Forces - USAAF,Takeoff (climb),Military / Government,Philippines,Asia,0,0,0,0,0,0,0,Unknown
1946-05-15 00:00:00,Shell Company of Ecuador,Landing (descent or approach),Business,Ecuador,South America,0,0,0,0,0,0,0,Unknown
1946-05-16 00:00:00,Ansett Airways Ltd.,Landing (descent or approach),Commercial,Australia,Oceania,12,2,0,10,0,0,12,Weather
1946-05-17 00:00:00,British Overseas Airways Corporation - BOAC,Landing (descent or approach),Commercial,Pakistan,Asia,0,0,0,0,0,0,0,Human Factor
1946-05-23 00:00:00,Royal Air Force - RAF,Landing (descent or approach),Military / Government,Pakistan,Asia,0,0,0,0,0,0,0,Human Factor
1946-05-28 00:00:00,Royal Air Force - RAF,Landing (descent or approach),Operational,United Kingdom,Europe,5,5,0,0,0,0,5,Human Factor
1946-05-28 00:00:00,Royal Air Force - RAF,Flight,Military / Government,Myanmar,Asia,0,0,0,0,0,0,0,Unknown
1946-05-29 00:00:00,United Airlines,Landing (descent or approach),Operational,United States of America,North America,4,4,0,0,0,0,4,Human Factor
1946-05-29 00:00:00,Royal Air Force - RAF,Landing (descent or approach),Military / Government,Indonesia,Asia,0,0,0,0,0,0,0,Technical Failure
1946-05-31 00:00:00,Royal Air Force - RAF,Flight,Operational,Serbia,Europe,3,3,0,0,0,0,3,Technical Failure
1946-06-12 00:00:00,Iberia - Lineas Aéreas de Espana,Takeoff (climb),Commercial,Spain,Europe,26,3,0,23,0,0,26,Technical Failure
1946-06-13 00:00:00,Servicios Aéreos Nacionales - SAN,Flight,Commercial,Mexico,Central America,0,0,0,0,0,0,0,Technical Failure
1946-06-14 00:00:00,Royal Air Force - RAF,Landing (descent or approach),Military / Government,India,Asia,0,0,0,0,0,0,0,Unknown
1946-06-17 00:00:00,MacRobertson Miller Airlines,Takeoff (climb),Operational,Australia,Oceania,3,3,0,0,0,0,3,Unknown
1946-06-18 00:00:00,Aer Lingus,Takeoff (climb),Commercial,Ireland,Europe,19,4,0,15,0,0,19,Technical Failure
1946-06-19 00:00:00,Ontario Provincial Air Service,Takeoff (climb),Commercial,Canada,North America,2,1,0,1,0,0,2,Unknown
1946-06-20 00:00:00,Uscan Engineering,Takeoff (climb),Business,Canada,North America,1,1,0,0,0,0,1,Human Factor
1946-06-20 00:00:00,Royal Air Force - RAF,Landing (descent or approach),Military / Government,Indonesia,Asia,0,0,0,0,0,0,0,Weather
1946-06-23 00:00:00,Norrlandsflyg,Landing (descent or approach),Commercial,Sweden,Europe,2,1,0,1,0,0,2,Unknown
1946-06-25 00:00:00,Mexicana de Aviación,Takeoff (climb),Commercial,Mexico,Central America,47,5,0,42,0,0,47,Technical Failure
1946-06-26 00:00:00,Royal Air Force - RAF,Flight,Military / Government,Pakistan,Asia,0,0,0,0,0,0,0,Human Factor
1946-06-26 00:00:00,Loftleidir Icelandic Airlines,Landing (descent or approach),Commercial,Iceland,Europe,0,0,0,0,0,0,0,Unknown
1946-06-28 00:00:00,East African Airways,Flight,Commercial,Kenya,Africa,8,1,0,7,0,0,8,Technical Failure
1946-07-02 00:00:00,Trans World Airlines - TWA,Takeoff (climb),Commercial,United States of America,North America,21,3,0,18,0,0,21,Technical Failure
1946-07-04 00:00:00,Bristol Aeroplane Company,Flight,Operational,World,World,5,5,0,0,0,0,5,Technical Failure
1946-07-08 00:00:00,British Overseas Airways Corporation - BOAC,Landing (descent or approach),Commercial,United Kingdom,Europe,0,0,0,0,0,0,0,Unknown
1946-07-08 00:00:00,Royal Air Force - RAF,Landing (descent or approach),Military / Government,Bangladesh,Asia,0,0,0,0,0,0,0,Unknown
1946-07-10 00:00:00,Royal Air Force - RAF,Flight,Military / Government,South Sudan,Africa,0,0,0,0,0,0,0,Technical Failure
1946-07-10 00:00:00,United States Marine Corps,Flight,Operational,United States of America,North America,7,7,0,0,0,0,7,Technical Failure
1946-07-12 00:00:00,United States Navy - USN,Takeoff (climb),Operational,United States of America,North America,0,0,0,0,0,0,0,Human Factor
1946-07-12 00:00:00,Royal Air Force - RAF,Flight,Operational,United Kingdom,Europe,6,6,0,0,0,0,6,Human Factor
1946-07-16 00:00:00,United States Army Air Forces - USAAF,Flight,Military / Government,South Korea,Asia,0,0,0,0,0,0,0,Technical Failure
1946-07-17 00:00:00,Royal Air Force - RAF,Landing (descent or approach),Operational,United Kingdom,Europe,5,5,0,0,0,0,5,Technical Failure
1946-07-18 00:00:00,United States Army Air Forces - USAAF,Landing (descent or approach),Operational,United States of America,North America,0,0,0,0,0,0,0,Unknown
1946-07-22 00:00:00,SABENA - Société Anonyme Belge d'Exploitation de la Navigation Aérienne,Landing (descent or approach),Operational,Ireland,Europe,0,0,0,0,0,0,0,Technical Failure
1946-07-30 00:00:00,Royal Air Force - RAF,Landing (descent or approach),Operational,Egypt,Africa,5,2,0,3,0,0,5,Human Factor
1946-08-01 00:00:00,Royal Air Force - RAF,Takeoff (climb),Military / Government,China,Asia,0,0,0,0,0,0,0,Technical Failure
1946-08-05 00:00:00,United States Army Air Forces - USAAF,Flight,Specialised Services,United States of America,North America,4,4,0,0,0,0,4,Technical Failure
1946-08-05 00:00:00,United States Navy - USN,Takeoff (climb),Military / Government,United States of America,North America,0,0,0,0,0,0,0,Unknown
1946-08-08 00:00:00,Trans Caribbean Air Cargo Line,Landing (descent or approach),Commercial,United States of America,North America,23,3,0,20,0,0,23,Human Factor
1946-08-09 00:00:00,United States Army Air Forces - USAAF,Flight,Military / Government,United Kingdom,Europe,0,0,0,0,0,0,0,Technical Failure
1946-08-12 00:00:00,French Air Force - Armée de l'Air,Flight,Commercial,Ireland,Europe,27,4,0,23,0,0,27,Human Factor
1946-08-15 00:00:00,British Overseas Airways Corporation - BOAC,Takeoff (climb),Operational,United Kingdom,Europe,4,4,0,0,0,0,4,Unknown
1946-08-16 00:00:00,United States Navy - USN,Landing (descent or approach),Military / Government,Marshall Islands,Oceania,0,0,0,0,0,0,0,Unknown
1946-08-16 00:00:00,Railway Air Services,Takeoff (climb),Specialised Services,United Kingdom,Europe,2,2,0,0,0,0,2,Unknown
1946-08-16 00:00:00,United States Army Air Forces - USAAF,Landing (descent or approach),Military / Government,Japan,Asia,0,0,0,0,0,0,0,Unknown
1946-08-17 00:00:00,Gold Belt Air Service,Takeoff (climb),Operational,Canada,North America,1,1,0,0,0,0,1,Unknown
1946-08-25 00:00:00,Royal Air Force - RAF,Landing (descent or approach),Military / Government,Canada,North America,7,7,0,0,0,0,7,Technical Failure
1946-08-29 00:00:00,Royal Air Force - RAF,Landing (descent or approach),Military / Government,Greece,Europe,2,2,0,0,0,0,2,Weather
1946-08-30 00:00:00,United States Army Air Forces - USAAF,Landing (descent or approach),Military / Government,Germany,Europe,0,0,0,0,0,0,0,Unknown
1946-08-30 00:00:00,Spinwood Sportland Airways,Takeoff (climb),Business,Canada,North America,2,1,0,1,0,0,2,Human Factor
1946-08-30 00:00:00,British South American Airways - BSAA,Landing (descent or approach),Commercial,Gambia,Africa,6,4,0,2,0,0,6,Unknown
1946-08-31 00:00:00,Mandated Airlines,Takeoff (climb),Commercial,Papua New Guinea,Oceania,6,1,0,5,0,0,6,Human Factor
1946-08-31 00:00:00,Royal Air Force - RAF,Takeoff (climb),Military / Government,United Kingdom,Europe,0,0,0,0,0,0,0,Unknown
1946-09-02 00:00:00,Indian Air Force - Bharatiya Vayu Sena,Takeoff (climb),Military / Government,India,Asia,18,3,0,15,0,0,18,Technical Failure
1946-09-03 00:00:00,United States Army Air Forces - USAAF,Flight,Military / Government,United States of America,North America,0,0,0,0,0,0,0,Unknown
1946-09-04 00:00:00,Det Danske Luftfartselskab - DDL,Landing (descent or approach),Commercial,United Kingdom,Europe,0,0,0,0,0,0,0,Weather
1946-09-05 00:00:00,Royal Air Force - RAF,Landing (descent or approach),Military / Government,Italy,Europe,0,0,0,0,0,0,0,Technical Failure
1946-09-05 00:00:00,Royal Australian Air Force - RAAF,Flight,Operational,Australia,Oceania,5,5,0,0,0,0,5,Technical Failure
1946-09-09 00:00:00,Royal Air Force - RAF,Landing (descent or approach),Military / Government,United Kingdom,Europe,0,0,0,0,0,0,0,Other
1946-09-10 00:00:00,Shell Company of Ecuador,Takeoff (climb),Operational,Ecuador,South America,3,1,0,2,0,0,3,Unknown
1946-09-12 00:00:00,Pennsylvania Central Air Lines,Landing (descent or approach),Operational,United States of America,North America,4,4,0,0,0,0,4,Technical Failure
1946-09-13 00:00:00,United States Army Air Forces - USAAF,Landing (descent or approach),Military / Government,Japan,Asia,0,0,0,0,0,0,0,Unknown
1946-09-16 00:00:00,London Aero %26 Motor Services - LAMS,Landing (descent or approach),Specialised Services,United Kingdom,Europe,4,4,0,0,0,0,4,Human Factor
1946-09-18 00:00:00,Rocky Point Airways,Flight,Operational,Canada,North America,2,1,0,1,0,0,2,Unknown
1946-09-19 00:00:00,Royal Air Force - RAF,Landing (descent or approach),Military / Government,Japan,Asia,0,0,0,0,0,0,0,Technical Failure
1946-09-24 00:00:00,Pan American World Airways - PAA,Landing (descent or approach),Commercial,Ireland,Europe,36,10,0,26,0,0,36,Human Factor
1946-09-25 00:00:00,Royal Air Force - RAF,Landing (descent or approach),Military / Government,Italy,Europe,0,0,0,0,0,0,0,Technical Failure
1946-09-27 00:00:00,Royal Canadian Air Force - RCAF,Flight,Military / Government,Canada,North America,0,0,0,0,0,0,0,Unknown
1946-10-01 00:00:00,Philippine Airlines - PAL,Flight,Commercial,Philippines,Asia,5,3,0,2,0,0,5,Human Factor
1946-10-02 00:00:00,United States Army Air Forces - USAAF,Takeoff (climb),Military / Government,Mexico,Central America,0,0,0,0,0,0,0,Technical Failure
1946-10-03 00:00:00,Southampton Air Services,Takeoff (climb),Commercial,Malta,Europe,16,2,0,14,0,0,16,Unknown
1946-10-04 00:00:00,United States Army Air Forces - USAAF,Flight,Operational,Denmark,Europe,3,3,0,0,0,0,3,Technical Failure
1946-10-04 00:00:00,McAvoy Diamond Drilling %26 Development Company Ltd,Flight,Business,Canada,North America,3,1,0,2,0,0,3,Weather
1946-10-07 00:00:00,United States Navy - USN,Landing (descent or approach),Operational,United States of America,North America,0,0,0,0,0,0,0,Unknown
1946-10-11 00:00:00,Eastern Airlines,Landing (descent or approach),Commercial,United States of America,North America,26,4,0,22,0,0,26,Human Factor
1946-10-12 00:00:00,Trans World Airlines - TWA,Landing (descent or approach),Operational,United States of America,North America,8,8,0,0,0,0,8,Human Factor
1946-10-13 00:00:00,Institut Géographique National,,Other,France,Europe,0,0,0,0,0,0,0,Unknown
1946-10-13 00:00:00,Royal Netherlands Navy - Marineluchtvaartdienst,Landing (descent or approach),Military / Government,Indonesia,Asia,0,0,0,0,0,0,0,Human Factor
1946-10-15 00:00:00,United States Army Air Forces - USAAF,Takeoff (climb),Military / Government,Germany,Europe,0,0,0,0,0,0,0,Unknown
1946-10-16 00:00:00,Far East Air Transport,Flight,Commercial,Philippines,Asia,0,0,0,0,0,0,0,Unknown
1946-10-16 00:00:00,Portsmouth Aviation,Flight,Operational,Zimbabwe,Africa,2,2,0,0,0,0,2,Unknown
1946-10-22 00:00:00,Royal Air Force - RAF,Takeoff (climb),Military / Government,United Kingdom,Europe,0,0,0,0,0,0,0,Unknown
1946-10-22 00:00:00,Panair do Brasil,Takeoff (climb),Commercial,Brazil,South America,0,0,0,0,0,0,0,Unknown
1946-10-29 00:00:00,Air Contractors UK,Takeoff (climb),Operational,Denmark,Europe,2,2,0,0,0,0,2,Technical Failure
1946-10-31 00:00:00,Aeroflot - Russian International Airlines,Landing (descent or approach),Commercial,Turkmenistan,Asia,16,4,0,12,0,0,16,Human Factor
1946-10-31 00:00:00,Westminster Airways,Flight,Other,Zambia,Africa,0,0,0,0,0,0,0,Unknown
1946-11-03 00:00:00,Royal Air Force - RAF,Landing (descent or approach),Military / Government,India,Asia,0,0,0,0,0,0,0,Human Factor
1946-11-06 00:00:00,KLM Royal Dutch Airlines - Koninklijke Luchtvaart Maatschappij,Landing (descent or approach),Commercial,United Kingdom,Europe,20,5,0,15,0,0,20,Human Factor
1946-11-09 00:00:00,CSA Czech Airlines - Československé Státní Aerolinie,Landing (descent or approach),Commercial,Czech Republic,Europe,18,5,0,13,0,0,18,Technical Failure
1946-11-09 00:00:00,Arnold Air Service,Takeoff (climb),Commercial,United States of America,North America,18,2,0,16,0,0,18,Human Factor
1946-11-10 00:00:00,Delta Airlines,Landing (descent or approach),Commercial,United States of America,North America,22,3,0,19,0,0,22,Human Factor
1946-11-12 00:00:00,United States Army Air Forces - USAAF,Takeoff (climb),Military / Government,Argentina,South America,9,9,0,0,0,0,9,Unknown
1946-11-13 00:00:00,Government of Tanganyika,Flight,Operational,Tanzania,Africa,2,2,0,0,0,0,2,Unknown
1946-11-18 00:00:00,British European Airways - BEA,Flight,Commercial,France,Europe,0,0,0,0,0,0,0,Weather
1946-11-19 00:00:00,United States Army Air Forces - USAAF,Flight,Military / Government,Switzerland,Europe,11,4,0,7,0,0,11,Weather
1946-11-19 00:00:00,Royal Air Force - RAF,Flight,Operational,Ireland,Europe,3,3,0,0,0,0,3,Technical Failure
1946-11-22 00:00:00,Royal Air Force - RAF,Landing (descent or approach),Military / Government,United Kingdom,Europe,4,4,0,0,0,0,4,Human Factor
1946-11-22 00:00:00,Interstate Air Services,Landing (descent or approach),Commercial,Papua New Guinea,Oceania,0,0,0,0,0,0,0,Technical Failure
1946-11-28 00:00:00,Royal Air Force - RAF,Takeoff (climb),Operational,United Kingdom,Europe,5,5,0,0,0,0,5,Technical Failure
1946-12-02 00:00:00,Royal Air Force - RAF,Landing (descent or approach),Military / Government,Malta,Europe,0,0,0,0,0,0,0,Human Factor
1946-12-02 00:00:00,Willis Air Service,Landing (descent or approach),Commercial,Puerto Rico,Central America,0,0,0,0,0,0,0,Human Factor
1946-12-09 00:00:00,Canadian Pacific Airlines - CP Air,Landing (descent or approach),Commercial,Canada,North America,0,0,0,0,0,0,0,Unknown
1946-12-13 00:00:00,Polyarnaya Aviatsiya,Flight,Commercial,Russia,Asia,21,4,0,17,0,0,21,Technical Failure
1946-12-17 00:00:00,Royal Air Force - RAF,Flight,Military / Government,Italy,Europe,0,0,0,0,0,0,0,Technical Failure
1946-12-18 00:00:00,United States Army Air Forces - USAAF,Flight,Military / Government,Italy,Europe,0,0,0,0,0,0,0,Technical Failure
1946-12-19 00:00:00,Railway Air Services,Takeoff (climb),Commercial,United Kingdom,Europe,5,4,0,1,0,0,5,Human Factor
1946-12-20 00:00:00,Royal Norwegian Air Force - Kongelige Norske Luftforsvaret,Flight,Operational,Norway,Europe,5,5,0,0,0,0,5,Technical Failure
1946-12-22 00:00:00,French Air Force - Armée de l'Air,Takeoff (climb),Military / Government,France,Europe,9,6,0,3,0,0,9,Technical Failure
1946-12-23 00:00:00,Canadian Pacific Airlines - CP Air,Flight,Commercial,Canada,North America,7,1,0,6,0,0,7,Technical Failure
1946-12-23 00:00:00,British Overseas Airways Corporation - BOAC,Takeoff (climb),Commercial,Malta,Europe,0,0,0,0,0,0,0,Unknown
1946-12-23 00:00:00,Atlas Aviation,Flight,Commercial,France,Europe,9,2,0,7,0,0,9,Technical Failure
1946-12-24 00:00:00,CSA Czech Airlines - Československé Státní Aerolinie,Landing (descent or approach),Commercial,France,Europe,15,5,0,10,0,0,15,Unknown
1946-12-24 00:00:00,United Airlines,Landing (descent or approach),Commercial,United States of America,North America,45,4,0,41,0,0,45,Human Factor
1946-12-24 00:00:00,Airways Individual Reservations,Flight,Commercial,United Kingdom,Europe,0,0,0,0,0,0,0,Unknown
1946-12-31 00:00:00,Intercontinental Air Transport,Landing (descent or approach),Operational,United States of America,North America,5,5,0,0,0,0,5,Human Factor
1946-12-31 00:00:00,Lineas Aéreas Mexicanas - LAMSA,,Commercial,Mexico,Central America,0,0,0,0,0,0,0,Unknown
1946-12-31 00:00:00,TACA International Airlines - Transportes Aéreos Centro Americanos,Landing (descent or approach),Operational,Nicaragua,Central America,3,3,0,0,0,0,3,Unknown
1947-01-01 00:00:00,Private American,Landing (descent or approach),Business,United States of America,North America,16,3,0,13,0,0,16,Unknown
1947-01-02 00:00:00,Canadian Airways,Takeoff (climb),Commercial,Canada,North America,0,0,0,0,0,0,0,Other
1947-01-03 00:00:00,United States Army Air Forces - USAAF,Flight,Military / Government,United Kingdom,Europe,5,5,0,0,0,0,5,Technical Failure
1947-01-03 00:00:00,British Overseas Airways Corporation - BOAC,Landing (descent or approach),Operational,United Kingdom,Europe,3,3,0,0,0,0,3,Unknown
1947-01-05 00:00:00,American Airlines,Flight,Commercial,United States of America,North America,16,3,0,13,0,0,16,Technical Failure
1947-01-06 00:00:00,Transports Aériens Intercontinentaux - TAI,Flight,Operational,France,Europe,3,3,0,0,0,0,3,Weather
1947-01-06 00:00:00,Air Transport - Belgium,Landing (descent or approach),Other,South Sudan,Africa,0,0,0,0,0,0,0,Unknown
1947-01-06 00:00:00,Northwest Airlines,Landing (descent or approach),Commercial,United States of America,North America,41,4,0,37,0,0,41,Human Factor
1947-01-07 00:00:00,SABENA - Société Anonyme Belge d'Exploitation de la Navigation Aérienne,,Commercial,Democratic Republic of Congo,Africa,0,0,0,0,0,0,0,Unknown
1947-01-08 00:00:00,Caribbean Atlantic Airlines,Landing (descent or approach),Commercial,United States of America,North America,15,3,0,12,0,0,15,Human Factor
1947-01-12 00:00:00,Air Contractors UK,Flight,Commercial,France,Europe,8,2,0,6,0,0,8,Technical Failure
1947-01-13 00:00:00,Canadian Pacific Airlines - CP Air,Landing (descent or approach),Commercial,Canada,North America,0,0,0,0,0,0,0,Unknown
1947-01-14 00:00:00,Brazilian Air Force - Força Aérea Brasileira,Flight,Military / Government,Brazil,South America,5,3,0,2,0,0,5,Unknown
1947-01-15 00:00:00,Private Hondurian,Flight,Business,Honduras,Central America,0,0,0,0,0,0,0,Unknown
1947-01-15 00:00:00,LAN Chile - Linea Aérea Nacional de Chile,Landing (descent or approach),Commercial,Chile,South America,2,2,0,0,0,0,2,Unknown
1947-01-16 00:00:00,Royal Air Force - RAF,Landing (descent or approach),Military / Government,United Kingdom,Europe,0,0,0,0,0,0,0,Technical Failure
1947-01-17 00:00:00,Royal Air Force - RAF,Takeoff (climb),Military / Government,Singapore,Asia,0,0,0,0,0,0,0,Technical Failure
1947-01-18 00:00:00,Swedish Air Force - Flygvapnet,Landing (descent or approach),Operational,Sweden,Europe,2,2,0,0,0,0,2,Technical Failure
1947-01-18 00:00:00,Royal Air Force - RAF,Landing (descent or approach),Military / Government,Indonesia,Asia,0,0,0,0,0,0,0,Other
1947-01-19 00:00:00,French Air Force - Armée de l'Air,Flight,Military / Government,Vietnam,Asia,0,0,0,0,0,0,0,Unknown
1947-01-22 00:00:00,TACA International Airlines - Transportes Aéreos Centro Americanos,Takeoff (climb),Commercial,Ecuador,South America,0,0,0,0,0,0,0,Technical Failure
1947-01-22 00:00:00,Qantas Airways - Queensland and Northern Territory Aerial Services,Takeoff (climb),Commercial,Australia,Oceania,4,2,0,2,0,0,4,Other
1947-01-22 00:00:00,Allegheny Air Cargo,Flight,Operational,United States of America,North America,3,3,0,0,0,0,3,Technical Failure
1947-01-22 00:00:00,Royal Air Force - RAF,Takeoff (climb),Military / Government,Germany,Europe,0,0,0,0,0,0,0,Unknown
1947-01-23 00:00:00,Allegheny Air Cargo,Flight,Operational,United States of America,North America,3,3,0,0,0,0,3,Human Factor
1947-01-23 00:00:00,United States Army Air Forces - USAAF,Flight,Military / Government,United States of America,North America,0,0,0,0,0,0,0,Unknown
1947-01-24 00:00:00,United States Navy - USN,Landing (descent or approach),Operational,United States of America,North America,0,0,0,0,0,0,0,Unknown
1947-01-25 00:00:00,CSA Czech Airlines - Československé Státní Aerolinie,Parking,Other,United Kingdom,Europe,0,0,0,0,0,0,0,Human Factor
1947-02-01 00:00:00,Royal Air Force - RAF,Flight,Operational,United Kingdom,Europe,4,4,0,0,0,0,4,Human Factor
1947-02-05 00:00:00,Aerovias Brasil,,Commercial,Brazil,South America,0,0,0,0,0,0,0,Unknown
1947-02-09 00:00:00,United States Army Air Forces - USAAF,Landing (descent or approach),Military / Government,Philippines,Asia,0,0,0,0,0,0,0,Unknown
1947-02-11 00:00:00,Royal Air Force - RAF,Landing (descent or approach),Military / Government,United Kingdom,Europe,0,0,0,0,0,0,0,Human Factor
1947-02-12 00:00:00,CL Air Surveys,Landing (descent or approach),Specialised Services,United Kingdom,Europe,2,1,0,1,0,0,2,Unknown
1947-02-14 00:00:00,Atlantic %26 Pacific Airlines,Flight,Specialised Services,United States of America,North America,1,1,0,0,0,0,1,Technical Failure
1947-02-17 00:00:00,Det Danske Luftfartselskab - DDL,Landing (descent or approach),Operational,Sweden,Europe,4,4,0,0,0,0,4,Technical Failure
1947-02-21 00:00:00,United States Army Air Forces - USAAF,Flight,Military / Government,Greenland,Europe,11,11,0,0,0,0,11,Technical Failure
1947-02-23 00:00:00,United States Army Air Forces - USAAF,Takeoff (climb),Military / Government,Germany,Europe,0,0,0,0,0,0,0,Unknown
1947-02-24 00:00:00,United Airlines,,Commercial,United States of America,North America,0,0,0,0,0,0,0,Unknown
1947-02-27 00:00:00,Líneas Aéreas del Estado - LADE,Flight,Military / Government,Argentina,South America,0,0,0,0,0,0,0,Unknown
1947-02-28 00:00:00,Royal Air Force - RAF,Landing (descent or approach),Military / Government,Myanmar,Asia,0,0,0,0,0,0,0,Human Factor
1947-03-07 00:00:00,United States Navy - USN,Landing (descent or approach),Military / Government,Guam Island,Asia,0,0,0,0,0,0,0,Unknown
1947-03-11 00:00:00,United States Army Air Forces - USAAF,Flight,Military / Government,United Kingdom,Europe,2,2,0,0,0,0,2,Weather
1947-03-14 00:00:00,Royal Air Force - RAF,Landing (descent or approach),Military / Government,United Kingdom,Europe,0,0,0,0,0,0,0,Human Factor
1947-03-16 00:00:00,Bahamas Airways,Takeoff (climb),Commercial,Bahamas,Central America,2,2,0,0,0,0,2,Unknown
1947-03-19 00:00:00,Pan African Air Charter,Flight,Commercial,Uganda,Africa,0,0,0,0,0,0,0,Technical Failure
1947-03-19 00:00:00,United States Army Air Forces - USAAF,Flight,Military / Government,Iran,Asia,0,0,0,0,0,0,0,Technical Failure
1947-03-20 00:00:00,Linea Aeropostal Venezolana - LAV,Landing (descent or approach),Operational,Venezuela,South America,3,3,0,0,0,0,3,Human Factor
1947-03-20 00:00:00,John Mahieu Aviation,Landing (descent or approach),Commercial,Netherlands,Europe,0,0,0,0,0,0,0,Unknown
1947-03-23 00:00:00,United States Army Air Forces - USAAF,Flight,Military / Government,Canada,North America,9,9,0,0,0,0,9,Unknown
1947-03-25 00:00:00,Private Belgian,Flight,Business,Denmark,Europe,0,0,0,0,0,0,0,Unknown
1947-03-26 00:00:00,Royal Netherlands Air Force - Koninklijke Luchtmacht,Flight,Military / Government,Australia,Oceania,6,6,0,0,0,0,6,Weather
1947-04-04 00:00:00,International Air Freight,Takeoff (climb),Operational,United States of America,North America,2,2,0,0,0,0,2,Technical Failure
1947-04-10 00:00:00,Indian Overseas Airlines - IOA,Flight,Commercial,India,Asia,0,0,0,0,0,0,0,Unknown
1947-04-13 00:00:00,Compañia Transandina de Aviación,Landing (descent or approach),Operational,Colombia,South America,2,2,0,0,0,0,2,Unknown
1947-04-15 00:00:00,British European Airways - BEA,Landing (descent or approach),Commercial,United Kingdom,Europe,7,2,0,5,0,0,7,Human Factor
1947-04-19 00:00:00,Mercury Aviation,Flight,Commercial,South Sudan,Africa,21,4,0,17,0,0,21,Technical Failure
1947-04-22 00:00:00,United States Army Air Forces - USAAF,Flight,Military / Government,Czech Republic,Europe,0,0,0,0,0,0,0,Unknown
1947-04-24 00:00:00,Guinea Air Traders,Landing (descent or approach),Operational,Papua New Guinea,Oceania,2,2,0,0,0,0,2,Unknown
1947-04-25 00:00:00,China National Aviation Corporation - CNAC,Takeoff (climb),Operational,China,Asia,2,2,0,0,0,0,2,Technical Failure
1947-04-27 00:00:00,McAvoy Diamond Drilling %26 Development Company Ltd,Flight,Business,Canada,North America,3,1,0,2,0,0,3,Technical Failure
1947-04-29 00:00:00,Anglo-Iranian Oil Company,Landing (descent or approach),Business,Iran,Asia,3,1,0,2,0,0,3,Unknown
1947-04-30 00:00:00,Aerovias Latino Americanas,Landing (descent or approach),Commercial,Salvador,Central America,4,3,0,1,0,0,4,Human Factor
1947-04-30 00:00:00,Air France,,Commercial,Niger,Africa,0,0,0,0,0,0,0,Unknown
1947-05-06 00:00:00,Polyarnaya Aviatsiya,Flight,Commercial,Russia,Asia,5,4,0,1,0,0,5,Technical Failure
1947-05-09 00:00:00,United States Army Air Forces - USAAF,Landing (descent or approach),Military / Government,Tanzania,Africa,4,2,0,2,0,0,4,Unknown
1947-05-11 00:00:00,United States Army Air Forces - USAAF,Landing (descent or approach),Military / Government,United States of America,North America,0,0,0,0,0,0,0,Unknown
1947-05-11 00:00:00,Skyways of London,Landing (descent or approach),Operational,Iraq,Asia,4,4,0,0,0,0,4,Unknown
1947-05-12 00:00:00,Indian Overseas Airlines - IOA,Landing (descent or approach),Commercial,India,Asia,0,0,0,0,0,0,0,Unknown
1947-05-12 00:00:00,Negociación Aérea Mexicana,Takeoff (climb),Operational,Mexico,Central America,2,2,0,0,0,0,2,Weather
1947-05-14 00:00:00,Corrieri Aerei Militari - CAM,Takeoff (climb),Military / Government,Italy,Europe,0,0,0,0,0,0,0,Unknown
1947-05-16 00:00:00,Strato Freight,Landing (descent or approach),Operational,United States of America,North America,2,2,0,0,0,0,2,Human Factor
1947-05-17 00:00:00,Royal Air Force - RAF,Takeoff (climb),Operational,United Kingdom,Europe,5,5,0,0,0,0,5,Human Factor
1947-05-19 00:00:00,United States Army Air Forces - USAAF,Flight,Military / Government,United States of America,North America,2,2,0,0,0,0,2,Technical Failure
1947-05-22 00:00:00,Royal Air Force - RAF,Takeoff (climb),Military / Government,United Kingdom,Europe,0,0,0,0,0,0,0,Technical Failure
1947-05-22 00:00:00,Aerovias Brasil,,Commercial,Brazil,South America,0,0,0,0,0,0,0,Unknown
1947-05-24 00:00:00,Royal Air Force - RAF,Landing (descent or approach),Military / Government,Malta,Europe,5,3,0,2,0,0,5,Human Factor
1947-05-24 00:00:00,Guinea Air Traders,Flight,Operational,Papua New Guinea,Oceania,2,2,0,0,0,0,2,Unknown
1947-05-28 00:00:00,Royal Air Force - RAF,Takeoff (climb),Operational,Kenya,Africa,5,5,0,0,0,0,5,Unknown
1947-05-29 00:00:00,Lloyd Aéreo Boliviano - LAB Airlines,Flight,Commercial,Bolivia,South America,0,0,0,0,0,0,0,Unknown
1947-05-30 00:00:00,Bond Air Services,Landing (descent or approach),Operational,Spain,Europe,4,4,0,0,0,0,4,Human Factor
1947-05-31 00:00:00,Ellis Airlines,Landing (descent or approach),Commercial,United States of America,North America,0,0,0,0,0,0,0,Human Factor
1947-06-03 00:00:00,Butler Air Transport,Landing (descent or approach),Operational,Australia,Oceania,2,2,0,0,0,0,2,Human Factor
1947-06-05 00:00:00,Lancashire Aircraft Corporation - LAC,Landing (descent or approach),Operational,United Kingdom,Europe,4,4,0,0,0,0,4,Human Factor
1947-06-06 00:00:00,Air Gagnon,Landing (descent or approach),Commercial,Canada,North America,0,0,0,0,0,0,0,Unknown
1947-06-07 00:00:00,Polyarnaya Aviatsiya,Landing (descent or approach),Operational,Russia,Asia,6,6,0,0,0,0,6,Human Factor
1947-06-10 00:00:00,LOT Polish Airlines - Polskie Linie Lotnicze,Landing (descent or approach),Other,Sweden,Europe,0,0,0,0,0,0,0,Unknown
1947-06-11 00:00:00,Royal Air Force - RAF,Landing (descent or approach),Operational,United Kingdom,Europe,4,4,0,0,0,0,4,Human Factor
1947-06-12 00:00:00,Pays Plat Outfitters,Takeoff (climb),Operational,Canada,North America,1,1,0,0,0,0,1,Human Factor
1947-06-15 00:00:00,United States Army Air Forces - USAAF,Landing (descent or approach),Military / Government,United States of America,North America,0,0,0,0,0,0,0,Unknown
1947-06-16 00:00:00,Philippine Airlines - PAL,Flight,Commercial,Philippines,Asia,0,0,0,0,0,0,0,Unknown
1947-06-20 00:00:00,Buchan's Mining Company,Flight,Business,Canada,North America,0,0,0,0,0,0,0,Unknown
1947-06-21 00:00:00,Ontario Provincial Air Service,Landing (descent or approach),Commercial,Canada,North America,4,1,0,3,0,0,4,Technical Failure
1947-06-22 00:00:00,Private Canadian,Takeoff (climb),Business,Canada,North America,0,0,0,0,0,0,0,Unknown
1947-06-23 00:00:00,Ontario Provincial Air Service,Takeoff (climb),Commercial,Canada,North America,2,1,0,1,0,0,2,Weather
1947-06-23 00:00:00,United States Army Air Forces - USAAF,Landing (descent or approach),Military / Government,Canada,North America,0,0,0,0,0,0,0,Unknown
1947-06-26 00:00:00,Société Aérienne de Transports Internationaux - SATI,,Commercial,India,Asia,0,0,0,0,0,0,0,Unknown
1947-06-27 00:00:00,Ulster Aviation,Flight,Operational,United Kingdom,Europe,2,2,0,0,0,0,2,Technical Failure
1947-06-27 00:00:00,Royal Air Force - RAF,Flight,Military / Government,Kenya,Africa,15,3,0,12,0,0,15,Technical Failure
1947-06-28 00:00:00,Royal Air Force - RAF,Landing (descent or approach),Military / Government,Madagascar,Africa,0,0,0,0,0,0,0,Human Factor
1947-07-02 00:00:00,Ulster Aviation,Landing (descent or approach),Operational,United Kingdom,Europe,2,2,0,0,0,0,2,Unknown
1947-07-05 00:00:00,French Air Force - Armée de l'Air,,Military / Government,Vietnam,Asia,0,0,0,0,0,0,0,Unknown
1947-07-08 00:00:00,Air Azur,Landing (descent or approach),Commercial,Tunisia,Africa,2,2,0,0,0,0,2,Unknown
1947-07-11 00:00:00,Brazilian Air Force - Força Aérea Brasileira,Takeoff (climb),Military / Government,Brazil,South America,0,0,0,0,0,0,0,Unknown
1947-07-12 00:00:00,United States Army Air Forces - USAAF,Flight,Military / Government,Germany,Europe,0,0,0,0,0,0,0,Technical Failure
1947-07-14 00:00:00,Qantas Airways - Queensland and Northern Territory Aerial Services,Flight,Commercial,Papua New Guinea,Oceania,3,1,0,2,0,0,3,Human Factor
1947-07-15 00:00:00,Aros-Flyg,Landing (descent or approach),Operational,Sweden,Europe,2,2,0,0,0,0,2,Unknown
1947-07-15 00:00:00,Miles Aircraft,Taxiing,Specialised Services,United Kingdom,Europe,0,0,0,0,0,0,0,Unknown
1947-07-15 00:00:00,French Air Force - Armée de l'Air,,Military / Government,Vietnam,Asia,0,0,0,0,0,0,0,Unknown
1947-07-16 00:00:00,Shell Company of Ecuador,,Business,Ecuador,South America,0,0,0,0,0,0,0,Unknown
1947-07-18 00:00:00,Southern Aerowork,Takeoff (climb),Operational,United Kingdom,Europe,2,2,0,0,0,0,2,Unknown
1947-07-25 00:00:00,Skyways of London,Landing (descent or approach),Commercial,United Kingdom,Europe,24,7,0,17,0,0,24,Technical Failure
1947-07-31 00:00:00,London Aero %26 Motor Services - LAMS,Takeoff (climb),Operational,Italy,Europe,5,5,0,0,0,0,5,Technical Failure
1947-08-05 00:00:00,Vingtor Luftveier,Landing (descent or approach),Commercial,Norway,Europe,12,5,0,7,0,0,12,Unknown
1947-08-06 00:00:00,British European Airways - BEA,Takeoff (climb),Commercial,United Kingdom,Europe,7,1,0,6,0,0,7,Unknown
1947-08-08 00:00:00,New England Airways,Landing (descent or approach),Operational,Australia,Oceania,2,2,0,0,0,0,2,Technical Failure
1947-08-11 00:00:00,Photographic Survey Company,Taxiing,Specialised Services,Canada,North America,2,1,0,1,0,0,2,Other
1947-08-12 00:00:00,Flota Aerea Mercante Argentina - FAMA,Landing (descent or approach),Military / Government,Brazil,South America,0,0,0,0,0,0,0,Technical Failure
1947-08-14 00:00:00,United States Army Air Forces - USAAF,Landing (descent or approach),Operational,United States of America,North America,4,4,0,0,0,0,4,Unknown
1947-08-14 00:00:00,Royal Air Force - RAF,Takeoff (climb),Operational,United Kingdom,Europe,5,5,0,0,0,0,5,Technical Failure
1947-08-18 00:00:00,Royal Air Force - RAF,Flight,Military / Government,South Sudan,Africa,2,2,0,0,0,0,2,Technical Failure
1947-08-20 00:00:00,Mandated Airlines,Takeoff (climb),Commercial,Papua New Guinea,Oceania,3,1,0,2,0,0,3,Human Factor
1947-08-25 00:00:00,Charter Airways,Landing (descent or approach),Commercial,Canada,North America,5,1,0,4,0,0,5,Weather
1947-08-28 00:00:00,Royal New Zealand Air Force - RNZAF,Landing (descent or approach),Military / Government,New Zealand,Oceania,4,2,0,2,0,0,4,Unknown
1947-08-29 00:00:00,Royal Canadian Air Force - RCAF,Landing (descent or approach),Military / Government,Canada,North America,0,0,0,0,0,0,0,Human Factor
1947-08-30 00:00:00,Transportes Aéreos Peruanas - TAPSA,Flight,Commercial,Peru,South America,0,0,0,0,0,0,0,Unknown
1947-08-31 00:00:00,Nayler Air Services,Landing (descent or approach),Business,United Kingdom,Europe,2,1,0,1,0,0,2,Unknown
1947-09-02 00:00:00,Royal Air Force - RAF,Landing (descent or approach),Operational,United Kingdom,Europe,5,5,0,0,0,0,5,Technical Failure
1947-09-02 00:00:00,Royal Air Force - RAF,Takeoff (climb),Military / Government,United Kingdom,Europe,11,5,0,6,0,0,11,Technical Failure
1947-09-05 00:00:00,British South American Airways - BSAA,Landing (descent or approach),Commercial,Bermuda,North America,20,5,0,15,0,0,20,Human Factor
1947-09-05 00:00:00,Payloads Charter Company,Landing (descent or approach),Operational,United Kingdom,Europe,4,4,0,0,0,0,4,Unknown
1947-09-09 00:00:00,Servicio Aéreo Panini,,Commercial,Mexico,Central America,0,0,0,0,0,0,0,Unknown
1947-09-15 00:00:00,French Air Force - Armée de l'Air,Flight,Military / Government,France,Europe,3,3,0,0,0,0,3,Technical Failure
1947-09-17 00:00:00,Slick Airways,Landing (descent or approach),Operational,United States of America,North America,2,2,0,0,0,0,2,Technical Failure
1947-09-17 00:00:00,Argentinian Air Force - Fuerza Aérea Argentina,Landing (descent or approach),Military / Government,Argentina,South America,0,0,0,0,0,0,0,Unknown
1947-09-17 00:00:00,Compania Anonima Vuelos Express - CAVE,Landing (descent or approach),Operational,Venezuela,South America,2,2,0,0,0,0,2,Unknown
1947-09-18 00:00:00,Tata Airlines,Flight,Commercial,India,Asia,0,0,0,0,0,0,0,Unknown
1947-09-18 00:00:00,Franco-British Commercial %26 Industrial Company,Takeoff (climb),Operational,Tunisia,Africa,2,2,0,0,0,0,2,Unknown
1947-09-20 00:00:00,Pan American World Airways - PAA,Landing (descent or approach),Commercial,United States of America,North America,41,5,0,36,0,0,41,Technical Failure
1947-09-21 00:00:00,The Uganda Company,Parking,Commercial,Tanzania,Africa,2,1,0,1,0,0,2,Technical Failure
1947-10-03 00:00:00,Skyways of London,Takeoff (climb),Operational,United Kingdom,Europe,3,3,0,0,0,0,3,Human Factor
1947-10-07 00:00:00,Air France,Takeoff (climb),Commercial,Algeria,Africa,0,0,0,0,0,0,0,Technical Failure
1947-10-10 00:00:00,Malayan Airways,,Commercial,Malaysia,Asia,0,0,0,0,0,0,0,Unknown
1947-10-14 00:00:00,American International Airlines,Flight,Commercial,World,World,69,7,0,62,0,0,69,Technical Failure
1947-10-23 00:00:00,British South American Airways - BSAA,Landing (descent or approach),Operational,United Kingdom,Europe,4,4,0,0,0,0,4,Unknown
1947-11-05 00:00:00,Royal Air Force - RAF,Landing (descent or approach),Military / Government,United Kingdom,Europe,6,6,0,0,0,0,6,Technical Failure
1947-11-11 00:00:00,American Airlines,Landing (descent or approach),Commercial,United States of America,North America,25,5,0,20,0,0,25,Human Factor
1947-11-13 00:00:00,British South American Airways - BSAA,Landing (descent or approach),Commercial,Bermuda,North America,16,4,0,12,0,0,16,Technical Failure
1947-11-13 00:00:00,Air India,Landing (descent or approach),Commercial,India,Asia,0,0,0,0,0,0,0,Unknown
1947-11-13 00:00:00,Private British,Flight,Business,France,Europe,0,0,0,0,0,0,0,Technical Failure
1947-11-13 00:00:00,Rijksluchtvaartschool - RLS,Flight,Operational,Netherlands,Europe,3,3,0,0,0,0,3,Technical Failure
1947-11-14 00:00:00,Airspan Travel,Flight,Business,France,Europe,0,0,0,0,0,0,0,Unknown
1947-11-15 00:00:00,Private American,,Business,United States of America,North America,0,0,0,0,0,0,0,Unknown
1947-11-16 00:00:00,Royal Air Force - RAF,Landing (descent or approach),Operational,India,Asia,3,3,0,0,0,0,3,Human Factor
1947-11-17 00:00:00,Royal Air Force - RAF,Landing (descent or approach),Operational,United Kingdom,Europe,4,4,0,0,0,0,4,Human Factor
1947-11-23 00:00:00,Bristol Aeroplane Company,Landing (descent or approach),Operational,Papua New Guinea,Oceania,5,5,0,0,0,0,5,Technical Failure
1947-11-25 00:00:00,Linea Aeropostal Venezolana - LAV,Takeoff (climb),Specialised Services,Venezuela,South America,3,3,0,0,0,0,3,Unknown
1947-11-25 00:00:00,London Aero %26 Motor Services - LAMS,Landing (descent or approach),Operational,Sudan,Africa,7,7,0,0,0,0,7,Unknown
1947-11-27 00:00:00,McAvoy Diamond Drilling %26 Development Company Ltd,Landing (descent or approach),Business,Canada,North America,3,1,0,2,0,0,3,Unknown
1947-11-27 00:00:00,Payloads Charter Company,Landing (descent or approach),Operational,France,Europe,3,2,0,1,0,0,3,Unknown
1947-11-28 00:00:00,Argentinian Air Force - Fuerza Aérea Argentina,Landing (descent or approach),Military / Government,Argentina,South America,0,0,0,0,0,0,0,Other
1947-12-01 00:00:00,Polyarnaya Aviatsiya,Takeoff (climb),Operational,Russia,Asia,5,5,0,0,0,0,5,Other
1947-12-01 00:00:00,Airlines WA,Takeoff (climb),Operational,Australia,Oceania,3,1,0,2,0,0,3,Unknown
1947-12-09 00:00:00,United States Air Force - USAF,Flight,Military / Government,United States of America,North America,0,0,0,0,0,0,0,Technical Failure
1947-12-13 00:00:00,Central African Airways - CAA,Landing (descent or approach),Commercial,Zambia,Africa,6,1,0,5,0,0,6,Unknown
1947-12-15 00:00:00,Alfred Wegener Institute,Landing (descent or approach),Business,India,Asia,2,1,0,1,0,0,2,Unknown
1947-12-16 00:00:00,Royal Air Force - RAF,Landing (descent or approach),Operational,United Kingdom,Europe,5,5,0,0,0,0,5,Technical Failure
1947-12-18 00:00:00,Aeroflot - Russian International Airlines,Landing (descent or approach),Specialised Services,Russia,Asia,0,0,0,0,0,0,0,Human Factor
1947-12-19 00:00:00,Royal New Zealand Air Force - RNZAF,Flight,Military / Government,Philippines,Asia,12,2,0,10,0,0,12,Technical Failure
1947-12-20 00:00:00,Royal Air Force - RAF,Landing (descent or approach),Military / Government,Germany,Europe,8,4,0,4,0,0,8,Technical Failure
1947-12-22 00:00:00,Iberia - Lineas Aéreas de Espana,,Commercial,Spain,Europe,0,0,0,0,0,0,0,Unknown
1947-12-23 00:00:00,Coastal Air Lines,Landing (descent or approach),Operational,United States of America,North America,2,2,0,0,0,0,2,Technical Failure
1947-12-24 00:00:00,French Air Force - Armée de l'Air,Flight,Military / Government,France,Europe,15,6,0,9,0,0,15,Technical Failure
1947-12-27 00:00:00,KLM Royal Dutch Airlines - Koninklijke Luchtvaart Maatschappij,Landing (descent or approach),Commercial,Netherlands,Europe,15,5,0,10,0,0,15,Weather
1947-12-28 00:00:00,Waite Fisheries,Flight,Commercial,Canada,North America,2,1,0,1,0,0,2,Weather
1947-12-29 00:00:00,Det Danske Luftfartselskab - DDL,Landing (descent or approach),Commercial,Denmark,Europe,15,4,0,11,0,0,15,Unknown
1947-12-31 00:00:00,Bharat Airways,Flight,Commercial,India,Asia,0,0,0,0,0,0,0,Unknown
1948-01-02 00:00:00,SOCOTRA - Société Coopérative de Tramping Aérien,Landing (descent or approach),Operational,Morocco,Africa,3,3,0,0,0,0,3,Technical Failure
1948-01-05 00:00:00,South African Airways -SAA - Suid Afrikaanse Lugdiens - SAL,Landing (descent or approach),Commercial,South Africa,Africa,15,4,0,11,0,0,15,Technical Failure
1948-01-07 00:00:00,Sivewright Airways,Flight,Commercial,United Kingdom,Europe,0,0,0,0,0,0,0,Unknown
1948-01-07 00:00:00,Royal Air Force - RAF,Landing (descent or approach),Operational,United Kingdom,Europe,3,3,0,0,0,0,3,Human Factor
1948-01-10 00:00:00,VIARCO - Vias Aéreas Colombianas,Landing (descent or approach),Operational,Colombia,South America,3,3,0,0,0,0,3,Unknown
1948-01-10 00:00:00,Royal Air Force - RAF,Flight,Military / Government,Egypt,Africa,0,0,0,0,0,0,0,Technical Failure
1948-01-13 00:00:00,Flota Aerea Mercante Argentina - FAMA,Flight,Specialised Services,Italy,Europe,7,6,0,1,0,0,7,Technical Failure
1948-01-13 00:00:00,Mexicana de Aviación,,Commercial,Mexico,Central America,0,0,0,0,0,0,0,Unknown
1948-01-17 00:00:00,Airways India,Flight,Operational,Italy,Europe,2,2,0,0,0,0,2,Unknown
1948-01-20 00:00:00,African Air Cars,Flight,Operational,Sudan,Africa,2,2,0,0,0,0,2,Unknown
1948-01-21 00:00:00,Eastern Airlines,Landing (descent or approach),Commercial,United States of America,North America,25,5,0,20,0,0,25,Other
1948-01-21 00:00:00,Philippine Airlines - PAL,Landing (descent or approach),Commercial,Philippines,Asia,0,0,0,0,0,0,0,Unknown
1948-01-24 00:00:00,Chartair - UK,Landing (descent or approach),Commercial,France,Europe,3,1,0,2,0,0,3,Weather
1948-01-25 00:00:00,Queen Charlotte Airlines,Landing (descent or approach),Commercial,Canada,North America,4,2,0,2,0,0,4,Technical Failure
1948-01-30 00:00:00,Middle East Airlines - MEA,Taxiing,Commercial,Lebanon,Asia,0,0,0,0,0,0,0,Unknown
1948-01-30 00:00:00,Compagnie Générale TransSaharienne - CGT France,Taxiing,Commercial,Lebanon,Asia,0,0,0,0,0,0,0,Unknown
1948-02-01 00:00:00,Skane Flyg,Landing (descent or approach),Commercial,Sweden,Europe,0,0,0,0,0,0,0,Unknown
1948-02-06 00:00:00,Air India,Landing (descent or approach),Commercial,India,Asia,19,4,0,15,0,0,19,Technical Failure
1948-02-09 00:00:00,British Overseas Airways Corporation - BOAC,Flight,Commercial,Italy,Europe,0,0,0,0,0,0,0,Unknown
1948-02-09 00:00:00,Cathay Pacific Airways,Landing (descent or approach),Commercial,Myanmar,Asia,0,0,0,0,0,0,0,Unknown
1948-02-11 00:00:00,Qantas Airways - Queensland and Northern Territory Aerial Services,Flight,Commercial,Australia,Oceania,11,2,0,9,0,0,11,Technical Failure
1948-02-13 00:00:00,Handley Page Aircraft Company Ltd,Landing (descent or approach),Specialised Services,United Kingdom,Europe,4,4,0,0,0,0,4,Technical Failure
1948-02-16 00:00:00,Royal Air Force - RAF,Landing (descent or approach),Operational,United Kingdom,Europe,4,4,0,0,0,0,4,Human Factor
1948-02-17 00:00:00,Royal Air Force - RAF,Flight,Operational,United Kingdom,Europe,5,5,0,0,0,0,5,Unknown
1948-02-19 00:00:00,Royal Australian Air Force - RAAF,Landing (descent or approach),Operational,Australia,Oceania,16,4,0,12,0,0,16,Other
1948-02-23 00:00:00,Linea Aeropostal Venezolana - LAV,Flight,Commercial,Venezuela,South America,17,5,0,12,0,0,17,Technical Failure
1948-03-01 00:00:00,United States Air Force - USAF,Flight,Operational,United States of America,North America,5,5,0,0,0,0,5,Technical Failure
1948-03-04 00:00:00,United Air Services - Tanzania,Landing (descent or approach),Commercial,Kenya,Africa,2,1,0,1,0,0,2,Unknown
1948-03-07 00:00:00,VARIG - Viação Aérea Rio Grandense,,Commercial,Brazil,South America,0,0,0,0,0,0,0,Unknown
1948-03-07 00:00:00,VARIG - Viação Aérea Rio Grandense,,Commercial,Brazil,South America,0,0,0,0,0,0,0,Unknown
1948-03-08 00:00:00,KLM Royal Dutch Airlines - Koninklijke Luchtvaart Maatschappij,Takeoff (climb),Commercial,Indonesia,Asia,13,4,0,9,0,0,13,Unknown
1948-03-10 00:00:00,American Airlines,Landing (descent or approach),Commercial,United States of America,North America,36,3,0,33,0,0,36,Other
1948-03-13 00:00:00,Great Northern Skyways,Takeoff (climb),Operational,Canada,North America,1,1,0,0,0,0,1,Technical Failure
1948-03-16 00:00:00,Polyarnaya Aviatsiya,Takeoff (climb),Military / Government,Russia,Asia,6,6,0,0,0,0,6,Other
1948-03-25 00:00:00,Private Swedish,Flight,Business,Sweden,Europe,1,1,0,0,0,0,1,Human Factor
1948-03-25 00:00:00,Ulster Aviation,Flight,Operational,United Kingdom,Europe,1,1,0,0,0,0,1,Technical Failure
1948-04-01 00:00:00,Portuguese Air Force - Aeronáutica Militar,Landing (descent or approach),Military / Government,Portugal,Europe,0,0,0,0,0,0,0,Unknown
1948-04-05 00:00:00,United States Marine Corps,Flight,Military / Government,China,Asia,0,0,0,0,0,0,0,Technical Failure
1948-04-07 00:00:00,Air Congo,Flight,Commercial,Democratic Republic of Congo,Africa,0,0,0,0,0,0,0,Unknown
1948-04-19 00:00:00,New Zealand National Airways,Landing (descent or approach),Commercial,New Zealand,Oceania,12,2,0,10,0,0,12,Weather
1948-04-20 00:00:00,Philippine Airlines - PAL,Landing (descent or approach),Commercial,Philippines,Asia,0,0,0,0,0,0,0,Unknown
1948-04-21 00:00:00,British European Airways - BEA,Landing (descent or approach),Commercial,United Kingdom,Europe,20,4,0,16,0,0,20,Human Factor
1948-04-23 00:00:00,United States Navy - USN,Landing (descent or approach),Military / Government,United States of America,North America,8,8,0,0,0,0,8,Technical Failure
1948-04-30 00:00:00,United States Marine Corps,Flight,Military / Government,China,Asia,0,0,0,0,0,0,0,Unknown
1948-04-30 00:00:00,Royal Air Force - RAF,Taxiing,Military / Government,Austria,Europe,0,0,0,0,0,0,0,Weather
1948-05-01 00:00:00,KLM Royal Dutch Airlines - Koninklijke Luchtvaart Maatschappij,Takeoff (climb),Operational,Netherlands,Europe,5,5,0,0,0,0,5,Human Factor
1948-05-06 00:00:00,Connellan Airways,Takeoff (climb),Operational,Australia,Oceania,4,2,0,2,0,0,4,Technical Failure
1948-05-09 00:00:00,Pakistan Airways - Pak Air,Landing (descent or approach),Operational,Iraq,Asia,3,3,0,0,0,0,3,Technical Failure
1948-05-09 00:00:00,New Holland Airways,Landing (descent or approach),Commercial,Australia,Oceania,0,0,0,0,0,0,0,Unknown
1948-05-12 00:00:00,Mandated Airlines,Flight,Operational,Australia,Oceania,1,1,0,0,0,0,1,Weather
1948-05-13 00:00:00,Aéro Cargo,Landing (descent or approach),Operational,United Kingdom,Europe,3,3,0,0,0,0,3,Unknown
1948-05-14 00:00:00,Flota Aerea Mercante Argentina - FAMA,Landing (descent or approach),Specialised Services,Argentina,South America,5,5,0,0,0,0,5,Technical Failure
1948-05-17 00:00:00,Philippine Airlines - PAL,Takeoff (climb),Commercial,Philippines,Asia,17,3,0,14,0,0,17,Unknown
1948-05-17 00:00:00,British American Air Services - BAAS,Landing (descent or approach),Operational,France,Europe,3,3,0,0,0,0,3,Technical Failure
1948-05-20 00:00:00,Royal Air Force - RAF,Flight,Operational,Germany,Europe,2,2,0,0,0,0,2,Technical Failure
1948-05-20 00:00:00,Société Auxiliaire de Navigation Aérienne - SANA,Landing (descent or approach),Operational,France,Europe,3,3,0,0,0,0,3,Unknown
1948-05-23 00:00:00,Bond Air Services,Landing (descent or approach),Operational,United Kingdom,Europe,5,5,0,0,0,0,5,Other
1948-05-24 00:00:00,Morton Air Services,Flight,Commercial,Egypt,Africa,4,2,0,2,0,0,4,Unknown
1948-05-26 00:00:00,LOT Polish Airlines - Polskie Linie Lotnicze,Flight,Commercial,Poland,Europe,0,0,0,0,0,0,0,Unknown
1948-05-28 00:00:00,Karachi Aero Club,Landing (descent or approach),Business,Pakistan,Asia,2,1,0,1,0,0,2,Unknown
1948-05-31 00:00:00,Royal Air Force - RAF,Takeoff (climb),Operational,United Kingdom,Europe,0,0,0,0,0,0,0,Weather
1948-06-08 00:00:00,Air Portugal - Transportes Aéreos Portugueses,Takeoff (climb),Operational,Portugal,Europe,5,5,0,0,0,0,5,Human Factor
1948-06-08 00:00:00,Air Portugal - Transportes Aéreos Portugueses,Takeoff (climb),Operational,Portugal,Europe,5,5,0,0,0,0,5,Human Factor
1948-06-11 00:00:00,Lancashire Aircraft Corporation - LAC,Flight,Commercial,United Kingdom,Europe,9,2,0,7,0,0,9,Technical Failure
1948-06-12 00:00:00,Eagle Air Freight,Flight,Operational,United States of America,North America,2,2,0,0,0,0,2,Technical Failure
1948-06-13 00:00:00,Southern Cross Aviation Service,Flight,Business,New Zealand,Oceania,1,1,0,0,0,0,1,Unknown
1948-06-14 00:00:00,Air France,Flight,Commercial,France,Europe,0,0,0,0,0,0,0,Unknown
1948-06-14 00:00:00,British Air Transport - BAT,Flight,Commercial,France,Europe,2,1,0,1,0,0,2,Unknown
1948-06-16 00:00:00,KLM Royal Dutch Airlines - Koninklijke Luchtvaart Maatschappij,Landing (descent or approach),Commercial,Netherlands,Europe,27,7,0,20,0,0,27,Human Factor
1948-06-17 00:00:00,Ecuadorian Air Force - Fuerza Aérea Ecuatoriana,Takeoff (climb),Operational,Ecuador,South America,3,3,0,0,0,0,3,Human Factor
1948-06-18 00:00:00,Compañía Auxiliar de Navegación Aérea,Flight,Operational,Spain,Europe,1,1,0,0,0,0,1,Unknown
1948-06-21 00:00:00,United States Navy - USN,Flight,Operational,United States of America,North America,0,0,0,0,0,0,0,Technical Failure
1948-06-21 00:00:00,Transporte Aéreo Transandino,Landing (descent or approach),Commercial,Venezuela,South America,0,0,0,0,0,0,0,Unknown
1948-06-23 00:00:00,Clairways,Flight,Operational,Somalia,Africa,1,1,0,0,0,0,1,Unknown
1948-06-24 00:00:00,Central BC Airways,Landing (descent or approach),Commercial,Canada,North America,0,0,0,0,0,0,0,Unknown
1948-06-25 00:00:00,Iraq Petroleum Transport Company,Flight,Business,Syria,Asia,2,1,0,1,0,0,2,Unknown
1948-06-29 00:00:00,SCOLTA - Sociedad Colombiana de Transportes Aéreos,Landing (descent or approach),Operational,Colombia,South America,3,3,0,0,0,0,3,Technical Failure
1948-07-01 00:00:00,Royal Air Force - RAF,Landing (descent or approach),Operational,United Kingdom,Europe,4,4,0,0,0,0,4,Unknown
1948-07-01 00:00:00,Clairways,Flight,Operational,Somalia,Africa,2,2,0,0,0,0,2,Unknown
1948-07-04 00:00:00,Israeli Air Force - Heyl Ha'avir,Parking,Military / Government,Israel,Asia,0,0,0,0,0,0,0,Technical Failure
1948-07-05 00:00:00,United States Air Force - USAF,Landing (descent or approach),Military / Government,Germany,Europe,2,2,0,0,0,0,2,Human Factor
1948-07-06 00:00:00,Royal Norwegian Air Force - Kongelige Norske Luftforsvaret,Landing (descent or approach),Operational,Norway,Europe,3,3,0,0,0,0,3,Unknown
1948-07-07 00:00:00,United States Air Force - USAF,Flight,Military / Government,United States of America,North America,0,0,0,0,0,0,0,Technical Failure
1948-07-10 00:00:00,Expreso Aéreo Interamericano,Landing (descent or approach),Operational,Venezuela,South America,3,3,0,0,0,0,3,Technical Failure
1948-07-11 00:00:00,Royal Australian Air Force - RAAF,Flight,Operational,Australia,Oceania,2,2,0,0,0,0,2,Unknown
1948-07-12 00:00:00,Air France,Landing (descent or approach),Commercial,France,Europe,12,4,0,8,0,0,12,Unknown
1948-07-14 00:00:00,Royal Air Force - RAF,Takeoff (climb),Operational,Singapore,Asia,5,5,0,0,0,0,5,Human Factor
1948-07-15 00:00:00,Private Venezuelan,,Business,Venezuela,South America,0,0,0,0,0,0,0,Unknown
1948-07-17 00:00:00,Israeli Air Force - Heyl Ha'avir,Flight,Military / Government,Israel,Asia,5,2,0,3,0,0,5,Technical Failure
1948-07-20 00:00:00,French Air Force - Armée de l'Air,Flight,Military / Government,World,World,20,2,0,18,0,0,20,Unknown
1948-07-20 00:00:00,Mayflower Air Services,Landing (descent or approach),Operational,Israel,Asia,3,3,0,0,0,0,3,Human Factor
1948-07-21 00:00:00,United States Air Force - USAF,Flight,Military / Government,United States of America,North America,5,5,0,0,0,0,5,Human Factor
1948-07-22 00:00:00,Ethiopian Airlines,Landing (descent or approach),Commercial,Ethiopia,Africa,0,0,0,0,0,0,0,Human Factor
1948-07-23 00:00:00,Compañía Auxiliar de Navegación Aérea,Flight,Commercial,Spain,Europe,10,3,0,7,0,0,10,Technical Failure
1948-07-24 00:00:00,Royal Air Force - RAF,Landing (descent or approach),Operational,Germany,Europe,3,3,0,0,0,0,3,Technical Failure
1948-07-27 00:00:00,Royal Air Force - RAF,Takeoff (climb),Military / Government,United Kingdom,Europe,0,0,0,0,0,0,0,Unknown
1948-07-27 00:00:00,Air Transport - Belgium,Takeoff (climb),Commercial,Sudan,Africa,14,5,0,9,0,0,14,Unknown
1948-07-27 00:00:00,Société Auxiliaire de Navigation Aérienne - SANA,Takeoff (climb),Operational,France,Europe,3,3,0,0,0,0,3,Unknown
1948-07-28 00:00:00,SNECMA - Société Nationale d'Etude et de Construction de Moteurs d'Aviation,Takeoff (climb),Specialised Services,France,Europe,0,0,0,0,0,0,0,Unknown
1948-07-28 00:00:00,Royal Canadian Air Force - RCAF,Landing (descent or approach),Military / Government,Canada,North America,0,0,0,0,0,0,0,Other
1948-07-30 00:00:00,British European Airways - BEA,Landing (descent or approach),Commercial,United Kingdom,Europe,19,5,0,14,0,0,19,Technical Failure
1948-07-30 00:00:00,Aéro Cargo,,Operational,Morocco,Africa,0,0,0,0,0,0,0,Unknown
1948-08-01 00:00:00,Royal Air Force - RAF,Landing (descent or approach),Operational,Germany,Europe,3,3,0,0,0,0,3,Technical Failure
1948-08-11 00:00:00,Royal Air Force - RAF,Landing (descent or approach),Military / Government,United Kingdom,Europe,4,4,0,0,0,0,4,Technical Failure
1948-08-12 00:00:00,Trans-Canada Air Lines - TCAL,Landing (descent or approach),Commercial,Canada,North America,17,6,0,11,0,0,17,Human Factor
1948-08-13 00:00:00,United States Air Force - USAF,Landing (descent or approach),Operational,Germany,Europe,4,4,0,0,0,0,4,Unknown
1948-08-15 00:00:00,Private British,Landing (descent or approach),Business,United Kingdom,Europe,1,1,0,0,0,0,1,Human Factor
1948-08-27 00:00:00,British Overseas Airways Corporation - BOAC,Landing (descent or approach),Commercial,Singapore,Asia,18,6,0,12,0,0,18,Technical Failure
1948-08-27 00:00:00,Lineas Aéreas de Nicaragua - LANICA,,Commercial,Nicaragua,Central America,0,0,0,0,0,0,0,Unknown
1948-08-27 00:00:00,Aerovías Cubanas Internacionales,,Commercial,Cuba,Central America,0,0,0,0,0,0,0,Unknown
1948-08-29 00:00:00,Air France,,Other,France,Europe,0,0,0,0,0,0,0,Unknown
1948-09-02 00:00:00,Transair UK,Flight,Commercial,Switzerland,Europe,3,1,0,2,0,0,3,Unknown
1948-09-03 00:00:00,Lancashire Aircraft Corporation - LAC,Landing (descent or approach),Operational,United Kingdom,Europe,3,3,0,0,0,0,3,Unknown
1948-09-03 00:00:00,Air Portugal - Transportes Aéreos Portugueses,Landing (descent or approach),Operational,Portugal,Europe,5,5,0,0,0,0,5,Human Factor
1948-09-05 00:00:00,British Overseas Airways Corporation - BOAC,Takeoff (climb),Commercial,Indonesia,Asia,25,7,0,18,0,0,25,Technical Failure
1948-09-07 00:00:00,Superior Oil Corporation,Landing (descent or approach),Business,Italy,Europe,7,2,0,5,0,0,7,Unknown
1948-09-07 00:00:00,Aros-Flyg,Landing (descent or approach),Commercial,Sweden,Europe,0,0,0,0,0,0,0,Weather
1948-09-09 00:00:00,Uruguayan Air Force - Fuerza Aérea Uruguaya,Flight,Operational,Brazil,South America,3,3,0,0,0,0,3,Technical Failure
1948-09-19 00:00:00,Hall's Air Service,Takeoff (climb),Operational,Canada,North America,1,1,0,0,0,0,1,Unknown
1948-09-20 00:00:00,Colonial Airlines,Landing (descent or approach),Commercial,United States of America,North America,17,3,0,14,0,0,17,Human Factor
1948-09-22 00:00:00,Aerovias Guest,Takeoff (climb),Commercial,Portugal,Europe,44,9,0,35,0,0,44,Technical Failure
1948-09-23 00:00:00,Italian Air Force - Aeronautica Militare Italiana,Landing (descent or approach),Military / Government,Italy,Europe,0,0,0,0,0,0,0,Technical Failure
1948-09-23 00:00:00,Royal Air Force - RAF,Takeoff (climb),Military / Government,Germany,Europe,4,4,0,0,0,0,4,Human Factor
1948-09-24 00:00:00,Private Canadian,Landing (descent or approach),Business,Canada,North America,2,1,0,1,0,0,2,Other
1948-09-25 00:00:00,Noord Nederlandse Aero Club - NNAC,Flight,Business,Germany,Europe,3,1,0,2,0,0,3,Unknown
1948-09-26 00:00:00,Royal Air Force - RAF,Landing (descent or approach),Military / Government,Pakistan,Asia,0,0,0,0,0,0,0,Unknown
1948-09-27 00:00:00,SOMACO,Flight,Operational,Bosnia and Herzegovina,Europe,0,0,0,0,0,0,0,Unknown
1948-09-28 00:00:00,Brazilian Air Force - Força Aérea Brasileira,Flight,Operational,Brazil,South America,2,2,0,0,0,0,2,Unknown
1948-09-28 00:00:00,Ontario Provincial Air Service,Landing (descent or approach),Commercial,Canada,North America,1,1,0,0,0,0,1,Unknown
1948-09-30 00:00:00,Israeli Air Force - Heyl Ha'avir,Landing (descent or approach),Military / Government,Israel,Asia,0,0,0,0,0,0,0,Unknown
1948-10-02 00:00:00,Royal Air Force - RAF,Landing (descent or approach),Operational,United Kingdom,Europe,4,4,0,0,0,0,4,Human Factor
1948-10-04 00:00:00,Royal Air Force - RAF,Landing (descent or approach),Operational,United Kingdom,Europe,4,4,0,0,0,0,4,Unknown
1948-10-04 00:00:00,New England Air Express,Flight,Commercial,Bahamas,Central America,23,4,0,19,0,0,23,Technical Failure
1948-10-07 00:00:00,Linhas Aéreas Paulistas,Landing (descent or approach),Commercial,Brazil,South America,0,0,0,0,0,0,0,Weather
1948-10-08 00:00:00,World Air Freight,Takeoff (climb),Operational,Germany,Europe,5,5,0,0,0,0,5,Unknown
1948-10-08 00:00:00,Indian National Airways - INA,Takeoff (climb),Commercial,India,Asia,23,4,0,19,0,0,23,Technical Failure
1948-10-10 00:00:00,Royal Air Force - RAF,Landing (descent or approach),Operational,Germany,Europe,4,4,0,0,0,0,4,Human Factor
1948-10-12 00:00:00,Mercury Aviation,Takeoff (climb),Commercial,Sudan,Africa,26,5,0,21,0,0,26,Technical Failure
1948-10-12 00:00:00,Royal Air Force - RAF,Taxiing,Military / Government,Germany,Europe,0,0,0,0,0,0,0,Other
1948-10-13 00:00:00,Scottish Airlines,Landing (descent or approach),Operational,United Kingdom,Europe,4,4,0,0,0,0,4,Human Factor
1948-10-15 00:00:00,Brazilian Air Force - Força Aérea Brasileira,Landing (descent or approach),Operational,Brazil,South America,0,0,0,0,0,0,0,Unknown
1948-10-15 00:00:00,Israeli Air Force - Heyl Ha'avir,Landing (descent or approach),Military / Government,Israel,Asia,0,0,0,0,0,0,0,Unknown
1948-10-15 00:00:00,Canadian Government,Landing (descent or approach),Military / Government,Canada,North America,0,0,0,0,0,0,0,Unknown
1948-10-22 00:00:00,Royal Air Force - RAF,Landing (descent or approach),Operational,United Kingdom,Europe,2,2,0,0,0,0,2,Unknown
1948-10-25 00:00:00,Pacific Overseas Airlines - POA,Flight,Commercial,Indonesia,Asia,0,0,0,0,0,0,0,Terrorism
1948-10-31 00:00:00,Israeli Air Force - Heyl Ha'avir,Landing (descent or approach),Military / Government,Israel,Asia,2,2,0,0,0,0,2,Unknown
1948-11-03 00:00:00,Ulster Aviation,Taxiing,Operational,United Kingdom,Europe,2,2,0,0,0,0,2,Unknown
1948-11-05 00:00:00,Brazilian Air Force - Força Aérea Brasileira,Takeoff (climb),Military / Government,Brazil,South America,0,0,0,0,0,0,0,Unknown
1948-11-07 00:00:00,United States Air Force - USAF,Landing (descent or approach),Military / Government,Germany,Europe,3,3,0,0,0,0,3,Unknown
1948-11-10 00:00:00,Israeli Air Force - Heyl Ha'avir,Landing (descent or approach),Military / Government,Israel,Asia,0,0,0,0,0,0,0,Unknown
1948-11-10 00:00:00,Royal Air Force - RAF,Landing (descent or approach),Operational,United Kingdom,Europe,0,0,0,0,0,0,0,Unknown
1948-11-10 00:00:00,Royal Air Force - RAF,Takeoff (climb),Military / Government,Germany,Europe,4,4,0,0,0,0,4,Technical Failure
1948-11-12 00:00:00,United States Air Force - USAF,Flight,Military / Government,Micronesia,Oceania,10,10,0,0,0,0,10,Technical Failure
1948-11-13 00:00:00,British Overseas Airways Corporation - BOAC,Landing (descent or approach),Commercial,United Kingdom,Europe,9,5,0,4,0,0,9,Technical Failure
1948-11-15 00:00:00,United States Navy - USN,Landing (descent or approach),Military / Government,Germany,Europe,4,4,0,0,0,0,4,Unknown
1948-11-15 00:00:00,Philippine Airlines - PAL,Landing (descent or approach),Commercial,United States of America,North America,0,0,0,0,0,0,0,Unknown
1948-11-20 00:00:00,Mercury Aviation,Landing (descent or approach),Commercial,France,Europe,14,5,0,9,0,0,14,Human Factor
1948-11-21 00:00:00,Indian Overseas Airlines - IOA,,Commercial,India,Asia,0,0,0,0,0,0,0,Unknown
1948-11-22 00:00:00,Arab Contracting %26 Trading Company,Takeoff (climb),Operational,Iraq,Asia,2,2,0,0,0,0,2,Unknown
1948-11-23 00:00:00,Royal Air Force - RAF,Landing (descent or approach),Military / Government,Nigeria,Africa,7,7,0,0,0,0,7,Technical Failure
1948-11-24 00:00:00,Transportes Carga Aérea,Flight,Operational,Brazil,South America,15,3,0,12,0,0,15,Unknown
1948-11-25 00:00:00,Trans World Airlines - TWA,Landing (descent or approach),Commercial,United States of America,North America,23,5,0,18,0,0,23,Human Factor
1948-12-02 00:00:00,Royal Air Force - RAF,Landing (descent or approach),Operational,Germany,Europe,4,4,0,0,0,0,4,Human Factor
1948-12-03 00:00:00,CSA Czech Airlines - Československé Státní Aerolinie,Landing (descent or approach),Commercial,Czech Republic,Europe,0,0,0,0,0,0,0,Human Factor
1948-12-07 00:00:00,R. W. Duff,Landing (descent or approach),Business,Venezuela,South America,2,2,0,0,0,0,2,Unknown
1948-12-09 00:00:00,United States Air Force - USAF,Flight,Military / Government,Greenland,Europe,6,6,0,0,0,0,6,Technical Failure
1948-12-12 00:00:00,Peruvian International Airways,Landing (descent or approach),Commercial,Chile,South America,6,2,0,4,0,0,6,Unknown
1948-12-13 00:00:00,United States Air Force - USAF,Landing (descent or approach),Military / Government,Greenland,Europe,6,6,0,0,0,0,6,Unknown
1948-12-14 00:00:00,United States Air Force - USAF,Landing (descent or approach),Operational,Germany,Europe,4,4,0,0,0,0,4,Technical Failure
1948-12-14 00:00:00,Royal Air Force - RAF,Takeoff (climb),Operational,Germany,Europe,4,4,0,0,0,0,4,Weather
1948-12-14 00:00:00,Royal Air Force - RAF,Takeoff (climb),Operational,Germany,Europe,4,4,0,0,0,0,4,Weather
1948-12-15 00:00:00,Faucett,Flight,Commercial,Peru,South America,0,0,0,0,0,0,0,Technical Failure
1948-12-27 00:00:00,British European Airways - BEA,Landing (descent or approach),Humanitarian,United Kingdom,Europe,4,2,0,2,0,0,4,Unknown
1948-12-29 00:00:00,Australian National Airways - ANA,Landing (descent or approach),Operational,Australia,Oceania,3,3,0,0,0,0,3,Human Factor
1948-12-31 00:00:00,Iberia - Lineas Aéreas de Espana,,Commercial,Spain,Europe,0,0,0,0,0,0,0,Unknown
1948-12-31 00:00:00,Private Colombian,,Business,Colombia,South America,0,0,0,0,0,0,0,Unknown
1949-01-02 00:00:00,Israeli Air Force - Heyl Ha'avir,Landing (descent or approach),Military / Government,Israel,Asia,0,0,0,0,0,0,0,Unknown
1949-01-05 00:00:00,Private Mexican,Takeoff (climb),Business,Mexico,Central America,2,2,0,0,0,0,2,Unknown
1949-01-08 00:00:00,Air Algérie,Landing (descent or approach),Operational,France,Europe,3,3,0,0,0,0,3,Technical Failure
1949-01-15 00:00:00,Pan African Air Charter,Landing (descent or approach),Commercial,Egypt,Africa,30,4,0,26,0,0,30,Technical Failure
1949-01-15 00:00:00,British European Airways - BEA,Landing (descent or approach),Humanitarian,United Kingdom,Europe,5,2,0,3,0,0,5,Unknown
1949-01-17 00:00:00,Aerovias Nacionales del Sur - ANDES,Flight,Commercial,Peru,South America,15,5,0,10,0,0,15,Technical Failure
1949-01-20 00:00:00,Central Northern Airways,Flight,Commercial,Canada,North America,7,1,0,6,0,0,7,Technical Failure
1949-01-21 00:00:00,United States Navy - USN,Taxiing,Military / Government,Puerto Rico,Central America,8,8,0,0,0,0,8,Technical Failure
1949-01-26 00:00:00,Pan American World Airways - PAA,Takeoff (climb),Operational,Eritrea,Africa,4,4,0,0,0,0,4,Technical Failure
1949-01-26 00:00:00,African Air Cars,Landing (descent or approach),Operational,Tanzania,Africa,1,1,0,0,0,0,1,Technical Failure
1949-01-27 00:00:00,United Airlines,Takeoff (climb),Operational,United States of America,North America,3,3,0,0,0,0,3,Human Factor
1949-02-02 00:00:00,United States Air Force - USAF,Flight,Operational,United States of America,North America,5,5,0,0,0,0,5,Unknown
1949-02-03 00:00:00,Aeroflot - Russian International Airlines,Flight,Operational,Russia,Asia,2,2,0,0,0,0,2,Weather
1949-02-10 00:00:00,Lutheran Mission,Flight,Commercial,China,Asia,0,0,0,0,0,0,0,Technical Failure
1949-02-11 00:00:00,Aeronaves de Mexico,Takeoff (climb),Commercial,Mexico,Central America,7,2,0,5,0,0,7,Technical Failure
1949-02-11 00:00:00,British American Air Services - BAAS,Landing (descent or approach),Operational,Germany,Europe,3,3,0,0,0,0,3,Technical Failure
1949-02-14 00:00:00,Royal Air Force - RAF,Landing (descent or approach),Operational,United Kingdom,Europe,0,0,0,0,0,0,0,Technical Failure
1949-02-14 00:00:00,Newfoundland Airways,Landing (descent or approach),Commercial,Canada,North America,4,2,0,2,0,0,4,Unknown
1949-02-15 00:00:00,United States Air Force - USAF,Landing (descent or approach),Operational,Germany,Europe,3,3,0,0,0,0,3,Technical Failure
1949-02-15 00:00:00,United States Navy - USN,Landing (descent or approach),Military / Government,Germany,Europe,0,0,0,0,0,0,0,Human Factor
1949-02-15 00:00:00,Colombian Air Force - Fuerza Aérea Colombiana,Flight,Military / Government,Colombia,South America,4,3,0,1,0,0,4,Technical Failure
1949-02-15 00:00:00,Lineas Aéreas Unidas,,Commercial,Mexico,Central America,0,0,0,0,0,0,0,Unknown
1949-02-15 00:00:00,Bond Air Services,Landing (descent or approach),Operational,Germany,Europe,4,4,0,0,0,0,4,Technical Failure
1949-02-17 00:00:00,Shell Company of Ecuador,Flight,Business,Ecuador,South America,2,2,0,0,0,0,2,Unknown
1949-02-22 00:00:00,Golden North Airways,Landing (descent or approach),Commercial,United States of America,North America,6,4,0,2,0,0,6,Weather
1949-02-27 00:00:00,Compagnie Laotienne de Commerce et de Transport,Flight,Commercial,Vietnam,Asia,0,0,0,0,0,0,0,Unknown
1949-03-01 00:00:00,United States Air Force - USAF,Flight,Military / Government,Brazil,South America,0,0,0,0,0,0,0,Technical Failure
1949-03-08 00:00:00,Private British,Takeoff (climb),Business,United Kingdom,Europe,1,1,0,0,0,0,1,Technical Failure
1949-03-11 00:00:00,Lineas Aéreas de Nicaragua - LANICA,,Commercial,Nicaragua,Central America,0,0,0,0,0,0,0,Unknown
1949-03-16 00:00:00,Guinea Air Traders,,Commercial,Papua New Guinea,Oceania,0,0,0,0,0,0,0,Unknown
1949-03-22 00:00:00,Kenting Aviation,Takeoff (climb),Specialised Services,Jamaica,Central America,3,2,0,1,0,0,3,Unknown
1949-03-23 00:00:00,Royal Air Force - RAF,Landing (descent or approach),Operational,United Kingdom,Europe,4,4,0,0,0,0,4,Unknown
1949-03-24 00:00:00,United States Air Force - USAF,Flight,Military / Government,Canada,North America,7,7,0,0,0,0,7,Technical Failure
1949-03-26 00:00:00,Freight Air,Flight,Operational,Mexico,Central America,2,2,0,0,0,0,2,Technical Failure
1949-03-27 00:00:00,United States Navy - USN,Flight,Military / Government,World,World,11,11,0,0,0,0,11,Unknown
1949-03-29 00:00:00,Aerovias Brasil,,Commercial,Brazil,South America,0,0,0,0,0,0,0,Unknown
1949-04-01 00:00:00,Westminster Airways,Landing (descent or approach),Operational,Germany,Europe,3,3,0,0,0,0,3,Unknown
1949-04-05 00:00:00,Myanmar Air Force - Tatmadaw Lei,Landing (descent or approach),Military / Government,Myanmar,Asia,0,0,0,0,0,0,0,Unknown
1949-04-06 00:00:00,Royal Air Force - RAF,Parking,Operational,Germany,Europe,3,3,0,0,0,0,3,Technical Failure
1949-04-07 00:00:00,Qantas Airways - Queensland and Northern Territory Aerial Services,Landing (descent or approach),Operational,Australia,Oceania,8,8,0,0,0,0,8,Human Factor
1949-04-07 00:00:00,Air India,Takeoff (climb),Commercial,India,Asia,25,3,0,22,0,0,25,Technical Failure
1949-04-09 00:00:00,Italian Air Force - Aeronautica Militare Italiana,Takeoff (climb),Specialised Services,Italy,Europe,5,5,0,0,0,0,5,Technical Failure
1949-04-09 00:00:00,Air France,Landing (descent or approach),Commercial,France,Europe,35,5,0,30,0,0,35,Unknown
1949-04-09 00:00:00,Bond Air Services,Landing (descent or approach),Operational,Germany,Europe,3,3,0,0,0,0,3,Unknown
1949-04-18 00:00:00,Argentinian Navy - Armada Argentina,,Military / Government,Argentina,South America,0,0,0,0,0,0,0,Unknown
1949-04-20 00:00:00,Transportes Carga Aérea,Landing (descent or approach),Operational,Brazil,South America,3,3,0,0,0,0,3,Technical Failure
1949-04-21 00:00:00,Royal Air Force - RAF,Landing (descent or approach),Military / Government,Germany,Europe,5,5,0,0,0,0,5,Technical Failure
1949-04-21 00:00:00,British South American Airways - BSAA,Takeoff (climb),Operational,United Kingdom,Europe,2,2,0,0,0,0,2,Technical Failure
1949-04-23 00:00:00,TAE National Greek Airlines,Landing (descent or approach),Operational,Greece,Europe,4,4,0,0,0,0,4,Unknown
1949-04-25 00:00:00,Guinea Air Traders,Landing (descent or approach),Humanitarian,Papua New Guinea,Oceania,2,1,0,1,0,0,2,Technical Failure
1949-04-27 00:00:00,United States Air Force - USAF,Flight,Military / Government,World,World,4,4,0,0,0,0,4,Technical Failure
1949-05-04 00:00:00,Continental Charters,Takeoff (climb),Operational,United States of America,Central America,3,3,0,0,0,0,3,Human Factor
1949-05-05 00:00:00,Private Brazilian,Flight,Business,Brazil,South America,0,0,0,0,0,0,0,Unknown
1949-05-06 00:00:00,United States Navy - USN,Landing (descent or approach),Operational,United States of America,North America,0,0,0,0,0,0,0,Other
1949-05-06 00:00:00,Starways,Flight,Commercial,United Kingdom,Europe,4,1,0,3,0,0,4,Unknown
1949-05-10 00:00:00,Flight Refuelling,Flight,Operational,Germany,Europe,4,4,0,0,0,0,4,Technical Failure
1949-05-11 00:00:00,Qantas Airways - Queensland and Northern Territory Aerial Services,Takeoff (climb),Operational,Papua New Guinea,Oceania,1,1,0,0,0,0,1,Other
1949-05-13 00:00:00,Transandina Ecuador,Takeoff (climb),Operational,Ecuador,South America,3,3,0,0,0,0,3,Unknown
1949-05-18 00:00:00,Société Indochinoise de Transports Aériens - SITA,,Commercial,Vietnam,Asia,0,0,0,0,0,0,0,Unknown
1949-05-20 00:00:00,United States Air Force - USAF,Takeoff (climb),Operational,Canada,North America,6,6,0,0,0,0,6,Human Factor
1949-05-23 00:00:00,Royal Air Force - RAF,Taxiing,Military / Government,United Kingdom,Europe,0,0,0,0,0,0,0,Unknown
1949-05-26 00:00:00,Czech Air Force - Ceské Vojenské Letectvo,Flight,Military / Government,Czech Republic,Europe,7,7,0,0,0,0,7,Weather
1949-05-26 00:00:00,Royal Air Force - RAF,Landing (descent or approach),Operational,United Kingdom,Europe,0,0,0,0,0,0,0,Unknown
1949-05-30 00:00:00,United States Navy - USN,Landing (descent or approach),Military / Government,Canada,North America,0,0,0,0,0,0,0,Technical Failure
1949-06-01 00:00:00,Lancashire Aircraft Corporation - LAC,Landing (descent or approach),Operational,Germany,Europe,4,4,0,0,0,0,4,Unknown
1949-06-03 00:00:00,Ransa - Rutas Aéreas Nacionales,Takeoff (climb),Operational,United States of America,North America,3,3,0,0,0,0,3,Technical Failure
1949-06-09 00:00:00,Canadian Pacific Airlines - CP Air,,Commercial,Canada,North America,0,0,0,0,0,0,0,Unknown
1949-06-12 00:00:00,Lancashire Aircraft Corporation - LAC,Landing (descent or approach),Operational,Germany,Europe,4,4,0,0,0,0,4,Technical Failure
1949-06-13 00:00:00,El Al Israel Airlines,Flight,Commercial,Israel,Asia,10,2,0,8,0,0,10,Unknown
1949-06-13 00:00:00,El Al Israel Airlines,Flight,Commercial,Israel,Asia,10,2,0,8,0,0,10,Unknown
1949-06-16 00:00:00,Somerton Airways,Landing (descent or approach),Commercial,United Kingdom,Europe,7,1,0,6,0,0,7,Human Factor
1949-06-19 00:00:00,Skyways of London,Takeoff (climb),Operational,Germany,Europe,3,3,0,0,0,0,3,Technical Failure
1949-06-22 00:00:00,American Airlines,Takeoff (climb),Commercial,United States of America,North America,44,3,0,41,0,0,44,Technical Failure
1949-06-24 00:00:00,United States Navy - USN,Landing (descent or approach),Military / Government,Canada,North America,0,0,0,0,0,0,0,Unknown
1949-06-25 00:00:00,United States Air Force - USAF,Landing (descent or approach),Military / Government,Germany,Europe,3,3,0,0,0,0,3,Unknown
1949-06-26 00:00:00,Skyways of London,Landing (descent or approach),Operational,Germany,Europe,3,3,0,0,0,0,3,Human Factor
1949-06-26 00:00:00,El Al Israel Airlines,Takeoff (climb),Operational,Israel,Asia,13,2,0,11,0,0,13,Unknown
1949-06-28 00:00:00,Société Indochinoise de Transports Aériens - SITA,Parking,Commercial,Vietnam,Asia,0,0,0,0,0,0,0,Unknown
1949-07-04 00:00:00,Yellowknife Airways,Takeoff (climb),Commercial,Canada,North America,3,1,0,2,0,0,3,Unknown
1949-07-06 00:00:00,Lancashire Aircraft Corporation - LAC,Landing (descent or approach),Operational,Germany,Europe,4,4,0,0,0,0,4,Technical Failure
1949-07-11 00:00:00,Hong Kong Airways,Takeoff (climb),Commercial,China,Asia,11,3,0,8,0,0,11,Unknown
1949-07-11 00:00:00,Société de Construction AéroNavale,Flight,Specialised Services,France,Europe,0,0,0,0,0,0,0,Unknown
1949-07-13 00:00:00,Royal Air Force - RAF,Landing (descent or approach),Operational,United Kingdom,Europe,0,0,0,0,0,0,0,Unknown
1949-07-14 00:00:00,United States Air Force - USAF,Landing (descent or approach),Military / Government,United States of America,North America,0,0,0,0,0,0,0,Unknown
1949-07-15 00:00:00,Olley Air Service,Flight,Commercial,United Kingdom,Europe,3,1,0,2,0,0,3,Unknown
1949-07-16 00:00:00,Anglo-Iranian Oil Company,Parking,Business,Iran,Asia,6,1,0,5,0,0,6,Technical Failure
1949-07-21 00:00:00,United States Air Force - USAF,Flight,Military / Government,United Kingdom,Europe,12,12,0,0,0,0,12,Unknown
1949-07-23 00:00:00,Scottish Airlines,Parking,Commercial,United Kingdom,Europe,1,1,0,0,0,0,1,Technical Failure
1949-07-30 00:00:00,Royal Air Force - RAF,Takeoff (climb),Military / Government,Germany,Europe,5,5,0,0,0,0,5,Technical Failure
1949-08-03 00:00:00,Lineas Aéreas Brasileiras - LAB,Landing (descent or approach),Commercial,Brazil,South America,15,4,0,11,0,0,15,Technical Failure
1949-08-10 00:00:00,Lloyd Aéreo Boliviano - LAB Airlines,,Commercial,Bolivia,South America,0,0,0,0,0,0,0,Unknown
1949-08-11 00:00:00,Northeast Airlines - USA,Landing (descent or approach),Commercial,United States of America,North America,28,3,0,25,0,0,28,Technical Failure
1949-08-14 00:00:00,Belgian International Air Services - BIAS,Landing (descent or approach),Operational,Netherlands,Europe,2,2,0,0,0,0,2,Human Factor
1949-08-15 00:00:00,Israeli Air Force - Heyl Ha'avir,Takeoff (climb),Operational,France,Europe,0,0,0,0,0,0,0,Unknown
1949-08-16 00:00:00,Lineas Aéreas Guerrero Oaxaca - LAGOSA,Takeoff (climb),Operational,Mexico,Central America,2,2,0,0,0,0,2,Technical Failure
1949-08-17 00:00:00,Youngmacs Prospecting %26 Development Company,Landing (descent or approach),Operational,Canada,North America,1,1,0,0,0,0,1,Other
1949-08-24 00:00:00,David Brown %26 Sons,Takeoff (climb),Business,United Kingdom,Europe,0,0,0,0,0,0,0,Unknown
1949-08-29 00:00:00,Royal Air Force - RAF,Flight,Operational,United Kingdom,Europe,3,3,0,0,0,0,3,Human Factor
1949-08-31 00:00:00,Argentinian Air Force - Fuerza Aérea Argentina,Takeoff (climb),Military / Government,Argentina,South America,4,4,0,0,0,0,4,Technical Failure
1949-08-31 00:00:00,Royal Air Force - RAF,Landing (descent or approach),Operational,United Kingdom,Europe,2,2,0,0,0,0,2,Human Factor
1949-08-31 00:00:00,Vestlandske Flyveselskap,,Commercial,Norway,Europe,0,0,0,0,0,0,0,Unknown
1949-09-02 00:00:00,Brazilian Air Force - Força Aérea Brasileira,Takeoff (climb),Operational,Brazil,South America,5,5,0,0,0,0,5,Unknown
1949-09-05 00:00:00,Royal Air Force - RAF,Landing (descent or approach),Operational,United Kingdom,Europe,3,3,0,0,0,0,3,Technical Failure
1949-09-06 00:00:00,Lloyd Aéreo Boliviano - LAB Airlines,Flight,Military / Government,Bolivia,South America,0,0,0,0,0,0,0,Terrorism
1949-09-13 00:00:00,Cathay Pacific Airways,Takeoff (climb),Commercial,Myanmar,Asia,0,0,0,0,0,0,0,Technical Failure
1949-09-13 00:00:00,Royal Air Force - RAF,Takeoff (climb),Operational,United Kingdom,Europe,2,2,0,0,0,0,2,Technical Failure
1949-09-24 00:00:00,Anglo-Iranian Oil Company,Takeoff (climb),Business,Iran,Asia,2,2,0,0,0,0,2,Technical Failure
1949-09-29 00:00:00,Royal Air Force - RAF,Landing (descent or approach),Operational,United Kingdom,Europe,4,4,0,0,0,0,4,Human Factor
1949-09-29 00:00:00,General Electric,Landing (descent or approach),Business,United States of America,North America,3,2,0,1,0,0,3,Human Factor
1949-10-02 00:00:00,Qantas Airways - Queensland and Northern Territory Aerial Services,Landing (descent or approach),Commercial,Papua New Guinea,Oceania,4,1,0,3,0,0,4,Human Factor
1949-10-02 00:00:00,Arab Contracting %26 Trading Company,Landing (descent or approach),Business,Iraq,Asia,0,0,0,0,0,0,0,Technical Failure
1949-10-04 00:00:00,Weston Air Service,Landing (descent or approach),Commercial,United Kingdom,Europe,7,2,0,5,0,0,7,Unknown
1949-10-08 00:00:00,Royal Air Force - RAF,Landing (descent or approach),Operational,Libya,Africa,3,3,0,0,0,0,3,Human Factor
1949-10-09 00:00:00,United States Air Force - USAF,Takeoff (climb),Military / Government,Canada,North America,10,6,0,4,0,0,10,Other
1949-10-12 00:00:00,East West Airlines - Australia,Takeoff (climb),Commercial,Australia,Oceania,8,1,0,7,0,0,8,Technical Failure
1949-10-13 00:00:00,Private Mexican,,Business,Mexico,Central America,0,0,0,0,0,0,0,Unknown
1949-10-14 00:00:00,Brazilian Air Force - Força Aérea Brasileira,Flight,Military / Government,Bolivia,South America,5,5,0,0,0,0,5,Unknown
1949-10-17 00:00:00,Services Aériens Internationaux d'Égypte - SAIDE,Takeoff (climb),Commercial,Egypt,Africa,0,0,0,0,0,0,0,Unknown
1949-10-18 00:00:00,SNCASE - Société Nationale de Constructions Aéronautiques du Sud-Est,Landing (descent or approach),Specialised Services,France,Europe,8,8,0,0,0,0,8,Human Factor
1949-10-20 00:00:00,Air France,Landing (descent or approach),Commercial,Pakistan,Asia,0,0,0,0,0,0,0,Human Factor
1949-10-22 00:00:00,Société Transafricaine d'Aviation - STA,,Other,South Sudan,Africa,0,0,0,0,0,0,0,Unknown
1949-11-01 00:00:00,International Airways,Landing (descent or approach),Commercial,United Kingdom,Europe,3,1,0,2,0,0,3,Unknown
1949-11-03 00:00:00,Gold Belt Air Service,Landing (descent or approach),Commercial,Canada,North America,0,0,0,0,0,0,0,Human Factor
1949-11-04 00:00:00,United States Air Force - USAF,Takeoff (climb),Operational,United States of America,North America,9,9,0,0,0,0,9,Technical Failure
1949-11-04 00:00:00,Pacific Petroleum,Takeoff (climb),Business,Canada,North America,8,2,0,6,0,0,8,Technical Failure
1949-11-07 00:00:00,British Overseas Airways Corporation - BOAC,Landing (descent or approach),Commercial,Libya,Africa,0,0,0,0,0,0,0,Unknown
1949-11-08 00:00:00,Civil Air Transport,Flight,Commercial,China,Asia,0,0,0,0,0,0,0,Unknown
1949-11-10 00:00:00,Royal Air Force - RAF,Flight,Operational,United Kingdom,Europe,5,5,0,0,0,0,5,Other
1949-11-13 00:00:00,Myanmar Air Force - Tatmadaw Lei,Landing (descent or approach),Military / Government,Myanmar,Asia,0,0,0,0,0,0,0,Unknown
1949-11-15 00:00:00,Royal Air Force - RAF,Landing (descent or approach),Military / Government,Kenya,Africa,27,4,0,23,0,0,27,Human Factor
1949-11-15 00:00:00,Linee Aeree Transcontinentali Italiane - LATI,Landing (descent or approach),Commercial,Western Sahara,Africa,17,5,0,12,0,0,17,Unknown
1949-11-17 00:00:00,Trans Asiatic Airlines - TAA,Landing (descent or approach),Commercial,Myanmar,Asia,0,0,0,0,0,0,0,Unknown
1949-11-23 00:00:00,Royal Air Force - RAF,Takeoff (climb),Operational,United Kingdom,Europe,3,3,0,0,0,0,3,Technical Failure
1949-11-24 00:00:00,Aviaco - Aviacion y Comercio,Landing (descent or approach),Commercial,Spain,Europe,26,4,0,22,0,0,26,Human Factor
1949-11-28 00:00:00,Royal Air Force - RAF,Takeoff (climb),Military / Government,Egypt,Africa,0,0,0,0,0,0,0,Technical Failure
1949-11-29 00:00:00,Noon %26 Pearce Air Charters,Parking,Commercial,Uganda,Africa,1,1,0,0,0,0,1,Technical Failure
1949-12-08 00:00:00,Royal Air Force - RAF,Landing (descent or approach),Operational,United Kingdom,Europe,3,3,0,0,0,0,3,Technical Failure
1949-12-18 00:00:00,Air Jordan,Takeoff (climb),Commercial,Lebanon,Asia,10,2,0,8,0,0,10,Technical Failure
1949-12-21 00:00:00,Air Ceylon,Landing (descent or approach),Commercial,India,Asia,24,3,0,21,0,0,24,Technical Failure
1949-12-22 00:00:00,United States Navy - USN,Landing (descent or approach),Military / Government,United States of America,North America,0,0,0,0,0,0,0,Unknown
1949-12-23 00:00:00,Alitalia - Linee Aeree Italiane,Landing (descent or approach),Commercial,Senegal,Africa,13,5,0,8,0,0,13,Unknown
1949-12-28 00:00:00,Lancashire Aircraft Corporation - LAC,Taxiing,Operational,France,Europe,3,3,0,0,0,0,3,Unknown
1949-12-30 00:00:00,Bharat Airways,Flight,Operational,Bangladesh,Asia,3,3,0,0,0,0,3,Technical Failure
1949-12-31 00:00:00,Airwork East Africa,,Commercial,Tanzania,Africa,0,0,0,0,0,0,0,Unknown
1949-12-31 00:00:00,Caspar Air Charters,Landing (descent or approach),Operational,Kenya,Africa,1,1,0,0,0,0,1,Unknown
1950-01-05 00:00:00,Companhia Itaú de Transportes Aéreos,Landing (descent or approach),Operational,Brazil,South America,3,3,0,0,0,0,3,Technical Failure
1950-01-06 00:00:00,United States Air Force - USAF,Takeoff (climb),Military / Government,Turkey,Asia,0,0,0,0,0,0,0,Technical Failure
1950-01-07 00:00:00,Lineas Aéreas Guerrero Oaxaca - LAGOSA,Takeoff (climb),Commercial,Mexico,Central America,0,0,0,0,0,0,0,Unknown
1950-01-10 00:00:00,Italian Air Force - Aeronautica Militare Italiana,Takeoff (climb),Military / Government,Italy,Europe,0,0,0,0,0,0,0,Unknown
1950-01-10 00:00:00,Air Nolis,Landing (descent or approach),Operational,Niger,Africa,3,3,0,0,0,0,3,Unknown
1950-01-11 00:00:00,United States Air Force - USAF,Landing (descent or approach),Military / Government,United States of America,North America,28,3,0,25,0,0,28,Human Factor
1950-01-12 00:00:00,Royal Air Force - RAF,Landing (descent or approach),Operational,United Kingdom,Europe,5,5,0,0,0,0,5,Unknown
1950-01-14 00:00:00,New Zealand National Airways,Parking,Commercial,New Zealand,Oceania,5,1,0,4,0,0,5,Technical Failure
1950-01-18 00:00:00,Trans Asiatic Airlines - TAA,Takeoff (climb),Commercial,Myanmar,Asia,0,0,0,0,0,0,0,Technical Failure
1950-01-20 00:00:00,World Air Freight,Landing (descent or approach),Operational,Italy,Europe,6,6,0,0,0,0,6,Unknown
1950-01-22 00:00:00,Central African Airways - CAA,Landing (descent or approach),Commercial,Zambia,Africa,0,0,0,0,0,0,0,Unknown
1950-01-25 00:00:00,Air Services of India,Takeoff (climb),Operational,India,Asia,3,3,0,0,0,0,3,Unknown
1950-01-29 00:00:00,Air Nolis,Flight,Operational,France,Europe,3,3,0,0,0,0,3,Technical Failure
1950-01-30 00:00:00,United States Air Force - USAF,Flight,Military / Government,Canada,North America,6,6,0,0,0,0,6,Unknown
1950-02-01 00:00:00,United States Air Force - USAF,Landing (descent or approach),Military / Government,United States of America,North America,5,5,0,0,0,0,5,Technical Failure
1950-02-01 00:00:00,British Overseas Airways Corporation - BOAC,Landing (descent or approach),Specialised Services,United Kingdom,Europe,11,6,0,5,0,0,11,Weather
1950-02-05 00:00:00,El Al Israel Airlines,Takeoff (climb),Commercial,Israel,Asia,50,4,0,46,0,0,50,Unknown
1950-02-07 00:00:00,United States Air Force - USAF,Flight,Military / Government,Canada,North America,10,5,0,5,0,0,10,Weather
1950-02-07 00:00:00,Royal New Zealand Air Force - RNZAF,Takeoff (climb),Military / Government,New Zealand,Oceania,0,0,0,0,0,0,0,Unknown
1950-02-09 00:00:00,Canadian Pacific Airlines - CP Air,Landing (descent or approach),Commercial,Japan,Asia,15,5,0,10,0,0,15,Unknown
1950-02-10 00:00:00,United States Air Force - USAF,Landing (descent or approach),Military / Government,United States of America,North America,7,7,0,0,0,0,7,Unknown
1950-02-10 00:00:00,Transair UK,Landing (descent or approach),Operational,France,Europe,2,2,0,0,0,0,2,Technical Failure
1950-02-12 00:00:00,DETA Mozambique Airlines - Direcção de Exploração dos Transportes Aéreos,Flight,Commercial,Mozambique,Africa,15,3,0,12,0,0,15,Unknown
1950-02-13 00:00:00,Private American,Flight,Business,United States of America,North America,0,0,0,0,0,0,0,Unknown
1950-02-16 00:00:00,Air France,Landing (descent or approach),Operational,Benin,Africa,3,3,0,0,0,0,3,Technical Failure
1950-02-16 00:00:00,Royal Canadian Air Force - RCAF,Takeoff (climb),Operational,Canada,North America,6,6,0,0,0,0,6,Human Factor
1950-02-22 00:00:00,United States Air Force - USAF,Flight,Military / Government,United States of America,North America,2,2,0,0,0,0,2,Unknown
1950-02-28 00:00:00,Royal Air Force - RAF,Landing (descent or approach),Operational,United Kingdom,Europe,0,0,0,0,0,0,0,Unknown
1950-03-01 00:00:00,United States Air Force - USAF,Landing (descent or approach),Military / Government,United States of America,North America,0,0,0,0,0,0,0,Unknown
1950-03-02 00:00:00,Misrair,,Operational,Egypt,Africa,0,0,0,0,0,0,0,Unknown
1950-03-02 00:00:00,British Government,Flight,Military / Government,Zimbabwe,Africa,0,0,0,0,0,0,0,Unknown
1950-03-02 00:00:00,Brazilian Air Force - Força Aérea Brasileira,Landing (descent or approach),Specialised Services,Brazil,South America,5,2,0,3,0,0,5,Unknown
1950-03-04 00:00:00,United States Air Force - USAF,Flight,Military / Government,United States of America,North America,0,0,0,0,0,0,0,Unknown
1950-03-07 00:00:00,Northwest Airlines,Landing (descent or approach),Commercial,United States of America,North America,13,3,0,10,0,0,13,Human Factor
1950-03-11 00:00:00,Avianca,Takeoff (climb),Commercial,Colombia,South America,0,0,0,0,0,0,0,Unknown
1950-03-15 00:00:00,Royal Air Force - RAF,Landing (descent or approach),Operational,United Kingdom,Europe,3,3,0,0,0,0,3,Technical Failure
1950-03-15 00:00:00,Royal Air Force - RAF,Flight,Operational,United Kingdom,Europe,6,6,0,0,0,0,6,Technical Failure
1950-03-15 00:00:00,Royal Air Force - RAF,Landing (descent or approach),Operational,United Kingdom,Europe,0,0,0,0,0,0,0,Human Factor
1950-03-16 00:00:00,Royal Air Force - RAF,Landing (descent or approach),Military / Government,Tanzania,Africa,0,0,0,0,0,0,0,Unknown
1950-03-19 00:00:00,Hudiksvalls Flygklubb,Takeoff (climb),Business,Sweden,Europe,1,1,0,0,0,0,1,Unknown
1950-03-28 00:00:00,LOT Polish Airlines - Polskie Linie Lotnicze,Landing (descent or approach),Commercial,Poland,Europe,0,0,0,0,0,0,0,Unknown
1950-03-28 00:00:00,United States Air Force - USAF,Flight,Military / Government,United States of America,North America,0,0,0,0,0,0,0,Technical Failure
1950-03-28 00:00:00,United States Air Force - USAF,Landing (descent or approach),Military / Government,Canada,North America,7,7,0,0,0,0,7,Unknown
1950-03-29 00:00:00,LOT Polish Airlines - Polskie Linie Lotnicze,Landing (descent or approach),Commercial,Poland,Europe,0,0,0,0,0,0,0,Unknown
1950-04-03 00:00:00,French Government,Takeoff (climb),Military / Government,Vietnam,Asia,3,1,0,2,0,0,3,Unknown
1950-04-05 00:00:00,United States Navy - USN,Landing (descent or approach),Military / Government,United States of America,North America,0,0,0,0,0,0,0,Technical Failure
1950-04-09 00:00:00,Caribbean International Airways,Landing (descent or approach),Operational,Jamaica,Central America,4,2,0,2,0,0,4,Technical Failure
1950-04-10 00:00:00,United States Air Force - USAF,Landing (descent or approach),Military / Government,United States of America,North America,0,0,0,0,0,0,0,Technical Failure
1950-04-13 00:00:00,United States Air Force - USAF,Takeoff (climb),Military / Government,Canada,North America,0,0,0,0,0,0,0,Unknown
1950-04-13 00:00:00,South African Air Force,Takeoff (climb),Military / Government,South Africa,Africa,0,0,0,0,0,0,0,Unknown
1950-04-15 00:00:00,Myanmar Air Force - Tatmadaw Lei,Takeoff (climb),Military / Government,Myanmar,Asia,0,0,0,0,0,0,0,Unknown
1950-04-21 00:00:00,United States Air Force - USAF,Takeoff (climb),Military / Government,United States of America,North America,0,0,0,0,0,0,0,Unknown
1950-04-23 00:00:00,Polyarnaya Aviatsiya,Landing (descent or approach),Commercial,Russia,Asia,9,8,0,1,0,0,9,Weather
1950-04-24 00:00:00,Lloyd Aéreo Boliviano - LAB Airlines,Landing (descent or approach),Commercial,Bolivia,South America,2,2,0,0,0,0,2,Unknown
1950-04-26 00:00:00,United States Air Force - USAF,Flight,Military / Government,United States of America,North America,4,4,0,0,0,0,4,Technical Failure
1950-04-26 00:00:00,Dennis Aviation,Flight,Operational,Belgium,Europe,2,2,0,0,0,0,2,Unknown
1950-04-29 00:00:00,Royal Canadian Air Force - RCAF,Landing (descent or approach),Military / Government,Canada,North America,0,0,0,0,0,0,0,Unknown
1950-05-02 00:00:00,French Government,Flight,Military / Government,Burkina Faso,Africa,13,3,0,10,0,0,13,Weather
1950-05-03 00:00:00,Royal Air Force - RAF,Landing (descent or approach),Military / Government,Iraq,Asia,0,0,0,0,0,0,0,Technical Failure
1950-05-05 00:00:00,United States Air Force - USAF,Takeoff (climb),Military / Government,United States of America,North America,31,3,0,28,0,0,31,Unknown
1950-05-12 00:00:00,East African Airways,Landing (descent or approach),Commercial,Tanzania,Africa,0,0,0,0,0,0,0,Unknown
1950-05-15 00:00:00,Det Norske Luftfartselskap - DNL,Takeoff (climb),Commercial,Norway,Europe,33,7,0,26,0,0,33,Unknown
1950-05-17 00:00:00,Airways India,Landing (descent or approach),Commercial,India,Asia,0,0,0,0,0,0,0,Unknown
1950-05-17 00:00:00,United States Air Force - USAF,Flight,Operational,United States of America,North America,4,4,0,0,0,0,4,Technical Failure
1950-05-24 00:00:00,United States Navy - USN,Flight,Operational,World,World,0,0,0,0,0,0,0,Terrorism
1950-05-26 00:00:00,VASP - Viação Aérea de São Paulo,Takeoff (climb),Commercial,Brazil,South America,24,4,0,20,0,0,24,Technical Failure
1950-05-26 00:00:00,Royal Air Force - RAF,Takeoff (climb),Military / Government,Malta,Europe,0,0,0,0,0,0,0,Human Factor
1950-06-10 00:00:00,United States Air Force - USAF,Takeoff (climb),Military / Government,United States of America,North America,18,2,0,16,0,0,18,Technical Failure
1950-06-12 00:00:00,Aerolineas Argentinas,Landing (descent or approach),Commercial,Argentina,South America,0,0,0,0,0,0,0,Unknown
1950-06-15 00:00:00,Myanmar Air Force - Tatmadaw Lei,Flight,Operational,Myanmar,Asia,0,0,0,0,0,0,0,Human Factor
1950-06-15 00:00:00,Pan American World Airways - PAA,Flight,Operational,Mexico,Central America,2,2,0,0,0,0,2,Technical Failure
1950-06-16 00:00:00,United States Air Force - USAF,Landing (descent or approach),Military / Government,United Kingdom,Europe,0,0,0,0,0,0,0,Unknown
1950-06-16 00:00:00,United States Air Force - USAF,Flight,Military / Government,World,World,0,0,0,0,0,0,0,Technical Failure
1950-06-19 00:00:00,MAP - Ministerstvo Aviatsionnoi Promyshlennosti - Minaviaprom,Flight,Military / Government,Russia,Asia,0,0,0,0,0,0,0,Unknown
1950-06-28 00:00:00,Royal Norwegian Air Force - Kongelige Norske Luftforsvaret,Taxiing,Military / Government,Norway,Europe,0,0,0,0,0,0,0,Unknown
1950-06-29 00:00:00,United States Air Force - USAF,Flight,Military / Government,United States of America,North America,5,5,0,0,0,0,5,Technical Failure
1950-06-30 00:00:00,Ransa - Rutas Aéreas Nacionales,,Commercial,Venezuela,South America,0,0,0,0,0,0,0,Unknown
1950-06-30 00:00:00,Wolverhampton Aviation,Parking,Commercial,United Kingdom,Europe,0,0,0,0,0,0,0,Technical Failure
1950-07-04 00:00:00,Royal Air Force - RAF,Landing (descent or approach),Operational,Zimbabwe,Africa,2,2,0,0,0,0,2,Technical Failure
1950-07-09 00:00:00,Governo do Acre,Takeoff (climb),Operational,Brazil,South America,2,2,0,0,0,0,2,Unknown
1950-07-11 00:00:00,Gibbes Sepik Airways,Takeoff (climb),Operational,Papua New Guinea,Oceania,1,1,0,0,0,0,1,Human Factor
1950-07-12 00:00:00,United States Air Force - USAF,Flight,Military / Government,World,World,13,13,0,0,0,0,13,Terrorism
1950-07-13 00:00:00,United States Air Force - USAF,Taxiing,Military / Government,South Korea,Asia,0,0,0,0,0,0,0,Unknown
1950-07-14 00:00:00,United States Air Force - USAF,Takeoff (climb),Operational,Bermuda,North America,0,0,0,0,0,0,0,Human Factor
1950-07-18 00:00:00,United States Air Force - USAF,Takeoff (climb),Military / Government,United States of America,North America,0,0,0,0,0,0,0,Unknown
1950-07-18 00:00:00,Royal Air Force - RAF,Flight,Military / Government,United Kingdom,Europe,2,2,0,0,0,0,2,Technical Failure
1950-07-21 00:00:00,United States Air Force - USAF,Landing (descent or approach),Military / Government,United States of America,North America,0,0,0,0,0,0,0,Unknown
1950-07-23 00:00:00,British Government,Flight,Military / Government,Zimbabwe,Africa,0,0,0,0,0,0,0,Technical Failure
1950-07-26 00:00:00,United States Air Force - USAF,Landing (descent or approach),Military / Government,Japan,Asia,0,0,0,0,0,0,0,Unknown
1950-07-29 00:00:00,CSA Czech Airlines - Československé Státní Aerolinie,Takeoff (climb),Operational,Slovakia,Europe,2,2,0,0,0,0,2,Technical Failure
1950-07-29 00:00:00,Flugferdir,,Commercial,Iceland,Europe,0,0,0,0,0,0,0,Unknown
1950-07-30 00:00:00,Flying Tiger Line,Takeoff (climb),Operational,United States of America,North America,4,2,0,2,0,0,4,Other
1950-07-30 00:00:00,Air France,Landing (descent or approach),Commercial,France,Europe,31,7,0,24,0,0,31,Technical Failure
1950-07-31 00:00:00,United States Air Force - USAF,Flight,Operational,United States of America,North America,0,0,0,0,0,0,0,Unknown
1950-07-31 00:00:00,Royal Air Force - RAF,Landing (descent or approach),Operational,United Kingdom,Europe,4,4,0,0,0,0,4,Human Factor
1950-08-03 00:00:00,United States Air Force - USAF,Landing (descent or approach),Operational,United States of America,North America,0,0,0,0,0,0,0,Unknown
1950-08-03 00:00:00,United States Air Force - USAF,Takeoff (climb),Military / Government,United States of America,North America,5,3,0,2,0,0,5,Unknown
1950-08-04 00:00:00,United States Air Force - USAF,Landing (descent or approach),Military / Government,United States of America,North America,0,0,0,0,0,0,0,Unknown
1950-08-04 00:00:00,United States Navy - USN,Landing (descent or approach),Military / Government,United States of America,North America,6,6,0,0,0,0,6,Technical Failure
1950-08-05 00:00:00,CSA Czech Airlines - Československé Státní Aerolinie,Landing (descent or approach),Commercial,Slovakia,Europe,23,3,0,20,0,0,23,Unknown
1950-08-13 00:00:00,United States Air Force - USAF,Flight,Operational,United States of America,North America,0,0,0,0,0,0,0,Technical Failure
1950-08-13 00:00:00,United States Air Force - USAF,Landing (descent or approach),Military / Government,United States of America,North America,0,0,0,0,0,0,0,Unknown
1950-08-14 00:00:00,United States Air Force - USAF,Flight,Military / Government,Japan,Asia,3,3,0,0,0,0,3,Technical Failure
1950-08-16 00:00:00,United States Navy - USN,Flight,Military / Government,North Korea,Asia,9,9,0,0,0,0,9,Terrorism
1950-08-17 00:00:00,United States Air Force - USAF,Takeoff (climb),Military / Government,United States of America,North America,0,0,0,0,0,0,0,Unknown
1950-08-19 00:00:00,United States Air Force - USAF,Takeoff (climb),Military / Government,South Korea,Asia,0,0,0,0,0,0,0,Unknown
1950-08-19 00:00:00,United States Air Force - USAF,Takeoff (climb),Military / Government,United States of America,North America,0,0,0,0,0,0,0,Unknown
1950-08-20 00:00:00,Pickford's Airways,Landing (descent or approach),Operational,United Kingdom,Europe,2,2,0,0,0,0,2,Unknown
1950-08-24 00:00:00,United States Air Force - USAF,Landing (descent or approach),Military / Government,South Korea,Asia,0,0,0,0,0,0,0,Unknown
1950-08-26 00:00:00,United States Navy - USN,Taxiing,Operational,United States of America,North America,0,0,0,0,0,0,0,Unknown
1950-08-29 00:00:00,Avianca,Landing (descent or approach),Operational,Colombia,South America,2,2,0,0,0,0,2,Unknown
1950-09-08 00:00:00,Transportes Aéreos Bandeirantes,Landing (descent or approach),Operational,Brazil,South America,3,3,0,0,0,0,3,Technical Failure
1950-09-10 00:00:00,United States Navy - USN,Flight,Military / Government,United States of America,North America,0,0,0,0,0,0,0,Human Factor
1950-09-12 00:00:00,Air Outre Mer,,Commercial,Vietnam,Asia,0,0,0,0,0,0,0,Unknown
1950-09-13 00:00:00,United States Air Force - USAF,Flight,Military / Government,Japan,Asia,0,0,0,0,0,0,0,Unknown
1950-09-14 00:00:00,United States Air Force - USAF,Landing (descent or approach),Military / Government,Japan,Asia,0,0,0,0,0,0,0,Unknown
1950-09-14 00:00:00,Loftleidir Icelandic Airlines,Flight,Operational,Iceland,Europe,6,6,0,0,0,0,6,Unknown
1950-09-16 00:00:00,United States Navy - USN,Takeoff (climb),Military / Government,United States of America,North America,0,0,0,0,0,0,0,Unknown
1950-09-21 00:00:00,Royal Air Force - RAF,Flight,Operational,Yemen,Asia,4,4,0,0,0,0,4,Technical Failure
1950-09-22 00:00:00,United States Air Force - USAF,Flight,Military / Government,Canada,North America,16,16,0,0,0,0,16,Weather
1950-09-22 00:00:00,British Government,Landing (descent or approach),Military / Government,United Kingdom,Europe,0,0,0,0,0,0,0,Unknown
1950-09-26 00:00:00,Air India,,Commercial,India,Asia,0,0,0,0,0,0,0,Unknown
1950-09-27 00:00:00,Civil Air Transport,Landing (descent or approach),Commercial,Japan,Asia,0,0,0,0,0,0,0,Human Factor
1950-09-27 00:00:00,Argentinian Air Force - Fuerza Aérea Argentina,Parking,Military / Government,Argentina,South America,0,0,0,0,0,0,0,Technical Failure
1950-10-02 00:00:00,Lloyd Aéreo Boliviano - LAB Airlines,,Commercial,Bolivia,South America,0,0,0,0,0,0,0,Unknown
1950-10-04 00:00:00,United States Air Force - USAF,Takeoff (climb),Military / Government,Japan,Asia,0,0,0,0,0,0,0,Unknown
1950-10-05 00:00:00,United States Air Force - USAF,Takeoff (climb),Military / Government,Japan,Asia,0,0,0,0,0,0,0,Technical Failure
1950-10-10 00:00:00,United States Air Force - USAF,Landing (descent or approach),Operational,United Kingdom,Europe,0,0,0,0,0,0,0,Technical Failure
1950-10-12 00:00:00,Ransa - Rutas Aéreas Nacionales,Landing (descent or approach),Commercial,Venezuela,South America,20,4,0,16,0,0,20,Technical Failure
1950-10-20 00:00:00,United States Air Force - USAF,Landing (descent or approach),Operational,United States of America,North America,0,0,0,0,0,0,0,Unknown
1950-10-25 00:00:00,Lancashire Aircraft Corporation - LAC,Landing (descent or approach),Commercial,United Kingdom,Europe,2,1,0,1,0,0,2,Technical Failure
1950-10-25 00:00:00,Royal Air Force - RAF,Landing (descent or approach),Military / Government,Singapore,Asia,0,0,0,0,0,0,0,Unknown
1950-10-28 00:00:00,Polyarnaya Aviatsiya,Takeoff (climb),Operational,Antarctica,Antarctica,7,6,0,1,0,0,7,Human Factor
1950-10-31 00:00:00,Air Jordan,Takeoff (climb),Commercial,Israel,Asia,6,1,0,5,0,0,6,Unknown
1950-11-02 00:00:00,United States Air Force - USAF,Flight,Operational,United States of America,North America,0,0,0,0,0,0,0,Technical Failure
1950-11-04 00:00:00,Central Aérea,Takeoff (climb),Commercial,Brazil,South America,0,0,0,0,0,0,0,Human Factor
1950-11-04 00:00:00,United States Air Force - USAF,Takeoff (climb),Military / Government,Japan,Asia,0,0,0,0,0,0,0,Unknown
1950-11-05 00:00:00,Royal Australian Air Force - RAAF,Landing (descent or approach),Military / Government,Australia,Oceania,0,0,0,0,0,0,0,Unknown
1950-11-07 00:00:00,Polyarnaya Aviatsiya,Takeoff (climb),Operational,Antarctica,Antarctica,0,0,0,0,0,0,0,Unknown
1950-11-08 00:00:00,Frigorifico Cooperativo Los Andes,Landing (descent or approach),Operational,Bolivia,South America,2,2,0,0,0,0,2,Unknown
1950-11-09 00:00:00,United States Air Force - USAF,Landing (descent or approach),Military / Government,South Korea,Asia,0,0,0,0,0,0,0,Unknown
1950-11-09 00:00:00,United States Air Force - USAF,Landing (descent or approach),Military / Government,South Korea,Asia,1,1,0,0,0,0,1,Unknown
1950-11-09 00:00:00,United States Air Force - USAF,Landing (descent or approach),Military / Government,United States of America,North America,0,0,0,0,0,0,0,Unknown
1950-11-10 00:00:00,Mexican Air Force - Fuerza Aérea Mexicana,Landing (descent or approach),Military / Government,Mexico,Central America,5,2,0,3,0,0,5,Other
1950-11-11 00:00:00,United States Air Force - USAF,Flight,Military / Government,North Korea,Asia,3,3,0,0,0,0,3,Terrorism
1950-11-14 00:00:00,United States Air Force - USAF,Landing (descent or approach),Military / Government,South Korea,Asia,12,12,0,0,0,0,12,Terrorism
1950-11-14 00:00:00,West African Airways Corporation,Flight,Commercial,Nigeria,Africa,0,0,0,0,0,0,0,Unknown
1950-11-15 00:00:00,United States Air Force - USAF,Takeoff (climb),Military / Government,Japan,Asia,0,0,0,0,0,0,0,Unknown
1950-11-15 00:00:00,United States Air Force - USAF,Flight,Operational,France,Europe,11,11,0,0,0,0,11,Technical Failure
1950-11-15 00:00:00,Frigorifico Cooperativo Los Andes,Takeoff (climb),Operational,Bolivia,South America,2,2,0,0,0,0,2,Technical Failure
1950-11-15 00:00:00,TARS - Transporturile Aeriene Româno-Sovietice,Flight,Commercial,Romania,Europe,0,0,0,0,0,0,0,Unknown
1950-11-16 00:00:00,Royal New Zealand Air Force - RNZAF,Landing (descent or approach),Operational,New Zealand,Oceania,3,3,0,0,0,0,3,Technical Failure
1950-11-17 00:00:00,United States Air Force - USAF,Takeoff (climb),Military / Government,Puerto Rico,Central America,0,0,0,0,0,0,0,Technical Failure
1950-11-17 00:00:00,United States Air Force - USAF,Takeoff (climb),Operational,United States of America,North America,0,0,0,0,0,0,0,Technical Failure
1950-11-17 00:00:00,United States Air Force - USAF,Taxiing,Military / Government,United States of America,North America,0,0,0,0,0,0,0,Technical Failure
1950-11-19 00:00:00,United States Air Force - USAF,Takeoff (climb),Military / Government,North Korea,Asia,0,0,0,0,0,0,0,Technical Failure
1950-11-21 00:00:00,United States Air Force - USAF,Landing (descent or approach),Military / Government,South Korea,Asia,0,0,0,0,0,0,0,Unknown
1950-11-22 00:00:00,United States Air Force - USAF,Flight,Military / Government,Germany,Europe,0,0,0,0,0,0,0,Unknown
1950-11-22 00:00:00,Union of Burma Airways,Takeoff (climb),Commercial,Myanmar,Asia,0,0,0,0,0,0,0,Human Factor
1950-11-23 00:00:00,United States Navy - USN,Landing (descent or approach),Operational,Japan,Asia,9,9,0,0,0,0,9,Unknown
1950-11-24 00:00:00,Aeronorte,Landing (descent or approach),Operational,Brazil,South America,3,3,0,0,0,0,3,Human Factor
1950-11-24 00:00:00,Lineas Aéreas del Caribe - LIDCA,Takeoff (climb),Operational,Colombia,South America,2,2,0,0,0,0,2,Unknown
1950-11-25 00:00:00,Cubana de Aviación,Landing (descent or approach),Commercial,Cuba,Central America,0,0,0,0,0,0,0,Weather
1950-11-27 00:00:00,Royal Air Force - RAF,Landing (descent or approach),Operational,United Kingdom,Europe,2,2,0,0,0,0,2,Human Factor
1950-11-27 00:00:00,Royal Air Force - RAF,Flight,Operational,Zimbabwe,Africa,2,2,0,0,0,0,2,Technical Failure
1950-11-28 00:00:00,United States Air Force - USAF,Flight,Operational,United States of America,North America,0,0,0,0,0,0,0,Unknown
1950-11-28 00:00:00,United States Air Force - USAF,Flight,Military / Government,South Korea,Asia,2,2,0,0,0,0,2,Technical Failure
1950-12-01 00:00:00,Brazilian Air Force - Força Aérea Brasileira,Landing (descent or approach),Military / Government,Brazil,South America,0,0,0,0,0,0,0,Unknown
1950-12-01 00:00:00,United States Marine Corps,Landing (descent or approach),Military / Government,North Korea,Asia,3,3,0,0,0,0,3,Other
1950-12-01 00:00:00,Linea Aérea Transatlantica de Colombia - LATCO,Landing (descent or approach),Commercial,Colombia,South America,0,0,0,0,0,0,0,Unknown
1950-12-02 00:00:00,United States Air Force - USAF,Takeoff (climb),Military / Government,North Korea,Asia,38,3,0,35,0,0,38,Unknown
1950-12-03 00:00:00,Handley Page Aircraft Company Ltd,Landing (descent or approach),Specialised Services,United Kingdom,Europe,0,0,0,0,0,0,0,Unknown
1950-12-04 00:00:00,Aero Scandia,Landing (descent or approach),Commercial,Sweden,Europe,0,0,0,0,0,0,0,Unknown
1950-12-04 00:00:00,Royal Air Force - RAF,Landing (descent or approach),Operational,Egypt,Africa,3,3,0,0,0,0,3,Human Factor
1950-12-05 00:00:00,Turkish Air Force - Türk Hava Kuvvetleri,Flight,Operational,Turkey,Asia,2,2,0,0,0,0,2,Unknown
1950-12-05 00:00:00,East West Airlines - Australia,Flight,Commercial,Australia,Oceania,4,1,0,3,0,0,4,Technical Failure
1950-12-08 00:00:00,Transportes Aéreos Bandeirantes,Takeoff (climb),Commercial,Brazil,South America,0,0,0,0,0,0,0,Technical Failure
1950-12-09 00:00:00,Private Australian,Flight,Business,Australia,Oceania,1,1,0,0,0,0,1,Technical Failure
1950-12-11 00:00:00,Private Australian,Takeoff (climb),Operational,France,Europe,2,2,0,0,0,0,2,Unknown
1950-12-12 00:00:00,Institut Géographique National,,Specialised Services,Niger,Africa,0,0,0,0,0,0,0,Unknown
1950-12-13 00:00:00,VASP - Viação Aérea de São Paulo,Takeoff (climb),Commercial,Brazil,South America,31,6,0,25,0,0,31,Technical Failure
1950-12-13 00:00:00,Swissair,Landing (descent or approach),Commercial,Canada,North America,31,11,0,20,0,0,31,Human Factor
1950-12-16 00:00:00,United States Air Force - USAF,Landing (descent or approach),Military / Government,Japan,Asia,0,0,0,0,0,0,0,Unknown
1950-12-17 00:00:00,Loide Aéreo Nacional,Landing (descent or approach),Commercial,Brazil,South America,49,5,0,44,0,0,49,Technical Failure
1950-12-20 00:00:00,Royal Australian Air Force - RAAF,Landing (descent or approach),Military / Government,Malaysia,Asia,8,4,0,4,0,0,8,Technical Failure
1950-12-24 00:00:00,United States Air Force - USAF,Flight,Military / Government,Italy,Europe,0,0,0,0,0,0,0,Technical Failure
1950-12-30 00:00:00,United States Air Force - USAF,Landing (descent or approach),Military / Government,United States of America,North America,0,0,0,0,0,0,0,Unknown
1950-12-31 00:00:00,Mayfair Air Services,,Commercial,United Kingdom,Europe,0,0,0,0,0,0,0,Unknown
1950-12-31 00:00:00,Lineas Aéreas Guerrero Oaxaca - LAGOSA,,Commercial,Mexico,Central America,0,0,0,0,0,0,0,Unknown
1951-01-01 00:00:00,Lloyd Aéreo Boliviano - LAB Airlines,Landing (descent or approach),Commercial,Bolivia,South America,0,0,0,0,0,0,0,Unknown
1951-01-01 00:00:00,Royal Air Force - RAF,Takeoff (climb),Operational,United Kingdom,Europe,2,2,0,0,0,0,2,Technical Failure
1951-01-01 00:00:00,Indian Air Force - Bharatiya Vayu Sena,Landing (descent or approach),Military / Government,India,Asia,0,0,0,0,0,0,0,Unknown
1951-01-02 00:00:00,McInnes Products Corporation,Takeoff (climb),Business,Canada,North America,0,0,0,0,0,0,0,Unknown
1951-01-04 00:00:00,Monarch Air Service,Takeoff (climb),Commercial,United States of America,North America,48,3,0,45,0,0,48,Human Factor
1951-01-10 00:00:00,United States Air Force - USAF,Flight,Military / Government,United States of America,North America,0,0,0,0,0,0,0,Technical Failure
1951-01-15 00:00:00,Siamese Airways,Flight,Commercial,Thailand,Asia,0,0,0,0,0,0,0,Unknown
1951-01-16 00:00:00,Royal Air Force - RAF,Landing (descent or approach),Operational,United Kingdom,Europe,6,6,0,0,0,0,6,Technical Failure
1951-01-16 00:00:00,United States Air Force - USAF,Takeoff (climb),Military / Government,Canada,North America,0,0,0,0,0,0,0,Unknown
1951-01-20 00:00:00,United States Air Force - USAF,Takeoff (climb),Military / Government,Syria,Asia,0,0,0,0,0,0,0,Unknown
1951-01-20 00:00:00,United States Air Force - USAF,Landing (descent or approach),Military / Government,South Korea,Asia,4,4,0,0,0,0,4,Unknown
1951-01-20 00:00:00,United States Air Force - USAF,Landing (descent or approach),Military / Government,Japan,Asia,0,0,0,0,0,0,0,Unknown
1951-01-21 00:00:00,United States Air Force - USAF,Flight,Military / Government,South Korea,Asia,3,3,0,0,0,0,3,Terrorism
1951-01-23 00:00:00,United States Air Force - USAF,Flight,Military / Government,Japan,Asia,0,0,0,0,0,0,0,Technical Failure
1951-01-23 00:00:00,Royal Netherlands Navy - Marineluchtvaartdienst,Landing (descent or approach),Operational,Netherlands,Europe,3,3,0,0,0,0,3,Unknown
1951-01-24 00:00:00,United States Air Force - USAF,Landing (descent or approach),Military / Government,South Korea,Asia,2,2,0,0,0,0,2,Unknown
1951-01-24 00:00:00,United States Air Force - USAF,Landing (descent or approach),Military / Government,South Korea,Asia,15,2,0,13,0,0,15,Human Factor
1951-01-28 00:00:00,United States Air Force - USAF,Takeoff (climb),Military / Government,South Korea,Asia,0,0,0,0,0,0,0,Unknown
1951-01-28 00:00:00,United States Air Force - USAF,Landing (descent or approach),Military / Government,United States of America,North America,0,0,0,0,0,0,0,Unknown
1951-01-29 00:00:00,Mandated Airlines,Flight,Commercial,Papua New Guinea,Oceania,6,1,0,5,0,0,6,Unknown
1951-01-30 00:00:00,Great Northern Skyways,Landing (descent or approach),Commercial,Canada,North America,8,1,0,7,0,0,8,Unknown
1951-01-31 00:00:00,LANSA Colombia - Limitada Nacional de Servicio Aéreo,Landing (descent or approach),Operational,Colombia,South America,2,2,0,0,0,0,2,Technical Failure
1951-02-05 00:00:00,Transair UK,Landing (descent or approach),Operational,United Kingdom,Europe,2,2,0,0,0,0,2,Human Factor
1951-02-07 00:00:00,Finnish Air Force - Suomen Ilmavoimat,Takeoff (climb),Military / Government,Finland,Europe,0,0,0,0,0,0,0,Technical Failure
1951-02-09 00:00:00,United States Navy - USN,Landing (descent or approach),Military / Government,Japan,Asia,0,0,0,0,0,0,0,Unknown
1951-02-10 00:00:00,South Coast Airways - SCA,Takeoff (climb),Operational,Australia,Oceania,2,2,0,0,0,0,2,Unknown
1951-02-12 00:00:00,Aigle Azur,Flight,Commercial,Laos,Asia,0,0,0,0,0,0,0,Unknown
1951-02-14 00:00:00,United States Navy - USN,Landing (descent or approach),Military / Government,Japan,Asia,0,0,0,0,0,0,0,Unknown
1951-02-17 00:00:00,United States Air Force - USAF,Landing (descent or approach),Military / Government,Japan,Asia,0,0,0,0,0,0,0,Unknown
1951-02-17 00:00:00,Indian Government,Flight,Military / Government,India,Asia,0,0,0,0,0,0,0,Unknown
1951-02-19 00:00:00,United States Navy - USN,Landing (descent or approach),Military / Government,United States of America,North America,0,0,0,0,0,0,0,Unknown
1951-02-21 00:00:00,Companhia Itaú de Transportes Aéreos,Landing (descent or approach),Operational,Brazil,South America,4,4,0,0,0,0,4,Weather
1951-02-23 00:00:00,United States Air Force - USAF,Landing (descent or approach),Military / Government,Norway,Europe,0,0,0,0,0,0,0,Unknown
1951-02-23 00:00:00,Slick Airways,Landing (descent or approach),Operational,United States of America,North America,3,3,0,0,0,0,3,Weather
1951-02-27 00:00:00,Mid-Continent Airlines,Takeoff (climb),Commercial,United States of America,North America,34,4,0,30,0,0,34,Human Factor
1951-02-28 00:00:00,Central Mining Corporation,Landing (descent or approach),Operational,South Africa,Africa,2,2,0,0,0,0,2,Technical Failure
1951-03-04 00:00:00,United States Air Force - USAF,Landing (descent or approach),Military / Government,South Korea,Asia,3,3,0,0,0,0,3,Terrorism
1951-03-05 00:00:00,Skyways of London,Taxiing,Commercial,Greece,Europe,6,1,0,5,0,0,6,Other
1951-03-08 00:00:00,United States Air Force - USAF,Landing (descent or approach),Military / Government,Japan,Asia,3,3,0,0,0,0,3,Terrorism
1951-03-08 00:00:00,United States Air Force - USAF,Flight,Operational,United States of America,North America,0,0,0,0,0,0,0,Technical Failure
1951-03-10 00:00:00,Royal Air Force - RAF,Landing (descent or approach),Operational,United Kingdom,Europe,2,2,0,0,0,0,2,Unknown
1951-03-15 00:00:00,Royal Canadian Air Force - RCAF,Takeoff (climb),Military / Government,Canada,North America,0,0,0,0,0,0,0,Human Factor
1951-03-27 00:00:00,Australian Government,Flight,Military / Government,Australia,Oceania,0,0,0,0,0,0,0,Unknown
1951-03-27 00:00:00,United States Air Force - USAF,Landing (descent or approach),Military / Government,United States of America,North America,0,0,0,0,0,0,0,Unknown
1951-03-29 00:00:00,Royal Air Force - RAF,Takeoff (climb),Military / Government,Uganda,Africa,0,0,0,0,0,0,0,Technical Failure
1951-03-30 00:00:00,Seaboard %26 Western Airlines,Landing (descent or approach),Operational,Iceland,Europe,6,6,0,0,0,0,6,Unknown
1951-04-01 00:00:00,Scandinavian Airlines System - SAS,Landing (descent or approach),Commercial,Sweden,Europe,22,4,0,18,0,0,22,Technical Failure
1951-04-02 00:00:00,United States Air Force - USAF,Flight,Operational,United States of America,North America,14,14,0,0,0,0,14,Unknown
1951-04-02 00:00:00,United States Air Force - USAF,Landing (descent or approach),Operational,United States of America,North America,0,0,0,0,0,0,0,Technical Failure
1951-04-02 00:00:00,Mandated Airlines,Takeoff (climb),Commercial,Papua New Guinea,Oceania,10,2,0,8,0,0,10,Human Factor
1951-04-06 00:00:00,United States Air Force - USAF,Landing (descent or approach),Military / Government,Japan,Asia,11,11,0,0,0,0,11,Weather
1951-04-06 00:00:00,United States Air Force - USAF,Landing (descent or approach),Military / Government,Japan,Asia,14,14,0,0,0,0,14,Technical Failure
1951-04-07 00:00:00,Eastern Provincial Airways - EPA,Landing (descent or approach),Operational,Canada,North America,2,2,0,0,0,0,2,Unknown
1951-04-07 00:00:00,Northern Airlines,Takeoff (climb),Commercial,Canada,North America,6,1,0,5,0,0,6,Technical Failure
1951-04-10 00:00:00,British Government,Flight,Specialised Services,United Kingdom,Europe,5,5,0,0,0,0,5,Technical Failure
1951-04-10 00:00:00,Royal Air Force - RAF,Flight,Military / Government,Sudan,Africa,6,4,0,2,0,0,6,Technical Failure
1951-04-11 00:00:00,United States Navy - USN,Landing (descent or approach),Military / Government,Morocco,Africa,0,0,0,0,0,0,0,Unknown
1951-04-12 00:00:00,United States Air Force - USAF,Landing (descent or approach),Military / Government,South Korea,Asia,0,0,0,0,0,0,0,Unknown
1951-04-12 00:00:00,United States Air Force - USAF,Flight,Military / Government,South Korea,Asia,13,13,0,0,0,0,13,Terrorism
1951-04-12 00:00:00,Royal Air Force - RAF,Landing (descent or approach),Military / Government,Sri Lanka,Asia,4,4,0,0,0,0,4,Human Factor
1951-04-15 00:00:00,United States Air Force - USAF,Flight,Military / Government,United States of America,North America,3,3,0,0,0,0,3,Human Factor
1951-04-15 00:00:00,Loide Aéreo Nacional,Landing (descent or approach),Commercial,Brazil,South America,38,4,0,34,0,0,38,Human Factor
1951-04-18 00:00:00,Royal Air Force - RAF,Flight,Operational,United Kingdom,Europe,2,2,0,0,0,0,2,Technical Failure
1951-04-19 00:00:00,United States Air Force - USAF,Landing (descent or approach),Military / Government,South Korea,Asia,0,0,0,0,0,0,0,Unknown
1951-04-19 00:00:00,United States Air Force - USAF,Takeoff (climb),Military / Government,South Korea,Asia,0,0,0,0,0,0,0,Technical Failure
1951-04-20 00:00:00,United States Air Force - USAF,Landing (descent or approach),Military / Government,South Korea,Asia,4,4,0,0,0,0,4,Unknown
1951-04-23 00:00:00,United States Air Force - USAF,Landing (descent or approach),Military / Government,United States of America,North America,0,0,0,0,0,0,0,Unknown
1951-04-24 00:00:00,United States Air Force - USAF,Flight,Military / Government,North Korea,Asia,3,3,0,0,0,0,3,Terrorism
1951-04-27 00:00:00,Avions Marcel Dassault - Groupe Dassault,Landing (descent or approach),Specialised Services,France,Europe,0,0,0,0,0,0,0,Unknown
1951-04-28 00:00:00,Lyon Air,Landing (descent or approach),Commercial,Argentina,South America,11,4,0,7,0,0,11,Weather
1951-05-04 00:00:00,Royal Air Force - RAF,Landing (descent or approach),Military / Government,United Kingdom,Europe,0,0,0,0,0,0,0,Human Factor
1951-05-08 00:00:00,Hunting Air Travel,Takeoff (climb),Commercial,France,Europe,31,5,0,26,0,0,31,Technical Failure
1951-05-08 00:00:00,Civil Air Training Center,Flight,Operational,India,Asia,0,0,0,0,0,0,0,Unknown
1951-05-15 00:00:00,Linhas Aéreas Paulistas,Flight,Commercial,Brazil,South America,16,4,0,12,0,0,16,Unknown
1951-05-15 00:00:00,United States Air Force - USAF,Takeoff (climb),Military / Government,Germany,Europe,0,0,0,0,0,0,0,Unknown
1951-05-19 00:00:00,United States Navy - USN,Landing (descent or approach),Operational,United States of America,North America,4,4,0,0,0,0,4,Unknown
1951-05-21 00:00:00,United States Air Force - USAF,Takeoff (climb),Military / Government,Canada,North America,6,6,0,0,0,0,6,Unknown
1951-05-24 00:00:00,United States Air Force - USAF,Flight,Military / Government,Japan,Asia,0,0,0,0,0,0,0,Technical Failure
1951-05-30 00:00:00,Royal Air Force - RAF,Landing (descent or approach),Military / Government,Jordan,Asia,0,0,0,0,0,0,0,Unknown
1951-05-31 00:00:00,French Air Force - Armée de l'Air,Landing (descent or approach),Military / Government,Vietnam,Asia,5,5,0,0,0,0,5,Unknown
1951-05-31 00:00:00,United States Air Force - USAF,Takeoff (climb),Military / Government,United States of America,North America,0,0,0,0,0,0,0,Unknown
1951-06-03 00:00:00,Aerolineas Argentinas,Landing (descent or approach),Commercial,Argentina,South America,0,0,0,0,0,0,0,Human Factor
1951-06-08 00:00:00,JAT Yugoslav Airlines - Jugoslovenski Aerotransport,Landing (descent or approach),Commercial,Germany,Europe,11,3,0,8,0,0,11,Technical Failure
1951-06-10 00:00:00,Qantas Airways - Queensland and Northern Territory Aerial Services,Taxiing,Commercial,Vanuatu,Oceania,0,0,0,0,0,0,0,Other
1951-06-12 00:00:00,Government of Sindh Province,Landing (descent or approach),Operational,Pakistan,Asia,3,3,0,0,0,0,3,Unknown
1951-06-16 00:00:00,MVD - Ministerstvo Vnutrennikh Del,Flight,Military / Government,Russia,Asia,8,2,0,6,0,0,8,Human Factor
1951-06-17 00:00:00,United States Air Force - USAF,Landing (descent or approach),Military / Government,United States of America,North America,20,2,0,18,0,0,20,Technical Failure
1951-06-21 00:00:00,United States Air Force - USAF,Flight,Military / Government,United States of America,North America,0,0,0,0,0,0,0,Technical Failure
1951-06-22 00:00:00,United States Air Force - USAF,Takeoff (climb),Military / Government,United States of America,North America,0,0,0,0,0,0,0,Unknown
1951-06-24 00:00:00,Royal Air Force - RAF,Landing (descent or approach),Military / Government,Zambia,Africa,0,0,0,0,0,0,0,Technical Failure
1951-06-26 00:00:00,United States Air Force - USAF,Landing (descent or approach),Military / Government,South Korea,Asia,3,3,0,0,0,0,3,Terrorism
1951-06-27 00:00:00,United States Air Force - USAF,Takeoff (climb),Military / Government,United States of America,North America,0,0,0,0,0,0,0,Technical Failure
1951-06-27 00:00:00,Cruzeiro do Sul,Flight,Operational,Bolivia,South America,4,4,0,0,0,0,4,Human Factor
1951-06-29 00:00:00,French Air Force - Armée de l'Air,Landing (descent or approach),Specialised Services,France,Europe,4,4,0,0,0,0,4,Technical Failure
1951-07-08 00:00:00,United States Air Force - USAF,Takeoff (climb),Military / Government,South Korea,Asia,0,0,0,0,0,0,0,Technical Failure
1951-07-09 00:00:00,United States Air Force - USAF,Landing (descent or approach),Military / Government,South Korea,Asia,0,0,0,0,0,0,0,Weather
1951-07-09 00:00:00,Avianca,Landing (descent or approach),Commercial,Colombia,South America,0,0,0,0,0,0,0,Unknown
1951-07-11 00:00:00,T. Eaton Company,Landing (descent or approach),Operational,Canada,North America,2,2,0,0,0,0,2,Technical Failure
1951-07-13 00:00:00,Siamese Airways,Takeoff (climb),Commercial,Thailand,Asia,0,0,0,0,0,0,0,Other
1951-07-14 00:00:00,Aero Propaganda,Landing (descent or approach),Commercial,Sweden,Europe,2,1,0,1,0,0,2,Unknown
1951-07-14 00:00:00,Butler Air Transport,Flight,Commercial,Australia,Oceania,11,1,0,10,0,0,11,Technical Failure
1951-07-15 00:00:00,United States Air Force - USAF,Flight,Military / Government,United States of America,North America,0,0,0,0,0,0,0,Technical Failure
1951-07-16 00:00:00,United States Air Force - USAF,Takeoff (climb),Military / Government,United States of America,North America,0,0,0,0,0,0,0,Unknown
1951-07-17 00:00:00,Royal Air Force - RAF,Landing (descent or approach),Military / Government,Egypt,Africa,0,0,0,0,0,0,0,Technical Failure
1951-07-18 00:00:00,Transports Aériens Intercontinentaux - TAI,Takeoff (climb),Commercial,Madagascar,Africa,0,0,0,0,0,0,0,Unknown
1951-07-25 00:00:00,French Air Force - Armée de l'Air,Flight,Military / Government,Vietnam,Asia,0,0,0,0,0,0,0,Unknown
1951-07-26 00:00:00,United States Air Force - USAF,Takeoff (climb),Military / Government,United States of America,North America,0,0,0,0,0,0,0,Unknown
1951-07-27 00:00:00,Sottocentro Soccorso Cadimare,Flight,Operational,Italy,Europe,6,6,0,0,0,0,6,Unknown
1951-07-27 00:00:00,West African Airways Corporation,Landing (descent or approach),Commercial,Nigeria,Africa,0,0,0,0,0,0,0,Technical Failure
1951-07-30 00:00:00,Royal Air Force - RAF,Landing (descent or approach),Operational,United Kingdom,Europe,3,3,0,0,0,0,3,Human Factor
1951-08-08 00:00:00,Pan American World Airways - PAA,Landing (descent or approach),Operational,Brazil,South America,3,3,0,0,0,0,3,Human Factor
1951-08-11 00:00:00,All American Airways,Takeoff (climb),Commercial,United States of America,North America,45,4,0,41,0,0,45,Technical Failure
1951-08-12 00:00:00,Royal Air Force - RAF,Landing (descent or approach),Operational,United Kingdom,Europe,0,0,0,0,0,0,0,Human Factor
1951-08-14 00:00:00,United States Air Force - USAF,Takeoff (climb),Military / Government,United States of America,North America,0,0,0,0,0,0,0,Unknown
1951-08-16 00:00:00,United States Air Force - USAF,,Military / Government,Germany,Europe,0,0,0,0,0,0,0,Unknown
1951-08-20 00:00:00,Siamese Airways,Landing (descent or approach),Operational,Thailand,Asia,3,3,0,0,0,0,3,Unknown
1951-08-23 00:00:00,United States Air Force - USAF,Flight,Operational,United States of America,North America,0,0,0,0,0,0,0,Technical Failure
1951-08-23 00:00:00,Queen Charlotte Airlines,Landing (descent or approach),Commercial,Canada,North America,8,1,0,7,0,0,8,Human Factor
1951-08-23 00:00:00,Royal Air Force - RAF,Flight,Military / Government,Sudan,Africa,2,2,0,0,0,0,2,Technical Failure
1951-08-27 00:00:00,Indian Air Force - Bharatiya Vayu Sena,Flight,Operational,India,Asia,2,2,0,0,0,0,2,Human Factor
1951-09-01 00:00:00,Mexicana de Aviación,Landing (descent or approach),Commercial,Mexico,Central America,42,4,0,38,0,0,42,Unknown
1951-09-02 00:00:00,Pan American World Airways - PAA,Landing (descent or approach),Commercial,Jamaica,Central America,34,4,0,30,0,0,34,Human Factor
1951-09-07 00:00:00,United States Air Force - USAF,Landing (descent or approach),Military / Government,United States of America,North America,0,0,0,0,0,0,0,Unknown
1951-09-08 00:00:00,United States Air Force - USAF,Flight,Military / Government,Japan,Asia,0,0,0,0,0,0,0,Technical Failure
1951-09-09 00:00:00,Queen Charlotte Airlines,Landing (descent or approach),Commercial,Canada,North America,5,1,0,4,0,0,5,Unknown
1951-09-10 00:00:00,United States Air Force - USAF,Flight,Military / Government,South Korea,Asia,0,0,0,0,0,0,0,Unknown
1951-09-12 00:00:00,United States Air Force - USAF,Takeoff (climb),Military / Government,United States of America,North America,0,0,0,0,0,0,0,Unknown
1951-09-14 00:00:00,Pakistan Air Force - Pakistan Fiza'ya,,Military / Government,Pakistan,Asia,0,0,0,0,0,0,0,Unknown
1951-09-18 00:00:00,Polyarnaya Aviatsiya,Takeoff (climb),Operational,Russia,Asia,2,2,0,0,0,0,2,Human Factor
1951-09-24 00:00:00,United States Air Force - USAF,Takeoff (climb),Operational,United States of America,North America,1,1,0,0,0,0,1,Technical Failure
1951-09-29 00:00:00,Connellan Airways,Parking,Commercial,Australia,Oceania,6,1,0,5,0,0,6,Technical Failure
1951-09-29 00:00:00,United States Air Force - USAF,Landing (descent or approach),Military / Government,United States of America,North America,0,0,0,0,0,0,0,Unknown
1951-09-29 00:00:00,Royal Air Force - RAF,Flight,Military / Government,France,Europe,8,8,0,0,0,0,8,Technical Failure
1951-10-02 00:00:00,United States Air Force - USAF,Takeoff (climb),Military / Government,Japan,Asia,6,6,0,0,0,0,6,Unknown
1951-10-03 00:00:00,United States Air Force - USAF,Landing (descent or approach),Military / Government,United States of America,North America,0,0,0,0,0,0,0,Unknown
1951-10-05 00:00:00,United States Air Force - USAF,Flight,Military / Government,Japan,Asia,0,0,0,0,0,0,0,Technical Failure
1951-10-06 00:00:00,Gibbes Sepik Airways,Flight,Operational,Papua New Guinea,Oceania,2,2,0,0,0,0,2,Technical Failure
1951-10-15 00:00:00,East African Airways,Landing (descent or approach),Commercial,Uganda,Africa,8,2,0,6,0,0,8,Unknown
1951-10-18 00:00:00,Hollinger Ungava Transport,Landing (descent or approach),Commercial,Canada,North America,0,0,0,0,0,0,0,Unknown
1951-10-19 00:00:00,United States Air Force - USAF,Flight,Military / Government,United States of America,North America,5,5,0,0,0,0,5,Technical Failure
1951-10-20 00:00:00,United States Air Force - USAF,Landing (descent or approach),Military / Government,South Korea,Asia,3,3,0,0,0,0,3,Unknown
1951-10-20 00:00:00,Private American,Flight,Business,United States of America,North America,4,2,0,2,0,0,4,Unknown
1951-10-22 00:00:00,United States Air Force - USAF,Flight,Military / Government,World,World,12,12,0,0,0,0,12,Terrorism
1951-10-26 00:00:00,William Dempster Line,Landing (descent or approach),Operational,United Kingdom,Europe,7,3,0,4,0,0,7,Human Factor
1951-10-27 00:00:00,United States Air Force - USAF,Landing (descent or approach),Military / Government,South Korea,Asia,11,11,0,0,0,0,11,Terrorism
1951-10-28 00:00:00,United States Air Force - USAF,Landing (descent or approach),Operational,United States of America,North America,0,0,0,0,0,0,0,Unknown
1951-10-28 00:00:00,Trans Oceanic Airways - TOA,Takeoff (climb),Operational,Australia,Oceania,4,4,0,0,0,0,4,Human Factor
1951-10-29 00:00:00,Central African Airways - CAA,Flight,Commercial,Zimbabwe,Africa,0,0,0,0,0,0,0,Unknown
1951-10-30 00:00:00,Air Algérie,Takeoff (climb),Commercial,France,Europe,34,4,0,30,0,0,34,Technical Failure
1951-11-01 00:00:00,French Air Force - Armée de l'Air,Flight,Military / Government,United States of America,North America,0,0,0,0,0,0,0,Unknown
1951-11-01 00:00:00,Siamese Airways,Landing (descent or approach),Commercial,Thailand,Asia,0,0,0,0,0,0,0,Unknown
1951-11-05 00:00:00,Compagnie Aérienne de Transports Indochinois - CATI,Takeoff (climb),Commercial,Vietnam,Asia,0,0,0,0,0,0,0,Technical Failure
1951-11-07 00:00:00,Société des Transports Aériens Camerounais - STAC,Takeoff (climb),Commercial,Chad,Africa,0,0,0,0,0,0,0,Unknown
1951-11-08 00:00:00,United States Air Force - USAF,Takeoff (climb),Military / Government,Japan,Asia,0,0,0,0,0,0,0,Unknown
1951-11-09 00:00:00,United States Air Force - USAF,Flight,Military / Government,North Korea,Asia,12,12,0,0,0,0,12,Terrorism
1951-11-11 00:00:00,Argentinian Air Force - Fuerza Aérea Argentina,,Military / Government,Argentina,South America,0,0,0,0,0,0,0,Unknown
1951-11-12 00:00:00,Royal Air Force - RAF,Landing (descent or approach),Military / Government,Sudan,Africa,20,2,0,18,0,0,20,Technical Failure
1951-11-14 00:00:00,Airways India,Takeoff (climb),Operational,India,Asia,3,3,0,0,0,0,3,Unknown
1951-11-17 00:00:00,Qantas Airways - Queensland and Northern Territory Aerial Services,Takeoff (climb),Operational,Australia,Oceania,7,7,0,0,0,0,7,Technical Failure
1951-11-18 00:00:00,United States Air Force - USAF,Takeoff (climb),Military / Government,Japan,Asia,11,11,0,0,0,0,11,Unknown
1951-11-21 00:00:00,United States Air Force - USAF,Landing (descent or approach),Operational,United States of America,North America,0,0,0,0,0,0,0,Technical Failure
1951-11-27 00:00:00,United States Air Force - USAF,Flight,Operational,United States of America,North America,13,13,0,0,0,0,13,Unknown
1951-11-27 00:00:00,Royal Air Force - RAF,Landing (descent or approach),Operational,United Kingdom,Europe,0,0,0,0,0,0,0,Unknown
1951-11-28 00:00:00,Linee Aeree Italiane - LAI,Takeoff (climb),Commercial,Italy,Europe,0,0,0,0,0,0,0,Unknown
1951-11-30 00:00:00,Royal Air Force - RAF,Landing (descent or approach),Operational,United Kingdom,Europe,3,3,0,0,0,0,3,Technical Failure
1951-11-30 00:00:00,United States Air Force - USAF,Flight,Operational,United States of America,North America,0,0,0,0,0,0,0,Technical Failure
1951-12-04 00:00:00,Canada Veneers,Takeoff (climb),Business,Canada,North America,0,0,0,0,0,0,0,Technical Failure
1951-12-06 00:00:00,British European Airways - BEA,Landing (descent or approach),Humanitarian,United Kingdom,Europe,2,2,0,0,0,0,2,Unknown
1951-12-08 00:00:00,CSA Czech Airlines - Československé Státní Aerolinie,Taxiing,Commercial,Czech Republic,Europe,0,0,0,0,0,0,0,Other
1951-12-14 00:00:00,Swissair,Landing (descent or approach),Commercial,Netherlands,Europe,20,5,0,15,0,0,20,Human Factor
1951-12-20 00:00:00,Royal Air Force - RAF,Landing (descent or approach),Military / Government,United Kingdom,Europe,6,6,0,0,0,0,6,Human Factor
1951-12-22 00:00:00,United States Air Force - USAF,Flight,Military / Government,Bahamas,Central America,0,0,0,0,0,0,0,Unknown
1951-12-23 00:00:00,Linee Aeree Italiane - LAI,Landing (descent or approach),Commercial,Italy,Europe,48,10,0,38,0,0,48,Human Factor
1951-12-31 00:00:00,Royal Air Force - RAF,Landing (descent or approach),Operational,United Kingdom,Europe,0,0,0,0,0,0,0,Human Factor
1952-01-02 00:00:00,Caribbean International Airways,Takeoff (climb),Commercial,Cayman Islands,Central America,0,0,0,0,0,0,0,Unknown
1952-01-02 00:00:00,Royal Air Force - RAF,Takeoff (climb),Military / Government,Singapore,Asia,3,3,0,0,0,0,3,Technical Failure
1952-01-04 00:00:00,United States Air Force - USAF,Flight,Operational,United States of America,North America,0,0,0,0,0,0,0,Technical Failure
1952-01-11 00:00:00,Trans Australia Airlines - TAA,Takeoff (climb),Commercial,Australia,Oceania,3,1,0,2,0,0,3,Technical Failure
1952-01-14 00:00:00,Northeast Airlines - USA,Landing (descent or approach),Commercial,United States of America,North America,36,3,0,33,0,0,36,Human Factor
1952-01-19 00:00:00,United States Air Force - USAF,Landing (descent or approach),Operational,United States of America,North America,3,3,0,0,0,0,3,Technical Failure
1952-01-21 00:00:00,United States Air Force - USAF,Flight,Military / Government,World,World,0,0,0,0,0,0,0,Technical Failure
1952-01-24 00:00:00,United States Air Force - USAF,Flight,Military / Government,United States of America,North America,6,6,0,0,0,0,6,Technical Failure
1952-01-27 00:00:00,Loftleidir Icelandic Airlines,Landing (descent or approach),Operational,Italy,Europe,4,4,0,0,0,0,4,Unknown
1952-01-28 00:00:00,United States Air Force - USAF,Landing (descent or approach),Military / Government,Germany,Europe,5,5,0,0,0,0,5,Unknown
1952-01-28 00:00:00,Private American,Flight,Operational,United States of America,North America,1,1,0,0,0,0,1,Unknown
1952-01-29 00:00:00,United States Air Force - USAF,Landing (descent or approach),Operational,United States of America,North America,0,0,0,0,0,0,0,Unknown
1952-01-29 00:00:00,United States Air Force - USAF,Flight,Military / Government,Japan,Asia,13,13,0,0,0,0,13,Technical Failure
1952-01-29 00:00:00,Gulf Aviation - Canada,Landing (descent or approach),Commercial,Canada,North America,0,0,0,0,0,0,0,Unknown
1952-01-30 00:00:00,Royal Air Force - RAF,Landing (descent or approach),Operational,United Kingdom,Europe,0,0,0,0,0,0,0,Human Factor
1952-02-01 00:00:00,United States Air Force - USAF,Landing (descent or approach),Military / Government,Japan,Asia,0,0,0,0,0,0,0,Technical Failure
1952-02-03 00:00:00,Indian Air Force - Bharatiya Vayu Sena,Takeoff (climb),Military / Government,India,Asia,8,2,0,6,0,0,8,Technical Failure
1952-02-07 00:00:00,United States Air Force - USAF,Landing (descent or approach),Military / Government,United States of America,North America,0,0,0,0,0,0,0,Unknown
1952-02-08 00:00:00,Indian National Airways - INA,Takeoff (climb),Operational,India,Asia,3,3,0,0,0,0,3,Unknown
1952-02-08 00:00:00,Maritime Central Airways,Takeoff (climb),Commercial,Canada,North America,0,0,0,0,0,0,0,Technical Failure
1952-02-11 00:00:00,United States Air Force - USAF,Landing (descent or approach),Military / Government,South Korea,Asia,0,0,0,0,0,0,0,Unknown
1952-02-15 00:00:00,Central African Airways - CAA,Flight,Commercial,Malawi,Africa,0,0,0,0,0,0,0,Unknown
1952-02-16 00:00:00,Argentinian Air Force - Fuerza Aérea Argentina,Landing (descent or approach),Military / Government,Argentina,South America,5,2,0,3,0,0,5,Technical Failure
1952-02-17 00:00:00,Transair UK,Landing (descent or approach),Operational,Belgium,Europe,2,2,0,0,0,0,2,Human Factor
1952-02-19 00:00:00,Brazilian Air Force - Força Aérea Brasileira,Takeoff (climb),Military / Government,Brazil,South America,2,2,0,0,0,0,2,Unknown
1952-02-20 00:00:00,Royal Air Force - RAF,Landing (descent or approach),Military / Government,Sudan,Africa,0,0,0,0,0,0,0,Technical Failure
1952-02-21 00:00:00,Arab Contracting %26 Trading Company,,Business,Syria,Asia,0,0,0,0,0,0,0,Unknown
1952-02-21 00:00:00,Lineas Aéreas Unidas,Takeoff (climb),Operational,Mexico,Central America,2,2,0,0,0,0,2,Technical Failure
1952-02-22 00:00:00,United States Air Force - USAF,Takeoff (climb),Military / Government,United States of America,North America,5,5,0,0,0,0,5,Technical Failure
1952-02-25 00:00:00,Royal Air Force - RAF,Landing (descent or approach),Operational,United Kingdom,Europe,6,6,0,0,0,0,6,Unknown
1952-02-26 00:00:00,Royal Air Force - RAF,Landing (descent or approach),Operational,United Kingdom,Europe,2,2,0,0,0,0,2,Technical Failure
1952-02-27 00:00:00,Indian Air Force - Bharatiya Vayu Sena,Takeoff (climb),Operational,India,Asia,3,3,0,0,0,0,3,Unknown
1952-02-28 00:00:00,United States Air Force - USAF,Flight,Military / Government,Canada,North America,18,4,0,14,0,0,18,Weather
1952-03-03 00:00:00,Royal Air Force - RAF,Landing (descent or approach),Operational,United Kingdom,Europe,2,2,0,0,0,0,2,Human Factor
1952-03-03 00:00:00,Royal Air Force - RAF,Landing (descent or approach),Military / Government,Malaysia,Asia,26,3,0,23,0,0,26,Technical Failure
1952-03-06 00:00:00,United States Air Force - USAF,Landing (descent or approach),Military / Government,United States of America,North America,0,0,0,0,0,0,0,Technical Failure
1952-03-09 00:00:00,Aeronorte,Takeoff (climb),Operational,Brazil,South America,3,3,0,0,0,0,3,Technical Failure
1952-03-10 00:00:00,United States Air Force - USAF,Takeoff (climb),Military / Government,United States of America,North America,12,12,0,0,0,0,12,Unknown
1952-03-10 00:00:00,United States Air Force - USAF,Flight,Military / Government,France,Europe,0,0,0,0,0,0,0,Technical Failure
1952-03-11 00:00:00,Air Charter Ltd London,Landing (descent or approach),Operational,Germany,Europe,10,3,0,7,0,0,10,Technical Failure
1952-03-14 00:00:00,Royal Air Force - RAF,Landing (descent or approach),Operational,United Kingdom,Europe,0,0,0,0,0,0,0,Weather
1952-03-14 00:00:00,Royal Air Force - RAF,Takeoff (climb),Operational,Egypt,Africa,4,4,0,0,0,0,4,Unknown
1952-03-15 00:00:00,Private Kenyan,Landing (descent or approach),Business,Uganda,Africa,4,1,0,3,0,0,4,Technical Failure
1952-03-22 00:00:00,Northern Wings,Flight,Commercial,Canada,North America,0,0,0,0,0,0,0,Weather
1952-03-23 00:00:00,KLM Royal Dutch Airlines - Koninklijke Luchtvaart Maatschappij,Landing (descent or approach),Commercial,Thailand,Asia,44,10,0,34,0,0,44,Technical Failure
1952-03-26 00:00:00,Braniff International Airways,Landing (descent or approach),Commercial,United States of America,North America,49,4,0,45,0,0,49,Technical Failure
1952-03-26 00:00:00,United States Air Force - USAF,Landing (descent or approach),Military / Government,Greenland,Europe,0,0,0,0,0,0,0,Unknown
1952-03-28 00:00:00,Royal Air Force - RAF,Landing (descent or approach),Military / Government,United Kingdom,Europe,11,11,0,0,0,0,11,Human Factor
1952-04-01 00:00:00,United States Air Force - USAF,Flight,Military / Government,North Korea,Asia,11,11,0,0,0,0,11,Technical Failure
1952-04-02 00:00:00,Fred. Olsen's Air Transport - Fred. Olsen Flyselskap,Landing (descent or approach),Commercial,France,Europe,28,6,0,22,0,0,28,Technical Failure
1952-04-04 00:00:00,Argentinian Air Force - Fuerza Aérea Argentina,Landing (descent or approach),Military / Government,Argentina,South America,5,2,0,3,0,0,5,Unknown
1952-04-07 00:00:00,Air France,Takeoff (climb),Commercial,France,Europe,23,5,0,18,0,0,23,Unknown
1952-04-08 00:00:00,Royal Air Force - RAF,Takeoff (climb),Operational,United Kingdom,Europe,2,2,0,0,0,0,2,Unknown
1952-04-16 00:00:00,Australian Government,Flight,Military / Government,Papua New Guinea,Oceania,3,1,0,2,0,0,3,Technical Failure
1952-04-18 00:00:00,Royal Air Force - RAF,Landing (descent or approach),Operational,United Kingdom,Europe,0,0,0,0,0,0,0,Technical Failure
1952-04-18 00:00:00,Royal Canadian Air Force - RCAF,,Military / Government,Canada,North America,0,0,0,0,0,0,0,Unknown
1952-04-19 00:00:00,Private Swedish,Landing (descent or approach),Business,Sweden,Europe,5,1,0,4,0,0,5,Technical Failure
1952-04-19 00:00:00,Air Enterprises,Landing (descent or approach),Commercial,United Kingdom,Europe,6,1,0,5,0,0,6,Human Factor
1952-04-26 00:00:00,Provincial Airways,Landing (descent or approach),Commercial,Canada,North America,0,0,0,0,0,0,0,Unknown
1952-04-29 00:00:00,Brazilian Air Force - Força Aérea Brasileira,Flight,Operational,Brazil,South America,2,2,0,0,0,0,2,Technical Failure
1952-05-03 00:00:00,United States Air Force - USAF,Takeoff (climb),Military / Government,Belgium,Europe,6,6,0,0,0,0,6,Unknown
1952-05-05 00:00:00,Taxis Aéreos Nacionales - TAN,Takeoff (climb),Operational,Mexico,Central America,2,2,0,0,0,0,2,Unknown
1952-05-06 00:00:00,Royal Canadian Air Force - RCAF,,Military / Government,Canada,North America,0,0,0,0,0,0,0,Unknown
1952-05-09 00:00:00,Gold Belt Air Service,Flight,Specialised Services,Canada,North America,6,1,0,5,0,0,6,Technical Failure
1952-05-19 00:00:00,LOT Polish Airlines - Polskie Linie Lotnicze,Flight,Commercial,Poland,Europe,0,0,0,0,0,0,0,Unknown
1952-05-19 00:00:00,Royal Air Force - RAF,Landing (descent or approach),Operational,United Kingdom,Europe,2,2,0,0,0,0,2,Human Factor
1952-05-21 00:00:00,Royal Air Force - RAF,Flight,Operational,United Kingdom,Europe,1,1,0,0,0,0,1,Technical Failure
1952-05-23 00:00:00,Butler Air Transport,Landing (descent or approach),Commercial,Australia,Oceania,5,1,0,4,0,0,5,Weather
1952-06-03 00:00:00,Royal Air Force - RAF,Landing (descent or approach),Operational,United Kingdom,Europe,2,2,0,0,0,0,2,Human Factor
1952-06-05 00:00:00,Scott Aero Service,Landing (descent or approach),Operational,United States of America,North America,2,2,0,0,0,0,2,Unknown
1952-06-11 00:00:00,United States Navy - USN,,Military / Government,United States of America,North America,0,0,0,0,0,0,0,Unknown
1952-06-16 00:00:00,Swedish Air Force - Flygvapnet,Flight,Military / Government,World,World,5,5,0,0,0,0,5,Terrorism
1952-06-16 00:00:00,Royal Air Force - RAF,Landing (descent or approach),Military / Government,Malta,Europe,0,0,0,0,0,0,0,Weather
1952-06-22 00:00:00,Detectors,Takeoff (climb),Business,Canada,North America,1,1,0,0,0,0,1,Unknown
1952-06-30 00:00:00,Royal Air Force - RAF,Takeoff (climb),Military / Government,Sudan,Africa,0,0,0,0,0,0,0,Technical Failure
1952-07-03 00:00:00,Royal Air Force - RAF,Flight,Military / Government,Malaysia,Asia,1,1,0,0,0,0,1,Technical Failure
1952-07-08 00:00:00,United States Navy - USN,Flight,Military / Government,South Korea,Asia,2,2,0,0,0,0,2,Terrorism
1952-07-11 00:00:00,United States Air Force - USAF,Landing (descent or approach),Military / Government,United States of America,North America,0,0,0,0,0,0,0,Technical Failure
1952-07-18 00:00:00,LOT Polish Airlines - Polskie Linie Lotnicze,Landing (descent or approach),Commercial,Poland,Europe,0,0,0,0,0,0,0,Unknown
1952-07-22 00:00:00,Royal Air Force - RAF,Taxiing,Operational,United Kingdom,Europe,0,0,0,0,0,0,0,Human Factor
1952-07-23 00:00:00,Airwork - UK,Landing (descent or approach),Commercial,France,Europe,76,8,0,68,0,0,76,Technical Failure
1952-07-25 00:00:00,United States Air Force - USAF,Landing (descent or approach),Military / Government,Japan,Asia,0,0,0,0,0,0,0,Technical Failure
1952-07-25 00:00:00,Crewsair,Landing (descent or approach),Operational,Malta,Europe,0,0,0,0,0,0,0,Technical Failure
1952-07-27 00:00:00,Tropic Airways,Flight,Commercial,World,World,32,4,0,28,0,0,32,Technical Failure
1952-07-28 00:00:00,Royal Canadian Air Force - RCAF,,Military / Government,Canada,North America,0,0,0,0,0,0,0,Unknown
1952-07-30 00:00:00,Misrair,Landing (descent or approach),Commercial,Egypt,Africa,38,5,0,33,0,0,38,Technical Failure
1952-08-01 00:00:00,Island Air Services - UK,Landing (descent or approach),Commercial,United Kingdom,Europe,9,1,0,8,0,0,9,Weather
1952-08-06 00:00:00,Spanish Air Force - Ejército del Aire,Flight,Operational,Spain,Europe,5,5,0,0,0,0,5,Technical Failure
1952-08-09 00:00:00,United States Air Force - USAF,Landing (descent or approach),Operational,United States of America,North America,0,0,0,0,0,0,0,Unknown
1952-08-15 00:00:00,Viaçao Aéreo Santos Dumont,Landing (descent or approach),Commercial,Brazil,South America,0,0,0,0,0,0,0,Human Factor
1952-08-15 00:00:00,Austin Airways,,Commercial,Canada,North America,0,0,0,0,0,0,0,Technical Failure
1952-08-20 00:00:00,Royal Air Force - RAF,Landing (descent or approach),Operational,United Kingdom,Europe,0,0,0,0,0,0,0,Technical Failure
1952-08-20 00:00:00,United States Air Force - USAF,Flight,Military / Government,South Korea,Asia,0,0,0,0,0,0,0,Technical Failure
1952-08-20 00:00:00,Sault Airways,Takeoff (climb),Commercial,Canada,North America,9,1,0,8,0,0,9,Technical Failure
1952-08-21 00:00:00,Belgian Air Force - Force Aérienne Belge - Belgische Luchtmacht,Landing (descent or approach),Operational,Belgium,Europe,4,4,0,0,0,0,4,Unknown
1952-08-24 00:00:00,United States Air Force - USAF,Landing (descent or approach),Military / Government,South Korea,Asia,2,2,0,0,0,0,2,Unknown
1952-08-27 00:00:00,Vickers-Armstrongs Ltd,Landing (descent or approach),Operational,Sudan,Africa,5,5,0,0,0,0,5,Unknown
1952-08-28 00:00:00,United States Air Force - USAF,Flight,Military / Government,France,Europe,0,0,0,0,0,0,0,Technical Failure
1952-08-31 00:00:00,Transportes Aéreos de Tampico,Takeoff (climb),Commercial,Mexico,Central America,23,3,0,20,0,0,23,Human Factor
1952-09-03 00:00:00,Wideroe - Wideroe's Flyveselskap,Flight,Operational,Norway,Europe,4,2,0,2,0,0,4,Unknown
1952-09-05 00:00:00,United States Air Force - USAF,Flight,Military / Government,Greenland,Europe,0,0,0,0,0,0,0,Technical Failure
1952-09-08 00:00:00,United States Air Force - USAF,Flight,Operational,United States of America,North America,12,12,0,0,0,0,12,Technical Failure
1952-09-11 00:00:00,United States Air Force - USAF,Flight,Military / Government,United States of America,North America,5,2,0,3,0,0,5,Technical Failure
1952-09-13 00:00:00,Belgian Air Force - Force Aérienne Belge - Belgische Luchtmacht,Flight,Military / Government,Democratic Republic of Congo,Africa,0,0,0,0,0,0,0,Unknown
1952-09-15 00:00:00,South African Airways -SAA - Suid Afrikaanse Lugdiens - SAL,Landing (descent or approach),Commercial,South Africa,Africa,19,5,0,14,0,0,19,Human Factor
1952-09-16 00:00:00,Royal Air Force - RAF,Flight,Military / Government,Greenland,Europe,11,11,0,0,0,0,11,Human Factor
1952-09-23 00:00:00,Veljekset Karhumäki,Flight,Commercial,Finland,Europe,2,1,0,1,0,0,2,Technical Failure
1952-09-24 00:00:00,Lusaka Air Charter,Landing (descent or approach),Operational,Zimbabwe,Africa,2,2,0,0,0,0,2,Unknown
1952-09-28 00:00:00,Royal Air Force - RAF,Landing (descent or approach),Military / Government,Tanzania,Africa,0,0,0,0,0,0,0,Technical Failure
1952-10-02 00:00:00,Campbell Chain Company,Takeoff (climb),Business,United States of America,North America,6,1,0,5,0,0,6,Technical Failure
1952-10-07 00:00:00,LOT Polish Airlines - Polskie Linie Lotnicze,Flight,Commercial,Poland,Europe,0,0,0,0,0,0,0,Unknown
1952-10-08 00:00:00,Royal Air Force - RAF,Landing (descent or approach),Operational,United Kingdom,Europe,1,1,0,0,0,0,1,Human Factor
1952-10-08 00:00:00,United States Navy - USN,Landing (descent or approach),Military / Government,Malta,Europe,0,0,0,0,0,0,0,Technical Failure
1952-10-09 00:00:00,United States Air Force - USAF,Landing (descent or approach),Military / Government,Japan,Asia,0,0,0,0,0,0,0,Unknown
1952-10-14 00:00:00,Northern Wings,Takeoff (climb),Operational,Canada,North America,2,2,0,0,0,0,2,Unknown
1952-10-15 00:00:00,Société Africaine de Travaux et d’Études en Photographies Aériennes,Landing (descent or approach),Business,France,Europe,0,0,0,0,0,0,0,Unknown
1952-10-16 00:00:00,Australian National Airways - ANA,Landing (descent or approach),Commercial,Australia,Oceania,0,0,0,0,0,0,0,Unknown
1952-10-18 00:00:00,VARIG - Viação Aérea Rio Grandense,Landing (descent or approach),Commercial,Brazil,South America,4,3,0,1,0,0,4,Human Factor
1952-10-21 00:00:00,Royal Air Force - RAF,Flight,Operational,United Kingdom,Europe,2,2,0,0,0,0,2,Technical Failure
1952-10-22 00:00:00,Royal Air Force - RAF,Flight,Operational,United Kingdom,Europe,3,3,0,0,0,0,3,Unknown
1952-10-23 00:00:00,United States Air Force - USAF,Taxiing,Military / Government,Marshall Islands,Oceania,0,0,0,0,0,0,0,Technical Failure
1952-10-26 00:00:00,British Overseas Airways Corporation - BOAC,Takeoff (climb),Commercial,Italy,Europe,43,8,0,35,0,0,43,Human Factor
1952-10-27 00:00:00,Argentinian Air Force - Fuerza Aérea Argentina,Landing (descent or approach),Military / Government,Argentina,South America,0,0,0,0,0,0,0,Technical Failure
1952-10-28 00:00:00,Royal Netherlands Navy - Marineluchtvaartdienst,Flight,Operational,Indonesia,Asia,0,0,0,0,0,0,0,Technical Failure
1952-11-02 00:00:00,United States Air Force - USAF,Flight,Military / Government,United States of America,North America,2,2,0,0,0,0,2,Unknown
1952-11-03 00:00:00,United States Air Force - USAF,Landing (descent or approach),Military / Government,World,World,0,0,0,0,0,0,0,Unknown
1952-11-03 00:00:00,Private Argentinian,Flight,Business,Argentina,South America,2,2,0,0,0,0,2,Unknown
1952-11-04 00:00:00,Royal Air Force - RAF,Landing (descent or approach),Operational,United Kingdom,Europe,2,2,0,0,0,0,2,Human Factor
1952-11-07 00:00:00,Aerial Surveys,Landing (descent or approach),Commercial,Australia,Oceania,2,1,0,1,0,0,2,Unknown
1952-11-12 00:00:00,Bharat Airways,Landing (descent or approach),Operational,India,Asia,3,3,0,0,0,0,3,Unknown
1952-11-14 00:00:00,MVD - Ministerstvo Vnutrennikh Del,Takeoff (climb),Military / Government,Russia,Asia,4,4,0,0,0,0,4,Human Factor
1952-11-16 00:00:00,France Hydro,Landing (descent or approach),Business,Central African Republic,Africa,0,0,0,0,0,0,0,Unknown
1952-11-20 00:00:00,French Air Force - Armée de l'Air,Flight,Military / Government,Vietnam,Asia,0,0,0,0,0,0,0,Unknown
1952-11-22 00:00:00,Gök-Tur,Takeoff (climb),Business,Turkey,Asia,1,1,0,0,0,0,1,Unknown
1952-11-25 00:00:00,Royal Air Force - RAF,Landing (descent or approach),Military / Government,United Kingdom,Europe,3,3,0,0,0,0,3,Human Factor
1952-11-27 00:00:00,Surrey Flying Services,Landing (descent or approach),Operational,United Kingdom,Europe,3,3,0,0,0,0,3,Human Factor
1952-11-30 00:00:00,United States Air Force - USAF,Landing (descent or approach),Military / Government,United States of America,North America,0,0,0,0,0,0,0,Unknown
1952-12-05 00:00:00,Air France,Flight,Commercial,Madagascar,Africa,0,0,0,0,0,0,0,Unknown
1952-12-08 00:00:00,Braniff Airways,Flight,Commercial,United States of America,North America,0,0,0,0,0,0,0,Unknown
1952-12-12 00:00:00,Hungarian Air Force - Magyar Honvédség Repülö Csapatai MHRC,Landing (descent or approach),Military / Government,Hungary,Europe,3,3,0,0,0,0,3,Weather
1952-12-15 00:00:00,Royal Air Force - RAF,Landing (descent or approach),Operational,United Kingdom,Europe,5,5,0,0,0,0,5,Human Factor
1952-12-18 00:00:00,United States Air Force - USAF,Flight,Military / Government,Morocco,Africa,0,0,0,0,0,0,0,Unknown
1952-12-19 00:00:00,Royal Air Force - RAF,Takeoff (climb),Operational,United Kingdom,Europe,5,5,0,0,0,0,5,Technical Failure
1952-12-21 00:00:00,United States Air Force - USAF,Landing (descent or approach),Military / Government,Japan,Asia,4,4,0,0,0,0,4,Unknown
1952-12-24 00:00:00,Private American,Landing (descent or approach),Business,United States of America,North America,0,0,0,0,0,0,0,Unknown
1952-12-31 00:00:00,Royal Air Maroc - RAM,,Commercial,Morocco,Africa,0,0,0,0,0,0,0,Unknown
1953-01-01 00:00:00,Aer Lingus,Flight,Commercial,United Kingdom,Europe,25,3,0,22,0,0,25,Human Factor
1953-01-01 00:00:00,Royal Air Force - RAF,Landing (descent or approach),Military / Government,United Kingdom,Europe,3,3,0,0,0,0,3,Technical Failure
1953-01-10 00:00:00,Union of Burma Airways,Landing (descent or approach),Commercial,Myanmar,Asia,18,3,0,15,0,0,18,Human Factor
1953-01-12 00:00:00,MVD - Ministerstvo Vnutrennikh Del,Takeoff (climb),Operational,Russia,Asia,5,5,0,0,0,0,5,Human Factor
1953-01-13 00:00:00,United States Air Force - USAF,Takeoff (climb),Military / Government,South Korea,Asia,3,3,0,0,0,0,3,Unknown
1953-01-15 00:00:00,Royal Air Force - RAF,Flight,Operational,United Kingdom,Europe,2,2,0,0,0,0,2,Technical Failure
1953-01-16 00:00:00,United States Air Force - USAF,Flight,Military / Government,France,Europe,6,6,0,0,0,0,6,Technical Failure
1953-01-17 00:00:00,Adastra Airways - Adastra Aerial Surveys,Takeoff (climb),Specialised Services,Australia,Oceania,3,3,0,0,0,0,3,Technical Failure
1953-01-18 00:00:00,United States Navy - USN,Flight,Military / Government,China,Asia,11,11,0,0,0,0,11,Terrorism
1953-01-19 00:00:00,Silver City Airways,Landing (descent or approach),Operational,Germany,Europe,2,2,0,0,0,0,2,Technical Failure
1953-01-19 00:00:00,Royal Air Force - RAF,Landing (descent or approach),Military / Government,United Kingdom,Europe,0,0,0,0,0,0,0,Human Factor
1953-01-20 00:00:00,United States Air Force - USAF,Flight,Military / Government,United States of America,North America,0,0,0,0,0,0,0,Technical Failure
1953-01-21 00:00:00,French Air Force - Armée de l'Air,Flight,Military / Government,Vietnam,Asia,0,0,0,0,0,0,0,Unknown
1953-01-21 00:00:00,Aquila Airways,,Commercial,Portugal,Europe,0,0,0,0,0,0,0,Unknown
1953-01-22 00:00:00,Intercontinent Airways,Landing (descent or approach),Specialised Services,United States of America,North America,5,5,0,0,0,0,5,Human Factor
1953-01-28 00:00:00,Aquila Airways,Takeoff (climb),Commercial,United Kingdom,Europe,31,5,0,26,0,0,31,Human Factor
1953-01-28 00:00:00,Royal Air Force - RAF,Landing (descent or approach),Operational,United Kingdom,Europe,3,3,0,0,0,0,3,Human Factor
1953-01-29 00:00:00,Lineas Interamericana Aérea,Takeoff (climb),Operational,Colombia,South America,2,2,0,0,0,0,2,Technical Failure
1953-02-04 00:00:00,United States Air Force - USAF,Landing (descent or approach),Military / Government,France,Europe,0,0,0,0,0,0,0,Unknown
1953-02-04 00:00:00,Goilala Air Service,Landing (descent or approach),Commercial,Papua New Guinea,Oceania,12,2,0,10,0,0,12,Technical Failure
1953-02-06 00:00:00,Royal Netherlands Air Force - Koninklijke Luchtmacht,Takeoff (climb),Operational,Netherlands,Europe,0,0,0,0,0,0,0,Weather
1953-02-07 00:00:00,Italian Air Force - Aeronautica Militare Italiana,Landing (descent or approach),Military / Government,Italy,Europe,0,0,0,0,0,0,0,Technical Failure
1953-02-07 00:00:00,United States Air Force - USAF,Flight,Military / Government,United Kingdom,Europe,14,14,0,0,0,0,14,Technical Failure
1953-02-09 00:00:00,United States Air Force - USAF,Landing (descent or approach),Operational,United States of America,North America,0,0,0,0,0,0,0,Human Factor
1953-02-12 00:00:00,Brazilian Air Force - Força Aérea Brasileira,Takeoff (climb),Military / Government,Brazil,South America,4,2,0,2,0,0,4,Technical Failure
1953-02-13 00:00:00,Aigle Azur,Parking,Commercial,Cambodia,Asia,5,2,0,3,0,0,5,Technical Failure
1953-02-14 00:00:00,United States Air Force - USAF,Flight,Military / Government,United States of America,North America,1,1,0,0,0,0,1,Weather
1953-02-14 00:00:00,United States Air Force - USAF,Takeoff (climb),Operational,United States of America,North America,0,0,0,0,0,0,0,Technical Failure
1953-02-15 00:00:00,Lineas Interamericana Aérea,Landing (descent or approach),Operational,Colombia,South America,6,5,0,1,0,0,6,Unknown
1953-02-18 00:00:00,United States Air Force - USAF,Landing (descent or approach),Military / Government,United States of America,North America,22,22,0,0,0,0,22,Technical Failure
1953-02-20 00:00:00,Brain %26 Brown Airfreighters,Takeoff (climb),Operational,Australia,Oceania,2,2,0,0,0,0,2,Unknown
1953-02-24 00:00:00,Belgian Air Force - Force Aérienne Belge - Belgische Luchtmacht,Taxiing,Operational,Belgium,Europe,4,4,0,0,0,0,4,Unknown
1953-02-27 00:00:00,United States Navy - USN,Flight,Military / Government,World,World,10,10,0,0,0,0,10,Technical Failure
1953-03-05 00:00:00,United States Air Force - USAF,Landing (descent or approach),Military / Government,Philippines,Asia,0,0,0,0,0,0,0,Human Factor
1953-03-11 00:00:00,United States Air Force - USAF,Landing (descent or approach),Military / Government,Canada,North America,0,0,0,0,0,0,0,Unknown
1953-03-11 00:00:00,United States Air Force - USAF,Flight,Operational,South Korea,Asia,4,4,0,0,0,0,4,Technical Failure
1953-03-13 00:00:00,LOT Polish Airlines - Polskie Linie Lotnicze,Landing (descent or approach),Commercial,Poland,Europe,0,0,0,0,0,0,0,Unknown
1953-03-15 00:00:00,Transportes Aéreos Catarinense,Takeoff (climb),Commercial,Brazil,South America,6,3,0,3,0,0,6,Technical Failure
1953-03-20 00:00:00,Aerovias Sud Americana,Landing (descent or approach),Operational,United States of America,North America,3,3,0,0,0,0,3,Human Factor
1953-03-26 00:00:00,Royal Air Force - RAF,Taxiing,Military / Government,Cyprus,Europe,0,0,0,0,0,0,0,Technical Failure
1953-03-27 00:00:00,California Eastern Airways,Flight,Operational,United States of America,North America,4,3,0,1,0,0,4,Technical Failure
1953-03-27 00:00:00,Transportes Aéreos Salvador,Takeoff (climb),Commercial,Brazil,South America,14,2,0,12,0,0,14,Technical Failure
1953-03-27 00:00:00,AREA Ecuador - Aerovias Ecuatorianas,Landing (descent or approach),Operational,Panama,Central America,2,2,0,0,0,0,2,Technical Failure
1953-04-03 00:00:00,Adastra Airways - Adastra Aerial Surveys,Takeoff (climb),Operational,Australia,Oceania,2,2,0,0,0,0,2,Technical Failure
1953-04-06 00:00:00,Salmita Consolidated Mines,Flight,Operational,Canada,North America,2,2,0,0,0,0,2,Unknown
1953-04-12 00:00:00,Northern Wings,Flight,Commercial,Canada,North America,0,0,0,0,0,0,0,Unknown
1953-04-24 00:00:00,Czech Air Force - Ceské Vojenské Letectvo,Takeoff (climb),Operational,Czech Republic,Europe,3,3,0,0,0,0,3,Human Factor
1953-04-27 00:00:00,Caspar Air Charters,Landing (descent or approach),Operational,Tanzania,Africa,2,2,0,0,0,0,2,Unknown
1953-05-01 00:00:00,Air Jordan,Takeoff (climb),Commercial,Jordan,Asia,0,0,0,0,0,0,0,Unknown
1953-05-06 00:00:00,Northwest Agricultural Aviation,Takeoff (climb),Military / Government,United States of America,North America,2,2,0,0,0,0,2,Weather
1953-05-07 00:00:00,Royal Air Force - RAF,Flight,Operational,United Kingdom,Europe,5,5,0,0,0,0,5,Human Factor
1953-05-09 00:00:00,Air Services of India,Takeoff (climb),Commercial,India,Asia,0,0,0,0,0,0,0,Human Factor
1953-05-11 00:00:00,Compagnie Autrex-Lopez-Loreta-Le Breton,Landing (descent or approach),Operational,Vietnam,Asia,0,0,0,0,0,0,0,Unknown
1953-05-12 00:00:00,Czech Air Force - Ceské Vojenské Letectvo,Flight,Operational,Czech Republic,Europe,3,3,0,0,0,0,3,Technical Failure
1953-05-13 00:00:00,Belgian Air Force - Force Aérienne Belge - Belgische Luchtmacht,Flight,Operational,Belgium,Europe,0,0,0,0,0,0,0,Unknown
1953-05-14 00:00:00,Royal Air Force - RAF,Landing (descent or approach),Operational,United Kingdom,Europe,0,0,0,0,0,0,0,Human Factor
1953-05-25 00:00:00,KLM Royal Dutch Airlines - Koninklijke Luchtvaart Maatschappij,Takeoff (climb),Commercial,Netherlands,Europe,34,6,0,28,0,0,34,Human Factor
1953-05-25 00:00:00,United States Air Force - USAF,Flight,Military / Government,United States of America,North America,5,5,0,0,0,0,5,Technical Failure
1953-06-08 00:00:00,Brazilian Air Force - Força Aérea Brasileira,Takeoff (climb),Military / Government,Brazil,South America,0,0,0,0,0,0,0,Unknown
1953-06-09 00:00:00,Argentinian Air Force - Fuerza Aérea Argentina,Flight,Commercial,Argentina,South America,23,3,0,20,0,0,23,Technical Failure
1953-06-16 00:00:00,Royal Air Force - RAF,Landing (descent or approach),Operational,Egypt,Africa,3,3,0,0,0,0,3,Technical Failure
1953-06-17 00:00:00,Aerolineas Argentinas,Landing (descent or approach),Commercial,Argentina,South America,41,7,0,34,0,0,41,Human Factor
1953-06-17 00:00:00,United States Air Force - USAF,Landing (descent or approach),Military / Government,South Korea,Asia,0,0,0,0,0,0,0,Unknown
1953-06-25 00:00:00,Union Aéromaritime de Transport - UAT,Landing (descent or approach),Commercial,Senegal,Africa,29,7,0,22,0,0,29,Other
1953-06-28 00:00:00,Brazilian Air Force - Força Aérea Brasileira,Landing (descent or approach),Military / Government,Brazil,South America,0,0,0,0,0,0,0,Technical Failure
1953-06-28 00:00:00,Royal Air Force - RAF,Landing (descent or approach),Military / Government,Philippines,Asia,0,0,0,0,0,0,0,Weather
1953-06-30 00:00:00,Iran Air,Landing (descent or approach),Operational,Iran,Asia,6,6,0,0,0,0,6,Human Factor
1953-07-05 00:00:00,Private Brazilian,Landing (descent or approach),Business,Brazil,South America,10,1,0,9,0,0,10,Weather
1953-07-05 00:00:00,Dragon Airways,Flight,Commercial,United Kingdom,Europe,8,1,0,7,0,0,8,Technical Failure
1953-07-09 00:00:00,Royal Air Force - RAF,Flight,Operational,United Kingdom,Europe,2,2,0,0,0,0,2,Human Factor
1953-07-11 00:00:00,Royal Norwegian Air Force - Kongelige Norske Luftforsvaret,Takeoff (climb),Military / Government,Norway,Europe,4,2,0,2,0,0,4,Technical Failure
1953-07-15 00:00:00,Convair,Flight,Specialised Services,United States of America,North America,11,11,0,0,0,0,11,Technical Failure
1953-07-16 00:00:00,South African Air Force,Flight,Military / Government,South Africa,Africa,2,2,0,0,0,0,2,Unknown
1953-07-19 00:00:00,Southern Air Transport,Landing (descent or approach),Operational,United States of America,North America,2,2,0,0,0,0,2,Human Factor
1953-07-20 00:00:00,MVD - Ministerstvo Vnutrennikh Del,Takeoff (climb),Military / Government,Russia,Asia,16,5,0,11,0,0,16,Technical Failure
1953-07-22 00:00:00,Royal Air Force - RAF,Flight,Military / Government,World,World,6,6,0,0,0,0,6,Technical Failure
1953-07-23 00:00:00,Argentinian Government,Flight,Military / Government,Argentina,South America,3,3,0,0,0,0,3,Unknown
1953-07-25 00:00:00,British Overseas Airways Corporation - BOAC,Taxiing,Commercial,India,Asia,42,6,0,36,0,0,42,Human Factor
1953-07-27 00:00:00,Royal Air Force - RAF,Landing (descent or approach),Operational,China,Asia,2,2,0,0,0,0,2,Weather
1953-07-28 00:00:00,World-Wide Airways,Landing (descent or approach),Operational,Canada,North America,2,2,0,0,0,0,2,Weather
1953-07-29 00:00:00,Royal Air Force - RAF,Landing (descent or approach),Military / Government,Egypt,Africa,0,0,0,0,0,0,0,Technical Failure
1953-07-29 00:00:00,Arctic Wings,Flight,Commercial,Canada,North America,5,1,0,4,0,0,5,Technical Failure
1953-07-30 00:00:00,Vietnamese Government,,Military / Government,Vietnam,Asia,0,0,0,0,0,0,0,Unknown
1953-08-04 00:00:00,Union of Burma Airways,Landing (descent or approach),Commercial,Myanmar,Asia,21,3,0,18,0,0,21,Unknown
1953-08-04 00:00:00,Ellis Airlines,,Commercial,United States of America,North America,0,0,0,0,0,0,0,Unknown
1953-08-04 00:00:00,Royal Air Force - RAF,Landing (descent or approach),Military / Government,Jordan,Asia,0,0,0,0,0,0,0,Technical Failure
1953-08-09 00:00:00,Brazilian Air Force - Força Aérea Brasileira,Landing (descent or approach),Operational,Brazil,South America,3,3,0,0,0,0,3,Technical Failure
1953-08-09 00:00:00,United States Air Force - USAF,Flight,Military / Government,Libya,Africa,24,6,0,18,0,0,24,Technical Failure
1953-08-12 00:00:00,British European Airways - BEA,Landing (descent or approach),Commercial,France,Europe,34,4,0,30,0,0,34,Technical Failure
1953-08-17 00:00:00,Johnson Flying Service,Flight,Military / Government,United States of America,North America,7,1,0,6,0,0,7,Technical Failure
1953-08-23 00:00:00,Real Aerovias,Landing (descent or approach),Operational,Brazil,South America,4,4,0,0,0,0,4,Human Factor
1953-08-23 00:00:00,United States Air Force - USAF,Flight,Military / Government,Philippines,Asia,0,0,0,0,0,0,0,Technical Failure
1953-08-27 00:00:00,United States Air Force - USAF,Flight,Operational,United States of America,North America,0,0,0,0,0,0,0,Technical Failure
1953-08-28 00:00:00,Royal Canadian Air Force - RCAF,,Military / Government,Canada,North America,0,0,0,0,0,0,0,Unknown
1953-09-06 00:00:00,Northwest Airlines,Landing (descent or approach),Commercial,United States of America,North America,32,6,0,26,0,0,32,Technical Failure
1953-09-06 00:00:00,United States Navy - USN,Landing (descent or approach),Military / Government,Bermuda,North America,50,3,0,47,0,0,50,Human Factor
1953-09-12 00:00:00,Brazilian Air Force - Força Aérea Brasileira,Takeoff (climb),Military / Government,Brazil,South America,0,0,0,0,0,0,0,Technical Failure
1953-09-13 00:00:00,Belgian Air Force - Force Aérienne Belge - Belgische Luchtmacht,Flight,Military / Government,Democratic Republic of Congo,Africa,0,0,0,0,0,0,0,Technical Failure
1953-09-14 00:00:00,Loide Aéreo Nacional,Landing (descent or approach),Commercial,Brazil,South America,17,5,0,12,0,0,17,Technical Failure
1953-09-22 00:00:00,North Star Airlines,Landing (descent or approach),Commercial,United States of America,North America,44,7,0,37,0,0,44,Technical Failure
1953-09-28 00:00:00,Royal Air Force - RAF,Takeoff (climb),Military / Government,Malta,Europe,5,5,0,0,0,0,5,Unknown
1953-10-03 00:00:00,Wideroe - Wideroe's Flyveselskap,Takeoff (climb),Commercial,Norway,Europe,0,0,0,0,0,0,0,Technical Failure
1953-10-09 00:00:00,Royal Air Force - RAF,Landing (descent or approach),Operational,United Kingdom,Europe,4,4,0,0,0,0,4,Human Factor
1953-10-09 00:00:00,Royal Air Force - RAF,Landing (descent or approach),Operational,United Kingdom,Europe,4,4,0,0,0,0,4,Human Factor
1953-10-10 00:00:00,United States Navy - USN,Takeoff (climb),Military / Government,Morocco,Africa,0,0,0,0,0,0,0,Technical Failure
1953-10-12 00:00:00,Royal Air Force - RAF,Landing (descent or approach),Military / Government,Jordan,Asia,0,0,0,0,0,0,0,Technical Failure
1953-10-17 00:00:00,Servicios Aéreos de Chiapas,Flight,Commercial,Mexico,Central America,0,0,0,0,0,0,0,Unknown
1953-10-19 00:00:00,United States Navy - USN,Takeoff (climb),Military / Government,Bermuda,North America,8,8,0,0,0,0,8,Technical Failure
1953-10-23 00:00:00,Italian Air Force - Aeronautica Militare Italiana,Flight,Specialised Services,Italy,Europe,4,2,0,2,0,0,4,Technical Failure
1953-11-05 00:00:00,United States Air Force - USAF,Flight,Military / Government,United States of America,North America,0,0,0,0,0,0,0,Unknown
1953-11-08 00:00:00,United States Air Force - USAF,Flight,Military / Government,United States of America,North America,1,1,0,0,0,0,1,Technical Failure
1953-11-17 00:00:00,Papuan Air Transport - Patair,Landing (descent or approach),Operational,Papua New Guinea,Oceania,1,1,0,0,0,0,1,Weather
1953-11-21 00:00:00,United States Air Force - USAF,Landing (descent or approach),Military / Government,United States of America,North America,13,13,0,0,0,0,13,Human Factor
1953-11-25 00:00:00,Royal Air Force - RAF,Taxiing,Operational,United Kingdom,Europe,2,2,0,0,0,0,2,Technical Failure
1953-11-26 00:00:00,United States Air Force - USAF,Flight,Military / Government,Libya,Africa,0,0,0,0,0,0,0,Unknown
1953-11-27 00:00:00,Nalanda Airways,Flight,Commercial,India,Asia,3,1,0,2,0,0,3,Unknown
1953-11-28 00:00:00,United States Air Force - USAF,Takeoff (climb),Military / Government,United States of America,North America,4,2,0,2,0,0,4,Unknown
1953-12-06 00:00:00,Mannix,Flight,Business,Canada,North America,3,1,0,2,0,0,3,Weather
1953-12-11 00:00:00,Italian Air Force - Aeronautica Militare Italiana,Landing (descent or approach),Operational,Italy,Europe,2,2,0,0,0,0,2,Human Factor
1953-12-20 00:00:00,Eagle Aviation - UK,Landing (descent or approach),Commercial,Germany,Europe,11,2,0,9,0,0,11,Human Factor
1953-12-20 00:00:00,Belgian Congo Geographic Institute,,Specialised Services,Democratic Republic of Congo,Africa,0,0,0,0,0,0,0,Unknown
1953-12-22 00:00:00,United States Navy - USN,Landing (descent or approach),Military / Government,China,Asia,0,0,0,0,0,0,0,Human Factor
1953-12-22 00:00:00,Royal Air Force - RAF,Landing (descent or approach),Operational,United Kingdom,Europe,5,5,0,0,0,0,5,Human Factor
1953-12-27 00:00:00,Royal Canadian Air Force - RCAF,Landing (descent or approach),Military / Government,United States of America,North America,8,6,0,2,0,0,8,Weather
1953-12-27 00:00:00,Royal Air Force - RAF,Flight,Military / Government,Japan,Asia,0,0,0,0,0,0,0,Technical Failure
1953-12-29 00:00:00,Israeli Air Force - Heyl Ha'avir,Takeoff (climb),Operational,Israel,Asia,4,4,0,0,0,0,4,Unknown
1953-12-29 00:00:00,Royal Air Force - RAF,Flight,Operational,United Kingdom,Europe,2,2,0,0,0,0,2,Technical Failure
1953-12-30 00:00:00,Royal Canadian Air Force - RCAF,Landing (descent or approach),Military / Government,Canada,North America,51,8,0,43,0,0,51,Technical Failure
1953-12-31 00:00:00,Flugfélag Íslands,Landing (descent or approach),Commercial,Iceland,Europe,0,0,0,0,0,0,0,Unknown
1953-12-31 00:00:00,Hollinger Ungava Transport,Landing (descent or approach),Operational,Canada,North America,0,0,0,0,0,0,0,Unknown
1953-12-31 00:00:00,United States Navy - USN,Flight,Military / Government,World,World,0,0,0,0,0,0,0,Technical Failure
1954-01-02 00:00:00,Royal Air Force - RAF,Takeoff (climb),Military / Government,Yemen,Asia,0,0,0,0,0,0,0,Unknown
1954-01-05 00:00:00,Private American,Takeoff (climb),Business,United States of America,North America,0,0,0,0,0,0,0,Technical Failure
1954-01-06 00:00:00,Air Liban,Takeoff (climb),Commercial,Lebanon,Asia,9,5,0,4,0,0,9,Technical Failure
1954-01-10 00:00:00,Fullerton Consolidated Oil Company,Takeoff (climb),Operational,United States of America,North America,2,2,0,0,0,0,2,Unknown
1954-01-10 00:00:00,A.G. Mechin %26 Company,Landing (descent or approach),Business,Zambia,Africa,0,0,0,0,0,0,0,Technical Failure
1954-01-15 00:00:00,Royal Air Force - RAF,Landing (descent or approach),Operational,United Kingdom,Europe,7,7,0,0,0,0,7,Unknown
1954-01-20 00:00:00,American Airlines,Takeoff (climb),Commercial,United States of America,North America,24,3,0,21,0,0,24,Technical Failure
1954-01-24 00:00:00,Compagnie Autrex-Lopez-Loreta-Le Breton,Landing (descent or approach),Operational,Lebanon,Asia,3,3,0,0,0,0,3,Other
1954-01-24 00:00:00,East African Airways,Takeoff (climb),Commercial,Uganda,Africa,4,1,0,3,0,0,4,Unknown
1954-01-30 00:00:00,Royal Air Force - RAF,Landing (descent or approach),Operational,United Kingdom,Europe,6,6,0,0,0,0,6,Technical Failure
1954-01-31 00:00:00,Lineas Interamericana Aérea,Flight,Operational,Colombia,South America,2,2,0,0,0,0,2,Technical Failure
1954-01-31 00:00:00,Aigle Azur,Takeoff (climb),Commercial,Vietnam,Asia,0,0,0,0,0,0,0,Human Factor
1954-02-01 00:00:00,Royal Air Force - RAF,Landing (descent or approach),Military / Government,Yemen,Asia,18,3,0,15,0,0,18,Human Factor
1954-02-03 00:00:00,Royal Canadian Air Force - RCAF,Flight,Military / Government,Italy,Europe,5,2,0,3,0,0,5,Unknown
1954-02-04 00:00:00,Bristol Aeroplane Company,Landing (descent or approach),Specialised Services,United Kingdom,Europe,13,13,0,0,0,0,13,Technical Failure
1954-02-05 00:00:00,Royal Air Force - RAF,Landing (descent or approach),Operational,United Kingdom,Europe,2,2,0,0,0,0,2,Human Factor
1954-02-08 00:00:00,United States Air Force - USAF,Flight,Military / Government,Spain,Europe,8,8,0,0,0,0,8,Technical Failure
1954-02-14 00:00:00,United States Air Force - USAF,Flight,Military / Government,United States of America,North America,0,0,0,0,0,0,0,Technical Failure
1954-02-19 00:00:00,Private Canadian,Flight,Business,Canada,North America,2,1,0,1,0,0,2,Unknown
1954-02-19 00:00:00,Oldstead Airlines,Flight,Commercial,United Kingdom,Europe,8,1,0,7,0,0,8,Weather
1954-02-21 00:00:00,Italian Air Force - Aeronautica Militare Italiana,Landing (descent or approach),Military / Government,Somalia,Africa,0,0,0,0,0,0,0,Human Factor
1954-02-22 00:00:00,United States Air Force - USAF,Flight,Military / Government,Greenland,Europe,0,0,0,0,0,0,0,Unknown
1954-02-23 00:00:00,Royal Air Force - RAF,Landing (descent or approach),Operational,United Kingdom,Europe,0,0,0,0,0,0,0,Other
1954-02-26 00:00:00,United States Air Force - USAF,Taxiing,Operational,United States of America,North America,0,0,0,0,0,0,0,Technical Failure
1954-02-26 00:00:00,Royal Air Force - RAF,Flight,Military / Government,Germany,Europe,4,4,0,0,0,0,4,Technical Failure
1954-02-26 00:00:00,Hewett Aviation,Flight,Operational,New Zealand,Oceania,1,1,0,0,0,0,1,Technical Failure
1954-03-03 00:00:00,Zonen Aviation - Zone-Redningskorpset Flyve-Tjenesten,Flight,Humanitarian,Denmark,Europe,0,0,0,0,0,0,0,Technical Failure
1954-03-03 00:00:00,United States Air Force - USAF,,Military / Government,South Korea,Asia,0,0,0,0,0,0,0,Unknown
1954-03-04 00:00:00,Linhas Aéreas Paulistas,Takeoff (climb),Operational,Brazil,South America,2,2,0,0,0,0,2,Technical Failure
1954-03-12 00:00:00,Argentinian Government,Takeoff (climb),Military / Government,Argentina,South America,4,4,0,0,0,0,4,Human Factor
1954-03-13 00:00:00,Compagnie Autrex-Lopez-Loreta-Le Breton,Landing (descent or approach),Operational,Laos,Asia,3,3,0,0,0,0,3,Terrorism
1954-03-16 00:00:00,Continental Airlines,Takeoff (climb),Commercial,United States of America,North America,11,3,0,8,0,0,11,Human Factor
1954-03-21 00:00:00,DETA Mozambique Airlines - Direcção de Exploração dos Transportes Aéreos,Takeoff (climb),Commercial,Mozambique,Africa,6,2,0,4,0,0,6,Unknown
1954-03-21 00:00:00,United States Air Force - USAF,Landing (descent or approach),Military / Government,Puerto Rico,Central America,1,1,0,0,0,0,1,Unknown
1954-03-29 00:00:00,Pacific Lumber Company,Landing (descent or approach),Business,United States of America,North America,6,2,0,4,0,0,6,Unknown
1954-04-10 00:00:00,Linee Aeree Italiane - LAI,Takeoff (climb),Operational,Italy,Europe,4,4,0,0,0,0,4,Technical Failure
1954-04-12 00:00:00,Royal Air Force - RAF,Landing (descent or approach),Operational,United Kingdom,Europe,4,4,0,0,0,0,4,Technical Failure
1954-04-13 00:00:00,Scottish Airlines,Taxiing,Operational,Malta,Europe,3,3,0,0,0,0,3,Human Factor
1954-04-17 00:00:00,United States Air Force - USAF,Taxiing,Specialised Services,United States of America,North America,2,2,0,0,0,0,2,Human Factor
1954-04-24 00:00:00,Misrair,Landing (descent or approach),Commercial,Syria,Asia,22,5,0,17,0,0,22,Technical Failure
1954-04-25 00:00:00,Compagnie Autrex-Lopez-Loreta-Le Breton,Landing (descent or approach),Operational,Vietnam,Asia,2,2,0,0,0,0,2,Technical Failure
1954-04-26 00:00:00,Royal Canadian Air Force - RCAF,,Military / Government,Canada,North America,0,0,0,0,0,0,0,Unknown
1954-04-26 00:00:00,Iraq Petroleum Transport Company,Flight,Business,Bahrain,Asia,0,0,0,0,0,0,0,Unknown
1954-04-26 00:00:00,Fiji Airways,Takeoff (climb),Commercial,Fiji Islands,Oceania,6,2,0,4,0,0,6,Technical Failure
1954-04-30 00:00:00,Air Laos,Takeoff (climb),Operational,Vietnam,Asia,4,4,0,0,0,0,4,Technical Failure
1954-05-01 00:00:00,SABENA - Société Anonyme Belge d'Exploitation de la Navigation Aérienne,Landing (descent or approach),Commercial,Democratic Republic of Congo,Africa,0,0,0,0,0,0,0,Technical Failure
1954-05-03 00:00:00,United States Navy - USN,Flight,Military / Government,United States of America,North America,0,0,0,0,0,0,0,Technical Failure
1954-05-03 00:00:00,Airtaco,Flight,Operational,Sweden,Europe,2,2,0,0,0,0,2,Technical Failure
1954-05-08 00:00:00,United States Air Force - USAF,Flight,Military / Government,South Korea,Asia,1,1,0,0,0,0,1,Weather
1954-05-08 00:00:00,Royal Canadian Air Force - RCAF,Landing (descent or approach),Military / Government,United Kingdom,Europe,0,0,0,0,0,0,0,Human Factor
1954-05-08 00:00:00,Polyarnaya Aviatsiya,Landing (descent or approach),Military / Government,World,World,5,5,0,0,0,0,5,Human Factor
1954-05-13 00:00:00,Paraense Transportes Aéreos,Flight,Commercial,Brazil,South America,6,3,0,3,0,0,6,Technical Failure
1954-05-13 00:00:00,Royal Air Force - RAF,Landing (descent or approach),Operational,United Kingdom,Europe,4,4,0,0,0,0,4,Human Factor
1954-05-15 00:00:00,Jamair,Landing (descent or approach),Operational,India,Asia,3,3,0,0,0,0,3,Human Factor
1954-05-17 00:00:00,Cubana de Aviación,Landing (descent or approach),Commercial,Cuba,Central America,0,0,0,0,0,0,0,Technical Failure
1954-05-29 00:00:00,LAN Chile - Linea Aérea Nacional de Chile,Landing (descent or approach),Commercial,Chile,South America,29,3,0,26,0,0,29,Weather
1954-06-05 00:00:00,Royal Australian Air Force - RAAF,Takeoff (climb),Military / Government,Japan,Asia,2,2,0,0,0,0,2,Technical Failure
1954-06-15 00:00:00,Delta Airlines,Takeoff (climb),Operational,United States of America,North America,2,2,0,0,0,0,2,Weather
1954-06-15 00:00:00,Great Lakes Airlines,Landing (descent or approach),Commercial,United States of America,North America,82,3,0,79,0,0,82,Technical Failure
1954-06-18 00:00:00,Private Peruvian,Flight,Business,Bolivia,South America,0,0,0,0,0,0,0,Unknown
1954-06-20 00:00:00,United States Air Force - USAF,Flight,Military / Government,Belgium,Europe,7,4,0,3,0,0,7,Technical Failure
1954-06-21 00:00:00,Royal Air Force - RAF,Landing (descent or approach),Military / Government,Australia,Oceania,0,0,0,0,0,0,0,Human Factor
1954-06-25 00:00:00,United States Air Force - USAF,Landing (descent or approach),Military / Government,United States of America,North America,0,0,0,0,0,0,0,Unknown
1954-07-02 00:00:00,Arkia Israeli Airlines,Takeoff (climb),Commercial,Israel,Asia,6,1,0,5,0,0,6,Technical Failure
1954-07-02 00:00:00,United States Air Force - USAF,Landing (descent or approach),Military / Government,United States of America,North America,0,0,0,0,0,0,0,Unknown
1954-07-02 00:00:00,United States Air Force - USAF,Takeoff (climb),Military / Government,United States of America,North America,1,1,0,0,0,0,1,Unknown
1954-07-08 00:00:00,Royal Air Force - RAF,Takeoff (climb),Operational,United Kingdom,Europe,2,2,0,0,0,0,2,Technical Failure
1954-07-12 00:00:00,Belgian Air Force - Force Aérienne Belge - Belgische Luchtmacht,Landing (descent or approach),Operational,Belgium,Europe,3,3,0,0,0,0,3,Technical Failure
1954-07-14 00:00:00,Swedish Air Force - Flygvapnet,Flight,Operational,Sweden,Europe,4,2,0,2,0,0,4,Technical Failure
1954-07-18 00:00:00,Royal Air Force - RAF,Takeoff (climb),Military / Government,China,Asia,5,5,0,0,0,0,5,Unknown
1954-07-25 00:00:00,A.G. Mechin %26 Company,Flight,Business,Zimbabwe,Africa,2,1,0,1,0,0,2,Technical Failure
1954-07-29 00:00:00,Arabian Desert Airlines,Landing (descent or approach),Operational,Kuwait,Asia,3,3,0,0,0,0,3,Human Factor
1954-07-30 00:00:00,Arab Contracting %26 Trading Company,Parking,Business,Iraq,Asia,6,1,0,5,0,0,6,Technical Failure
1954-07-31 00:00:00,Travelair Taxi,Takeoff (climb),Commercial,United States of America,North America,14,2,0,12,0,0,14,Unknown
1954-08-02 00:00:00,Autair Ltd,Landing (descent or approach),Commercial,Germany,Europe,7,2,0,5,0,0,7,Technical Failure
1954-08-03 00:00:00,Air France,Landing (descent or approach),Commercial,United States of America,North America,37,8,0,29,0,0,37,Technical Failure
1954-08-04 00:00:00,Royal Air Force - RAF,Landing (descent or approach),Military / Government,Bahrain,Asia,0,0,0,0,0,0,0,Technical Failure
1954-08-06 00:00:00,United States Air Force - USAF,Flight,Operational,Morocco,Africa,0,0,0,0,0,0,0,Technical Failure
1954-08-09 00:00:00,Mandated Airlines,Takeoff (climb),Commercial,Papua New Guinea,Oceania,8,1,0,7,0,0,8,Technical Failure
1954-08-11 00:00:00,Spanish Air Force - Ejército del Aire,Flight,Operational,Spain,Europe,6,6,0,0,0,0,6,Technical Failure
1954-08-14 00:00:00,Wideroe - Wideroe's Flyveselskap,,Commercial,Norway,Europe,0,0,0,0,0,0,0,Unknown
1954-08-15 00:00:00,Airwork - UK,Landing (descent or approach),Commercial,United Kingdom,Europe,37,5,0,32,0,0,37,Human Factor
1954-08-18 00:00:00,Royal Air Force - RAF,Flight,Operational,United Kingdom,Europe,3,3,0,0,0,0,3,Technical Failure
1954-08-18 00:00:00,Fiji Airways,Flight,Commercial,Fiji Islands,Oceania,8,1,0,7,0,0,8,Technical Failure
1954-08-19 00:00:00,United States Navy - USN,Flight,Military / Government,United States of America,North America,0,0,0,0,0,0,0,Unknown
1954-08-20 00:00:00,Compagnie Autrex-Lopez-Loreta-Le Breton,Takeoff (climb),Commercial,Laos,Asia,5,1,0,4,0,0,5,Unknown
1954-08-25 00:00:00,Air France,Landing (descent or approach),Commercial,Canada,North America,67,9,0,58,0,0,67,Unknown
1954-08-30 00:00:00,Aigle Azur,Flight,Commercial,Vietnam,Asia,0,0,0,0,0,0,0,Technical Failure
1954-09-03 00:00:00,United States Air Force - USAF,Flight,Military / Government,Greenland,Europe,0,0,0,0,0,0,0,Unknown
1954-09-04 00:00:00,Air Outre Mer,Landing (descent or approach),Commercial,Vietnam,Asia,0,0,0,0,0,0,0,Unknown
1954-09-15 00:00:00,Royal Air Force - RAF,Landing (descent or approach),Military / Government,United Kingdom,Europe,0,0,0,0,0,0,0,Other
1954-09-20 00:00:00,United States Air Force - USAF,Flight,Military / Government,United States of America,North America,20,3,0,17,0,0,20,Technical Failure
1954-09-22 00:00:00,Private Canadian,Takeoff (climb),Business,Canada,North America,1,1,0,0,0,0,1,Unknown
1954-09-22 00:00:00,Scottish Airlines,Takeoff (climb),Commercial,United Kingdom,Europe,49,5,0,44,0,0,49,Weather
1954-09-29 00:00:00,United States Air Force - USAF,Landing (descent or approach),Military / Government,Japan,Asia,0,0,0,0,0,0,0,Unknown
1954-10-04 00:00:00,Royal Air Force - RAF,Takeoff (climb),Operational,United Kingdom,Europe,1,1,0,0,0,0,1,Technical Failure
1954-10-07 00:00:00,United States Air Force - USAF,Flight,Military / Government,Brazil,South America,2,2,0,0,0,0,2,Technical Failure
1954-10-08 00:00:00,United States Air Force - USAF,Flight,Military / Government,Japan,Asia,2,1,0,1,0,0,2,Technical Failure
1954-10-08 00:00:00,Aviateca,Takeoff (climb),Commercial,Guatemala,Central America,10,3,0,7,0,0,10,Technical Failure
1954-10-13 00:00:00,Orient Airways,Takeoff (climb),Commercial,Pakistan,Asia,11,3,0,8,0,0,11,Technical Failure
1954-10-16 00:00:00,Aerolineas Argentinas,Flight,Commercial,Argentina,South America,32,5,0,27,0,0,32,Human Factor
1954-10-21 00:00:00,Cruzeiro do Sul,Landing (descent or approach),Commercial,Brazil,South America,31,3,0,28,0,0,31,Human Factor
1954-10-25 00:00:00,Royal Air Force - RAF,Flight,Operational,United Kingdom,Europe,2,2,0,0,0,0,2,Technical Failure
1954-10-26 00:00:00,Royal Air Force - RAF,Takeoff (climb),Operational,United Kingdom,Europe,7,7,0,0,0,0,7,Human Factor
1954-10-28 00:00:00,Royal Air Force - RAF,Landing (descent or approach),Military / Government,United Kingdom,Europe,2,2,0,0,0,0,2,Weather
1954-11-25 00:00:00,Garuda Indonesian Airways,Landing (descent or approach),Commercial,Indonesia,Asia,22,3,0,19,0,0,22,Human Factor
1954-12-02 00:00:00,Private Argentinian,Takeoff (climb),Business,Argentina,South America,4,2,0,2,0,0,4,Human Factor
1954-12-06 00:00:00,United States Air Force - USAF,Takeoff (climb),Military / Government,Japan,Asia,0,0,0,0,0,0,0,Technical Failure
1954-12-09 00:00:00,United States Navy - USN,Landing (descent or approach),Military / Government,United States of America,North America,10,10,0,0,0,0,10,Human Factor
1954-12-10 00:00:00,Linea Aeropostal Venezolana - LAV,Landing (descent or approach),Commercial,Venezuela,South America,0,0,0,0,0,0,0,Unknown
1954-12-17 00:00:00,Trans-Canada Air Lines - TCAL,Landing (descent or approach),Commercial,Canada,North America,23,7,0,16,0,0,23,Human Factor
1954-12-18 00:00:00,Papuan Air Transport - Patair,Landing (descent or approach),Commercial,Papua New Guinea,Oceania,15,2,0,13,0,0,15,Technical Failure
1954-12-22 00:00:00,Papuan Air Transport - Patair,Landing (descent or approach),Commercial,Papua New Guinea,Oceania,15,2,0,13,0,0,15,Unknown
1954-12-23 00:00:00,Malév Hungarian Airlines - Magyar Légiközlekedési Vallalat,Flight,Commercial,Czech Republic,Europe,33,5,0,28,0,0,33,Weather
1954-12-23 00:00:00,Malév Hungarian Airlines - Magyar Légiközlekedési Vallalat,Flight,Commercial,Czech Republic,Europe,19,5,0,14,0,0,19,Weather
1954-12-29 00:00:00,Lineas Aéreas del Caribe - LIDCA,Takeoff (climb),Operational,Colombia,South America,4,4,0,0,0,0,4,Technical Failure
1954-12-31 00:00:00,Aero-Nord Sweden,Landing (descent or approach),Operational,Sweden,Europe,2,2,0,0,0,0,2,Unknown
1954-12-31 00:00:00,Polyarnaya Aviatsiya,Landing (descent or approach),Operational,Antarctica,Antarctica,0,0,0,0,0,0,0,Human Factor
1955-01-10 00:00:00,National Airlines,Takeoff (climb),Commercial,United States of America,North America,13,3,0,10,0,0,13,Human Factor
1955-01-15 00:00:00,United States Air Force - USAF,Flight,Military / Government,United States of America,North America,1,1,0,0,0,0,1,Unknown
1955-01-19 00:00:00,United Airlines,Flight,Commercial,United States of America,North America,39,3,0,36,0,0,39,Human Factor
1955-01-20 00:00:00,Argentinian Navy - Armada Argentina,Flight,Operational,Trinidad and Tobago,Central America,0,0,0,0,0,0,0,Technical Failure
1955-01-22 00:00:00,Resort Airlines,Landing (descent or approach),Operational,United States of America,North America,2,2,0,0,0,0,2,Human Factor
1955-01-26 00:00:00,United States Air Force - USAF,Flight,Military / Government,World,World,8,8,0,0,0,0,8,Technical Failure
1955-01-27 00:00:00,United States Air Force - USAF,Landing (descent or approach),Military / Government,Japan,Asia,0,0,0,0,0,0,0,Unknown
1955-02-02 00:00:00,United States Air Force - USAF,Landing (descent or approach),Military / Government,United States of America,North America,0,0,0,0,0,0,0,Unknown
1955-02-04 00:00:00,Eastern Provincial Airways - EPA,Takeoff (climb),Commercial,Canada,North America,0,0,0,0,0,0,0,Unknown
1955-02-04 00:00:00,Iraqi Airways,Flight,Commercial,Iraq,Asia,0,0,0,0,0,0,0,Technical Failure
1955-02-08 00:00:00,United States Air Force - USAF,Landing (descent or approach),Operational,United States of America,North America,0,0,0,0,0,0,0,Human Factor
1955-02-21 00:00:00,Linea Aérea Ala de Chile,Landing (descent or approach),Commercial,Chile,South America,19,4,0,15,0,0,19,Unknown
1955-03-01 00:00:00,Royal Air Force - RAF,Takeoff (climb),Operational,United Kingdom,Europe,1,1,0,0,0,0,1,Technical Failure
1955-03-03 00:00:00,United States Air Force - USAF,Landing (descent or approach),Military / Government,United States of America,North America,13,13,0,0,0,0,13,Human Factor
1955-03-05 00:00:00,United States Air Force - USAF,Landing (descent or approach),Operational,United States of America,North America,11,11,0,0,0,0,11,Unknown
1955-03-06 00:00:00,United States Air Force - USAF,Flight,Military / Government,United States of America,North America,0,0,0,0,0,0,0,Unknown
1955-03-08 00:00:00,United States Air Force - USAF,Landing (descent or approach),Military / Government,United States of America,North America,0,0,0,0,0,0,0,Unknown
1955-03-10 00:00:00,United States Air Force - USAF,Flight,Operational,United States of America,North America,11,11,0,0,0,0,11,Technical Failure
1955-03-13 00:00:00,Southern Airlines,Takeoff (climb),Operational,Australia,Oceania,1,1,0,0,0,0,1,Human Factor
1955-03-14 00:00:00,Air Laos,Takeoff (climb),Commercial,Laos,Asia,0,0,0,0,0,0,0,Unknown
1955-03-15 00:00:00,Italian Air Force - Aeronautica Militare Italiana,Landing (descent or approach),Military / Government,Kenya,Africa,19,3,0,16,0,0,19,Technical Failure
1955-03-17 00:00:00,Central African Airways - CAA,Landing (descent or approach),Commercial,Zimbabwe,Africa,28,5,0,23,0,0,28,Weather
1955-03-17 00:00:00,Gendarmerie nationale,Takeoff (climb),Military / Government,France,Europe,0,0,0,0,0,0,0,Unknown
1955-03-28 00:00:00,Royal Air Force - RAF,Takeoff (climb),Operational,United Kingdom,Europe,7,7,0,0,0,0,7,Unknown
1955-03-28 00:00:00,Royal Air Force - RAF,Flight,Military / Government,United Kingdom,Europe,0,0,0,0,0,0,0,Technical Failure
1955-03-29 00:00:00,Airways India,Landing (descent or approach),Commercial,India,Asia,8,4,0,4,0,0,8,Human Factor
1955-03-31 00:00:00,United States Air Force - USAF,Landing (descent or approach),Military / Government,United States of America,North America,0,0,0,0,0,0,0,Unknown
1955-04-01 00:00:00,United States Air Force - USAF,Flight,Operational,United States of America,North America,6,6,0,0,0,0,6,Technical Failure
1955-04-02 00:00:00,Polyarnaya Aviatsiya,Landing (descent or approach),Other,Russia,Asia,10,3,0,7,0,0,10,Other
1955-04-02 00:00:00,Royal Air Force - RAF,Landing (descent or approach),Military / Government,Malaysia,Asia,0,0,0,0,0,0,0,Technical Failure
1955-04-04 00:00:00,United States Air Force - USAF,Landing (descent or approach),Military / Government,United States of America,North America,1,1,0,0,0,0,1,Unknown
1955-04-08 00:00:00,British European Airways - BEA,Takeoff (climb),Commercial,Germany,Europe,53,6,0,47,0,0,53,Technical Failure
1955-04-11 00:00:00,Associated Airways,Takeoff (climb),Operational,Canada,North America,2,2,0,0,0,0,2,Unknown
1955-04-12 00:00:00,Arctic Wings,Takeoff (climb),Operational,Canada,North America,3,3,0,0,0,0,3,Unknown
1955-04-13 00:00:00,United States Air Force - USAF,Flight,Military / Government,United States of America,North America,1,1,0,0,0,0,1,Unknown
1955-04-14 00:00:00,United States Air Force - USAF,Taxiing,Military / Government,Greenland,Europe,0,0,0,0,0,0,0,Other
1955-04-14 00:00:00,LOT Polish Airlines - Polskie Linie Lotnicze,Landing (descent or approach),Commercial,Poland,Europe,15,3,0,12,0,0,15,Unknown
1955-04-18 00:00:00,United States Air Force - USAF,Landing (descent or approach),Military / Government,France,Europe,4,4,0,0,0,0,4,Human Factor
1955-04-18 00:00:00,United States Air Force - USAF,Flight,Military / Government,France,Europe,0,0,0,0,0,0,0,Technical Failure
1955-04-20 00:00:00,Royal Air Force - RAF,Flight,Military / Government,Yemen,Asia,5,2,0,3,0,0,5,Technical Failure
1955-04-20 00:00:00,United States Air Force - USAF,Flight,Military / Government,Japan,Asia,1,1,0,0,0,0,1,Technical Failure
1955-04-27 00:00:00,United States Air Force - USAF,Landing (descent or approach),Operational,Canada,North America,5,5,0,0,0,0,5,Human Factor
1955-04-28 00:00:00,Royal Air Force - RAF,Taxiing,Military / Government,United Kingdom,Europe,0,0,0,0,0,0,0,Technical Failure
1955-04-28 00:00:00,Lau-Goma Airways,Landing (descent or approach),Commercial,Canada,North America,3,1,0,2,0,0,3,Technical Failure
1955-05-03 00:00:00,French Air Force - Armée de l'Air,Landing (descent or approach),Military / Government,France,Europe,4,4,0,0,0,0,4,Unknown
1955-05-10 00:00:00,Lambair - Lamb Airways,Takeoff (climb),Commercial,Canada,North America,4,1,0,3,0,0,4,Other
1955-05-15 00:00:00,Hürkus Hava Yollari,Flight,Commercial,Turkey,Asia,1,1,0,0,0,0,1,Unknown
1955-05-15 00:00:00,United States Air Force - USAF,Takeoff (climb),Military / Government,Greenland,Europe,7,7,0,0,0,0,7,Unknown
1955-05-20 00:00:00,Aerolineas Argentinas,Takeoff (climb),Operational,Argentina,South America,5,4,0,1,0,0,5,Human Factor
1955-05-20 00:00:00,Spanish Air Force - Ejército del Aire,Landing (descent or approach),Operational,Spain,Europe,6,6,0,0,0,0,6,Human Factor
1955-05-23 00:00:00,Royal Air Force - RAF,Landing (descent or approach),Military / Government,Egypt,Africa,0,0,0,0,0,0,0,Technical Failure
1955-05-26 00:00:00,Polyarnaya Aviatsiya,Landing (descent or approach),Other,World,World,10,6,0,4,0,0,10,Other
1955-05-28 00:00:00,United States Air Force - USAF,Flight,Military / Government,Belgium,Europe,5,5,0,0,0,0,5,Technical Failure
1955-06-13 00:00:00,Belgian Air Force - Force Aérienne Belge - Belgische Luchtmacht,Landing (descent or approach),Operational,Belgium,Europe,2,2,0,0,0,0,2,Human Factor
1955-06-13 00:00:00,Maluti Air Services,Landing (descent or approach),Commercial,Lesotho,Africa,0,0,0,0,0,0,0,Unknown
1955-06-22 00:00:00,United States Navy - USN,Flight,Military / Government,United States of America,North America,8,8,0,0,0,0,8,Terrorism
1955-06-22 00:00:00,Belgian Air Force - Force Aérienne Belge - Belgische Luchtmacht,Flight,Operational,Belgium,Europe,2,2,0,0,0,0,2,Unknown
1955-06-24 00:00:00,Drakensberg Air Services,Landing (descent or approach),Commercial,Lesotho,Africa,5,1,0,4,0,0,5,Unknown
1955-07-01 00:00:00,Aeroflot - Russian International Airlines,Flight,Commercial,Russia,Asia,10,2,0,8,0,0,10,Technical Failure
1955-07-02 00:00:00,Polyarnaya Aviatsiya,Landing (descent or approach),Military / Government,Russia,Asia,0,0,0,0,0,0,0,Human Factor
1955-07-03 00:00:00,Servicios Aéreos de Chiapas,Flight,Commercial,Mexico,Central America,4,2,0,2,0,0,4,Technical Failure
1955-07-11 00:00:00,Royal Air Force - RAF,Flight,Operational,United Kingdom,Europe,3,3,0,0,0,0,3,Human Factor
1955-07-14 00:00:00,Royal Air Force - RAF,Landing (descent or approach),Operational,United Kingdom,Europe,6,6,0,0,0,0,6,Human Factor
1955-07-19 00:00:00,Royal Canadian Air Force - RCAF,Flight,Military / Government,Canada,North America,0,0,0,0,0,0,0,Unknown
1955-07-26 00:00:00,Royal Air Force - RAF,Landing (descent or approach),Operational,United Kingdom,Europe,3,3,0,0,0,0,3,Human Factor
1955-07-29 00:00:00,United States Air Force - USAF,Flight,Military / Government,World,World,18,2,0,16,0,0,18,Technical Failure
1955-08-01 00:00:00,Royal Air Force - RAF,Landing (descent or approach),Operational,Yemen,Asia,3,3,0,0,0,0,3,Technical Failure
1955-08-04 00:00:00,Royal Air Force - RAF,Taxiing,Specialised Services,United Kingdom,Europe,5,5,0,0,0,0,5,Technical Failure
1955-08-05 00:00:00,Pakistan Air Force - Pakistan Fiza'ya,Flight,Operational,Pakistan,Asia,0,0,0,0,0,0,0,Unknown
1955-08-05 00:00:00,Royal Air Force - RAF,Landing (descent or approach),Operational,Egypt,Africa,4,4,0,0,0,0,4,Technical Failure
1955-08-06 00:00:00,Fairways Jersey,Flight,Commercial,United Kingdom,Europe,11,1,0,10,0,0,11,Technical Failure
1955-08-18 00:00:00,Belgian Air Force - Force Aérienne Belge - Belgische Luchtmacht,Flight,Military / Government,Belgium,Europe,2,2,0,0,0,0,2,Unknown
1955-08-23 00:00:00,Italian Air Force - Aeronautica Militare Italiana,Flight,Military / Government,Italy,Europe,4,4,0,0,0,0,4,Unknown
1955-08-23 00:00:00,Gibbes Sepik Airways,Takeoff (climb),Operational,Papua New Guinea,Oceania,1,1,0,0,0,0,1,Technical Failure
1955-09-01 00:00:00,Iberia - Lineas Aéreas de Espana,Flight,Specialised Services,Spain,Europe,3,2,0,1,0,0,3,Technical Failure
1955-09-04 00:00:00,Private Belgian,,Business,Angola,Africa,0,0,0,0,0,0,0,Unknown
1955-09-09 00:00:00,Italian Air Force - Aeronautica Militare Italiana,Flight,Military / Government,Italy,Europe,3,3,0,0,0,0,3,Technical Failure
1955-09-09 00:00:00,Royal New Zealand Air Force - RNZAF,Takeoff (climb),Military / Government,Australia,Oceania,25,5,0,20,0,0,25,Other
1955-09-14 00:00:00,Persian Air Services,Flight,Commercial,Iraq,Asia,13,4,0,9,0,0,13,Human Factor
1955-09-20 00:00:00,Belgian Air Force - Force Aérienne Belge - Belgische Luchtmacht,,Military / Government,Belgium,Europe,0,0,0,0,0,0,0,Unknown
1955-09-20 00:00:00,United States Air Force - USAF,Landing (descent or approach),Operational,United States of America,North America,12,12,0,0,0,0,12,Unknown
1955-09-20 00:00:00,Belgian Air Force - Force Aérienne Belge - Belgische Luchtmacht,Landing (descent or approach),Military / Government,Belgium,Europe,0,0,0,0,0,0,0,Unknown
1955-09-20 00:00:00,Corporación Boliviana de Fomento,Takeoff (climb),Operational,Bolivia,South America,2,2,0,0,0,0,2,Unknown
1955-09-20 00:00:00,Royal Air Force - RAF,Landing (descent or approach),Operational,United Kingdom,Europe,3,3,0,0,0,0,3,Unknown
1955-09-21 00:00:00,Air France,Landing (descent or approach),Operational,France,Europe,3,3,0,0,0,0,3,Weather
1955-09-21 00:00:00,Lloyd Aéreo Boliviano - LAB Airlines,Landing (descent or approach),Operational,Bolivia,South America,0,0,0,0,0,0,0,Unknown
1955-09-23 00:00:00,Air Ads,Flight,Operational,Germany,Europe,0,0,0,0,0,0,0,Unknown
1955-09-30 00:00:00,Royal Air Force - RAF,Landing (descent or approach),Operational,Yemen,Asia,4,4,0,0,0,0,4,Unknown
1955-10-03 00:00:00,Royal Air Force - RAF,Landing (descent or approach),Operational,Cyprus,Europe,3,3,0,0,0,0,3,Human Factor
1955-10-10 00:00:00,Iraqi Airways,Takeoff (climb),Commercial,Iraq,Asia,19,3,0,16,0,0,19,Unknown
1955-10-25 00:00:00,Maritime Central Airways,Landing (descent or approach),Commercial,Canada,North America,0,0,0,0,0,0,0,Unknown
1955-10-25 00:00:00,Wideroe - Wideroe's Flyveselskap,,Commercial,Norway,Europe,0,0,0,0,0,0,0,Unknown
1955-10-28 00:00:00,Argentinian Navy - Armada Argentina,,Military / Government,Argentina,South America,0,0,0,0,0,0,0,Unknown
1955-10-29 00:00:00,Madang Air Charters,Takeoff (climb),Commercial,Papua New Guinea,Oceania,3,1,0,2,0,0,3,Human Factor
1955-11-06 00:00:00,Hürkus Hava Yollari,Flight,Commercial,Turkey,Asia,0,0,0,0,0,0,0,Unknown
1955-11-07 00:00:00,Brazilian Air Force - Força Aérea Brasileira,Landing (descent or approach),Military / Government,Brazil,South America,7,2,0,5,0,0,7,Unknown
1955-11-08 00:00:00,Swedish Air Force - Flygvapnet,Landing (descent or approach),Military / Government,Sweden,Europe,0,0,0,0,0,0,0,Unknown
1955-11-14 00:00:00,Allegheny Airlines,Landing (descent or approach),Operational,United States of America,North America,3,3,0,0,0,0,3,Technical Failure
1955-11-23 00:00:00,Argentinian Air Force - Fuerza Aérea Argentina,Takeoff (climb),Military / Government,Argentina,South America,0,0,0,0,0,0,0,Unknown
1955-11-26 00:00:00,Indian Air Force - Bharatiya Vayu Sena,Landing (descent or approach),Military / Government,India,Asia,3,3,0,0,0,0,3,Unknown
1955-11-30 00:00:00,United States Air Force - USAF,Flight,Military / Government,Japan,Asia,5,5,0,0,0,0,5,Technical Failure
1955-12-02 00:00:00,Spanish Air Force - Ejército del Aire,Flight,Military / Government,Spain,Europe,8,8,0,0,0,0,8,Technical Failure
1955-12-06 00:00:00,United States Air Force - USAF,Landing (descent or approach),Military / Government,United States of America,North America,0,0,0,0,0,0,0,Unknown
1955-12-09 00:00:00,British Overseas Airways Corporation - BOAC,Landing (descent or approach),Specialised Services,United Kingdom,Europe,3,1,0,2,0,0,3,Human Factor
1955-12-15 00:00:00,Butler Air Transport,Takeoff (climb),Commercial,Australia,Oceania,13,3,0,10,0,0,13,Technical Failure
1955-12-17 00:00:00,Air Algérie,Takeoff (climb),Commercial,Algeria,Africa,0,0,0,0,0,0,0,Technical Failure
1955-12-17 00:00:00,SAHSA - Servicios Aéreos de Honduras SA,Flight,Commercial,Honduras,Central America,0,0,0,0,0,0,0,Unknown
1955-12-22 00:00:00,United States Navy - USN,Takeoff (climb),Military / Government,Antarctica,Antarctica,0,0,0,0,0,0,0,Unknown
1955-12-27 00:00:00,United States Air Force - USAF,Takeoff (climb),Military / Government,United States of America,North America,8,8,0,0,0,0,8,Unknown
1955-12-30 00:00:00,Fiji Airways,Flight,Commercial,Fiji Islands,Oceania,1,1,0,0,0,0,1,Human Factor
1955-12-31 00:00:00,Pakistan Air Force - Pakistan Fiza'ya,,Military / Government,Pakistan,Asia,0,0,0,0,0,0,0,Unknown
1956-01-04 00:00:00,United States Air Force - USAF,Landing (descent or approach),Operational,United States of America,North America,0,0,0,0,0,0,0,Technical Failure
1956-01-09 00:00:00,Royal Air Force - RAF,Landing (descent or approach),Military / Government,United Kingdom,Europe,3,3,0,0,0,0,3,Unknown
1956-01-13 00:00:00,Royal Air Force - RAF,Landing (descent or approach),Military / Government,Malta,Europe,0,0,0,0,0,0,0,Technical Failure
1956-01-19 00:00:00,United States Air Force - USAF,Landing (descent or approach),Operational,United States of America,North America,0,0,0,0,0,0,0,Unknown
1956-01-20 00:00:00,British European Airways - BEA,Takeoff (climb),Operational,United Kingdom,Europe,5,5,0,0,0,0,5,Human Factor
1956-01-20 00:00:00,Aerotaxi Servicios Aéreos,,Commercial,Colombia,South America,0,0,0,0,0,0,0,Unknown
1956-01-21 00:00:00,Royal New Zealand Air Force - RNZAF,Landing (descent or approach),Military / Government,New Zealand,Oceania,2,2,0,0,0,0,2,Technical Failure
1956-01-24 00:00:00,Maritime Central Airways,Landing (descent or approach),Commercial,Canada,North America,0,0,0,0,0,0,0,Technical Failure
1956-01-24 00:00:00,Air France,Flight,Operational,France,Europe,5,5,0,0,0,0,5,Technical Failure
1956-02-02 00:00:00,Royal Air Force - RAF,Takeoff (climb),Operational,United Kingdom,Europe,6,6,0,0,0,0,6,Unknown
1956-02-03 00:00:00,United States Navy - USN,Flight,Military / Government,Antarctica,Antarctica,2,2,0,0,0,0,2,Weather
1956-02-04 00:00:00,West Darling Air Service,Takeoff (climb),Operational,Australia,Oceania,1,1,0,0,0,0,1,Technical Failure
1956-02-06 00:00:00,Brazilian Air Force - Força Aérea Brasileira,Landing (descent or approach),Military / Government,Brazil,South America,0,0,0,0,0,0,0,Technical Failure
1956-02-08 00:00:00,United States Navy - USN,Flight,Military / Government,Venezuela,South America,8,8,0,0,0,0,8,Technical Failure
1956-02-16 00:00:00,Saudi Arabian Airlines - SAUDIA,Takeoff (climb),Commercial,Saudi Arabia,Asia,0,0,0,0,0,0,0,Unknown
1956-02-16 00:00:00,CATS,Takeoff (climb),Operational,Denmark,Europe,2,2,0,0,0,0,2,Unknown
1956-02-16 00:00:00,CATS,Landing (descent or approach),Operational,Denmark,Europe,2,2,0,0,0,0,2,Technical Failure
1956-02-17 00:00:00,Eastern Airlines,Landing (descent or approach),Commercial,United States of America,North America,23,3,0,20,0,0,23,Human Factor
1956-02-17 00:00:00,Royal Air Force - RAF,Takeoff (climb),Military / Government,Vietnam,Asia,3,3,0,0,0,0,3,Technical Failure
1956-02-20 00:00:00,Capital Airlines,Landing (descent or approach),Commercial,United States of America,North America,42,4,0,38,0,0,42,Technical Failure
1956-02-20 00:00:00,Private Danish,Landing (descent or approach),Specialised Services,Denmark,Europe,2,1,0,1,0,0,2,Unknown
1956-02-25 00:00:00,Royal Air Force - RAF,Taxiing,Operational,United Kingdom,Europe,2,2,0,0,0,0,2,Technical Failure
1956-02-29 00:00:00,Argentinian Navy - Armada Argentina,Landing (descent or approach),Military / Government,Argentina,South America,0,0,0,0,0,0,0,Unknown
1956-03-04 00:00:00,United States Air Force - USAF,Flight,Military / Government,Japan,Asia,2,2,0,0,0,0,2,Unknown
1956-03-10 00:00:00,Royal Air Force - RAF,Taxiing,Military / Government,United Kingdom,Europe,2,2,0,0,0,0,2,Weather
1956-03-16 00:00:00,Royal Air Force - RAF,Landing (descent or approach),Operational,United Kingdom,Europe,2,2,0,0,0,0,2,Human Factor
1956-03-18 00:00:00,Flying Tiger Line,Landing (descent or approach),Operational,Canada,North America,3,2,0,1,0,0,3,Human Factor
1956-03-30 00:00:00,United States Air Force - USAF,Takeoff (climb),Military / Government,Japan,Asia,7,7,0,0,0,0,7,Technical Failure
1956-04-03 00:00:00,Transair Canada,Landing (descent or approach),Operational,Canada,North America,2,2,0,0,0,0,2,Unknown
1956-04-09 00:00:00,Royal Air Force - RAF,Landing (descent or approach),Military / Government,Yemen,Asia,5,5,0,0,0,0,5,Technical Failure
1956-04-18 00:00:00,United States Air Force - USAF,Takeoff (climb),Military / Government,Libya,Africa,0,0,0,0,0,0,0,Unknown
1956-04-21 00:00:00,Central African Airways - CAA,Flight,Commercial,Malawi,Africa,5,1,0,4,0,0,5,Weather
1956-04-22 00:00:00,British Overseas Airways Corporation - BOAC,Taxiing,Commercial,Libya,Africa,0,0,0,0,0,0,0,Unknown
1956-04-23 00:00:00,Rural Aviation,Flight,Military / Government,New Zealand,Oceania,1,1,0,0,0,0,1,Unknown
1956-04-24 00:00:00,United States Air Force - USAF,Takeoff (climb),Military / Government,United States of America,North America,0,0,0,0,0,0,0,Unknown
1956-04-27 00:00:00,Royal Air Force - RAF,Landing (descent or approach),Operational,United Kingdom,Europe,2,2,0,0,0,0,2,Human Factor
1956-05-04 00:00:00,Royal Air Force - RAF,Takeoff (climb),Operational,United Kingdom,Europe,2,2,0,0,0,0,2,Technical Failure
1956-05-07 00:00:00,Royal Air Force - RAF,Landing (descent or approach),Operational,United Kingdom,Europe,7,7,0,0,0,0,7,Human Factor
1956-05-18 00:00:00,Indian Airlines,Landing (descent or approach),Commercial,India,Asia,19,3,0,16,0,0,19,Human Factor
1956-05-20 00:00:00,Private Brazilian,Takeoff (climb),Business,Brazil,South America,2,2,0,0,0,0,2,Technical Failure
1956-05-23 00:00:00,Pacific Western Airlines - PWA,,Other,Canada,North America,0,0,0,0,0,0,0,Unknown
1956-05-30 00:00:00,Pacific Western Airlines - PWA,Landing (descent or approach),Operational,Canada,North America,3,3,0,0,0,0,3,Unknown
1956-06-16 00:00:00,United States Air Force - USAF,Landing (descent or approach),Military / Government,Marshall Islands,Oceania,0,0,0,0,0,0,0,Human Factor
1956-06-18 00:00:00,French Air Force - Armée de l'Air,Flight,Military / Government,Algeria,Africa,0,0,0,0,0,0,0,Unknown
1956-06-18 00:00:00,Transair Canada,Parking,Operational,Canada,North America,3,3,0,0,0,0,3,Unknown
1956-06-19 00:00:00,Johnson Flying Service,Flight,Military / Government,United States of America,North America,2,2,0,0,0,0,2,Technical Failure
1956-06-22 00:00:00,Royal Air Force - RAF,Takeoff (climb),Operational,United Kingdom,Europe,2,2,0,0,0,0,2,Technical Failure
1956-06-22 00:00:00,Private Danish,Flight,Business,Denmark,Europe,1,1,0,0,0,0,1,Unknown
1956-06-28 00:00:00,Argentinian Air Force - Fuerza Aérea Argentina,Takeoff (climb),Military / Government,Argentina,South America,25,2,0,23,0,0,25,Technical Failure
1956-06-29 00:00:00,Air France,Flight,Operational,France,Europe,4,4,0,0,0,0,4,Unknown
1956-07-04 00:00:00,Aeroflot - Russian International Airlines,Taxiing,Commercial,Russia,Asia,4,4,0,0,0,0,4,Terrorism
1956-07-06 00:00:00,Royal Air Force - RAF,Landing (descent or approach),Military / Government,Germany,Europe,2,2,0,0,0,0,2,Unknown
1956-07-06 00:00:00,Transair Canada,Flight,Commercial,Canada,North America,0,0,0,0,0,0,0,Unknown
1956-07-08 00:00:00,Air Brousse,Flight,Commercial,Democratic Republic of Congo,Africa,6,1,0,5,0,0,6,Unknown
1956-07-08 00:00:00,Air Brousse,Flight,Commercial,Democratic Republic of Congo,Africa,6,1,0,5,0,0,6,Unknown
1956-07-22 00:00:00,Oilfields Supply %26 Trading Company,Takeoff (climb),Business,Libya,Africa,7,1,0,6,0,0,7,Unknown
1956-07-29 00:00:00,Private Belgian,Flight,Business,Belgium,Europe,1,1,0,0,0,0,1,Technical Failure
1956-08-01 00:00:00,COPA Panama - Compania Panamena de Aviacion,Takeoff (climb),Commercial,Panama,Central America,7,3,0,4,0,0,7,Unknown
1956-08-02 00:00:00,Royal Air Force - RAF,Landing (descent or approach),Military / Government,Yemen,Asia,0,0,0,0,0,0,0,Unknown
1956-08-05 00:00:00,Britavia,Landing (descent or approach),Commercial,Pakistan,Asia,72,7,0,65,0,0,72,Human Factor
1956-08-09 00:00:00,Avianca,,Commercial,Colombia,South America,0,0,0,0,0,0,0,Unknown
1956-08-18 00:00:00,Stewart %26 Lloyds,,Business,South Africa,Africa,0,0,0,0,0,0,0,Unknown
1956-08-26 00:00:00,United States Navy - USN,Takeoff (climb),Operational,United States of America,North America,2,2,0,0,0,0,2,Human Factor
1956-08-26 00:00:00,Iran Air,,Commercial,Iran,Asia,0,0,0,0,0,0,0,Unknown
1956-08-26 00:00:00,Air Ads,Flight,Operational,France,Europe,0,0,0,0,0,0,0,Unknown
1956-09-05 00:00:00,Royal Air Force - RAF,Landing (descent or approach),Military / Government,India,Asia,3,3,0,0,0,0,3,Technical Failure
1956-09-06 00:00:00,Loide Aéreo Nacional,Takeoff (climb),Commercial,Brazil,South America,16,3,0,13,0,0,16,Technical Failure
1956-09-08 00:00:00,Polyarnaya Aviatsiya,Landing (descent or approach),Commercial,Russia,Asia,0,0,0,0,0,0,0,Human Factor
1956-09-10 00:00:00,Royal Air Force - RAF,Landing (descent or approach),Operational,United Kingdom,Europe,2,2,0,0,0,0,2,Human Factor
1956-09-11 00:00:00,Compañia Aeronautica Uruguaya SA - CAUSA,,Commercial,Uruguay,South America,0,0,0,0,0,0,0,Unknown
1956-09-13 00:00:00,Transair Canada,Takeoff (climb),Operational,Canada,North America,3,3,0,0,0,0,3,Unknown
1956-09-13 00:00:00,United States Air Force - USAF,Landing (descent or approach),Military / Government,Germany,Europe,9,3,0,6,0,0,9,Unknown
1956-09-13 00:00:00,Swedish Air Force - Flygvapnet,Landing (descent or approach),Humanitarian,Sweden,Europe,0,0,0,0,0,0,0,Technical Failure
1956-09-14 00:00:00,Lancashire Aircraft Corporation - LAC,Flight,Commercial,United Kingdom,Europe,7,1,0,6,0,0,7,Unknown
1956-09-17 00:00:00,United States Navy - USN,Flight,Other,World,World,18,18,0,0,0,0,18,Human Factor
1956-09-17 00:00:00,Royal Air Force - RAF,Landing (descent or approach),Operational,United Kingdom,Europe,1,1,0,0,0,0,1,Unknown
1956-09-23 00:00:00,World-Wide Airways,Landing (descent or approach),Operational,Canada,North America,2,2,0,0,0,0,2,Unknown
1956-09-25 00:00:00,Giro Aviation,Takeoff (climb),Commercial,United Kingdom,Europe,4,1,0,3,0,0,4,Unknown
1956-09-28 00:00:00,Royal Air Force - RAF,Landing (descent or approach),Military / Government,United Kingdom,Europe,5,5,0,0,0,0,5,Unknown
1956-09-29 00:00:00,Aviaco - Aviacion y Comercio,Landing (descent or approach),Commercial,Spain,Europe,38,5,0,33,0,0,38,Human Factor
1956-10-04 00:00:00,Argentinian Navy - Armada Argentina,Flight,Military / Government,Argentina,South America,6,2,0,4,0,0,6,Unknown
1956-10-07 00:00:00,Don Everall Aviation,Landing (descent or approach),Commercial,United Kingdom,Europe,9,2,0,7,0,0,9,Technical Failure
1956-10-11 00:00:00,Cruzeiro do Sul,Flight,Specialised Services,Brazil,South America,6,2,0,4,0,0,6,Technical Failure
1956-10-14 00:00:00,Argentinian Government,Flight,Military / Government,Argentina,South America,3,3,0,0,0,0,3,Unknown
1956-10-16 00:00:00,Pan American World Airways - PAA,Flight,Commercial,World,World,31,7,0,24,0,0,31,Technical Failure
1956-10-20 00:00:00,National Airlines,Landing (descent or approach),Commercial,United States of America,North America,0,0,0,0,0,0,0,Human Factor
1956-10-23 00:00:00,Frigorifico Cooperativo Los Andes,,Operational,Bolivia,South America,0,0,0,0,0,0,0,Unknown
1956-10-26 00:00:00,Royal Australian Air Force - RAAF,Takeoff (climb),Military / Government,Australia,Oceania,0,0,0,0,0,0,0,Unknown
1956-10-30 00:00:00,Royal Air Force - RAF,Taxiing,Military / Government,United Kingdom,Europe,0,0,0,0,0,0,0,Human Factor
1956-11-03 00:00:00,Lyon Air,Flight,Commercial,Panama,Central America,7,2,0,5,0,0,7,Technical Failure
1956-11-11 00:00:00,United States Navy - USN,Takeoff (climb),Military / Government,Portugal,Europe,8,8,0,0,0,0,8,Unknown
1956-11-14 00:00:00,Royal Air Force - RAF,Takeoff (climb),Operational,United Kingdom,Europe,0,0,0,0,0,0,0,Technical Failure
1956-11-15 00:00:00,Trans World Airlines - TWA,Landing (descent or approach),Commercial,United States of America,North America,38,3,0,35,0,0,38,Technical Failure
1956-11-15 00:00:00,United States Air Force - USAF,Landing (descent or approach),Military / Government,United States of America,North America,21,4,0,17,0,0,21,Technical Failure
1956-11-15 00:00:00,Air Laos,Landing (descent or approach),Commercial,Laos,Asia,0,0,0,0,0,0,0,Technical Failure
1956-11-27 00:00:00,Royal Air Force - RAF,Landing (descent or approach),Operational,United Kingdom,Europe,7,7,0,0,0,0,7,Unknown
1956-11-28 00:00:00,United States Air Force - USAF,Landing (descent or approach),Military / Government,Antarctica,Antarctica,17,3,0,14,0,0,17,Technical Failure
1956-11-28 00:00:00,Royal Air Force - RAF,Landing (descent or approach),Military / Government,Yemen,Asia,0,0,0,0,0,0,0,Other
1956-12-12 00:00:00,ASA International Airlines - Aerovias Sud Americana,Takeoff (climb),Operational,Panama,Central America,2,2,0,0,0,0,2,Technical Failure
1956-12-15 00:00:00,Royal Canadian Air Force - RCAF,,Military / Government,Canada,North America,0,0,0,0,0,0,0,Unknown
1956-12-16 00:00:00,Zantop Air Transport,Landing (descent or approach),Operational,United States of America,North America,4,4,0,0,0,0,4,Human Factor
1956-12-19 00:00:00,Royal Air Force - RAF,Landing (descent or approach),Military / Government,Somalia,Africa,0,0,0,0,0,0,0,Technical Failure
1956-12-22 00:00:00,Private Canadian,Takeoff (climb),Business,Canada,North America,0,0,0,0,0,0,0,Unknown
1956-12-27 00:00:00,Austin Airways,Flight,Commercial,Canada,North America,3,2,0,1,0,0,3,Technical Failure
1957-01-02 00:00:00,Alitalia - Linee Aeree Italiane,Landing (descent or approach),Commercial,Italy,Europe,7,3,0,4,0,0,7,Unknown
1957-01-08 00:00:00,Transair Canada,Takeoff (climb),Operational,Canada,North America,3,3,0,0,0,0,3,Technical Failure
1957-01-09 00:00:00,Private New Zealand,Flight,Military / Government,New Zealand,Oceania,1,1,0,0,0,0,1,Unknown
1957-01-22 00:00:00,Royal Air Force - RAF,Takeoff (climb),Operational,United Kingdom,Europe,8,8,0,0,0,0,8,Technical Failure
1957-01-23 00:00:00,Royal Air Force - RAF,Landing (descent or approach),Military / Government,Yemen,Asia,0,0,0,0,0,0,0,Human Factor
1957-01-27 00:00:00,United States Air Force - USAF,Takeoff (climb),Military / Government,United States of America,North America,12,11,0,1,0,0,12,Technical Failure
1957-02-18 00:00:00,Aerovias Los Andes,,Operational,Bolivia,South America,0,0,0,0,0,0,0,Unknown
1957-03-08 00:00:00,Aviation de la Force Publique,,Military / Government,Democratic Republic of Congo,Africa,0,0,0,0,0,0,0,Unknown
1957-03-10 00:00:00,Eastern Airlines,Landing (descent or approach),Commercial,United States of America,North America,34,3,0,31,0,0,34,Human Factor
1957-03-19 00:00:00,Northern Wings,Landing (descent or approach),Commercial,Canada,North America,0,0,0,0,0,0,0,Unknown
1957-03-19 00:00:00,Union of Burma Airways,Takeoff (climb),Commercial,Myanmar,Asia,23,4,0,19,0,0,23,Other
1957-03-21 00:00:00,Gibbes Sepik Airways,Takeoff (climb),Operational,Papua New Guinea,Oceania,1,1,0,0,0,0,1,Technical Failure
1957-03-27 00:00:00,Royal Air Force - RAF,Landing (descent or approach),Military / Government,United Kingdom,Europe,0,0,0,0,0,0,0,Unknown
1957-04-02 00:00:00,United States Air Force - USAF,Landing (descent or approach),Military / Government,Canada,North America,0,0,0,0,0,0,0,Human Factor
1957-04-11 00:00:00,Transa Chile,Flight,Commercial,Chile,South America,0,0,0,0,0,0,0,Unknown
1957-04-17 00:00:00,United States Navy - USN,Landing (descent or approach),Military / Government,Canada,North America,24,4,0,20,0,0,24,Technical Failure
1957-04-18 00:00:00,Capital Airlines,Landing (descent or approach),Commercial,United States of America,North America,55,4,0,51,0,0,55,Human Factor
1957-04-26 00:00:00,Northern Territory Medical Services,Landing (descent or approach),Humanitarian,Australia,Oceania,3,1,0,2,0,0,3,Human Factor
1957-05-02 00:00:00,Hürkus Hava Yollari,,Commercial,Turkey,Asia,0,0,0,0,0,0,0,Unknown
1957-05-05 00:00:00,Aeroflot - Russian International Airlines,Takeoff (climb),Specialised Services,Russia,Asia,8,3,0,5,0,0,8,Human Factor
1957-05-07 00:00:00,Royal Air Force - RAF,Flight,Military / Government,Yemen,Asia,0,0,0,0,0,0,0,Technical Failure
1957-05-09 00:00:00,United States Air Force - USAF,Flight,Military / Government,World,World,7,7,0,0,0,0,7,Technical Failure
1957-05-10 00:00:00,United States Navy - USN,Flight,Operational,United States of America,North America,0,0,0,0,0,0,0,Technical Failure
1957-05-10 00:00:00,United States Air Force - USAF,Takeoff (climb),Military / Government,Portugal,Europe,7,7,0,0,0,0,7,Technical Failure
1957-05-27 00:00:00,Bahamas Helicopters,Landing (descent or approach),Commercial,Libya,Africa,4,1,0,3,0,0,4,Technical Failure
1957-05-28 00:00:00,Royal Air Force - RAF,Flight,Military / Government,Libya,Africa,0,0,0,0,0,0,0,Technical Failure
1957-05-29 00:00:00,United States Navy - USN,Landing (descent or approach),Operational,United States of America,North America,6,6,0,0,0,0,6,Unknown
1957-06-04 00:00:00,L. M. Berner %26 Company,Taxiing,Business,Democratic Republic of Congo,Africa,0,0,0,0,0,0,0,Unknown
1957-06-09 00:00:00,Malév Hungarian Airlines - Magyar Légiközlekedési Vallalat,Landing (descent or approach),Commercial,Hungary,Europe,0,0,0,0,0,0,0,Technical Failure
1957-06-12 00:00:00,Royal Air Force - RAF,Landing (descent or approach),Military / Government,Yemen,Asia,0,0,0,0,0,0,0,Unknown
1957-06-14 00:00:00,Aero Club do Cabo Verde,Landing (descent or approach),Commercial,Cabo Verde,Africa,0,0,0,0,0,0,0,Unknown
1957-06-14 00:00:00,Austin Airways,Landing (descent or approach),Operational,Canada,North America,2,2,0,0,0,0,2,Weather
1957-06-16 00:00:00,World Wide Air Services,Landing (descent or approach),Operational,Papua New Guinea,Oceania,2,2,0,0,0,0,2,Other
1957-06-25 00:00:00,Pacific Western Airlines - PWA,Landing (descent or approach),Operational,Canada,North America,3,3,0,0,0,0,3,Unknown
1957-06-28 00:00:00,Eastern Airlines,Taxiing,Operational,United States of America,North America,3,3,0,0,0,0,3,Unknown
1957-06-28 00:00:00,Eastern Airlines,Parking,Commercial,United States of America,North America,0,0,0,0,0,0,0,Unknown
1957-06-29 00:00:00,Island Air Services - UK,Takeoff (climb),Commercial,United Kingdom,Europe,8,1,0,7,0,0,8,Unknown
1957-07-06 00:00:00,Northland Fish,Flight,Commercial,Canada,North America,2,1,0,1,0,0,2,Technical Failure
1957-07-09 00:00:00,Royal Air Force - RAF,Landing (descent or approach),Military / Government,Cyprus,Europe,0,0,0,0,0,0,0,Technical Failure
1957-07-10 00:00:00,Ethiopian Airlines,Flight,Commercial,Sudan,Africa,20,6,0,14,0,0,20,Technical Failure
1957-07-13 00:00:00,Servicios Aéreos Nacionales - SAN,Flight,Operational,Mexico,Central America,0,0,0,0,0,0,0,Unknown
1957-07-25 00:00:00,United States Air Force - USAF,Takeoff (climb),Operational,Italy,Europe,7,1,0,6,0,0,7,Unknown
1957-08-21 00:00:00,Royal Air Force - RAF,Flight,Military / Government,Germany,Europe,0,0,0,0,0,0,0,Technical Failure
1957-09-01 00:00:00,Airwork - UK,Landing (descent or approach),Commercial,India,Asia,64,6,0,58,0,0,64,Human Factor
1957-09-04 00:00:00,United States Air Force - USAF,Landing (descent or approach),Military / Government,United States of America,North America,9,9,0,0,0,0,9,Human Factor
1957-09-05 00:00:00,Royal Air Force - RAF,Landing (descent or approach),Military / Government,United Kingdom,Europe,0,0,0,0,0,0,0,Unknown
1957-09-06 00:00:00,Royal Air Force - RAF,Taxiing,Military / Government,Iraq,Asia,0,0,0,0,0,0,0,Human Factor
1957-09-11 00:00:00,Aviaco - Aviacion y Comercio,Landing (descent or approach),Commercial,Morocco,Africa,0,0,0,0,0,0,0,Human Factor
1957-09-13 00:00:00,United States Navy - USN,Takeoff (climb),Military / Government,Antarctica,Antarctica,0,0,0,0,0,0,0,Human Factor
1957-09-14 00:00:00,Royal Air Force - RAF,Landing (descent or approach),Military / Government,United Kingdom,Europe,0,0,0,0,0,0,0,Technical Failure
1957-09-20 00:00:00,Western Hemisphere Import %26 Export Company,Landing (descent or approach),Operational,India,Asia,2,2,0,0,0,0,2,Unknown
1957-09-23 00:00:00,United States Navy - USN,Landing (descent or approach),Military / Government,United States of America,North America,0,0,0,0,0,0,0,Unknown
1957-09-26 00:00:00,Karl Herfurtner Luftreederei,Landing (descent or approach),Commercial,Spain,Europe,37,4,0,33,0,0,37,Unknown
1957-09-30 00:00:00,Japan Airlines,Takeoff (climb),Commercial,Japan,Asia,57,5,0,52,0,0,57,Technical Failure
1957-10-01 00:00:00,Eastern Provincial Airways - EPA,Flight,Operational,Canada,North America,3,3,0,0,0,0,3,Technical Failure
1957-10-02 00:00:00,United States Air Force - USAF,Takeoff (climb),Military / Government,Japan,Asia,13,3,0,10,0,0,13,Unknown
1957-10-03 00:00:00,Polyarnaya Aviatsiya,Flight,Specialised Services,Russia,Asia,0,0,0,0,0,0,0,Human Factor
1957-10-04 00:00:00,Eldorado Aviation,Flight,Operational,Canada,North America,2,2,0,0,0,0,2,Weather
1957-10-08 00:00:00,Saudi Arabian Airlines - SAUDIA,Landing (descent or approach),Commercial,Saudi Arabia,Asia,0,0,0,0,0,0,0,Unknown
1957-10-11 00:00:00,Royal Netherlands Navy - Marineluchtvaartdienst,Landing (descent or approach),Operational,Netherlands,Europe,5,5,0,0,0,0,5,Technical Failure
1957-10-11 00:00:00,Royal Thai Air Force - Kong Thap Akat Thai,Takeoff (climb),Humanitarian,Japan,Asia,4,4,0,0,0,0,4,Technical Failure
1957-10-12 00:00:00,Argentinian Air Force - Fuerza Aérea Argentina,Flight,Specialised Services,Argentina,South America,0,0,0,0,0,0,0,Unknown
1957-10-20 00:00:00,Vickers-Armstrongs Ltd,Landing (descent or approach),Specialised Services,South Africa,Africa,10,4,0,6,0,0,10,Human Factor
1957-10-20 00:00:00,Transair Canada,Flight,Commercial,Canada,North America,0,0,0,0,0,0,0,Unknown
1957-10-21 00:00:00,Royal Air Force - RAF,Landing (descent or approach),Operational,United Kingdom,Europe,5,5,0,0,0,0,5,Human Factor
1957-10-26 00:00:00,Aviaco - Aviacion y Comercio,Landing (descent or approach),Commercial,Spain,Europe,22,5,0,17,0,0,22,Technical Failure
1957-10-26 00:00:00,Northern Wings,,Commercial,Canada,North America,0,0,0,0,0,0,0,Unknown
1957-10-26 00:00:00,AREA Ecuador - Aerovias Ecuatorianas,Landing (descent or approach),Operational,Ecuador,South America,2,2,0,0,0,0,2,Unknown
1957-11-02 00:00:00,Air France,Parking,Commercial,France,Europe,0,0,0,0,0,0,0,Technical Failure
1957-11-02 00:00:00,Transportes Aéreos da Índia Portuguesa - TAIP,Landing (descent or approach),Commercial,Pakistan,Asia,27,3,0,24,0,0,27,Unknown
1957-11-02 00:00:00,Royal Air Force - RAF,Landing (descent or approach),Military / Government,United Kingdom,Europe,0,0,0,0,0,0,0,Weather
1957-11-04 00:00:00,Real Aerovias,Flight,Commercial,Brazil,South America,34,4,0,30,0,0,34,Technical Failure
1957-11-06 00:00:00,Aerovias Sud Americana,Landing (descent or approach),Operational,Guatemala,Central America,2,2,0,0,0,0,2,Technical Failure
1957-11-06 00:00:00,United States Air Force - USAF,Landing (descent or approach),Operational,United States of America,North America,0,0,0,0,0,0,0,Technical Failure
1957-11-14 00:00:00,Eastern Airlines,Landing (descent or approach),Commercial,United States of America,North America,5,3,0,2,0,0,5,Human Factor
1957-11-17 00:00:00,British European Airways - BEA,Landing (descent or approach),Operational,Denmark,Europe,2,2,0,0,0,0,2,Technical Failure
1957-11-22 00:00:00,Royal Netherlands Navy - Marineluchtvaartdienst,Landing (descent or approach),Operational,Netherlands,Europe,7,7,0,0,0,0,7,Human Factor
1957-11-28 00:00:00,Scandinavian Airlines System - SAS,Landing (descent or approach),Operational,Sweden,Europe,5,5,0,0,0,0,5,Technical Failure
1957-11-30 00:00:00,Royal Air Force - RAF,Landing (descent or approach),Operational,United Kingdom,Europe,2,2,0,0,0,0,2,Technical Failure
1957-12-03 00:00:00,Aeroflot - Russian International Airlines,Landing (descent or approach),Commercial,Finland,Europe,21,5,0,16,0,0,21,Unknown
1957-12-06 00:00:00,Air France,Landing (descent or approach),Operational,France,Europe,6,6,0,0,0,0,6,Human Factor
1957-12-10 00:00:00,Royal Air Force - RAF,Landing (descent or approach),Operational,United Kingdom,Europe,4,4,0,0,0,0,4,Technical Failure
1957-12-11 00:00:00,Muir Airlines,Takeoff (climb),Operational,Australia,Oceania,3,1,0,2,0,0,3,Other
1957-12-16 00:00:00,Aero Transport,Landing (descent or approach),Operational,United Kingdom,Europe,2,2,0,0,0,0,2,Human Factor
1957-12-20 00:00:00,Belgian Air Force - Force Aérienne Belge - Belgische Luchtmacht,Flight,Operational,Belgium,Europe,2,2,0,0,0,0,2,Unknown
1957-12-20 00:00:00,Royal Air Force - RAF,Landing (descent or approach),Operational,United Kingdom,Europe,6,6,0,0,0,0,6,Weather
1957-12-21 00:00:00,Air France,Flight,Commercial,France,Europe,0,0,0,0,0,0,0,Unknown
1957-12-30 00:00:00,Ethiopian Air Force - Ye Ityopya Ayer Hayl,,Military / Government,Ethiopia,Africa,0,0,0,0,0,0,0,Unknown
1957-12-31 00:00:00,Aero Llanos,Flight,Commercial,Colombia,South America,0,0,0,0,0,0,0,Technical Failure
1958-01-02 00:00:00,Royal Air Force - RAF,Takeoff (climb),Operational,United Kingdom,Europe,4,4,0,0,0,0,4,Technical Failure
1958-01-03 00:00:00,VARIG - Viação Aérea Rio Grandense,Landing (descent or approach),Operational,Brazil,South America,2,2,0,0,0,0,2,Human Factor
1958-01-08 00:00:00,Air France,Landing (descent or approach),Operational,France,Europe,8,2,0,6,0,0,8,Human Factor
1958-01-09 00:00:00,Iberia - Lineas Aéreas de Espana,Takeoff (climb),Commercial,Spain,Europe,4,2,0,2,0,0,4,Technical Failure
1958-01-11 00:00:00,Cruzeiro do Sul,Takeoff (climb),Operational,Brazil,South America,2,2,0,0,0,0,2,Unknown
1958-01-15 00:00:00,Channel Airways,Flight,Commercial,United Kingdom,Europe,7,2,0,5,0,0,7,Technical Failure
1958-01-16 00:00:00,Interior Enterprise,Flight,Operational,Canada,North America,3,3,0,0,0,0,3,Other
1958-01-17 00:00:00,Riverton Airways,Flight,Commercial,Canada,North America,4,1,0,3,0,0,4,Unknown
1958-01-24 00:00:00,Aerial Farming Services,Takeoff (climb),Military / Government,South Africa,Africa,1,1,0,0,0,0,1,Unknown
1958-01-24 00:00:00,United States Navy - USN,Landing (descent or approach),Military / Government,United States of America,North America,21,5,0,16,0,0,21,Technical Failure
1958-01-27 00:00:00,Pacific Western Airlines - PWA,Flight,Commercial,Canada,North America,0,0,0,0,0,0,0,Unknown
1958-01-31 00:00:00,Transair Canada,Flight,Commercial,Canada,North America,4,1,0,3,0,0,4,Human Factor
1958-02-11 00:00:00,Royal Air Force - RAF,Landing (descent or approach),Military / Government,United Kingdom,Europe,0,0,0,0,0,0,0,Unknown
1958-02-13 00:00:00,Western Airlines,Takeoff (climb),Commercial,United States of America,North America,21,3,0,18,0,0,21,Human Factor
1958-02-15 00:00:00,AVENSA - Aerovias Venezolanas,,Commercial,Venezuela,South America,0,0,0,0,0,0,0,Unknown
1958-02-15 00:00:00,Polyarnaya Aviatsiya,Flight,Military / Government,Antarctica,Antarctica,0,0,0,0,0,0,0,Human Factor
1958-02-15 00:00:00,Polyarnaya Aviatsiya,Takeoff (climb),Military / Government,Antarctica,Antarctica,0,0,0,0,0,0,0,Human Factor
1958-02-16 00:00:00,Polyarnaya Aviatsiya,Taxiing,Military / Government,Antarctica,Antarctica,0,0,0,0,0,0,0,Human Factor
1958-02-19 00:00:00,Aeroflot - Russian International Airlines,Landing (descent or approach),Operational,Russia,Asia,8,8,0,0,0,0,8,Technical Failure
1958-02-24 00:00:00,Cluett Peabody %26 Company,Takeoff (climb),Business,United States of America,North America,7,2,0,5,0,0,7,Unknown
1958-03-01 00:00:00,American Airlines,Takeoff (climb),Commercial,United States of America,North America,8,3,0,5,0,0,8,Human Factor
1958-03-10 00:00:00,Douglas Aircraft Company,Flight,Specialised Services,United States of America,North America,0,0,0,0,0,0,0,Unknown
1958-03-17 00:00:00,Eastern Airlines,Landing (descent or approach),Commercial,United States of America,North America,10,3,0,7,0,0,10,Human Factor
1958-03-22 00:00:00,Fleming Airways System Transport,Takeoff (climb),Commercial,Philippines,Asia,40,3,0,37,0,0,40,Human Factor
1958-03-22 00:00:00,United States Air Force - USAF,Takeoff (climb),Specialised Services,United States of America,North America,18,4,0,14,0,0,18,Technical Failure
1958-03-25 00:00:00,Saudi Arabian Airlines - SAUDIA,Landing (descent or approach),Commercial,Saudi Arabia,Asia,0,0,0,0,0,0,0,Technical Failure
1958-03-27 00:00:00,Indian Air Force - Bharatiya Vayu Sena,Flight,Military / Government,Myanmar,Asia,0,0,0,0,0,0,0,Technical Failure
1958-03-30 00:00:00,Aerolineas Nacionales - Costa Rica,Flight,Commercial,Cuba,Central America,0,0,0,0,0,0,0,Terrorism
1958-04-01 00:00:00,Royal Air Force - RAF,Flight,Military / Government,United Kingdom,Europe,2,2,0,0,0,0,2,Technical Failure
1958-04-10 00:00:00,Iberia - Lineas Aéreas de Espana,Takeoff (climb),Commercial,Spain,Europe,31,4,0,27,0,0,31,Technical Failure
1958-04-11 00:00:00,LOT Polish Airlines - Polskie Linie Lotnicze,Landing (descent or approach),Operational,Poland,Europe,4,4,0,0,0,0,4,Technical Failure
1958-04-28 00:00:00,British European Airways - BEA,Landing (descent or approach),Operational,United Kingdom,Europe,5,5,0,0,0,0,5,Human Factor
1958-04-30 00:00:00,Air France,Landing (descent or approach),Commercial,Algeria,Africa,0,0,0,0,0,0,0,Human Factor
1958-05-04 00:00:00,United States Air Force - USAF,Landing (descent or approach),Military / Government,Malta,Europe,0,0,0,0,0,0,0,Technical Failure
1958-05-05 00:00:00,Royal Air Force - RAF,Landing (descent or approach),Operational,United Kingdom,Europe,4,4,0,0,0,0,4,Human Factor
1958-05-10 00:00:00,Quaker City Airways,Flight,Specialised Services,United States of America,North America,2,2,0,0,0,0,2,Human Factor
1958-05-12 00:00:00,Royal Air Force - RAF,Landing (descent or approach),Operational,Singapore,Asia,2,2,0,0,0,0,2,Human Factor
1958-05-20 00:00:00,Dan-Air London,Landing (descent or approach),Operational,Malta,Europe,3,3,0,0,0,0,3,Human Factor
1958-05-22 00:00:00,Royal Air Force - RAF,Landing (descent or approach),Operational,United Kingdom,Europe,2,2,0,0,0,0,2,Technical Failure
1958-05-25 00:00:00,United States Air Force - USAF,Parking,Military / Government,United States of America,North America,15,4,0,11,0,0,15,Technical Failure
1958-05-25 00:00:00,French Navy,Landing (descent or approach),Operational,Portugal,Europe,2,2,0,0,0,0,2,Human Factor
1958-05-25 00:00:00,French Navy,Landing (descent or approach),Operational,Portugal,Europe,2,2,0,0,0,0,2,Human Factor
1958-06-03 00:00:00,Royal Air Force - RAF,Flight,Operational,United Kingdom,Europe,1,1,0,0,0,0,1,Weather
1958-06-06 00:00:00,Hunting Aerosurveys,Flight,Military / Government,Kenya,Africa,2,2,0,0,0,0,2,Unknown
1958-06-10 00:00:00,Aerolineas Argentinas,Flight,Commercial,Brazil,South America,22,6,0,16,0,0,22,Technical Failure
1958-06-12 00:00:00,Belgian Air Force - Force Aérienne Belge - Belgische Luchtmacht,Takeoff (climb),Operational,Belgium,Europe,2,2,0,0,0,0,2,Technical Failure
1958-06-17 00:00:00,H.J. O'Connell Supplies,Landing (descent or approach),Business,Canada,North America,6,1,0,5,0,0,6,Human Factor
1958-06-18 00:00:00,French Air Force - Armée de l'Air,Flight,Operational,Algeria,Africa,0,0,0,0,0,0,0,Other
1958-06-19 00:00:00,Luxembourg Airlines,Landing (descent or approach),Operational,Germany,Europe,2,2,0,0,0,0,2,Technical Failure
1958-06-19 00:00:00,Royal New Zealand Air Force - RNZAF,Landing (descent or approach),Operational,New Zealand,Oceania,0,0,0,0,0,0,0,Human Factor
1958-06-24 00:00:00,Royal Air Force - RAF,Taxiing,Operational,United Kingdom,Europe,2,2,0,0,0,0,2,Technical Failure
1958-06-26 00:00:00,Lloyd Aéreo Colombiano - LACSA,Flight,Commercial,Colombia,South America,23,3,0,20,0,0,23,Technical Failure
1958-06-27 00:00:00,Argentinian Air Force - Fuerza Aérea Argentina,Flight,Military / Government,Argentina,South America,5,2,0,3,0,0,5,Weather
1958-06-27 00:00:00,United States Air Force - USAF,Flight,Military / Government,Azerbaijan,Asia,9,9,0,0,0,0,9,Terrorism
1958-06-28 00:00:00,H. D. %26 M. Aviation,Landing (descent or approach),Specialised Services,United Kingdom,Europe,0,0,0,0,0,0,0,Unknown
1958-07-04 00:00:00,Royal Air Force - RAF,Parking,Humanitarian,United Kingdom,Europe,4,2,0,2,0,0,4,Human Factor
1958-07-08 00:00:00,Fairey Air Surveys,Flight,Military / Government,United Kingdom,Europe,0,0,0,0,0,0,0,Unknown
1958-07-10 00:00:00,Television Associates of Indiana,Flight,Operational,Iran,Asia,0,0,0,0,0,0,0,Unknown
1958-07-12 00:00:00,Royal Air Force - RAF,Landing (descent or approach),Operational,United Kingdom,Europe,4,4,0,0,0,0,4,Technical Failure
1958-07-17 00:00:00,Argentinian Air Force - Fuerza Aérea Argentina,Takeoff (climb),Military / Government,Argentina,South America,0,0,0,0,0,0,0,Technical Failure
1958-07-21 00:00:00,Private Canadian,Takeoff (climb),Operational,Canada,North America,1,1,0,0,0,0,1,Unknown
1958-07-25 00:00:00,Parson's Airways,Landing (descent or approach),Commercial,Canada,North America,4,1,0,3,0,0,4,Human Factor
1958-07-28 00:00:00,Lloyd Aéreo Boliviano - LAB Airlines,Takeoff (climb),Operational,Bolivia,South America,0,0,0,0,0,0,0,Unknown
1958-07-29 00:00:00,Pacific Western Airlines - PWA,Flight,Commercial,Canada,North America,3,1,0,2,0,0,3,Human Factor
1958-08-05 00:00:00,Hürkus Hava Yollari,Flight,Operational,Turkey,Asia,2,2,0,0,0,0,2,Technical Failure
1958-08-06 00:00:00,Royal Air Force - RAF,Takeoff (climb),Operational,United Kingdom,Europe,3,3,0,0,0,0,3,Human Factor
1958-08-11 00:00:00,Swedish Air Force - Flygvapnet,Landing (descent or approach),Operational,Sweden,Europe,4,4,0,0,0,0,4,Unknown
1958-08-11 00:00:00,United States Navy - USN,Flight,Specialised Services,United States of America,North America,0,0,0,0,0,0,0,Technical Failure
1958-08-11 00:00:00,TMA of Lebanon - Trans Mediterranean Airways,Landing (descent or approach),Operational,Saudi Arabia,Asia,5,5,0,0,0,0,5,Unknown
1958-08-15 00:00:00,Jersey Airlines,Landing (descent or approach),Operational,United Kingdom,Europe,1,1,0,0,0,0,1,Human Factor
1958-08-16 00:00:00,Cuban Air Force - Fuerza Aérea del Ejército de Cuba,,Military / Government,Cuba,Central America,0,0,0,0,0,0,0,Unknown
1958-08-19 00:00:00,Cruzeiro do Sul,Landing (descent or approach),Commercial,Brazil,South America,0,0,0,0,0,0,0,Human Factor
1958-08-20 00:00:00,Pacific Western Airlines - PWA,,Commercial,Canada,North America,0,0,0,0,0,0,0,Unknown
1958-08-21 00:00:00,Belgian Air Force - Force Aérienne Belge - Belgische Luchtmacht,Takeoff (climb),Operational,Belgium,Europe,2,2,0,0,0,0,2,Unknown
1958-08-28 00:00:00,Northwest Airlines,Takeoff (climb),Commercial,United States of America,North America,62,4,0,58,0,0,62,Human Factor
1958-08-30 00:00:00,Handley Page Aircraft Company Ltd,Flight,Operational,United Kingdom,Europe,9,2,0,7,0,0,9,Technical Failure
1958-09-08 00:00:00,Indian Airlines,Landing (descent or approach),Commercial,India,Asia,31,4,0,27,0,0,31,Technical Failure
1958-09-16 00:00:00,SAM Colombia - Sociedad Aeronáutica de Medellín,Takeoff (climb),Operational,Colombia,South America,2,2,0,0,0,0,2,Technical Failure
1958-09-19 00:00:00,Boreal Airways,Takeoff (climb),Commercial,Canada,North America,4,1,0,3,0,0,4,Human Factor
1958-09-21 00:00:00,Private British,Landing (descent or approach),Business,Spain,Europe,0,0,0,0,0,0,0,Unknown
1958-09-22 00:00:00,VARIG - Viação Aérea Rio Grandense,Landing (descent or approach),Operational,Brazil,South America,3,3,0,0,0,0,3,Human Factor
1958-09-24 00:00:00,Iran Air,Takeoff (climb),Commercial,Iran,Asia,12,2,0,10,0,0,12,Unknown
1958-09-25 00:00:00,Transair Canada,Landing (descent or approach),Operational,Canada,North America,2,2,0,0,0,0,2,Unknown
1958-09-26 00:00:00,West African Airways Corporation,Landing (descent or approach),Commercial,Nigeria,Africa,0,0,0,0,0,0,0,Unknown
1958-10-06 00:00:00,Aviation de la Force Publique,Flight,Military / Government,Democratic Republic of Congo,Africa,0,0,0,0,0,0,0,Unknown
1958-10-08 00:00:00,Pacific Western Airlines - PWA,,Commercial,Canada,North America,0,0,0,0,0,0,0,Unknown
1958-10-13 00:00:00,French Air Force - Armée de l'Air,Flight,Humanitarian,Algeria,Africa,0,0,0,0,0,0,0,Unknown
1958-10-14 00:00:00,United States Air Force - USAF,Flight,Military / Government,Germany,Europe,2,1,0,1,0,0,2,Weather
1958-10-15 00:00:00,United States Air Force - USAF,Flight,Military / Government,Germany,Europe,0,0,0,0,0,0,0,Unknown
1958-10-15 00:00:00,United States Air Force - USAF,Landing (descent or approach),Operational,United States of America,North America,4,4,0,0,0,0,4,Unknown
1958-10-16 00:00:00,Aeroflot - Russian International Airlines,Flight,Specialised Services,Russia,Asia,0,0,0,0,0,0,0,Technical Failure
1958-10-17 00:00:00,Deutsche Flugdienst,Flight,Operational,Belgium,Europe,3,3,0,0,0,0,3,Technical Failure
1958-10-22 00:00:00,United States Navy - USN,Takeoff (climb),Military / Government,Antarctica,Antarctica,0,0,0,0,0,0,0,Technical Failure
1958-11-04 00:00:00,Compagnie Air Transport - CAT,Landing (descent or approach),Operational,France,Europe,3,3,0,0,0,0,3,Human Factor
1958-11-10 00:00:00,Seaboard %26 Western Airlines,Takeoff (climb),Operational,United States of America,North America,5,5,0,0,0,0,5,Technical Failure
1958-11-10 00:00:00,Trans-Canada Air Lines - TCAL,Parking,Commercial,United States of America,North America,0,0,0,0,0,0,0,Technical Failure
1958-11-11 00:00:00,Transcontinental TSA,Takeoff (climb),Operational,Argentina,South America,4,4,0,0,0,0,4,Technical Failure
1958-11-13 00:00:00,Royal Air Force - RAF,Landing (descent or approach),Operational,United Kingdom,Europe,3,3,0,0,0,0,3,Technical Failure
1958-11-14 00:00:00,Royal Air Maroc - RAM,Landing (descent or approach),Commercial,Morocco,Africa,0,0,0,0,0,0,0,Technical Failure
1958-11-17 00:00:00,United States Air Force - USAF,Landing (descent or approach),Military / Government,United States of America,North America,34,5,0,29,0,0,34,Unknown
1958-11-22 00:00:00,Portuguese Air Force - Força Aerea Portuguesa,,Humanitarian,Portugal,Europe,0,0,0,0,0,0,0,Unknown
1958-11-24 00:00:00,Aeroflot - Russian International Airlines,Takeoff (climb),Commercial,Russia,Asia,4,2,0,2,0,0,4,Other
1958-11-25 00:00:00,Air France,Flight,Operational,France,Europe,3,3,0,0,0,0,3,Unknown
1958-11-27 00:00:00,Aerotaxi Servicios Aéreos,Landing (descent or approach),Commercial,Colombia,South America,3,1,0,2,0,0,3,Unknown
1958-12-01 00:00:00,Belgian Air Force - Force Aérienne Belge - Belgische Luchtmacht,Landing (descent or approach),Military / Government,Democratic Republic of Congo,Africa,0,0,0,0,0,0,0,Weather
1958-12-10 00:00:00,Garuda Indonesian Airways,,Commercial,Indonesia,Asia,0,0,0,0,0,0,0,Unknown
1958-12-11 00:00:00,Royal Air Force - RAF,Landing (descent or approach),Military / Government,United Kingdom,Europe,0,0,0,0,0,0,0,Technical Failure
1958-12-13 00:00:00,Royal Canadian Air Force - RCAF,Flight,Military / Government,Italy,Europe,7,7,0,0,0,0,7,Weather
1958-12-15 00:00:00,Aeroflot - Russian International Airlines,Landing (descent or approach),Operational,Russia,Asia,0,0,0,0,0,0,0,Human Factor
1958-12-22 00:00:00,LASLI-Chile,Landing (descent or approach),Commercial,Chile,South America,3,1,0,2,0,0,3,Technical Failure
1958-12-24 00:00:00,Air France,Landing (descent or approach),Commercial,Austria,Europe,34,6,0,28,0,0,34,Human Factor
1958-12-24 00:00:00,Aeroflot - Russian International Airlines,Takeoff (climb),Operational,Kazakhstan,Asia,5,5,0,0,0,0,5,Human Factor
1958-12-29 00:00:00,Frigorifico Grigota,,Operational,Bolivia,South America,0,0,0,0,0,0,0,Unknown
1958-12-31 00:00:00,Peruvian Air Force - Fuerza Aérea del Perú,,Military / Government,Peru,South America,0,0,0,0,0,0,0,Unknown
1958-12-31 00:00:00,Peruvian Air Force - Fuerza Aérea del Perú,,Military / Government,Peru,South America,0,0,0,0,0,0,0,Unknown
1959-01-04 00:00:00,Transportes Aéreos Peruanas - TAPSA,Landing (descent or approach),Operational,Peru,South America,2,2,0,0,0,0,2,Unknown
1959-01-05 00:00:00,TMA of Lebanon - Trans Mediterranean Airways,Landing (descent or approach),Operational,Italy,Europe,3,3,0,0,0,0,3,Unknown
1959-01-06 00:00:00,Paraense Transportes Aéreos,Landing (descent or approach),Operational,Brazil,South America,5,5,0,0,0,0,5,Human Factor
1959-01-14 00:00:00,Royal Air Force - RAF,Landing (descent or approach),Military / Government,Oman,Asia,0,0,0,0,0,0,0,Technical Failure
1959-01-15 00:00:00,Arctic Wings,Flight,Commercial,Canada,North America,4,1,0,3,0,0,4,Weather
1959-01-26 00:00:00,Royal Air Force - RAF,Takeoff (climb),Military / Government,Malaysia,Asia,5,5,0,0,0,0,5,Human Factor
1959-01-27 00:00:00,Brazilian Air Force - Força Aérea Brasileira,Takeoff (climb),Military / Government,Brazil,South America,7,2,0,5,0,0,7,Technical Failure
1959-01-27 00:00:00,Polyarnaya Aviatsiya,Landing (descent or approach),Humanitarian,Russia,Asia,0,0,0,0,0,0,0,Human Factor
1959-01-29 00:00:00,United States Air Force - USAF,Takeoff (climb),Military / Government,United States of America,North America,0,0,0,0,0,0,0,Unknown
1959-01-31 00:00:00,Wien Alaska Airlines,Landing (descent or approach),Operational,United States of America,North America,1,1,0,0,0,0,1,Weather
1959-01-31 00:00:00,Aeroflot - Russian International Airlines,Landing (descent or approach),Operational,Antarctica,Antarctica,5,5,0,0,0,0,5,Human Factor
1959-02-01 00:00:00,South African Airways -SAA - Suid Afrikaanse Lugdiens - SAL,Flight,Operational,South Africa,Africa,3,3,0,0,0,0,3,Unknown
1959-02-04 00:00:00,Aeroflot - Russian International Airlines,Landing (descent or approach),Operational,Russia,Asia,6,5,0,1,0,0,6,Human Factor
1959-02-07 00:00:00,Private New Zealand,Flight,Military / Government,New Zealand,Oceania,1,1,0,0,0,0,1,Unknown
1959-02-11 00:00:00,Aerolineas Argentinas,Landing (descent or approach),Commercial,Uruguay,South America,55,6,0,49,0,0,55,Other
1959-02-18 00:00:00,Trans Island Airways - New Zealand,Landing (descent or approach),Commercial,New Zealand,Oceania,3,2,0,1,0,0,3,Technical Failure
1959-02-20 00:00:00,Pan American World Airways - PAA,Landing (descent or approach),Operational,United States of America,North America,3,3,0,0,0,0,3,Human Factor
1959-02-24 00:00:00,De Havilland Aircraft of Canada,Flight,Specialised Services,Canada,North America,2,2,0,0,0,0,2,Technical Failure
1959-02-25 00:00:00,Private Mexican,Landing (descent or approach),Operational,Mexico,Central America,3,3,0,0,0,0,3,Unknown
1959-03-04 00:00:00,Indian Air Force - Bharatiya Vayu Sena,Landing (descent or approach),Military / Government,India,Asia,0,0,0,0,0,0,0,Unknown
1959-03-05 00:00:00,Private New Zealand,Flight,Military / Government,New Zealand,Oceania,1,1,0,0,0,0,1,Unknown
1959-03-10 00:00:00,Bradley Air Services,Landing (descent or approach),Commercial,Canada,North America,2,1,0,1,0,0,2,Human Factor
1959-03-12 00:00:00,Corporación Boliviana de Fomento,,Commercial,Bolivia,South America,0,0,0,0,0,0,0,Unknown
1959-03-15 00:00:00,American Airlines,Landing (descent or approach),Operational,United States of America,North America,2,2,0,0,0,0,2,Human Factor
1959-03-29 00:00:00,United States Navy - USN,Landing (descent or approach),Military / Government,Canada,North America,21,4,0,17,0,0,21,Weather
1959-03-31 00:00:00,Haiti Air Force - Corps d'Aviation Haïti,Takeoff (climb),Military / Government,Haiti,Central America,28,3,0,25,0,0,28,Technical Failure
1959-04-08 00:00:00,Royal Air Force - RAF,Flight,Operational,Yemen,Asia,5,5,0,0,0,0,5,Technical Failure
1959-04-08 00:00:00,Royal Air Force - RAF,Landing (descent or approach),Operational,Yemen,Asia,5,5,0,0,0,0,5,Technical Failure
1959-04-10 00:00:00,Argentinian Air Force - Fuerza Aérea Argentina,,Military / Government,Argentina,South America,0,0,0,0,0,0,0,Unknown
1959-04-10 00:00:00,Pan American World Airways - PAA,Landing (descent or approach),Commercial,United States of America,North America,10,5,0,5,0,0,10,Human Factor
1959-04-13 00:00:00,United States Navy - USN,Landing (descent or approach),Military / Government,United States of America,North America,0,0,0,0,0,0,0,Technical Failure
1959-04-15 00:00:00,Aeroflot - Russian International Airlines,,Commercial,Russia,Asia,0,0,0,0,0,0,0,Unknown
1959-04-24 00:00:00,Royal Air Force - RAF,Landing (descent or approach),Operational,United Kingdom,Europe,2,2,0,0,0,0,2,Human Factor
1959-04-25 00:00:00,Iran Air,Takeoff (climb),Commercial,Iran,Asia,0,0,0,0,0,0,0,Unknown
1959-04-29 00:00:00,Polyarnaya Aviatsiya,Takeoff (climb),Military / Government,Russia,Asia,6,6,0,0,0,0,6,Human Factor
1959-04-30 00:00:00,Air France,Landing (descent or approach),Operational,France,Europe,2,2,0,0,0,0,2,Unknown
1959-05-05 00:00:00,Royal Air Force - RAF,Landing (descent or approach),Military / Government,United Kingdom,Europe,2,2,0,0,0,0,2,Unknown
1959-05-07 00:00:00,Brazilian Air Force - Força Aérea Brasileira,Landing (descent or approach),Military / Government,Brazil,South America,0,0,0,0,0,0,0,Technical Failure
1959-05-08 00:00:00,Transportes Aéreos Peruanas - TAPSA,Takeoff (climb),Commercial,Peru,South America,5,2,0,3,0,0,5,Unknown
1959-05-14 00:00:00,DETA Mozambique Airlines - Direcção de Exploração dos Transportes Aéreos,Flight,Commercial,Mozambique,Africa,5,2,0,3,0,0,5,Technical Failure
1959-05-18 00:00:00,Pakistan International Airlines - PIA,Landing (descent or approach),Commercial,Pakistan,Asia,43,4,0,39,0,0,43,Weather
1959-05-21 00:00:00,British European Airways - BEA,Landing (descent or approach),Commercial,United Kingdom,Europe,6,2,0,4,0,0,6,Unknown
1959-05-26 00:00:00,Royal Air Force - RAF,Landing (descent or approach),Military / Government,United Kingdom,Europe,2,2,0,0,0,0,2,Technical Failure
1959-06-02 00:00:00,Belgian Air Force - Force Aérienne Belge - Belgische Luchtmacht,Takeoff (climb),Operational,Belgium,Europe,2,2,0,0,0,0,2,Technical Failure
1959-06-15 00:00:00,French Air Force - Armée de l'Air,Flight,Military / Government,Congo,Africa,0,0,0,0,0,0,0,Unknown
1959-06-20 00:00:00,International Air Applicators,Flight,Humanitarian,United States of America,North America,0,0,0,0,0,0,0,Unknown
1959-06-21 00:00:00,Royal Canadian Air Force - RCAF,Landing (descent or approach),Military / Government,Greece,Europe,26,7,0,19,0,0,26,Technical Failure
1959-06-22 00:00:00,Pan American World Airways - PAA,Takeoff (climb),Operational,Ireland,Europe,8,6,0,2,0,0,8,Technical Failure
1959-06-25 00:00:00,Aeroflot - Russian International Airlines,Takeoff (climb),Commercial,Russia,Asia,0,0,0,0,0,0,0,Unknown
1959-07-02 00:00:00,Austin Airways,Takeoff (climb),Commercial,Canada,North America,12,3,0,9,0,0,12,Human Factor
1959-07-03 00:00:00,Argentinian Air Force - Fuerza Aérea Argentina,Takeoff (climb),Military / Government,Argentina,South America,0,0,0,0,0,0,0,Unknown
1959-07-03 00:00:00,Royal Air Force - RAF,Landing (descent or approach),Military / Government,Maldives,Asia,0,0,0,0,0,0,0,Weather
1959-07-06 00:00:00,United States Air Force - USAF,Takeoff (climb),Military / Government,United States of America,North America,7,7,0,0,0,0,7,Unknown
1959-07-09 00:00:00,Pan American World Airways - PAA,Landing (descent or approach),Commercial,Japan,Asia,59,6,0,53,0,0,59,Technical Failure
1959-07-10 00:00:00,Aerolineas Nacionales - Costa Rica,Takeoff (climb),Commercial,Costa Rica,Central America,9,2,0,7,0,0,9,Technical Failure
1959-07-14 00:00:00,Aerolineas Argentinas,Landing (descent or approach),Commercial,Argentina,South America,10,3,0,7,0,0,10,Technical Failure
1959-07-19 00:00:00,Air India,Landing (descent or approach),Commercial,India,Asia,46,7,0,39,0,0,46,Human Factor
1959-07-26 00:00:00,Austin Airways,Takeoff (climb),Commercial,Canada,North America,3,1,0,2,0,0,3,Human Factor
1959-07-28 00:00:00,Argentinian Air Force - Fuerza Aérea Argentina,Takeoff (climb),Military / Government,Argentina,South America,0,0,0,0,0,0,0,Technical Failure
1959-07-28 00:00:00,East Anglian Flying Services,Landing (descent or approach),Commercial,United Kingdom,Europe,39,3,0,36,0,0,39,Technical Failure
1959-07-31 00:00:00,Transair Denmark,Landing (descent or approach),Operational,Denmark,Europe,0,0,0,0,0,0,0,Unknown
1959-08-05 00:00:00,Royal Air Force - RAF,Landing (descent or approach),Operational,United Kingdom,Europe,2,2,0,0,0,0,2,Human Factor
1959-08-05 00:00:00,Falcon Airways - UK,,Commercial,United Kingdom,Europe,0,0,0,0,0,0,0,Unknown
1959-08-07 00:00:00,Argentinian Air Force - Fuerza Aérea Argentina,,Military / Government,Argentina,South America,0,0,0,0,0,0,0,Unknown
1959-08-10 00:00:00,Skyway Air Services,Takeoff (climb),Commercial,Canada,North America,0,0,0,0,0,0,0,Human Factor
1959-08-10 00:00:00,United States Air Force - USAF,Flight,Operational,United States of America,North America,8,8,0,0,0,0,8,Technical Failure
1959-08-15 00:00:00,Lineas Aéreas Costarricenses - LACSA,Landing (descent or approach),Operational,Costa Rica,Central America,3,3,0,0,0,0,3,Weather
1959-08-23 00:00:00,LIAT - The Caribbean Airline,Landing (descent or approach),Commercial,Saint Kitts and Nevis,Central America,0,0,0,0,0,0,0,Unknown
1959-08-27 00:00:00,Real Aerovias,Landing (descent or approach),Commercial,Brazil,South America,0,0,0,0,0,0,0,Unknown
1959-09-02 00:00:00,Aeroflot - Russian International Airlines,Flight,Commercial,Russia,Asia,56,8,0,48,0,0,56,Weather
1959-09-05 00:00:00,Air Nautic,Flight,Operational,France,Europe,2,2,0,0,0,0,2,Unknown
1959-09-15 00:00:00,United States Navy - USN,Landing (descent or approach),Military / Government,Antarctica,Antarctica,0,0,0,0,0,0,0,Technical Failure
1959-09-23 00:00:00,Royal Air Force - RAF,Landing (descent or approach),Operational,United Kingdom,Europe,2,2,0,0,0,0,2,Technical Failure
1959-09-25 00:00:00,Saudi Arabian Airlines - SAUDIA,Takeoff (climb),Commercial,Saudi Arabia,Asia,72,5,0,67,0,0,72,Human Factor
1959-10-03 00:00:00,Trans-Canada Air Lines - TCAL,Landing (descent or approach),Commercial,Canada,North America,38,4,0,34,0,0,38,Human Factor
1959-10-15 00:00:00,United States Overseas Airlines - USOA,Takeoff (climb),Operational,United States of America,North America,2,2,0,0,0,0,2,Human Factor
1959-10-15 00:00:00,Soviet Air Force - Voyenno-vozdushnye sily CCCP,Landing (descent or approach),Military / Government,Russia,Asia,0,0,0,0,0,0,0,Unknown
1959-10-17 00:00:00,Gibbes Sepik Airways,Landing (descent or approach),Operational,Papua New Guinea,Oceania,0,0,0,0,0,0,0,Human Factor
1959-10-25 00:00:00,Corporación Boliviana de Fomento,,Operational,Bolivia,South America,0,0,0,0,0,0,0,Unknown
1959-11-01 00:00:00,Royal New Zealand Air Force - RNZAF,Takeoff (climb),Military / Government,New Zealand,Oceania,0,0,0,0,0,0,0,Other
1959-11-05 00:00:00,National Aero Sales Company,Takeoff (climb),Operational,United States of America,North America,5,1,0,4,0,0,5,Weather
1959-11-15 00:00:00,Royal Thai Air Force - Kong Thap Akat Thai,Taxiing,Military / Government,China,Asia,0,0,0,0,0,0,0,Human Factor
1959-11-15 00:00:00,Pakistan Air Force - Pakistan Fiza'ya,Landing (descent or approach),Military / Government,Pakistan,Asia,0,0,0,0,0,0,0,Unknown
1959-11-15 00:00:00,Pakistan Air Force - Pakistan Fiza'ya,,Military / Government,Pakistan,Asia,0,0,0,0,0,0,0,Unknown
1959-11-17 00:00:00,Lloyd Aéreo Boliviano - LAB Airlines,,Operational,Bolivia,South America,0,0,0,0,0,0,0,Unknown
1959-11-21 00:00:00,Private British,Landing (descent or approach),Business,United Kingdom,Europe,2,1,0,1,0,0,2,Unknown
1959-11-22 00:00:00,Private Australian,Landing (descent or approach),Business,Australia,Oceania,1,1,0,0,0,0,1,Technical Failure
1959-11-22 00:00:00,Portuguese Air Force - Força Aerea Portuguesa,Landing (descent or approach),Military / Government,Cabo Verde,Africa,0,0,0,0,0,0,0,Unknown
1959-12-01 00:00:00,Aero Atlas,Takeoff (climb),Humanitarian,United States of America,North America,2,2,0,0,0,0,2,Technical Failure
1959-12-08 00:00:00,Aeroflot - Russian International Airlines,Landing (descent or approach),Operational,Russia,Asia,5,5,0,0,0,0,5,Human Factor
1959-12-12 00:00:00,Spanish Air Force - Ejército del Aire,Landing (descent or approach),Operational,Spain,Europe,0,0,0,0,0,0,0,Unknown
1959-12-12 00:00:00,Aerolineas Argentinas,Landing (descent or approach),Commercial,Argentina,South America,32,6,0,26,0,0,32,Technical Failure
1959-12-12 00:00:00,Scottish Aviation,Takeoff (climb),Operational,Mozambique,Africa,15,1,0,14,0,0,15,Other
1959-12-14 00:00:00,United States Air Force - USAF,Flight,Operational,United States of America,North America,7,7,0,0,0,0,7,Human Factor
1959-12-18 00:00:00,Wheeler Airlines,Landing (descent or approach),Commercial,Canada,North America,0,0,0,0,0,0,0,Human Factor
1959-12-22 00:00:00,Eagle Aviation - UK,Landing (descent or approach),Commercial,Morocco,Africa,36,4,0,32,0,0,36,Technical Failure
1959-12-23 00:00:00,Desert Locust Control Organization for Eastern Africa,Flight,Military / Government,Kenya,Africa,0,0,0,0,0,0,0,Unknown
1959-12-29 00:00:00,United States Navy - USN,Landing (descent or approach),Military / Government,United States of America,North America,0,0,0,0,0,0,0,Unknown
1960-01-03 00:00:00,Eastern Airlines,Landing (descent or approach),Commercial,United States of America,North America,45,6,0,39,0,0,45,Technical Failure
1960-01-04 00:00:00,Transportes Aéreos Salvador,Takeoff (climb),Commercial,Brazil,South America,0,0,0,0,0,0,0,Other
1960-01-05 00:00:00,British European Airways - BEA,Landing (descent or approach),Commercial,Malta,Europe,51,5,0,46,0,0,51,Technical Failure
1960-01-06 00:00:00,United States Navy - USN,Landing (descent or approach),Military / Government,Antarctica,Antarctica,0,0,0,0,0,0,0,Unknown
1960-01-07 00:00:00,British European Airways - BEA,Landing (descent or approach),Commercial,United Kingdom,Europe,59,5,0,54,0,0,59,Human Factor
1960-01-12 00:00:00,Philippine Airlines - PAL,Landing (descent or approach),Operational,Philippines,Asia,3,3,0,0,0,0,3,Unknown
1960-01-15 00:00:00,Royal New Zealand Air Force - RNZAF,Landing (descent or approach),Military / Government,Antarctica,Antarctica,2,2,0,0,0,0,2,Human Factor
1960-01-26 00:00:00,Cruzeiro do Sul,Taxiing,Operational,Brazil,South America,3,3,0,0,0,0,3,Unknown
1960-01-29 00:00:00,Pacific Western Airlines - PWA,Landing (descent or approach),Commercial,Canada,North America,51,3,0,48,0,0,51,Technical Failure
1960-02-13 00:00:00,Associated Air Transport,Landing (descent or approach),Commercial,United States of America,North America,57,3,0,54,0,0,57,Technical Failure
1960-02-15 00:00:00,Royal Air Force - RAF,Taxiing,Operational,Germany,Europe,2,2,0,0,0,0,2,Technical Failure
1960-02-15 00:00:00,Lineas Aéreas de Nicaragua - LANICA,,Commercial,Nicaragua,Central America,0,0,0,0,0,0,0,Unknown
1960-02-16 00:00:00,Aircraft Service,Flight,Military / Government,New Zealand,Oceania,1,1,0,0,0,0,1,Unknown
1960-02-18 00:00:00,Private New Zealand,Flight,Military / Government,New Zealand,Oceania,1,1,0,0,0,0,1,Unknown
1960-02-19 00:00:00,Aeroflot - Russian International Airlines,Takeoff (climb),Commercial,Russia,Asia,0,0,0,0,0,0,0,Weather
1960-02-20 00:00:00,Aerolineas Argentinas,Landing (descent or approach),Operational,Argentina,South America,6,6,0,0,0,0,6,Human Factor
1960-02-20 00:00:00,United States Navy - USN,Landing (descent or approach),Military / Government,Iceland,Europe,0,0,0,0,0,0,0,Human Factor
1960-02-22 00:00:00,Alaska Airlines,Landing (descent or approach),Operational,United States of America,North America,4,4,0,0,0,0,4,Human Factor
1960-02-26 00:00:00,Air Brousse,Landing (descent or approach),Commercial,Senegal,Africa,6,2,0,4,0,0,6,Unknown
1960-02-29 00:00:00,Trans World Airlines - TWA,Takeoff (climb),Commercial,United States of America,North America,60,6,0,54,0,0,60,Technical Failure
1960-03-01 00:00:00,Royal Air Force - RAF,Landing (descent or approach),Military / Government,Maldives,Asia,20,6,0,14,0,0,20,Human Factor
1960-03-05 00:00:00,United States Air Force - USAF,Flight,Military / Government,Italy,Europe,18,4,0,14,0,0,18,Technical Failure
1960-03-05 00:00:00,Don Everall Aviation,Takeoff (climb),Commercial,United Kingdom,Europe,31,3,0,28,0,0,31,Technical Failure
1960-03-08 00:00:00,United States Air Force - USAF,Landing (descent or approach),Military / Government,United States of America,North America,7,7,0,0,0,0,7,Human Factor
1960-03-08 00:00:00,United States Navy - USN,Flight,Military / Government,Spain,Europe,24,4,0,20,0,0,24,Unknown
1960-03-08 00:00:00,Skyways of London,Landing (descent or approach),Operational,United Kingdom,Europe,6,6,0,0,0,0,6,Technical Failure
1960-03-09 00:00:00,Royal Air Force - RAF,Flight,Operational,Malaysia,Asia,3,3,0,0,0,0,3,Technical Failure
1960-03-17 00:00:00,Bush Church Aid Society,Landing (descent or approach),Humanitarian,Australia,Oceania,5,2,0,3,0,0,5,Technical Failure
1960-03-25 00:00:00,United States Air Force - USAF,,Military / Government,Germany,Europe,0,0,0,0,0,0,0,Unknown
1960-03-25 00:00:00,Wheeler Airlines,Landing (descent or approach),Operational,Canada,North America,2,2,0,0,0,0,2,Human Factor
1960-03-26 00:00:00,Ontario Central Airlines,Landing (descent or approach),Operational,Canada,North America,1,1,0,0,0,0,1,Weather
1960-03-27 00:00:00,Líneas Aéreas de Cuyo,Flight,Commercial,Argentina,South America,0,0,0,0,0,0,0,Unknown
1960-04-06 00:00:00,Servicio Especializado de Carga Aérea - SECA,Flight,Operational,Argentina,South America,2,2,0,0,0,0,2,Unknown
1960-04-11 00:00:00,Italian Air Force - Aeronautica Militare Italiana,Takeoff (climb),Military / Government,Italy,Europe,1,1,0,0,0,0,1,Unknown
1960-04-12 00:00:00,Brain %26 Brown Airfreighters,Landing (descent or approach),Operational,Australia,Oceania,3,3,0,0,0,0,3,Technical Failure
1960-04-12 00:00:00,English Electric Company,Takeoff (climb),Operational,United Kingdom,Europe,2,2,0,0,0,0,2,Human Factor
1960-04-14 00:00:00,Expreso Aéreo Interamericano,Takeoff (climb),Operational,United States of America,North America,4,2,0,2,0,0,4,Unknown
1960-04-15 00:00:00,United States Air Force - USAF,Takeoff (climb),Military / Government,United States of America,North America,24,10,0,14,0,0,24,Technical Failure
1960-04-15 00:00:00,United States Air Force - USAF,Flight,Military / Government,Germany,Europe,0,0,0,0,0,0,0,Unknown
1960-04-19 00:00:00,Royal Air Force - RAF,Flight,Military / Government,Malaysia,Asia,5,2,0,3,0,0,5,Technical Failure
1960-04-29 00:00:00,Royal Air Force - RAF,Takeoff (climb),Operational,United Kingdom,Europe,2,2,0,0,0,0,2,Unknown
1960-05-01 00:00:00,Private Australian,Flight,Business,Australia,Oceania,1,1,0,0,0,0,1,Unknown
1960-05-03 00:00:00,Argentinian Air Force - Fuerza Aérea Argentina,Takeoff (climb),Military / Government,Argentina,South America,0,0,0,0,0,0,0,Unknown
1960-05-05 00:00:00,Swiss Dhaulagiri Expedition,Takeoff (climb),Military / Government,Nepal,Asia,2,2,0,0,0,0,2,Technical Failure
1960-05-10 00:00:00,German Navy - Deutsche Marine,Flight,Military / Government,Germany,Europe,0,0,0,0,0,0,0,Technical Failure
1960-05-19 00:00:00,Linea Expressa Bolivar Compania Aérea - LEBCA,Landing (descent or approach),Commercial,Panama,Central America,0,0,0,0,0,0,0,Unknown
1960-05-21 00:00:00,Boliviana de Aviación,,Commercial,Bolivia,South America,0,0,0,0,0,0,0,Unknown
1960-05-25 00:00:00,Spantax,Flight,Commercial,World,World,4,1,0,3,0,0,4,Technical Failure
1960-05-27 00:00:00,Air Liban,Takeoff (climb),Operational,Iran,Asia,3,3,0,0,0,0,3,Unknown
1960-05-29 00:00:00,Air Safaris,Landing (descent or approach),Commercial,France,Europe,30,3,0,27,0,0,30,Human Factor
1960-05-31 00:00:00,East German Air Force - Luftstreitkräfte der Nationalen Volksarmee,Landing (descent or approach),Military / Government,Germany,Europe,0,0,0,0,0,0,0,Unknown
1960-06-01 00:00:00,Royal Air Force - RAF,Takeoff (climb),Military / Government,United Kingdom,Europe,4,2,0,2,0,0,4,Technical Failure
1960-06-17 00:00:00,Royal Air Force - RAF,Landing (descent or approach),Military / Government,Yemen,Asia,0,0,0,0,0,0,0,Technical Failure
1960-06-20 00:00:00,Air Brousse,Landing (descent or approach),Commercial,Democratic Republic of Congo,Africa,5,1,0,4,0,0,5,Unknown
1960-06-29 00:00:00,Soviet Air Force - Voyenno-vozdushnye sily CCCP,Landing (descent or approach),Military / Government,Russia,Asia,0,0,0,0,0,0,0,Unknown
1960-07-11 00:00:00,Cal-Nat Airways,Flight,Humanitarian,United States of America,North America,2,2,0,0,0,0,2,Unknown
1960-07-14 00:00:00,Philippine Airlines - PAL,Flight,Commercial,Philippines,Asia,31,3,0,28,0,0,31,Technical Failure
1960-07-27 00:00:00,Private Danish,Landing (descent or approach),Business,United Kingdom,Europe,1,1,0,0,0,0,1,Unknown
1960-08-09 00:00:00,Royal Air Force - RAF,Landing (descent or approach),Operational,United Kingdom,Europe,3,3,0,0,0,0,3,Unknown
1960-08-15 00:00:00,VASP - Viação Aérea de São Paulo,Landing (descent or approach),Commercial,Brazil,South America,0,0,0,0,0,0,0,Technical Failure
1960-08-15 00:00:00,SLM Surinam Airways - Surinaamse Luchtvaart Maatschappij,,Commercial,Suriname,South America,0,0,0,0,0,0,0,Unknown
1960-08-15 00:00:00,East African Airways,Takeoff (climb),Commercial,Uganda,Africa,0,0,0,0,0,0,0,Unknown
1960-08-20 00:00:00,Aerial Photography Company,Flight,Specialised Services,Canada,North America,0,0,0,0,0,0,0,Technical Failure
1960-08-23 00:00:00,United States Navy - USN,Landing (descent or approach),Military / Government,Morocco,Africa,0,0,0,0,0,0,0,Unknown
1960-08-24 00:00:00,Qantas Airways - Queensland and Northern Territory Aerial Services,Takeoff (climb),Commercial,Mauritius,Africa,50,12,0,38,0,0,50,Technical Failure
1960-08-24 00:00:00,Société Générale d'Affrètement Aérien,Landing (descent or approach),Operational,Algeria,Africa,2,2,0,0,0,0,2,Unknown
1960-08-24 00:00:00,Bolivian Government,,Military / Government,Bolivia,South America,0,0,0,0,0,0,0,Unknown
1960-08-28 00:00:00,Indian Air Force - Bharatiya Vayu Sena,Flight,Military / Government,India,Asia,0,0,0,0,0,0,0,Terrorism
1960-09-01 00:00:00,Syrian Airways,Flight,Operational,Congo,Africa,14,5,0,9,0,0,14,Technical Failure
1960-09-03 00:00:00,Trek Airways,Flight,Commercial,Egypt,Africa,67,6,0,61,0,0,67,Technical Failure
1960-09-14 00:00:00,American Airlines,Landing (descent or approach),Commercial,United States of America,North America,76,6,0,70,0,0,76,Human Factor
1960-10-06 00:00:00,Air Brousse,Landing (descent or approach),Commercial,Democratic Republic of Congo,Africa,6,1,0,5,0,0,6,Technical Failure
1960-10-07 00:00:00,Royal Air Force - RAF,Landing (descent or approach),Operational,United Kingdom,Europe,2,2,0,0,0,0,2,Unknown
1960-10-08 00:00:00,TAROM - Transporturile Aeriene Române,Flight,Commercial,Romania,Europe,0,0,0,0,0,0,0,Unknown
1960-10-09 00:00:00,Falcon Airways - UK,Landing (descent or approach),Commercial,United Kingdom,Europe,76,5,0,71,0,0,76,Weather
1960-10-11 00:00:00,Overseas Aviation,Landing (descent or approach),Commercial,United Kingdom,Europe,3,1,0,2,0,0,3,Other
1960-10-17 00:00:00,Royal Air Force - RAF,Landing (descent or approach),Operational,United Kingdom,Europe,2,2,0,0,0,0,2,Human Factor
1960-10-22 00:00:00,Royal Australian Air Force - RAAF,Landing (descent or approach),Operational,Papua New Guinea,Oceania,8,8,0,0,0,0,8,Unknown
1960-10-28 00:00:00,Chilean Air Force - Fuerza Aérea de Chile,Flight,Military / Government,Nicaragua,Central America,1,1,0,0,0,0,1,Unknown
1960-10-31 00:00:00,United States Navy - USN,Landing (descent or approach),Military / Government,Antarctica,Antarctica,23,4,0,19,0,0,23,Other
1960-11-08 00:00:00,Lineas Aéreas Costarricenses - LACSA,Landing (descent or approach),Operational,Costa Rica,Central America,2,2,0,0,0,0,2,Human Factor
1960-11-08 00:00:00,Iberia - Lineas Aéreas de Espana,Landing (descent or approach),Commercial,Spain,Europe,71,8,0,63,0,0,71,Human Factor
1960-11-11 00:00:00,British Overseas Airways Corporation - BOAC,Landing (descent or approach),Commercial,Sudan,Africa,27,9,0,18,0,0,27,Technical Failure
1960-11-21 00:00:00,Bahamas Airways,Landing (descent or approach),Commercial,Bahamas,Central America,0,0,0,0,0,0,0,Technical Failure
1960-12-04 00:00:00,Polynesian Airline of Samoa - Polynesian Airlines,Landing (descent or approach),Commercial,Samoa Islands (Western Samoa),Oceania,0,0,0,0,0,0,0,Technical Failure
1960-12-15 00:00:00,United States Air Force - USAF,Landing (descent or approach),Military / Government,United States of America,North America,10,10,0,0,0,0,10,Human Factor
1960-12-18 00:00:00,Wien Alaska Airlines,Takeoff (climb),Commercial,United States of America,North America,7,1,0,6,0,0,7,Other
1960-12-18 00:00:00,VARIG - Viação Aérea Rio Grandense,Landing (descent or approach),Operational,Brazil,South America,3,3,0,0,0,0,3,Human Factor
1960-12-21 00:00:00,Borneo Airways,Landing (descent or approach),Commercial,Malaysia,Asia,5,1,0,4,0,0,5,Unknown
1960-12-31 00:00:00,Canadian Government,,Other,Canada,North America,0,0,0,0,0,0,0,Unknown
1960-12-31 00:00:00,Compania Impulsora de Aviación,,Other,Mexico,Central America,0,0,0,0,0,0,0,Unknown
1960-12-31 00:00:00,French Navy,Flight,Military / Government,France,Europe,0,0,0,0,0,0,0,Unknown
1960-12-31 00:00:00,Private American,,Business,United States of America,North America,0,0,0,0,0,0,0,Unknown
1960-12-31 00:00:00,Ringsby Truck Lines,,Other,United States of America,North America,0,0,0,0,0,0,0,Unknown
1960-12-31 00:00:00,Private French,Flight,Business,World,World,0,0,0,0,0,0,0,Unknown
1961-01-04 00:00:00,Argentinian Navy - Armada Argentina,Takeoff (climb),Military / Government,Argentina,South America,10,10,0,0,0,0,10,Unknown
1961-01-09 00:00:00,United States Air Force - USAF,Landing (descent or approach),Military / Government,Germany,Europe,15,4,0,11,0,0,15,Human Factor
1961-01-23 00:00:00,United States Air Force - USAF,Landing (descent or approach),Military / Government,Spain,Europe,0,0,0,0,0,0,0,Unknown
1961-01-23 00:00:00,Royal Air Force - RAF,Takeoff (climb),Military / Government,Kenya,Africa,0,0,0,0,0,0,0,Technical Failure
1961-01-23 00:00:00,Soviet Air Force - Voyenno-vozdushnye sily CCCP,Landing (descent or approach),Military / Government,Laos,Asia,0,0,0,0,0,0,0,Weather
1961-01-26 00:00:00,Panair do Brasil,Landing (descent or approach),Commercial,Brazil,South America,59,6,0,53,0,0,59,Human Factor
1961-02-01 00:00:00,Aeroflot - Russian International Airlines,Landing (descent or approach),Commercial,Russia,Asia,0,0,0,0,0,0,0,Human Factor
1961-02-02 00:00:00,Italian Air Force - Aeronautica Militare Italiana,Flight,Military / Government,Democratic Republic of Congo,Africa,0,0,0,0,0,0,0,Unknown
1961-02-04 00:00:00,Private German,Takeoff (climb),Business,Germany,Europe,9,2,0,7,0,0,9,Weather
1961-02-17 00:00:00,Toyo Menka Kaisha,Flight,Military / Government,Japan,Asia,2,1,0,1,0,0,2,Unknown
1961-02-18 00:00:00,Pan American World Airways - PAA,Landing (descent or approach),Operational,Germany,Europe,3,3,0,0,0,0,3,Human Factor
1961-02-22 00:00:00,Northern Air Service - Canada,Takeoff (climb),Commercial,Canada,North America,2,1,0,1,0,0,2,Weather
1961-02-23 00:00:00,United States Navy - USN,Landing (descent or approach),Military / Government,United States of America,North America,8,4,0,4,0,0,8,Technical Failure
1961-03-03 00:00:00,Private British,Takeoff (climb),Business,United Kingdom,Europe,0,0,0,0,0,0,0,Unknown
1961-03-06 00:00:00,Iberia - Lineas Aéreas de Espana,Landing (descent or approach),Commercial,Brazil,South America,46,10,0,36,0,0,46,Weather
1961-03-09 00:00:00,Royal Nepal Airlines,,Commercial,Nepal,Asia,0,0,0,0,0,0,0,Unknown
1961-03-14 00:00:00,Brazilian Air Force - Força Aérea Brasileira,Flight,Military / Government,Brazil,South America,5,5,0,0,0,0,5,Unknown
1961-03-14 00:00:00,United States Air Force - USAF,Flight,Military / Government,United States of America,North America,8,8,0,0,0,0,8,Technical Failure
1961-03-22 00:00:00,Seven Seas Airlines,Landing (descent or approach),Operational,India,Asia,3,3,0,0,0,0,3,Technical Failure
1961-03-22 00:00:00,Pakistan International Airlines - PIA,Flight,Commercial,Bangladesh,Asia,13,5,0,8,0,0,13,Unknown
1961-03-22 00:00:00,Brain %26 Brown Airfreighters,Flight,Operational,Australia,Oceania,3,1,0,2,0,0,3,Technical Failure
1961-03-22 00:00:00,Royal Air Force - RAF,Landing (descent or approach),Operational,United Kingdom,Europe,4,4,0,0,0,0,4,Human Factor
1961-03-25 00:00:00,Polish Air Force - Polska Wojska Lotnicze i Obrony Powietrznej,,Military / Government,Poland,Europe,0,0,0,0,0,0,0,Unknown
1961-03-26 00:00:00,Cunard Eagle Airways,Landing (descent or approach),Operational,Ireland,Europe,6,6,0,0,0,0,6,Human Factor
1961-03-27 00:00:00,Private Swiss,Flight,Business,Equatorial Guinea,Africa,1,1,0,0,0,0,1,Technical Failure
1961-04-04 00:00:00,Argentinian Air Force - Fuerza Aérea Argentina,Landing (descent or approach),Humanitarian,Argentina,South America,0,0,0,0,0,0,0,Unknown
1961-04-04 00:00:00,Eastern Provincial Airways - EPA,Takeoff (climb),Commercial,Saint Pierre and Miquelon,North America,27,2,0,25,0,0,27,Technical Failure
1961-04-05 00:00:00,French Air Force - Armée de l'Air,Landing (descent or approach),Military / Government,Algeria,Africa,6,6,0,0,0,0,6,Unknown
1961-04-08 00:00:00,Texaco Colombia,Landing (descent or approach),Business,Colombia,South America,29,2,0,27,0,0,29,Unknown
1961-04-08 00:00:00,Papuan Air Transport - Patair,Landing (descent or approach),Operational,Papua New Guinea,Oceania,3,3,0,0,0,0,3,Technical Failure
1961-04-12 00:00:00,Canadian Government,Takeoff (climb),Specialised Services,Canada,North America,3,2,0,1,0,0,3,Human Factor
1961-04-12 00:00:00,United States Steel Corporation - USS,Landing (descent or approach),Business,United States of America,North America,4,3,0,1,0,0,4,Unknown
1961-04-15 00:00:00,Maritime Central Airways,Landing (descent or approach),Operational,Canada,North America,2,2,0,0,0,0,2,Human Factor
1961-04-27 00:00:00,Air Cameroon,Takeoff (climb),Operational,Central African Republic,Africa,4,3,0,1,0,0,4,Technical Failure
1961-05-01 00:00:00,Skyways Coach-Air,Landing (descent or approach),Commercial,United Kingdom,Europe,6,1,0,5,0,0,6,Unknown
1961-05-01 00:00:00,Indian Air Force - Bharatiya Vayu Sena,Flight,Military / Government,India,Asia,5,5,0,0,0,0,5,Human Factor
1961-05-06 00:00:00,United Arab Airlines,Landing (descent or approach),Commercial,Syria,Asia,7,5,0,2,0,0,7,Human Factor
1961-05-19 00:00:00,L. Mauldin,Flight,Business,United States of America,North America,2,2,0,0,0,0,2,Unknown
1961-05-19 00:00:00,Bruce Campbell,Landing (descent or approach),Business,United Kingdom,Europe,0,0,0,0,0,0,0,Unknown
1961-05-19 00:00:00,L. Mauldin,Flight,Business,United States of America,North America,2,2,0,0,0,0,2,Unknown
1961-05-22 00:00:00,Aigle Azur,Landing (descent or approach),Commercial,Vietnam,Asia,28,4,0,24,0,0,28,Technical Failure
1961-05-24 00:00:00,TMA of Lebanon - Trans Mediterranean Airways,Landing (descent or approach),Operational,Oman,Asia,3,3,0,0,0,0,3,Technical Failure
1961-05-25 00:00:00,Soviet Air Force - Voyenno-vozdushnye sily CCCP,Takeoff (climb),Military / Government,Russia,Asia,0,0,0,0,0,0,0,Unknown
1961-05-26 00:00:00,Royal Air Force - RAF,Takeoff (climb),Military / Government,United Kingdom,Europe,2,2,0,0,0,0,2,Technical Failure
1961-05-27 00:00:00,United States Air Force - USAF,Landing (descent or approach),Operational,Germany,Europe,0,0,0,0,0,0,0,Unknown
1961-06-12 00:00:00,All Nippon Airways,Landing (descent or approach),Commercial,Japan,Asia,49,5,0,44,0,0,49,Human Factor
1961-06-16 00:00:00,Aeroplane %26 Armament Experimental Establishment - A%26AEE,Flight,Operational,United Kingdom,Europe,1,1,0,0,0,0,1,Human Factor
1961-06-19 00:00:00,Trans Atlantica Argentina - TAA,Landing (descent or approach),Commercial,Brazil,South America,0,0,0,0,0,0,0,Human Factor
1961-06-20 00:00:00,Overseas National Airways - ONA,Taxiing,Commercial,United States of America,North America,0,0,0,0,0,0,0,Unknown
1961-06-20 00:00:00,International Aircraft Services,Taxiing,Commercial,United States of America,North America,0,0,0,0,0,0,0,Unknown
1961-06-22 00:00:00,Metropolitan Air Movements,Landing (descent or approach),Commercial,France,Europe,0,0,0,0,0,0,0,Unknown
1961-06-22 00:00:00,Aeroflot - Russian International Airlines,Flight,Commercial,Russia,Asia,97,8,0,89,0,0,97,Technical Failure
1961-06-25 00:00:00,Private Belgian,Landing (descent or approach),Business,Belgium,Europe,4,1,0,3,0,0,4,Unknown
1961-07-13 00:00:00,Argentinian Air Force - Fuerza Aérea Argentina,,Military / Government,Argentina,South America,0,0,0,0,0,0,0,Unknown
1961-07-27 00:00:00,Air France,Takeoff (climb),Commercial,Germany,Europe,41,15,0,26,0,0,41,Technical Failure
1961-07-28 00:00:00,Aeroflot - Russian International Airlines,Landing (descent or approach),Specialised Services,Russia,Asia,6,6,0,0,0,0,6,Technical Failure
1961-08-03 00:00:00,Eastern Airlines,Taxiing,Operational,United States of America,North America,3,3,0,0,0,0,3,Technical Failure
1961-08-04 00:00:00,Iran Air,Flight,Operational,Iran,Asia,3,3,0,0,0,0,3,Terrorism
1961-08-05 00:00:00,Indian Air Force - Bharatiya Vayu Sena,Landing (descent or approach),Military / Government,India,Asia,0,0,0,0,0,0,0,Technical Failure
1961-08-09 00:00:00,Nordair,Landing (descent or approach),Commercial,Canada,North America,9,2,0,7,0,0,9,Human Factor
1961-08-09 00:00:00,Private German,,Business,Switzerland,Europe,0,0,0,0,0,0,0,Unknown
1961-08-13 00:00:00,Aeroflot - Russian International Airlines,Landing (descent or approach),Operational,Latvia,Europe,6,6,0,0,0,0,6,Human Factor
1961-08-14 00:00:00,Overseas Aviation,Takeoff (climb),Commercial,France,Europe,40,3,0,37,0,0,40,Technical Failure
1961-08-14 00:00:00,Private American,Takeoff (climb),Operational,United States of America,North America,3,3,0,0,0,0,3,Human Factor
1961-08-14 00:00:00,Private British,Takeoff (climb),Business,France,Europe,3,1,0,2,0,0,3,Unknown
1961-08-14 00:00:00,Trans Australia Airlines - TAA,Flight,Commercial,Papua New Guinea,Oceania,9,2,0,7,0,0,9,Technical Failure
1961-08-24 00:00:00,Portuguese Air Force - Força Aerea Portuguesa,Flight,Military / Government,Angola,Africa,0,0,0,0,0,0,0,Terrorism
1961-08-26 00:00:00,Indian Airlines,Takeoff (climb),Operational,India,Asia,3,3,0,0,0,0,3,Human Factor
1961-08-28 00:00:00,United States Navy - USN,Flight,Military / Government,United States of America,North America,0,0,0,0,0,0,0,Unknown
1961-08-30 00:00:00,Groupement Aéronautique et Automobile,Takeoff (climb),Commercial,Gabon,Africa,7,1,0,6,0,0,7,Unknown
1961-09-01 00:00:00,Air Alpes,Takeoff (climb),Operational,France,Europe,2,1,0,1,0,0,2,Weather
1961-09-07 00:00:00,Aero Club do Cabo Verde,Landing (descent or approach),Commercial,Cabo Verde,Africa,0,0,0,0,0,0,0,Technical Failure
1961-09-17 00:00:00,Aeroflot - Russian International Airlines,Landing (descent or approach),Commercial,Uzbekistan,Asia,0,0,0,0,0,0,0,Human Factor
1961-09-17 00:00:00,Boliviana de Aviación,,Other,Bolivia,South America,0,0,0,0,0,0,0,Unknown
1961-09-19 00:00:00,Starways,Landing (descent or approach),Commercial,Ireland,Europe,73,4,0,69,0,0,73,Human Factor
1961-09-22 00:00:00,Avitor Air Services,Landing (descent or approach),Operational,Israel,Asia,2,2,0,0,0,0,2,Unknown
1961-09-24 00:00:00,United Nations Organization,,Humanitarian,Democratic Republic of Congo,Africa,0,0,0,0,0,0,0,Unknown
1961-09-26 00:00:00,Overseas National Airways - ONA,Landing (descent or approach),Operational,United States of America,North America,5,5,0,0,0,0,5,Human Factor
1961-09-27 00:00:00,VARIG - Viação Aérea Rio Grandense,Landing (descent or approach),Commercial,Brazil,South America,71,9,0,62,0,0,71,Human Factor
1961-09-29 00:00:00,Pacific Western Airlines - PWA,Landing (descent or approach),Commercial,Canada,North America,0,0,0,0,0,0,0,Technical Failure
1961-10-01 00:00:00,Aviaco - Aviacion y Comercio,Landing (descent or approach),Commercial,Spain,Europe,0,0,0,0,0,0,0,Unknown
1961-10-12 00:00:00,British Army Air Corps,Takeoff (climb),Military / Government,Germany,Europe,4,1,0,3,0,0,4,Technical Failure
1961-10-14 00:00:00,Panair do Brasil,Landing (descent or approach),Commercial,Brazil,South America,0,0,0,0,0,0,0,Technical Failure
1961-10-14 00:00:00,Soviet Air Force - Voyenno-vozdushnye sily CCCP,Flight,Military / Government,Russia,Asia,0,0,0,0,0,0,0,Technical Failure
1961-10-20 00:00:00,Royal Air Force - RAF,Landing (descent or approach),Operational,United Kingdom,Europe,4,4,0,0,0,0,4,Unknown
1961-10-24 00:00:00,Panair do Brasil,Flight,Operational,Brazil,South America,0,0,0,0,0,0,0,Technical Failure
1961-10-25 00:00:00,Royal Air Force - RAF,Landing (descent or approach),Operational,Germany,Europe,0,0,0,0,0,0,0,Human Factor
1961-10-30 00:00:00,British United Airways - BUA,Landing (descent or approach),Commercial,Germany,Europe,16,4,0,12,0,0,16,Human Factor
1961-11-02 00:00:00,Aeroflot - Russian International Airlines,Landing (descent or approach),Commercial,Russia,Asia,0,0,0,0,0,0,0,Human Factor
1961-11-12 00:00:00,United States Navy - USN,Taxiing,Military / Government,Antarctica,Antarctica,0,0,0,0,0,0,0,Technical Failure
1961-11-14 00:00:00,Zantop Air Transport,Landing (descent or approach),Operational,United States of America,North America,3,3,0,0,0,0,3,Unknown
1961-11-14 00:00:00,All Nippon Airways,Landing (descent or approach),Operational,Japan,Asia,2,2,0,0,0,0,2,Technical Failure
1961-11-15 00:00:00,National Airlines,Takeoff (climb),Commercial,United States of America,North America,30,5,0,25,0,0,30,Human Factor
1961-11-15 00:00:00,Northeast Airlines - USA,Landing (descent or approach),Commercial,United States of America,North America,45,8,0,37,0,0,45,Human Factor
1961-11-15 00:00:00,Indian Airlines,Landing (descent or approach),Commercial,Sri Lanka,Asia,42,6,0,36,0,0,42,Human Factor
1961-11-18 00:00:00,Falcks Redningskorps,Landing (descent or approach),Humanitarian,Denmark,Europe,0,0,0,0,0,0,0,Unknown
1961-11-21 00:00:00,Royal Air Force - RAF,Flight,Operational,United Kingdom,Europe,2,2,0,0,0,0,2,Technical Failure
1961-12-07 00:00:00,Jamair,Takeoff (climb),Operational,India,Asia,2,2,0,0,0,0,2,Human Factor
1961-12-12 00:00:00,VARIG - Viação Aérea Rio Grandense,Flight,Operational,Brazil,South America,2,2,0,0,0,0,2,Technical Failure
1961-12-12 00:00:00,British European Airways - BEA,Landing (descent or approach),Commercial,United Kingdom,Europe,0,0,0,0,0,0,0,Unknown
1961-12-15 00:00:00,Katanga Air Force,,Operational,Zambia,Africa,0,0,0,0,0,0,0,Unknown
1961-12-16 00:00:00,Delta Airlines,Landing (descent or approach),Commercial,United States of America,North America,0,0,0,0,0,0,0,Unknown
1961-12-18 00:00:00,Pacific Aviation,Flight,Operational,Australia,Oceania,4,3,0,1,0,0,4,Technical Failure
1961-12-27 00:00:00,Royal Air Force - RAF,Takeoff (climb),Operational,United Kingdom,Europe,4,4,0,0,0,0,4,Unknown
1961-12-31 00:00:00,Sudan Airways,Landing (descent or approach),Commercial,Sudan,Africa,0,0,0,0,0,0,0,Unknown
1961-12-31 00:00:00,Pakistan Air Force - Pakistan Fiza'ya,Flight,Military / Government,Pakistan,Asia,0,0,0,0,0,0,0,Unknown
1962-01-02 00:00:00,Iran Air,Takeoff (climb),Operational,Afghanistan,Asia,2,2,0,0,0,0,2,Technical Failure
1962-01-04 00:00:00,Royal Air Force - RAF,Takeoff (climb),Military / Government,Eritrea,Africa,6,2,0,4,0,0,6,Technical Failure
1962-01-08 00:00:00,Brazilian Air Force - Força Aérea Brasileira,Landing (descent or approach),Military / Government,Brazil,South America,3,3,0,0,0,0,3,Unknown
1962-01-11 00:00:00,Aerovias Panama Airways - APASA,Flight,Commercial,Democratic Republic of Congo,Africa,0,0,0,0,0,0,0,Terrorism
1962-01-11 00:00:00,Royal Netherlands Navy - Marineluchtvaartdienst,Flight,Military / Government,Netherlands,Europe,2,2,0,0,0,0,2,Unknown
1962-01-15 00:00:00,United States Air Force - USAF,Landing (descent or approach),Military / Government,Norway,Europe,0,0,0,0,0,0,0,Unknown
1962-01-15 00:00:00,Katanga Air Force,Flight,Military / Government,Democratic Republic of Congo,Africa,0,0,0,0,0,0,0,Unknown
1962-01-15 00:00:00,Nordair,,Commercial,Canada,North America,0,0,0,0,0,0,0,Unknown
1962-01-16 00:00:00,Aeroflot - Russian International Airlines,Landing (descent or approach),Operational,Russia,Asia,6,3,0,3,0,0,6,Human Factor
1962-01-16 00:00:00,Aerovias Moxos,Takeoff (climb),Operational,Bolivia,South America,4,4,0,0,0,0,4,Unknown
1962-01-17 00:00:00,Aerocarga - Paraguay,Landing (descent or approach),Operational,Argentina,South America,2,2,0,0,0,0,2,Human Factor
1962-01-21 00:00:00,TMA of Lebanon - Trans Mediterranean Airways,Landing (descent or approach),Operational,Oman,Asia,4,4,0,0,0,0,4,Human Factor
1962-01-23 00:00:00,French Navy,Flight,Military / Government,France,Europe,0,0,0,0,0,0,0,Technical Failure
1962-01-28 00:00:00,Private Uruguayan,Flight,Business,Argentina,South America,4,3,0,1,0,0,4,Unknown
1962-01-28 00:00:00,Avianca,Landing (descent or approach),Commercial,Colombia,South America,54,4,0,50,0,0,54,Human Factor
1962-02-01 00:00:00,Royal Canadian Air Force - RCAF,Takeoff (climb),Military / Government,Canada,North America,21,4,0,17,0,0,21,Technical Failure
1962-02-20 00:00:00,Iran Air,,Commercial,Iran,Asia,0,0,0,0,0,0,0,Unknown
1962-02-21 00:00:00,Aerial Agriculture,Flight,Military / Government,Australia,Oceania,1,1,0,0,0,0,1,Unknown
1962-02-24 00:00:00,TAROM - Transporturile Aeriene Române,Flight,Commercial,Cyprus,Europe,87,8,0,79,0,0,87,Technical Failure
1962-02-27 00:00:00,Garuda Indonesian Airways,,Commercial,Indonesia,Asia,0,0,0,0,0,0,0,Unknown
1962-02-28 00:00:00,BC Air Lines,Landing (descent or approach),Commercial,Canada,North America,0,0,0,0,0,0,0,Unknown
1962-03-03 00:00:00,Panair do Brasil,Landing (descent or approach),Commercial,Brazil,South America,0,0,0,0,0,0,0,Technical Failure
1962-03-03 00:00:00,VARIG - Viação Aérea Rio Grandense,,Commercial,Brazil,South America,0,0,0,0,0,0,0,Unknown
1962-03-03 00:00:00,Polish Air Force - Polska Wojska Lotnicze i Obrony Powietrznej,Flight,Operational,Poland,Europe,0,0,0,0,0,0,0,Unknown
1962-03-07 00:00:00,Royal Air Force - RAF,Landing (descent or approach),Military / Government,United Kingdom,Europe,0,0,0,0,0,0,0,Weather
1962-03-14 00:00:00,United States Navy - USN,Landing (descent or approach),Military / Government,Japan,Asia,0,0,0,0,0,0,0,Human Factor
1962-03-15 00:00:00,Katanga Air Force,Landing (descent or approach),Military / Government,Democratic Republic of Congo,Africa,0,0,0,0,0,0,0,Unknown
1962-03-16 00:00:00,United Arab Airlines,Landing (descent or approach),Commercial,Sudan,Africa,16,6,0,10,0,0,16,Technical Failure
1962-03-20 00:00:00,Private New Zealand,Flight,Military / Government,New Zealand,Oceania,1,1,0,0,0,0,1,Unknown
1962-03-31 00:00:00,Royal Netherlands Air Force - Koninklijke Luchtmacht,Landing (descent or approach),Military / Government,Indonesia,Asia,6,6,0,0,0,0,6,Technical Failure
1962-04-04 00:00:00,Aeroflot - Russian International Airlines,Landing (descent or approach),Operational,Russia,Asia,0,0,0,0,0,0,0,Unknown
1962-04-05 00:00:00,Swedish Air Force - Flygvapnet,Takeoff (climb),Military / Government,Sweden,Europe,6,2,0,4,0,0,6,Unknown
1962-04-05 00:00:00,Garuda Indonesian Airways,,Commercial,Indonesia,Asia,0,0,0,0,0,0,0,Unknown
1962-04-05 00:00:00,Aviateca,,Commercial,Guatemala,Central America,0,0,0,0,0,0,0,Unknown
1962-04-06 00:00:00,Kuwait Airways,Landing (descent or approach),Operational,Pakistan,Asia,3,3,0,0,0,0,3,Technical Failure
1962-04-09 00:00:00,Aviatia Utilitara,Flight,Military / Government,Romania,Europe,0,0,0,0,0,0,0,Unknown
1962-04-10 00:00:00,Japan Airlines,Landing (descent or approach),Commercial,Japan,Asia,64,4,0,60,0,0,64,Technical Failure
1962-04-11 00:00:00,Private New Zealand,Flight,Military / Government,New Zealand,Oceania,1,1,0,0,0,0,1,Unknown
1962-04-11 00:00:00,East African Airways,Landing (descent or approach),Operational,Kenya,Africa,3,3,0,0,0,0,3,Human Factor
1962-04-14 00:00:00,Private New Zealand,Flight,Military / Government,New Zealand,Oceania,1,1,0,0,0,0,1,Unknown
1962-04-15 00:00:00,Aeroflot - Russian International Airlines,Flight,Operational,Russia,Asia,2,2,0,0,0,0,2,Human Factor
1962-04-18 00:00:00,Honduran Air Force - Fuerza Aérea Hondureña,Takeoff (climb),Military / Government,Honduras,Central America,3,3,0,0,0,0,3,Unknown
1962-04-19 00:00:00,Aviaco - Aviacion y Comercio,Landing (descent or approach),Commercial,Spain,Europe,0,0,0,0,0,0,0,Technical Failure
1962-04-20 00:00:00,United States Air Force - USAF,Landing (descent or approach),Operational,Vietnam,Asia,3,3,0,0,0,0,3,Human Factor
1962-04-26 00:00:00,Trans Australia Airlines - TAA,Landing (descent or approach),Commercial,Papua New Guinea,Oceania,11,5,0,6,0,0,11,Unknown
1962-05-07 00:00:00,Indian Airlines,Flight,Commercial,India,Asia,36,6,0,30,0,0,36,Human Factor
1962-05-07 00:00:00,LAN Chile - Linea Aérea Nacional de Chile,Takeoff (climb),Commercial,Chile,South America,30,5,0,25,0,0,30,Technical Failure
1962-05-11 00:00:00,Royal Netherlands Navy - Marineluchtvaartdienst,Landing (descent or approach),Military / Government,Indonesia,Asia,0,0,0,0,0,0,0,Unknown
1962-05-15 00:00:00,Royal Air Force - RAF,Landing (descent or approach),Military / Government,Maldives,Asia,0,0,0,0,0,0,0,Technical Failure
1962-05-17 00:00:00,Indonesian Air Force - TNI-AU Tentara Nasional Indonesia - Angkatan Udara,Flight,Military / Government,Indonesia,Asia,7,7,0,0,0,0,7,Terrorism
1962-05-22 00:00:00,Soviet Air Force - Voyenno-vozdushnye sily CCCP,Flight,Military / Government,Russia,Asia,0,0,0,0,0,0,0,Unknown
1962-05-29 00:00:00,Ferranti,Takeoff (climb),Business,United Kingdom,Europe,2,2,0,0,0,0,2,Technical Failure
1962-06-07 00:00:00,SAHSA - Servicios Aéreos de Honduras SA,Landing (descent or approach),Operational,Honduras,Central America,2,2,0,0,0,0,2,Technical Failure
1962-06-08 00:00:00,Transair Denmark,Landing (descent or approach),Operational,Denmark,Europe,2,2,0,0,0,0,2,Unknown
1962-06-08 00:00:00,Transair Sweden,Landing (descent or approach),Humanitarian,Democratic Republic of Congo,Africa,2,2,0,0,0,0,2,Unknown
1962-06-22 00:00:00,Société Anonyme CARTA,Flight,Other,France,Europe,0,0,0,0,0,0,0,Human Factor
1962-06-22 00:00:00,United States Air Force - USAF,Takeoff (climb),Military / Government,United States of America,North America,4,4,0,0,0,0,4,Technical Failure
1962-06-27 00:00:00,Royal Malaysian Air Force - Tentera Udara Diraja Malaysia,Flight,Military / Government,Malaysia,Asia,14,2,0,12,0,0,14,Unknown
1962-06-27 00:00:00,Paraense Transportes Aéreos,Landing (descent or approach),Commercial,Brazil,South America,0,0,0,0,0,0,0,Human Factor
1962-06-28 00:00:00,Turkish Airlines - THY Türk Hava Yollari,Landing (descent or approach),Operational,Turkey,Asia,3,3,0,0,0,0,3,Unknown
1962-06-30 00:00:00,Manx Airways,Landing (descent or approach),Commercial,United Kingdom,Europe,0,0,0,0,0,0,0,Technical Failure
1962-07-01 00:00:00,United Nations Organization,Takeoff (climb),Humanitarian,Democratic Republic of Congo,Africa,0,0,0,0,0,0,0,Unknown
1962-07-06 00:00:00,Linea Expressa Bolivar Compania Aérea - LEBCA,Flight,Operational,Venezuela,South America,3,3,0,0,0,0,3,Technical Failure
1962-07-07 00:00:00,Wien Alaska Airlines,Takeoff (climb),Operational,United States of America,North America,2,2,0,0,0,0,2,Human Factor
1962-07-08 00:00:00,Continental Airlines,Takeoff (climb),Commercial,United States of America,North America,16,3,0,13,0,0,16,Human Factor
1962-07-12 00:00:00,Brazilian Air Force - Força Aérea Brasileira,Takeoff (climb),Military / Government,Brazil,South America,0,0,0,0,0,0,0,Technical Failure
1962-07-15 00:00:00,United States Air Force - USAF,Flight,Military / Government,Vietnam,Asia,4,4,0,0,0,0,4,Human Factor
1962-07-26 00:00:00,Pakistan Air Force - Pakistan Fiza'ya,Flight,Military / Government,Pakistan,Asia,0,0,0,0,0,0,0,Unknown
1962-07-26 00:00:00,Portuguese Air Force - Força Aerea Portuguesa,Landing (descent or approach),Military / Government,Spain,Europe,0,0,0,0,0,0,0,Unknown
1962-07-29 00:00:00,MAP - Ministerstvo Aviatsionnoi Promyshlennosti - Minaviaprom,Takeoff (climb),Operational,Russia,Asia,8,8,0,0,0,0,8,Human Factor
1962-07-29 00:00:00,Aviatia Utilitara,,Other,Romania,Europe,0,0,0,0,0,0,0,Unknown
1962-07-30 00:00:00,LAN Chile - Linea Aérea Nacional de Chile,Takeoff (climb),Commercial,Chile,South America,0,0,0,0,0,0,0,Unknown
1962-08-06 00:00:00,American Airlines,Landing (descent or approach),Commercial,United States of America,North America,72,5,0,67,0,0,72,Human Factor
1962-08-17 00:00:00,Garuda Indonesian Airways,Landing (descent or approach),Commercial,Indonesia,Asia,0,0,0,0,0,0,0,Unknown
1962-08-22 00:00:00,Piedmont Airlines,Landing (descent or approach),Operational,United States of America,North America,3,3,0,0,0,0,3,Technical Failure
1962-08-25 00:00:00,JAT Yugoslav Airlines - Jugoslovenski Aerotransport,Landing (descent or approach),Commercial,Bosnia and Herzegovina,Europe,32,4,0,28,0,0,32,Technical Failure
1962-08-26 00:00:00,Royal Nepal Airlines,Flight,Commercial,Nepal,Asia,0,0,0,0,0,0,0,Unknown
1962-08-31 00:00:00,United States Air Force - USAF,,Military / Government,United States of America,North America,0,0,0,0,0,0,0,Unknown
1962-09-09 00:00:00,British Army Air Corps,Takeoff (climb),Military / Government,Greece,Europe,0,0,0,0,0,0,0,Technical Failure
1962-09-11 00:00:00,Middle East Airlines - MEA,Landing (descent or approach),Operational,Oman,Asia,3,3,0,0,0,0,3,Unknown
1962-09-18 00:00:00,Prinair - Puerto Rico International Airlines,Takeoff (climb),Operational,Honduras,Central America,2,2,0,0,0,0,2,Technical Failure
1962-10-06 00:00:00,Brazilian Air Force - Força Aérea Brasileira,Takeoff (climb),Operational,Brazil,South America,3,3,0,0,0,0,3,Unknown
1962-10-13 00:00:00,Private German,,Business,Germany,Europe,0,0,0,0,0,0,0,Unknown
1962-10-22 00:00:00,Northwest Airlines,Flight,Commercial,United States of America,North America,102,7,0,95,0,0,102,Technical Failure
1962-10-23 00:00:00,Philippine Airlines - PAL,Landing (descent or approach),Operational,Philippines,Asia,3,3,0,0,0,0,3,Unknown
1962-10-26 00:00:00,Airlift Antwerp,Landing (descent or approach),Humanitarian,Belgium,Europe,3,2,0,1,0,0,3,Technical Failure
1962-10-29 00:00:00,Panagra - Pan American-Grace Airways,Takeoff (climb),Commercial,Bolivia,South America,42,6,0,36,0,0,42,Unknown
1962-10-29 00:00:00,Argentinian Navy - Armada Argentina,Flight,Military / Government,Argentina,South America,2,2,0,0,0,0,2,Technical Failure
1962-10-29 00:00:00,United States Air Force - USAF,Landing (descent or approach),Military / Government,Vietnam,Asia,6,6,0,0,0,0,6,Human Factor
1962-11-01 00:00:00,United States Navy - USN,Landing (descent or approach),Military / Government,United States of America,North America,0,0,0,0,0,0,0,Technical Failure
1962-11-02 00:00:00,Linea Expressa Bolivar Compania Aérea - LEBCA,Landing (descent or approach),Operational,Venezuela,South America,2,2,0,0,0,0,2,Unknown
1962-11-06 00:00:00,Finnish Air Force - Suomen Ilmavoimat,Landing (descent or approach),Military / Government,Finland,Europe,1,1,0,0,0,0,1,Unknown
1962-11-22 00:00:00,United States Navy - USN,Landing (descent or approach),Military / Government,Antarctica,Antarctica,0,0,0,0,0,0,0,Technical Failure
1962-11-25 00:00:00,United States Navy - USN,Takeoff (climb),Military / Government,Antarctica,Antarctica,0,0,0,0,0,0,0,Technical Failure
1962-11-29 00:00:00,Aeroflot - Russian International Airlines,,Commercial,Russia,Asia,0,0,0,0,0,0,0,Unknown
1962-12-06 00:00:00,Aerolineas Abaroa - ALAS,,Commercial,Bolivia,South America,0,0,0,0,0,0,0,Unknown
1962-12-10 00:00:00,Argentinian Air Force - Fuerza Aérea Argentina,Takeoff (climb),Military / Government,Antarctica,Antarctica,0,0,0,0,0,0,0,Unknown
1962-12-21 00:00:00,Frontier Airlines,Landing (descent or approach),Commercial,United States of America,North America,42,3,0,39,0,0,42,Human Factor
1962-12-29 00:00:00,Carter Air Service,Takeoff (climb),Commercial,Canada,North America,4,1,0,3,0,0,4,Human Factor
1962-12-31 00:00:00,Cogeair - Compagnie Générale Aérienne Africaine,Taxiing,Business,Democratic Republic of Congo,Africa,8,1,0,7,0,0,8,Unknown
1963-01-04 00:00:00,Norell %26 Chyk,Flight,Business,Canada,North America,5,1,0,4,0,0,5,Unknown
1963-01-05 00:00:00,Bird %26 Sons,Flight,Operational,Laos,Asia,4,2,0,2,0,0,4,Terrorism
1963-01-07 00:00:00,United States Navy - USN,Takeoff (climb),Military / Government,United States of America,North America,0,0,0,0,0,0,0,Technical Failure
1963-01-08 00:00:00,Royal New Zealand Air Force - RNZAF,Landing (descent or approach),Operational,New Zealand,Oceania,1,1,0,0,0,0,1,Technical Failure
1963-01-10 00:00:00,Bird %26 Sons,Flight,Commercial,Laos,Asia,1,1,0,0,0,0,1,Unknown
1963-01-13 00:00:00,Wheeler Airlines,Flight,Commercial,Canada,North America,8,1,0,7,0,0,8,Weather
1963-01-16 00:00:00,Bristow Helicopters,Flight,Operational,Morocco,Africa,3,3,0,0,0,0,3,Technical Failure
1963-01-22 00:00:00,Cruzeiro do Sul,Landing (descent or approach),Commercial,Brazil,South America,9,3,0,6,0,0,9,Weather
1963-02-16 00:00:00,Zantop Air Transport,Landing (descent or approach),Operational,United States of America,North America,2,2,0,0,0,0,2,Technical Failure
1963-02-18 00:00:00,All Nippon Airways,Landing (descent or approach),Commercial,Japan,Asia,0,0,0,0,0,0,0,Unknown
1963-02-23 00:00:00,Corporación Boliviana de Fomento,,Operational,Bolivia,South America,0,0,0,0,0,0,0,Unknown
1963-03-04 00:00:00,French Air Force - Armée de l'Air,Flight,Operational,France,Europe,4,4,0,0,0,0,4,Unknown
1963-03-04 00:00:00,Flugtransport,Landing (descent or approach),Operational,Germany,Europe,2,2,0,0,0,0,2,Unknown
1963-03-04 00:00:00,United States Air Force - USAF,Taxiing,Specialised Services,United Kingdom,Europe,3,3,0,0,0,0,3,Human Factor
1963-03-13 00:00:00,Royal Air Force - RAF,Landing (descent or approach),Military / Government,Kenya,Africa,0,0,0,0,0,0,0,Unknown
1963-03-15 00:00:00,United States Navy - USN,Landing (descent or approach),Military / Government,United States of America,North America,33,3,0,30,0,0,33,Technical Failure
1963-03-29 00:00:00,Air Congo,Takeoff (climb),Commercial,Democratic Republic of Congo,Africa,0,0,0,0,0,0,0,Technical Failure
1963-03-30 00:00:00,Italian Air Force - Aeronautica Militare Italiana,Landing (descent or approach),Military / Government,Italy,Europe,0,0,0,0,0,0,0,Unknown
1963-04-01 00:00:00,French Air Force - Armée de l'Air,Flight,Military / Government,France,Europe,0,0,0,0,0,0,0,Technical Failure
1963-04-02 00:00:00,Aeroflot - Russian International Airlines,Takeoff (climb),Operational,Russia,Asia,0,0,0,0,0,0,0,Human Factor
1963-04-08 00:00:00,Panair do Brasil,Takeoff (climb),Operational,Brazil,South America,7,7,0,0,0,0,7,Human Factor
1963-04-09 00:00:00,BKS Air Survey,Takeoff (climb),Operational,United Kingdom,Europe,3,3,0,0,0,0,3,Technical Failure
1963-04-13 00:00:00,Sterling Airways,Landing (descent or approach),Operational,Denmark,Europe,3,3,0,0,0,0,3,Human Factor
1963-04-24 00:00:00,Sociedade Anônima Viação Aérea Gaúcha - SAVAG,Takeoff (climb),Operational,Brazil,South America,2,2,0,0,0,0,2,Technical Failure
1963-04-30 00:00:00,All Nippon Airways,Landing (descent or approach),Operational,Japan,Asia,2,2,0,0,0,0,2,Unknown
1963-05-02 00:00:00,Aerovias Moxos,,Operational,Bolivia,South America,0,0,0,0,0,0,0,Unknown
1963-05-05 00:00:00,Paraense Transportes Aéreos,Parking,Other,Brazil,South America,0,0,0,0,0,0,0,Unknown
1963-05-06 00:00:00,Ostermans Aero,Landing (descent or approach),Commercial,Liberia,Africa,0,0,0,0,0,0,0,Unknown
1963-05-07 00:00:00,United States Air Force - USAF,Landing (descent or approach),Military / Government,United States of America,North America,0,0,0,0,0,0,0,Unknown
1963-05-10 00:00:00,All Nippon Airways,,Commercial,Japan,Asia,0,0,0,0,0,0,0,Unknown
1963-05-14 00:00:00,Garuda Indonesian Airways,Takeoff (climb),Commercial,Indonesia,Asia,0,0,0,0,0,0,0,Unknown
1963-05-18 00:00:00,Aeroflot - Russian International Airlines,Landing (descent or approach),Commercial,Russia,Asia,0,0,0,0,0,0,0,Human Factor
1963-05-22 00:00:00,Air Algérie,Landing (descent or approach),Commercial,Algeria,Africa,0,0,0,0,0,0,0,Unknown
1963-05-28 00:00:00,Standard Airways,Landing (descent or approach),Commercial,United States of America,North America,70,6,0,64,0,0,70,Human Factor
1963-06-12 00:00:00,Royal Air Force - RAF,Flight,Operational,France,Europe,2,2,0,0,0,0,2,Weather
1963-06-21 00:00:00,Real Aerovias,Landing (descent or approach),Commercial,Brazil,South America,0,0,0,0,0,0,0,Unknown
1963-06-29 00:00:00,Argentinian Air Force - Fuerza Aérea Argentina,Landing (descent or approach),Military / Government,Argentina,South America,0,0,0,0,0,0,0,Unknown
1963-07-03 00:00:00,Aerolineas Argentinas,Landing (descent or approach),Commercial,Argentina,South America,70,7,0,63,0,0,70,Human Factor
1963-07-10 00:00:00,Aerovias Panama Airways - APASA,Flight,Operational,Turks and Caicos Islands,Central America,2,2,0,0,0,0,2,Technical Failure
1963-07-20 00:00:00,Mayflower Air Services,Takeoff (climb),Commercial,United Kingdom,Europe,8,1,0,7,0,0,8,Technical Failure
1963-07-23 00:00:00,Cordova Airlines,Landing (descent or approach),Commercial,United States of America,North America,4,2,0,2,0,0,4,Human Factor
1963-07-31 00:00:00,United States Navy - USN,Landing (descent or approach),Operational,Canada,North America,7,7,0,0,0,0,7,Unknown
1963-08-04 00:00:00,MIAT Mongolian Airlines - Mongolyn Irgeniy Agaaryn Teever,Flight,Commercial,Mongolia,Asia,0,0,0,0,0,0,0,Unknown
1963-08-15 00:00:00,United States Army,Flight,Military / Government,Vietnam,Asia,0,0,0,0,0,0,0,Unknown
1963-08-16 00:00:00,Soviet Air Force - Voyenno-vozdushnye sily CCCP,Flight,Military / Government,Russia,Asia,0,0,0,0,0,0,0,Technical Failure
1963-08-21 00:00:00,Aeroflot - Russian International Airlines,Landing (descent or approach),Commercial,Russia,Asia,52,5,0,47,0,0,52,Technical Failure
1963-08-24 00:00:00,West Coast Airlines,Landing (descent or approach),Commercial,Canada,North America,15,3,0,12,0,0,15,Human Factor
1963-08-29 00:00:00,Brazilian Air Force - Força Aérea Brasileira,Landing (descent or approach),Military / Government,Brazil,South America,0,0,0,0,0,0,0,Unknown
1963-09-06 00:00:00,Panair do Brasil,Landing (descent or approach),Commercial,Brazil,South America,0,0,0,0,0,0,0,Unknown
1963-09-07 00:00:00,Borneo Airways,Takeoff (climb),Commercial,Malaysia,Asia,14,1,0,13,0,0,14,Technical Failure
1963-09-10 00:00:00,Garuda Indonesian Airways,Flight,Commercial,Indonesia,Asia,0,0,0,0,0,0,0,Unknown
1963-09-18 00:00:00,French Air Force - Armée de l'Air,Landing (descent or approach),Military / Government,France,Europe,0,0,0,0,0,0,0,Unknown
1963-09-21 00:00:00,The Decca Navigator,Landing (descent or approach),Specialised Services,United Kingdom,Europe,4,2,0,2,0,0,4,Technical Failure
1963-09-24 00:00:00,British United Air Ferries - BAF,Takeoff (climb),Commercial,United Kingdom,Europe,4,3,0,1,0,0,4,Technical Failure
1963-09-28 00:00:00,Eastern Airlines,Landing (descent or approach),Commercial,United States of America,North America,45,5,0,40,0,0,45,Human Factor
1963-09-28 00:00:00,United States Air Force - USAF,Landing (descent or approach),Military / Government,Thailand,Asia,4,4,0,0,0,0,4,Unknown
1963-10-11 00:00:00,Ladysmith Air Charter,Landing (descent or approach),Commercial,South Africa,Africa,6,1,0,5,0,0,6,Unknown
1963-10-29 00:00:00,All Nippon Airways,,Commercial,Japan,Asia,0,0,0,0,0,0,0,Unknown
1963-11-02 00:00:00,Allegheny Airlines,Taxiing,Commercial,United States of America,North America,0,0,0,0,0,0,0,Unknown
1963-11-25 00:00:00,Cameroon Air Force - Armée de l'Air du Cameroun,Landing (descent or approach),Military / Government,Cameroon,Africa,0,0,0,0,0,0,0,Unknown
1963-11-30 00:00:00,Ethiopian Airlines,Takeoff (climb),Specialised Services,Ethiopia,Africa,3,3,0,0,0,0,3,Human Factor
1963-12-03 00:00:00,Aeroflot - Russian International Airlines,Takeoff (climb),Operational,Russia,Asia,6,6,0,0,0,0,6,Human Factor
1963-12-07 00:00:00,Interflug,Flight,Commercial,Germany,Europe,33,5,0,28,0,0,33,Technical Failure
1963-12-13 00:00:00,Private Brazilian,Landing (descent or approach),Operational,Brazil,South America,1,1,0,0,0,0,1,Human Factor
1963-12-16 00:00:00,LOT Polish Airlines - Polskie Linie Lotnicze,Landing (descent or approach),Commercial,Poland,Europe,15,3,0,12,0,0,15,Unknown
1963-12-16 00:00:00,Aeroflot - Russian International Airlines,Takeoff (climb),Commercial,Russia,Asia,4,3,0,1,0,0,4,Unknown
1963-12-17 00:00:00,Royal Air Force - RAF,Landing (descent or approach),Operational,United Kingdom,Europe,0,0,0,0,0,0,0,Unknown
1963-12-18 00:00:00,Servicios Aéreos Cochabamba,,Commercial,Bolivia,South America,0,0,0,0,0,0,0,Unknown
1963-12-21 00:00:00,Union Oil Company of California,Landing (descent or approach),Business,United States of America,North America,4,3,0,1,0,0,4,Weather
1963-12-23 00:00:00,French Air Force - Armée de l'Air,Flight,Military / Government,France,Europe,0,0,0,0,0,0,0,Technical Failure
1963-12-29 00:00:00,British Army Air Corps,Takeoff (climb),Military / Government,Kenya,Africa,4,1,0,3,0,0,4,Unknown
1963-12-30 00:00:00,Solair Flying Services,Flight,Specialised Services,United Kingdom,Europe,2,1,0,1,0,0,2,Weather
1963-12-31 00:00:00,Ariana Afghan Airlines,Flight,Commercial,Afghanistan,Asia,0,0,0,0,0,0,0,Unknown
1963-12-31 00:00:00,Compania Impulsora de Aviación,Flight,Commercial,Mexico,Central America,0,0,0,0,0,0,0,Unknown
1963-12-31 00:00:00,East German Air Force - Luftstreitkräfte der Nationalen Volksarmee,Flight,Operational,Egypt,Africa,0,0,0,0,0,0,0,Terrorism
1964-01-09 00:00:00,Austin Airways,Flight,Operational,Canada,North America,2,2,0,0,0,0,2,Technical Failure
1964-01-10 00:00:00,Royal Air Force - RAF,Landing (descent or approach),Military / Government,United Kingdom,Europe,5,5,0,0,0,0,5,Technical Failure
1964-01-13 00:00:00,Transair Sweden,Takeoff (climb),Humanitarian,Democratic Republic of Congo,Africa,2,2,0,0,0,0,2,Unknown
1964-01-18 00:00:00,Private American,Landing (descent or approach),Business,United States of America,North America,2,2,0,0,0,0,2,Human Factor
1964-01-31 00:00:00,Private American,Takeoff (climb),Business,Netherlands,Central America,1,1,0,0,0,0,1,Technical Failure
1964-02-07 00:00:00,United States Air Force - USAF,Flight,Military / Government,United States of America,North America,7,7,0,0,0,0,7,Technical Failure
1964-02-08 00:00:00,Boliviana de Aviación,,Operational,Bolivia,South America,0,0,0,0,0,0,0,Unknown
1964-02-15 00:00:00,Paraense Transportes Aéreos,Flight,Commercial,Brazil,South America,34,9,0,25,0,0,34,Human Factor
1964-02-23 00:00:00,United Arab Airlines,Landing (descent or approach),Commercial,Lebanon,Asia,53,48,0,5,0,0,53,Human Factor
1964-02-26 00:00:00,Libyan Aviation Company,Landing (descent or approach),Business,Libya,Africa,0,0,0,0,0,0,0,Technical Failure
1964-03-05 00:00:00,Wideroe - Wideroe's Flyveselskap,Takeoff (climb),Commercial,Norway,Europe,18,3,0,15,0,0,18,Unknown
1964-03-06 00:00:00,Private American,Takeoff (climb),Operational,Dominican Republic,Central America,2,2,0,0,0,0,2,Unknown
1964-03-08 00:00:00,VASP - Viação Aérea de São Paulo,Landing (descent or approach),Operational,Brazil,South America,4,4,0,0,0,0,4,Human Factor
1964-03-18 00:00:00,British Aircraft Corporation,Landing (descent or approach),Operational,United Kingdom,Europe,5,5,0,0,0,0,5,Human Factor
1964-03-22 00:00:00,Malaysian Airways,Landing (descent or approach),Commercial,Singapore,Asia,68,8,0,60,0,0,68,Technical Failure
1964-04-02 00:00:00,Kalinga Airlines,Landing (descent or approach),Operational,India,Asia,2,2,0,0,0,0,2,Human Factor
1964-04-04 00:00:00,Paraense Transportes Aéreos,Takeoff (climb),Commercial,Brazil,South America,0,0,0,0,0,0,0,Human Factor
1964-04-07 00:00:00,Pan American World Airways - PAA,Landing (descent or approach),Commercial,United States of America,North America,145,9,0,136,0,0,145,Human Factor
1964-04-07 00:00:00,Kalinga Airlines,Landing (descent or approach),Operational,India,Asia,7,3,0,4,0,0,7,Human Factor
1964-04-07 00:00:00,Private Brazilian,Landing (descent or approach),Business,Argentina,South America,2,2,0,0,0,0,2,Human Factor
1964-04-07 00:00:00,Bird %26 Sons,Flight,Operational,Laos,Asia,1,1,0,0,0,0,1,Human Factor
1964-04-09 00:00:00,Parson's Airways,Flight,Commercial,Canada,North America,0,0,0,0,0,0,0,Unknown
1964-04-11 00:00:00,Private American,Flight,Operational,United States of America,North America,2,2,0,0,0,0,2,Technical Failure
1964-04-11 00:00:00,Panair do Brasil,Landing (descent or approach),Commercial,Brazil,South America,0,0,0,0,0,0,0,Weather
1964-04-21 00:00:00,Middle East Airlines - MEA,Taxiing,Commercial,Egypt,Africa,0,0,0,0,0,0,0,Other
1964-04-22 00:00:00,Southern Scenic Air-Services,Takeoff (climb),Commercial,New Zealand,Oceania,3,1,0,2,0,0,3,Unknown
1964-04-24 00:00:00,Federal Aviation Administration - FAA,Takeoff (climb),Specialised Services,United States of America,North America,0,0,0,0,0,0,0,Unknown
1964-04-26 00:00:00,Private American,Landing (descent or approach),Operational,United States of America,North America,1,1,0,0,0,0,1,Human Factor
1964-04-28 00:00:00,Private New Zealand,Flight,Military / Government,New Zealand,Oceania,1,1,0,0,0,0,1,Unknown
1964-04-29 00:00:00,Rosenbalm Aviation,Takeoff (climb),Military / Government,United States of America,North America,1,1,0,0,0,0,1,Human Factor
1964-04-30 00:00:00,Aerolineas Carreras Transportes Aéreos - ACTA,Flight,Operational,Argentina,South America,6,6,0,0,0,0,6,Technical Failure
1964-05-02 00:00:00,United States Air Force - USAF,Takeoff (climb),Military / Government,Japan,Asia,0,0,0,0,0,0,0,Technical Failure
1964-05-03 00:00:00,Royal Danish Air Force - Flyvevåbnet,Flight,Military / Government,Greenland,Europe,14,9,0,5,0,0,14,Technical Failure
1964-05-04 00:00:00,Iran Air,,Commercial,Iran,Asia,0,0,0,0,0,0,0,Unknown
1964-05-07 00:00:00,Private New Zealand,Flight,Military / Government,New Zealand,Oceania,1,1,0,0,0,0,1,Unknown
1964-05-19 00:00:00,Private American,Flight,Business,Bahamas,Central America,2,1,0,1,0,0,2,Technical Failure
1964-05-22 00:00:00,Royal Norwegian Air Force - Kongelige Norske Luftforsvaret,Flight,Military / Government,Democratic Republic of Congo,Africa,6,2,0,4,0,0,6,Terrorism
1964-05-29 00:00:00,Transportes Aéreos Benianos - TABSA,Landing (descent or approach),Commercial,Bolivia,South America,0,0,0,0,0,0,0,Unknown
1964-05-29 00:00:00,Royal Air Force - RAF,Landing (descent or approach),Military / Government,Malaysia,Asia,3,3,0,0,0,0,3,Other
1964-05-31 00:00:00,Private American,Takeoff (climb),Business,United States of America,North America,2,1,0,1,0,0,2,Human Factor
1964-06-04 00:00:00,Lear Jet Corporation,Takeoff (climb),Specialised Services,United States of America,North America,2,2,0,0,0,0,2,Human Factor
1964-06-04 00:00:00,Celgar,Takeoff (climb),Commercial,Canada,North America,6,1,0,5,0,0,6,Other
1964-06-06 00:00:00,Aerolineas Abaroa - ALAS,Takeoff (climb),Commercial,Bolivia,South America,0,0,0,0,0,0,0,Unknown
1964-06-06 00:00:00,VASP - Viação Aérea de São Paulo,Landing (descent or approach),Operational,Brazil,South America,2,2,0,0,0,0,2,Human Factor
1964-06-09 00:00:00,Aeroflot - Russian International Airlines,Landing (descent or approach),Commercial,Russia,Asia,0,0,0,0,0,0,0,Unknown
1964-06-11 00:00:00,Royal Air Force - RAF,Landing (descent or approach),Military / Government,Malaysia,Asia,7,7,0,0,0,0,7,Technical Failure
1964-06-13 00:00:00,Air Canada,Landing (descent or approach),Commercial,Canada,North America,44,3,0,41,0,0,44,Human Factor
1964-06-13 00:00:00,TAROM - Transporturile Aeriene Române,Landing (descent or approach),Commercial,Romania,Europe,0,0,0,0,0,0,0,Unknown
1964-06-25 00:00:00,Argentinian Air Force - Fuerza Aérea Argentina,Landing (descent or approach),Military / Government,Argentina,South America,0,0,0,0,0,0,0,Unknown
1964-06-25 00:00:00,Argentinian Air Force - Fuerza Aérea Argentina,Landing (descent or approach),Military / Government,Argentina,South America,0,0,0,0,0,0,0,Unknown
1964-06-26 00:00:00,Argentinian Navy - Armada Argentina,Takeoff (climb),Military / Government,Argentina,South America,64,10,0,54,0,0,64,Weather
1964-07-01 00:00:00,Royal Australian Air Force - RAAF,Landing (descent or approach),Operational,Australia,Oceania,0,0,0,0,0,0,0,Unknown
1964-07-04 00:00:00,Sécurité civile française,Takeoff (climb),Humanitarian,France,Europe,2,2,0,0,0,0,2,Technical Failure
1964-07-04 00:00:00,Nitto Airlines,Flight,Military / Government,Japan,Asia,0,0,0,0,0,0,0,Unknown
1964-07-13 00:00:00,Catalina-Channel Airlines,Takeoff (climb),Commercial,United States of America,North America,10,1,0,9,0,0,10,Technical Failure
1964-07-17 00:00:00,Eastern Airlines,Landing (descent or approach),Commercial,United States of America,North America,76,5,0,71,0,0,76,Human Factor
1964-07-20 00:00:00,Eastern Airlines,Landing (descent or approach),Commercial,United States of America,North America,57,5,0,52,0,0,57,Human Factor
1964-07-22 00:00:00,Lineas Aéreas de Nicaragua - LANICA,Takeoff (climb),Operational,Nicaragua,Central America,2,2,0,0,0,0,2,Technical Failure
1964-07-22 00:00:00,United States Navy - USN,,Military / Government,United States of America,North America,0,0,0,0,0,0,0,Unknown
1964-07-23 00:00:00,United States Air Force - USAF,Landing (descent or approach),Military / Government,Vietnam,Asia,4,4,0,0,0,0,4,Technical Failure
1964-07-30 00:00:00,Federal Aviation Administration - FAA,Landing (descent or approach),Specialised Services,United States of America,North America,8,3,0,5,0,0,8,Human Factor
1964-08-01 00:00:00,Società Aerofotografie,Flight,Specialised Services,Italy,Europe,3,1,0,2,0,0,3,Technical Failure
1964-08-02 00:00:00,Guatemalan Air Force - Fuerza Aérea Guatemalteca,Flight,Military / Government,Guatemala,Central America,4,4,0,0,0,0,4,Unknown
1964-08-03 00:00:00,M %26 F,Landing (descent or approach),Operational,United States of America,North America,4,2,0,2,0,0,4,Human Factor
1964-08-03 00:00:00,Aeroflot - Russian International Airlines,Landing (descent or approach),Commercial,Russia,Asia,0,0,0,0,0,0,0,Human Factor
1964-08-05 00:00:00,Argentinian Air Force - Fuerza Aérea Argentina,Takeoff (climb),Operational,Argentina,South America,0,0,0,0,0,0,0,Weather
1964-08-09 00:00:00,L. C. Cassidy %26 Son,Takeoff (climb),Business,United States of America,North America,4,1,0,3,0,0,4,Technical Failure
1964-08-14 00:00:00,United States Army,Flight,Operational,Puerto Rico,Central America,0,0,0,0,0,0,0,Unknown
1964-08-15 00:00:00,Rusk Aviation,Takeoff (climb),Specialised Services,United States of America,North America,1,1,0,0,0,0,1,Human Factor
1964-08-18 00:00:00,Wideroe - Wideroe's Flyveselskap,,Commercial,Norway,Europe,7,1,0,6,0,0,7,Unknown
1964-08-19 00:00:00,Hawthorne Nevada Airlines,Landing (descent or approach),Commercial,United States of America,North America,35,3,0,32,0,0,35,Human Factor
1964-08-21 00:00:00,Japan Air Self-Defense Force - Kōkū Jieitai,Landing (descent or approach),Operational,Japan,Asia,5,5,0,0,0,0,5,Unknown
1964-08-23 00:00:00,United States Navy - USN,Flight,Other,Puerto Rico,Central America,23,4,0,19,0,0,23,Weather
1964-08-25 00:00:00,Portuguese Air Force - Força Aerea Portuguesa,Landing (descent or approach),Military / Government,Mozambique,Africa,0,0,0,0,0,0,0,Unknown
1964-09-03 00:00:00,Federal Aviation Administration - FAA,Takeoff (climb),Specialised Services,United States of America,North America,0,0,0,0,0,0,0,Unknown
1964-09-11 00:00:00,Royal Air Force - RAF,Landing (descent or approach),Military / Government,Malaysia,Asia,4,4,0,0,0,0,4,Other
1964-09-13 00:00:00,Balair - Switzerland,Landing (descent or approach),Commercial,Spain,Europe,0,0,0,0,0,0,0,Human Factor
1964-09-16 00:00:00,Royal Air Force - RAF,Landing (descent or approach),Operational,Yemen,Asia,3,3,0,0,0,0,3,Weather
1964-09-16 00:00:00,Airexec Services,,Commercial,Canada,North America,0,0,0,0,0,0,0,Unknown
1964-09-20 00:00:00,Bird %26 Sons,Landing (descent or approach),Operational,Vietnam,Asia,0,0,0,0,0,0,0,Weather
1964-09-28 00:00:00,Caledonian Airways,Landing (descent or approach),Commercial,Turkey,Asia,97,8,0,89,0,0,97,Human Factor
1964-10-02 00:00:00,Syrianair - Syrian Arab Airlines,Landing (descent or approach),Commercial,Syria,Asia,0,0,0,0,0,0,0,Unknown
1964-10-13 00:00:00,Aeroflot - Russian International Airlines,Flight,Military / Government,Russia,Asia,6,4,0,2,0,0,6,Human Factor
1964-10-13 00:00:00,Air Lloyd,,Commercial,Germany,Europe,0,0,0,0,0,0,0,Unknown
1964-10-14 00:00:00,United States Air Force - USAF,Flight,Military / Government,Thailand,Asia,6,6,0,0,0,0,6,Technical Failure
1964-10-22 00:00:00,United States Navy - USN,Flight,Military / Government,Antarctica,Antarctica,0,0,0,0,0,0,0,Human Factor
1964-10-30 00:00:00,Compania Boliviana de Rutas Aéreas,,Operational,Bolivia,South America,0,0,0,0,0,0,0,Unknown
1964-10-30 00:00:00,Argentinian Air Force - Fuerza Aérea Argentina,Takeoff (climb),Military / Government,Argentina,South America,0,0,0,0,0,0,0,Technical Failure
1964-11-03 00:00:00,United States Navy - USN,Landing (descent or approach),Military / Government,United States of America,North America,0,0,0,0,0,0,0,Unknown
1964-11-04 00:00:00,Private New Zealand,Flight,Military / Government,New Zealand,Oceania,1,1,0,0,0,0,1,Unknown
1964-11-09 00:00:00,Aerocondor de Colombia - Aerovias Condor,Takeoff (climb),Operational,Colombia,South America,2,2,0,0,0,0,2,Unknown
1964-11-18 00:00:00,Royal Australian Air Force - RAAF,Landing (descent or approach),Military / Government,Vietnam,Asia,0,0,0,0,0,0,0,Unknown
1964-11-20 00:00:00,Zantop Air Transport,Takeoff (climb),Operational,United States of America,North America,2,2,0,0,0,0,2,Human Factor
1964-11-21 00:00:00,Eastern Provincial Airways - EPA,Landing (descent or approach),Commercial,Canada,North America,4,2,0,2,0,0,4,Human Factor
1964-11-24 00:00:00,Delta Airlines,Landing (descent or approach),Operational,United States of America,North America,2,2,0,0,0,0,2,Human Factor
1964-11-24 00:00:00,Aerolineas Flecha Austral - AFA,Landing (descent or approach),Commercial,Chile,South America,0,0,0,0,0,0,0,Unknown
1964-11-30 00:00:00,Japan Air Self-Defense Force - Kōkū Jieitai,Landing (descent or approach),Operational,Japan,Asia,4,4,0,0,0,0,4,Unknown
1964-12-16 00:00:00,Bolivian Air System,Landing (descent or approach),Operational,Bolivia,South America,3,3,0,0,0,0,3,Unknown
1964-12-29 00:00:00,Indian Air Force - Bharatiya Vayu Sena,Landing (descent or approach),Military / Government,India,Asia,0,0,0,0,0,0,0,Unknown
1964-12-30 00:00:00,Private American,Landing (descent or approach),Specialised Services,United States of America,North America,1,1,0,0,0,0,1,Technical Failure
1964-12-31 00:00:00,Dornier Flugzeugwerke,Flight,Specialised Services,Germany,Europe,0,0,0,0,0,0,0,Unknown
1964-12-31 00:00:00,East German Air Force - Luftstreitkräfte der Nationalen Volksarmee,Flight,Operational,Egypt,Africa,0,0,0,0,0,0,0,Unknown
1964-12-31 00:00:00,Private Mexican,Landing (descent or approach),Business,Mexico,Central America,0,0,0,0,0,0,0,Unknown
1965-01-11 00:00:00,Corn Belt Hatcheries of Arkansas,Flight,Business,United States of America,North America,1,1,0,0,0,0,1,Technical Failure
1965-01-11 00:00:00,United States Navy - USN,Landing (descent or approach),Military / Government,Antarctica,Antarctica,6,6,0,0,0,0,6,Other
1965-01-15 00:00:00,VASP - Viação Aérea de São Paulo,,Commercial,Brazil,South America,0,0,0,0,0,0,0,Unknown
1965-01-16 00:00:00,Interior Airways,Flight,Operational,United States of America,North America,3,3,0,0,0,0,3,Human Factor
1965-01-20 00:00:00,Shackleton Aviation,Flight,Operational,United Kingdom,Europe,1,1,0,0,0,0,1,Technical Failure
1965-01-21 00:00:00,Filipinas Orient Airways,Landing (descent or approach),Commercial,Philippines,Asia,0,0,0,0,0,0,0,Technical Failure
1965-01-22 00:00:00,Panair do Brasil,,Commercial,Brazil,South America,0,0,0,0,0,0,0,Unknown
1965-02-03 00:00:00,Robertson Air Service,Flight,Military / Government,New Zealand,Oceania,1,1,0,0,0,0,1,Unknown
1965-02-07 00:00:00,Lloyd Aéreo Boliviano - LAB Airlines,Landing (descent or approach),Operational,Bolivia,South America,0,0,0,0,0,0,0,Unknown
1965-02-08 00:00:00,Scandinavian Airlines System - SAS,Takeoff (climb),Commercial,Spain,Europe,91,7,0,84,0,0,91,Human Factor
1965-02-08 00:00:00,Air Nautic,Takeoff (climb),Commercial,France,Europe,10,3,0,7,0,0,10,Technical Failure
1965-02-10 00:00:00,French Air Force - Armée de l'Air,Flight,Military / Government,France,Europe,0,0,0,0,0,0,0,Unknown
1965-02-15 00:00:00,Iran Air,Landing (descent or approach),Commercial,Iran,Asia,0,0,0,0,0,0,0,Unknown
1965-02-15 00:00:00,Finnish Air Force - Suomen Ilmavoimat,Landing (descent or approach),Military / Government,Finland,Europe,2,2,0,0,0,0,2,Unknown
1965-02-18 00:00:00,Bird %26 Sons,Landing (descent or approach),Commercial,Laos,Asia,7,1,0,6,0,0,7,Technical Failure
1965-02-21 00:00:00,Compania Boliviana de Rutas Aéreas,,Operational,Bolivia,South America,0,0,0,0,0,0,0,Unknown
1965-02-25 00:00:00,Private New Zealand,Flight,Military / Government,New Zealand,Oceania,1,1,0,0,0,0,1,Unknown
1965-02-27 00:00:00,Japan Airlines,Takeoff (climb),Operational,Japan,Asia,6,6,0,0,0,0,6,Human Factor
1965-03-03 00:00:00,VASP - Viação Aérea de São Paulo,Landing (descent or approach),Operational,Brazil,South America,4,4,0,0,0,0,4,Unknown
1965-03-04 00:00:00,Royal Air Force - RAF,Landing (descent or approach),Operational,United Kingdom,Europe,3,3,0,0,0,0,3,Technical Failure
1965-03-06 00:00:00,Royal Australian Air Force - RAAF,Landing (descent or approach),Military / Government,Papua New Guinea,Oceania,0,0,0,0,0,0,0,Unknown
1965-03-11 00:00:00,Avianca,Takeoff (climb),Commercial,Colombia,South America,34,3,0,31,0,0,34,Unknown
1965-03-16 00:00:00,Canadian Government,Takeoff (climb),Military / Government,Canada,North America,9,3,0,6,0,0,9,Human Factor
1965-03-17 00:00:00,ANSETT-ANA,Landing (descent or approach),Commercial,Australia,Oceania,23,4,0,19,0,0,23,Technical Failure
1965-03-19 00:00:00,Iraqi Airways,Landing (descent or approach),Commercial,Egypt,Africa,0,0,0,0,0,0,0,Technical Failure
1965-03-24 00:00:00,Paraense Transportes Aéreos,Landing (descent or approach),Commercial,Brazil,South America,0,0,0,0,0,0,0,Unknown
1965-03-26 00:00:00,Aden Airways,Landing (descent or approach),Commercial,Yemen,Asia,17,3,0,14,0,0,17,Human Factor
1965-03-27 00:00:00,Tasman Empire Airways,Landing (descent or approach),Operational,New Zealand,Oceania,6,4,0,2,0,0,6,Human Factor
1965-04-02 00:00:00,Airlines of New South Wales,Takeoff (climb),Commercial,Australia,Oceania,23,3,0,20,0,0,23,Technical Failure
1965-04-03 00:00:00,Eastern Provincial Airways - EPA,Landing (descent or approach),Commercial,Saint Pierre and Miquelon,North America,0,0,0,0,0,0,0,Unknown
1965-04-06 00:00:00,Private American,Flight,Business,Bahamas,Central America,7,3,0,4,0,0,7,Technical Failure
1965-04-09 00:00:00,Jim Hill Aircraft,Flight,Operational,United States of America,North America,1,1,0,0,0,0,1,Technical Failure
1965-04-09 00:00:00,Chilean Air Force - Fuerza Aérea de Chile,Takeoff (climb),Operational,Peru,South America,4,4,0,0,0,0,4,Unknown
1965-04-16 00:00:00,Bonanza Airlines,Takeoff (climb),Operational,United States of America,North America,2,2,0,0,0,0,2,Human Factor
1965-04-26 00:00:00,Aircruise,Flight,Commercial,United Kingdom,Europe,0,0,0,0,0,0,0,Technical Failure
1965-05-01 00:00:00,Sunline Helicopters,Landing (descent or approach),Business,United States of America,North America,7,1,0,6,0,0,7,Technical Failure
1965-05-10 00:00:00,Aaxico Airlines - American Air Export %26 Import Company,Landing (descent or approach),Operational,United States of America,North America,3,3,0,0,0,0,3,Human Factor
1965-05-12 00:00:00,United States Air Force - USAF,Flight,Military / Government,Vietnam,Asia,5,5,0,0,0,0,5,Human Factor
1965-05-16 00:00:00,United States Air Force - USAF,Takeoff (climb),Military / Government,Vietnam,Asia,0,0,0,0,0,0,0,Unknown
1965-05-19 00:00:00,Hansen Air Activities,Takeoff (climb),Operational,United States of America,North America,1,1,0,0,0,0,1,Human Factor
1965-05-19 00:00:00,Linea Expressa Bolivar Compania Aérea - LEBCA,Flight,Commercial,Venezuela,South America,0,0,0,0,0,0,0,Unknown
1965-05-29 00:00:00,Reeve Aleutian Airways - RAA,Takeoff (climb),Commercial,United States of America,North America,5,3,0,2,0,0,5,Weather
1965-05-29 00:00:00,Japan Domestic Airlines,Landing (descent or approach),Commercial,Japan,Asia,0,0,0,0,0,0,0,Technical Failure
1965-06-05 00:00:00,Private New Zealand,Flight,Military / Government,New Zealand,Oceania,1,1,0,0,0,0,1,Unknown
1965-06-06 00:00:00,Filipinas Orient Airways,Takeoff (climb),Commercial,Philippines,Asia,0,0,0,0,0,0,0,Technical Failure
1965-06-11 00:00:00,Air Algérie,,Commercial,Algeria,Africa,0,0,0,0,0,0,0,Unknown
1965-06-13 00:00:00,Cardinal Airways,Takeoff (climb),Operational,United States of America,North America,2,1,0,1,0,0,2,Human Factor
1965-06-14 00:00:00,German Air Force - Deutsche Luftwaffe,Takeoff (climb),Military / Government,Germany,Europe,4,4,0,0,0,0,4,Technical Failure
1965-06-14 00:00:00,Arruda Indústria e Comércio,Takeoff (climb),Operational,Brazil,South America,2,2,0,0,0,0,2,Unknown
1965-06-15 00:00:00,Southern Scenic Air-Services,Flight,Specialised Services,New Zealand,Oceania,5,1,0,4,0,0,5,Human Factor
1965-06-18 00:00:00,United States Air Force - USAF,Flight,Military / Government,World,World,5,5,0,0,0,0,5,Unknown
1965-06-22 00:00:00,Spanish Air Force - Ejército del Aire,Flight,Operational,Spain,Europe,4,4,0,0,0,0,4,Technical Failure
1965-06-23 00:00:00,SLM Surinam Airways - Surinaamse Luchtvaart Maatschappij,Landing (descent or approach),Commercial,Suriname,South America,0,0,0,0,0,0,0,Unknown
1965-07-01 00:00:00,Continental Airlines,Landing (descent or approach),Commercial,United States of America,North America,66,6,0,60,0,0,66,Weather
1965-07-03 00:00:00,United States Air Force - USAF,Flight,Military / Government,World,World,0,0,0,0,0,0,0,Unknown
1965-07-04 00:00:00,British European Airways - BEA,Landing (descent or approach),Operational,Italy,Europe,2,2,0,0,0,0,2,Human Factor
1965-07-06 00:00:00,Compagnie Sénégalaise de Transports Aériens - COSETRA,Landing (descent or approach),Commercial,Mauritania,Africa,0,0,0,0,0,0,0,Unknown
1965-07-09 00:00:00,Aeronaves de Mexico,Landing (descent or approach),Commercial,Mexico,Central America,82,9,0,73,0,0,82,Technical Failure
1965-07-10 00:00:00,Monroe County Mosquito Control District,Takeoff (climb),Military / Government,United States of America,North America,1,1,0,0,0,0,1,Human Factor
1965-07-11 00:00:00,Skyways Coach-Air,Landing (descent or approach),Commercial,United Kingdom,Europe,52,4,0,48,0,0,52,Human Factor
1965-07-18 00:00:00,Private American,Takeoff (climb),Business,United States of America,North America,4,1,0,3,0,0,4,Technical Failure
1965-07-23 00:00:00,Allegheny Airlines,Takeoff (climb),Commercial,United States of America,North America,40,4,0,36,0,0,40,Technical Failure
1965-07-25 00:00:00,Private American,Landing (descent or approach),Business,Bahamas,Central America,1,1,0,0,0,0,1,Technical Failure
1965-07-27 00:00:00,Hartzog-Schneck Aviation,Landing (descent or approach),Operational,United States of America,North America,2,2,0,0,0,0,2,Human Factor
1965-07-29 00:00:00,Private American,Flight,Operational,Mexico,Central America,3,3,0,0,0,0,3,Technical Failure
1965-08-01 00:00:00,Argentinian Air Force - Fuerza Aérea Argentina,Flight,Operational,Argentina,South America,2,2,0,0,0,0,2,Technical Failure
1965-08-02 00:00:00,Invicta International Airways,Takeoff (climb),Operational,United Kingdom,Europe,3,3,0,0,0,0,3,Human Factor
1965-08-12 00:00:00,Connellan Airways,Landing (descent or approach),Commercial,Australia,Oceania,6,4,0,2,0,0,6,Technical Failure
1965-08-17 00:00:00,Private American,Takeoff (climb),Operational,United States of America,North America,1,1,0,0,0,0,1,Technical Failure
1965-08-18 00:00:00,Pakistan Air Force - Pakistan Fiza'ya,Landing (descent or approach),Military / Government,Pakistan,Asia,0,0,0,0,0,0,0,Unknown
1965-08-20 00:00:00,Cruzeiro do Sul,Landing (descent or approach),Commercial,Brazil,South America,0,0,0,0,0,0,0,Unknown
1965-08-20 00:00:00,United States Navy - USN,Landing (descent or approach),Operational,Japan,Asia,23,4,0,19,0,0,23,Technical Failure
1965-08-20 00:00:00,Aéroclub de Suisse,Landing (descent or approach),Commercial,Switzerland,Europe,8,1,0,7,0,0,8,Unknown
1965-08-26 00:00:00,Riverside Business Flight Service,Landing (descent or approach),Commercial,United States of America,North America,8,2,0,6,0,0,8,Technical Failure
1965-08-28 00:00:00,Transportes Aéreos Catarinense,Landing (descent or approach),Commercial,Brazil,South America,0,0,0,0,0,0,0,Human Factor
1965-08-30 00:00:00,United States Navy - USN,Landing (descent or approach),Military / Government,Vietnam,Asia,7,3,0,4,0,0,7,Technical Failure
1965-09-06 00:00:00,United States Air Force - USAF,Taxiing,Military / Government,Vietnam,Asia,0,0,0,0,0,0,0,Unknown
1965-09-13 00:00:00,Trans World Airlines - TWA,Takeoff (climb),Operational,United States of America,North America,4,4,0,0,0,0,4,Human Factor
1965-09-13 00:00:00,Zantop Air Transport,Takeoff (climb),Operational,United States of America,North America,3,3,0,0,0,0,3,Technical Failure
1965-09-20 00:00:00,American Flyers Airline,Landing (descent or approach),Operational,United States of America,North America,3,3,0,0,0,0,3,Weather
1965-09-25 00:00:00,Indian Air Force - Bharatiya Vayu Sena,Flight,Military / Government,India,Asia,0,0,0,0,0,0,0,Unknown
1965-10-01 00:00:00,Argentinian Air Force - Fuerza Aérea Argentina,Landing (descent or approach),Operational,Argentina,South America,4,4,0,0,0,0,4,Weather
1965-10-06 00:00:00,United States Navy - USN,Takeoff (climb),Operational,Antarctica,Antarctica,0,0,0,0,0,0,0,Technical Failure
1965-10-14 00:00:00,Zantop Air Transport,Flight,Operational,United States of America,North America,3,3,0,0,0,0,3,Human Factor
1965-10-16 00:00:00,Eastern Airlines,Landing (descent or approach),Commercial,United States of America,North America,62,5,0,57,0,0,62,Human Factor
1965-10-17 00:00:00,United Airlines,Takeoff (climb),Commercial,United States of America,North America,16,5,0,11,0,0,16,Technical Failure
1965-10-18 00:00:00,Private American,Flight,Business,United States of America,North America,4,1,0,3,0,0,4,Human Factor
1965-10-22 00:00:00,Scan Fly,Flight,Other,Denmark,Europe,0,0,0,0,0,0,0,Unknown
1965-10-23 00:00:00,Paraense Transportes Aéreos,Flight,Commercial,Brazil,South America,0,0,0,0,0,0,0,Unknown
1965-10-25 00:00:00,Private Australian,Flight,Operational,Australia,Oceania,2,2,0,0,0,0,2,Unknown
1965-10-28 00:00:00,Air National Guard,Landing (descent or approach),Military / Government,United States of America,North America,0,0,0,0,0,0,0,Technical Failure
1965-10-29 00:00:00,Webair,Landing (descent or approach),Operational,Brazil,South America,2,2,0,0,0,0,2,Human Factor
1965-10-29 00:00:00,Transportes Aéreos Acre,Flight,Commercial,Bolivia,South America,0,0,0,0,0,0,0,Unknown
1965-10-30 00:00:00,United States Air Force - USAF,Takeoff (climb),Military / Government,Vietnam,Asia,4,4,0,0,0,0,4,Unknown
1965-10-30 00:00:00,Private New Zealand,Flight,Military / Government,New Zealand,Oceania,1,1,0,0,0,0,1,Unknown
1965-11-04 00:00:00,Lloyd Aéreo Boliviano - LAB Airlines,,Operational,Bolivia,South America,0,0,0,0,0,0,0,Unknown
1965-11-07 00:00:00,Lewis M. Watson,Takeoff (climb),Business,United States of America,North America,4,1,0,3,0,0,4,Human Factor
1965-11-08 00:00:00,Royal Danish Air Force - Flyvevåbnet,Flight,Operational,Denmark,Europe,20,4,0,16,0,0,20,Technical Failure
1965-11-09 00:00:00,Federal Aviation Administration - FAA,Landing (descent or approach),Specialised Services,United States of America,North America,3,3,0,0,0,0,3,Technical Failure
1965-11-11 00:00:00,Private New Zealand,Flight,Military / Government,New Zealand,Oceania,1,1,0,0,0,0,1,Unknown
1965-11-12 00:00:00,Spanish Air Force - Ejército del Aire,,Military / Government,Spain,Europe,0,0,0,0,0,0,0,Unknown
1965-11-16 00:00:00,Aeroflot - Russian International Airlines,Landing (descent or approach),Commercial,Russia,Asia,0,0,0,0,0,0,0,Technical Failure
1965-11-18 00:00:00,Air America,Takeoff (climb),Commercial,Laos,Asia,61,5,0,56,0,0,61,Unknown
1965-11-21 00:00:00,United States Air Force - USAF,Landing (descent or approach),Military / Government,Vietnam,Asia,7,7,0,0,0,0,7,Technical Failure
1965-11-25 00:00:00,Private American,Flight,Business,Nigeria,Africa,1,1,0,0,0,0,1,Technical Failure
1965-11-29 00:00:00,United States Air Force - USAF,Flight,Military / Government,Vietnam,Asia,2,2,0,0,0,0,2,Terrorism
1965-12-05 00:00:00,British Army Air Corps,Takeoff (climb),Military / Government,Yemen,Asia,2,2,0,0,0,0,2,Weather
1965-12-05 00:00:00,United States Navy - USN,Landing (descent or approach),Military / Government,Antarctica,Antarctica,0,0,0,0,0,0,0,Technical Failure
1965-12-05 00:00:00,Argentinian Air Force - Fuerza Aérea Argentina,Takeoff (climb),Operational,Argentina,South America,6,6,0,0,0,0,6,Unknown
1965-12-08 00:00:00,United States Air Force - USAF,Takeoff (climb),Military / Government,Vietnam,Asia,5,5,0,0,0,0,5,Human Factor
1965-12-14 00:00:00,Papuan Air Transport - Patair,Takeoff (climb),Operational,Papua New Guinea,Oceania,2,1,0,1,0,0,2,Unknown
1965-12-17 00:00:00,Skyways Coach-Air,Landing (descent or approach),Commercial,France,Europe,32,3,0,29,0,0,32,Technical Failure
1965-12-19 00:00:00,Jack Richards Aircraft Sales,Takeoff (climb),Business,Mexico,Central America,1,1,0,0,0,0,1,Technical Failure
1965-12-19 00:00:00,VASP - Viação Aérea de São Paulo,Landing (descent or approach),Commercial,Brazil,South America,54,5,0,49,0,0,54,Technical Failure
1965-12-23 00:00:00,Aeroflot - Russian International Airlines,Flight,Commercial,Russia,Asia,0,0,0,0,0,0,0,Technical Failure
1965-12-27 00:00:00,Private American,Flight,Business,United States of America,North America,4,1,0,3,0,0,4,Weather
1965-12-31 00:00:00,United States Army,Flight,Military / Government,Vietnam,Asia,0,0,0,0,0,0,0,Technical Failure
1965-12-31 00:00:00,United States Air Force - USAF,Flight,Operational,Puerto Rico,Central America,0,0,0,0,0,0,0,Unknown
1965-12-31 00:00:00,Merpati Nusantara Airlines - MNA,Flight,Commercial,Indonesia,Asia,0,0,0,0,0,0,0,Unknown
1966-01-04 00:00:00,United States Air Force - USAF,Landing (descent or approach),Military / Government,Vietnam,Asia,5,5,0,0,0,0,5,Technical Failure
1966-01-05 00:00:00,Royal Flying Doctor Service - RFDS,Takeoff (climb),Humanitarian,Australia,Oceania,3,1,0,2,0,0,3,Weather
1966-01-06 00:00:00,Polish Air Force - Polska Wojska Lotnicze i Obrony Powietrznej,,Military / Government,Poland,Europe,0,0,0,0,0,0,0,Unknown
1966-01-09 00:00:00,United States Air Force - USAF,Landing (descent or approach),Military / Government,Vietnam,Asia,5,5,0,0,0,0,5,Unknown
1966-01-09 00:00:00,United States Air Force - USAF,Landing (descent or approach),Military / Government,Vietnam,Asia,2,2,0,0,0,0,2,Terrorism
1966-01-09 00:00:00,Republic of China Air Force,Flight,Military / Government,World,World,0,0,0,0,0,0,0,Terrorism
1966-01-14 00:00:00,Air America,Landing (descent or approach),Commercial,Vietnam,Asia,3,2,0,1,0,0,3,Terrorism
1966-01-25 00:00:00,Private New Zealand,Flight,Military / Government,New Zealand,Oceania,1,1,0,0,0,0,1,Unknown
1966-01-26 00:00:00,Trans World Airlines - TWA,Taxiing,Operational,United States of America,North America,3,3,0,0,0,0,3,Technical Failure
1966-01-27 00:00:00,Aerovias Halcón,Landing (descent or approach),Operational,Argentina,South America,4,4,0,0,0,0,4,Human Factor
1966-02-08 00:00:00,Fieldair,Takeoff (climb),Military / Government,New Zealand,Oceania,1,1,0,0,0,0,1,Technical Failure
1966-02-15 00:00:00,Chinese Air Force - AFPLA - Chung-Kuo Shan Min Taie Fang Tsun Pu-Tai,Flight,Operational,China,Asia,2,2,0,0,0,0,2,Unknown
1966-02-21 00:00:00,Aeroflot - Russian International Airlines,Landing (descent or approach),Commercial,Russia,Asia,2,2,0,0,0,0,2,Human Factor
1966-02-22 00:00:00,Aerocarga Especializada,Landing (descent or approach),Operational,Mexico,Central America,0,0,0,0,0,0,0,Unknown
1966-02-24 00:00:00,Kiewit Construction Company,Takeoff (climb),Business,United States of America,North America,6,2,0,4,0,0,6,Human Factor
1966-03-01 00:00:00,AREA Ecuador - Aerovias Ecuatorianas,Taxiing,Operational,United States of America,North America,4,4,0,0,0,0,4,Unknown
1966-03-04 00:00:00,South American Placers of Bolivia,,Operational,Bolivia,South America,0,0,0,0,0,0,0,Unknown
1966-03-06 00:00:00,Lineas Aéreas Patagonicas Argentinas - LAPA,Landing (descent or approach),Operational,Peru,South America,5,5,0,0,0,0,5,Technical Failure
1966-03-06 00:00:00,Transair Sweden,Landing (descent or approach),Humanitarian,Democratic Republic of Congo,Africa,3,3,0,0,0,0,3,Human Factor
1966-03-08 00:00:00,Merpati Nusantara Airlines - MNA,Flight,Commercial,Indonesia,Asia,0,0,0,0,0,0,0,Unknown
1966-03-09 00:00:00,Royal Canadian Air Force - RCAF,Flight,Military / Government,Canada,North America,0,0,0,0,0,0,0,Unknown
1966-03-19 00:00:00,Mutual Benefit Health and Accident Association,Landing (descent or approach),Operational,United States of America,North America,2,2,0,0,0,0,2,Human Factor
1966-03-19 00:00:00,Soviet Air Force - Voyenno-vozdushnye sily CCCP,Takeoff (climb),Military / Government,Russia,Asia,6,6,0,0,0,0,6,Human Factor
1966-03-21 00:00:00,Flying Tiger Line,Landing (descent or approach),Operational,United States of America,North America,6,6,0,0,0,0,6,Human Factor
1966-03-26 00:00:00,Royal Thai Air Force - Kong Thap Akat Thai,Flight,Military / Government,Laos,Asia,7,7,0,0,0,0,7,Terrorism
1966-03-26 00:00:00,United States Air Force - USAF,Landing (descent or approach),Military / Government,Vietnam,Asia,6,6,0,0,0,0,6,Technical Failure
1966-04-01 00:00:00,C. D. Stoltzfus %26 Associates,Landing (descent or approach),Operational,United States of America,North America,2,2,0,0,0,0,2,Technical Failure
1966-04-05 00:00:00,Private German,Takeoff (climb),Business,Germany,Europe,0,0,0,0,0,0,0,Unknown
1966-04-14 00:00:00,Dan-Air London,Landing (descent or approach),Commercial,France,Europe,59,4,0,55,0,0,59,Human Factor
1966-04-15 00:00:00,Royal Canadian Air Force - RCAF,Flight,Military / Government,Canada,North America,0,0,0,0,0,0,0,Technical Failure
1966-04-16 00:00:00,JAT Yugoslav Airlines - Jugoslovenski Aerotransport,Takeoff (climb),Commercial,Macedonia,Europe,0,0,0,0,0,0,0,Unknown
1966-04-17 00:00:00,United States Air Force - USAF,Takeoff (climb),Specialised Services,United States of America,North America,3,3,0,0,0,0,3,Unknown
1966-04-20 00:00:00,VARIG - Viação Aérea Rio Grandense,,Commercial,Brazil,South America,0,0,0,0,0,0,0,Unknown
1966-04-21 00:00:00,Private New Zealand,Flight,Military / Government,New Zealand,Oceania,1,1,0,0,0,0,1,Unknown
1966-04-25 00:00:00,Indian Airlines,Landing (descent or approach),Operational,India,Asia,3,3,0,0,0,0,3,Weather
1966-04-28 00:00:00,Air America,Takeoff (climb),Operational,Vietnam,Asia,0,0,0,0,0,0,0,Technical Failure
1966-05-04 00:00:00,Royal Air Force - RAF,Landing (descent or approach),Military / Government,Libya,Africa,0,0,0,0,0,0,0,Technical Failure
1966-05-12 00:00:00,Portuguese Air Force - Força Aerea Portuguesa,Flight,Military / Government,Mozambique,Africa,0,0,0,0,0,0,0,Unknown
1966-05-18 00:00:00,TRB Flying Services,Landing (descent or approach),Operational,United States of America,North America,1,1,0,0,0,0,1,Technical Failure
1966-05-18 00:00:00,United Airlines,Landing (descent or approach),Operational,United States of America,North America,4,4,0,0,0,0,4,Technical Failure
1966-05-18 00:00:00,United States Navy - USN,Landing (descent or approach),Military / Government,United States of America,North America,7,7,0,0,0,0,7,Technical Failure
1966-05-25 00:00:00,Canadian Voyageur Airlines,Takeoff (climb),Commercial,Canada,North America,6,1,0,5,0,0,6,Technical Failure
1966-06-06 00:00:00,Pacific Northern Airlines - PNA,Landing (descent or approach),Operational,United States of America,North America,4,4,0,0,0,0,4,Unknown
1966-06-13 00:00:00,Aeroflot - Russian International Airlines,Landing (descent or approach),Commercial,Belarus,Europe,0,0,0,0,0,0,0,Unknown
1966-06-20 00:00:00,United States Air Force - USAF,Flight,Military / Government,Vietnam,Asia,3,3,0,0,0,0,3,Terrorism
1966-06-23 00:00:00,VARIG - Viação Aérea Rio Grandense,,Commercial,Brazil,South America,0,0,0,0,0,0,0,Unknown
1966-06-30 00:00:00,Kuwait Airways,Landing (descent or approach),Commercial,Kuwait,Asia,83,11,0,72,0,0,83,Human Factor
1966-06-30 00:00:00,TAN Airlines - Transportes Aéreos Nacionales de Honduras,Landing (descent or approach),Operational,Honduras,Central America,3,3,0,0,0,0,3,Weather
1966-06-30 00:00:00,United States Air Force - USAF,Flight,Military / Government,Vietnam,Asia,4,4,0,0,0,0,4,Unknown
1966-07-09 00:00:00,Piedmont Airlines,Parking,Commercial,United States of America,North America,42,4,0,38,0,0,42,Human Factor
1966-07-10 00:00:00,Cubana de Aviación,Flight,Commercial,Cuba,Central America,93,6,0,87,0,0,93,Technical Failure
1966-07-15 00:00:00,Real Aerovias,Landing (descent or approach),Commercial,Brazil,South America,20,4,0,16,0,0,20,Technical Failure
1966-07-16 00:00:00,Air National Guard,Takeoff (climb),Operational,United States of America,North America,34,4,0,30,0,0,34,Technical Failure
1966-07-27 00:00:00,Frontier Airlines,Takeoff (climb),Commercial,United States of America,North America,16,3,0,13,0,0,16,Human Factor
1966-07-27 00:00:00,Aeroflot - Russian International Airlines,Flight,Military / Government,Russia,Asia,4,4,0,0,0,0,4,Technical Failure
1966-07-28 00:00:00,Zantop Air Transport,Takeoff (climb),Operational,United States of America,North America,2,2,0,0,0,0,2,Human Factor
1966-07-31 00:00:00,ABC Service,Landing (descent or approach),Business,United States of America,North America,5,1,0,4,0,0,5,Human Factor
1966-08-04 00:00:00,Cardinal Airways,Landing (descent or approach),Commercial,United States of America,North America,9,1,0,8,0,0,9,Technical Failure
1966-08-14 00:00:00,Private American,Flight,Operational,United States of America,North America,3,2,0,1,0,0,3,Human Factor
1966-08-15 00:00:00,Federal Aviation Administration - FAA,Landing (descent or approach),Specialised Services,Japan,Asia,5,5,0,0,0,0,5,Human Factor
1966-08-17 00:00:00,Lauderdale Leasing Company,Landing (descent or approach),Business,Mexico,Central America,2,2,0,0,0,0,2,Technical Failure
1966-08-17 00:00:00,Gulf Aviation - Oman,Takeoff (climb),Commercial,Oman,Asia,20,2,0,18,0,0,20,Human Factor
1966-08-23 00:00:00,Angeles Flying Service,Flight,Commercial,United States of America,North America,11,1,0,10,0,0,11,Technical Failure
1966-08-25 00:00:00,Portuguese Air Force - Força Aerea Portuguesa,Flight,Military / Government,Mozambique,Africa,0,0,0,0,0,0,0,Unknown
1966-08-27 00:00:00,Aeroflot - Russian International Airlines,Takeoff (climb),Commercial,Russia,Asia,121,7,0,114,0,0,121,Human Factor
1966-08-27 00:00:00,Rolled Steel Corp.,Landing (descent or approach),Operational,United States of America,North America,2,2,0,0,0,0,2,Other
1966-08-29 00:00:00,Cubana de Aviación,Flight,Operational,Cuba,Central America,6,6,0,0,0,0,6,Unknown
1966-09-02 00:00:00,United States Forest Service - USFS,Takeoff (climb),Military / Government,United States of America,North America,6,1,0,5,0,0,6,Human Factor
1966-09-07 00:00:00,United States Air Force - USAF,Parking,Military / Government,United States of America,North America,0,0,0,0,0,0,0,Human Factor
1966-09-12 00:00:00,Airlift International,Takeoff (climb),Operational,Japan,Asia,4,4,0,0,0,0,4,Human Factor
1966-09-15 00:00:00,Private Bolivian,Flight,Business,Bolivia,South America,0,0,0,0,0,0,0,Unknown
1966-09-17 00:00:00,Thunderbird Airways,Takeoff (climb),Specialised Services,United States of America,North America,4,4,0,0,0,0,4,Human Factor
1966-09-19 00:00:00,Major %26 White,Flight,Business,Liberia,Africa,0,0,0,0,0,0,0,Unknown
1966-09-26 00:00:00,Pay %26 Williamson,Takeoff (climb),Military / Government,Australia,Oceania,1,1,0,0,0,0,1,Unknown
1966-09-30 00:00:00,United Arab Airlines,Landing (descent or approach),Commercial,Egypt,Africa,43,6,0,37,0,0,43,Other
1966-10-11 00:00:00,Hank Wharton,Flight,Operational,Cameroon,Africa,4,4,0,0,0,0,4,Technical Failure
1966-10-14 00:00:00,Private American,Takeoff (climb),Business,Canada,North America,3,1,0,2,0,0,3,Human Factor
1966-10-25 00:00:00,United States Air Force - USAF,Landing (descent or approach),Military / Government,Vietnam,Asia,0,0,0,0,0,0,0,Unknown
1966-10-26 00:00:00,Brazilian Air Force - Força Aérea Brasileira,Landing (descent or approach),Operational,Brazil,South America,7,7,0,0,0,0,7,Human Factor
1966-10-26 00:00:00,Malaysia-Singapore Airlines - MSA,Landing (descent or approach),Commercial,Malaysia,Asia,0,0,0,0,0,0,0,Unknown
1966-10-29 00:00:00,Private American,Landing (descent or approach),Business,United States of America,North America,5,1,0,4,0,0,5,Human Factor
1966-10-31 00:00:00,VASP - Viação Aérea de São Paulo,Landing (descent or approach),Operational,Brazil,South America,3,3,0,0,0,0,3,Unknown
1966-10-31 00:00:00,United States Air Force - USAF,Flight,Military / Government,Vietnam,Asia,3,3,0,0,0,0,3,Terrorism
1966-11-04 00:00:00,Aerocarga - Colombia,Takeoff (climb),Operational,Colombia,South America,2,2,0,0,0,0,2,Technical Failure
1966-11-09 00:00:00,Fiji Airways,Landing (descent or approach),Commercial,Fiji Islands,Oceania,0,0,0,0,0,0,0,Unknown
1966-11-11 00:00:00,United States Air Force - USAF,Flight,Military / Government,Vietnam,Asia,4,4,0,0,0,0,4,Technical Failure
1966-11-16 00:00:00,United States Air Force - USAF,,Specialised Services,United States of America,North America,0,0,0,0,0,0,0,Unknown
1966-11-17 00:00:00,National Steel Corp.,Takeoff (climb),Business,United States of America,North America,8,2,0,6,0,0,8,Technical Failure
1966-11-17 00:00:00,Air America,Flight,Commercial,Vietnam,Asia,34,2,0,32,0,0,34,Terrorism
1966-11-19 00:00:00,Carolina Aircraft Corporation,Takeoff (climb),Operational,Iceland,Europe,2,2,0,0,0,0,2,Human Factor
1966-11-20 00:00:00,United States Army,Flight,Military / Government,Vietnam,Asia,0,0,0,0,0,0,0,Unknown
1966-11-24 00:00:00,Private American,Landing (descent or approach),Operational,British Virgin Islands,Central America,2,1,0,1,0,0,2,Unknown
1966-11-26 00:00:00,Johnson Flying Service,Flight,Operational,United States of America,North America,2,2,0,0,0,0,2,Technical Failure
1966-11-26 00:00:00,United States Air Force - USAF,Takeoff (climb),Military / Government,Vietnam,Asia,37,2,0,35,0,0,37,Terrorism
1966-11-29 00:00:00,Allegheny Airlines,Takeoff (climb),Commercial,United States of America,North America,16,4,0,12,0,0,16,Technical Failure
1966-11-30 00:00:00,Servicio Aéreo de Transportes Comerciales - SATCO,Takeoff (climb),Commercial,Peru,South America,0,0,0,0,0,0,0,Unknown
1966-12-06 00:00:00,Germa Inc.,Flight,Operational,Argentina,South America,3,3,0,0,0,0,3,Technical Failure
1966-12-07 00:00:00,Home Oil Company,,Business,Canada,North America,0,0,0,0,0,0,0,Unknown
1966-12-09 00:00:00,Merpati Nusantara Airlines - MNA,,Commercial,Indonesia,Asia,0,0,0,0,0,0,0,Unknown
1966-12-12 00:00:00,Wideroe - Wideroe's Flyveselskap,Landing (descent or approach),Commercial,Norway,Europe,1,1,0,0,0,0,1,Unknown
1966-12-19 00:00:00,Private American,Landing (descent or approach),Business,United States of America,North America,1,1,0,0,0,0,1,Human Factor
1966-12-21 00:00:00,British Army Air Corps,Takeoff (climb),Military / Government,United Kingdom,Europe,1,1,0,0,0,0,1,Human Factor
1966-12-24 00:00:00,Aeronaves de Mexico,Landing (descent or approach),Commercial,Mexico,Central America,109,8,0,101,0,0,109,Human Factor
1966-12-28 00:00:00,Colombian Air Force - Fuerza Aérea Colombiana,Flight,Operational,Colombia,South America,2,2,0,0,0,0,2,Unknown
1966-12-28 00:00:00,United States Air Force - USAF,Takeoff (climb),Military / Government,Thailand,Asia,2,2,0,0,0,0,2,Technical Failure
1966-12-30 00:00:00,Airlift International,Takeoff (climb),Operational,Vietnam,Asia,4,4,0,0,0,0,4,Technical Failure
1966-12-31 00:00:00,JAT Agricultural Aviation,,Military / Government,Serbia,Europe,0,0,0,0,0,0,0,Unknown
1967-01-04 00:00:00,United States Air Force - USAF,Flight,Military / Government,Vietnam,Asia,5,5,0,0,0,0,5,Unknown
1967-01-04 00:00:00,Air Vietnam,,Commercial,China,Asia,0,0,0,0,0,0,0,Unknown
1967-01-18 00:00:00,Private American,Landing (descent or approach),Business,United States of America,North America,2,1,0,1,0,0,2,Technical Failure
1967-01-19 00:00:00,United Airlines,Landing (descent or approach),Commercial,United States of America,North America,50,4,0,46,0,0,50,Human Factor
1967-01-21 00:00:00,Cameroon Air Transport,Landing (descent or approach),Commercial,Cameroon,Africa,2,2,0,0,0,0,2,Unknown
1967-01-21 00:00:00,Continental Air Services,Flight,Commercial,Laos,Asia,0,0,0,0,0,0,0,Unknown
1967-01-23 00:00:00,Caribair,Landing (descent or approach),Commercial,Puerto Rico,Central America,28,3,0,25,0,0,28,Human Factor
1967-01-24 00:00:00,Saturn Airways,Landing (descent or approach),Operational,United States of America,North America,4,4,0,0,0,0,4,Human Factor
1967-01-24 00:00:00,United Arab Airlines,Landing (descent or approach),Commercial,Yemen,Asia,0,0,0,0,0,0,0,Human Factor
1967-01-24 00:00:00,East Pakistan Flying Club,Flight,Business,Bangladesh,Asia,0,0,0,0,0,0,0,Unknown
1967-01-27 00:00:00,Royal Canadian Air Force - RCAF,Takeoff (climb),Military / Government,Canada,North America,0,0,0,0,0,0,0,Unknown
1967-01-30 00:00:00,Mexicana de Aviación,Landing (descent or approach),Commercial,Mexico,Central America,29,3,0,26,0,0,29,Human Factor
1967-01-30 00:00:00,Malaysia-Singapore Airlines - MSA,,Commercial,Malaysia,Asia,0,0,0,0,0,0,0,Unknown
1967-02-03 00:00:00,Aerolineas Flecha Austral - AFA,Flight,Operational,Chile,South America,4,4,0,0,0,0,4,Unknown
1967-02-08 00:00:00,Swiss Government,Landing (descent or approach),Military / Government,Nepal,Asia,0,0,0,0,0,0,0,Technical Failure
1967-02-09 00:00:00,United States Air Force - USAF,Takeoff (climb),Military / Government,Germany,Europe,4,4,0,0,0,0,4,Technical Failure
1967-02-13 00:00:00,Private Danish,,Business,Denmark,Europe,0,0,0,0,0,0,0,Unknown
1967-02-17 00:00:00,United States Air Force - USAF,Takeoff (climb),Military / Government,Vietnam,Asia,5,5,0,0,0,0,5,Technical Failure
1967-02-18 00:00:00,United States Air Force - USAF,Landing (descent or approach),Military / Government,Vietnam,Asia,7,7,0,0,0,0,7,Unknown
1967-02-19 00:00:00,United States Navy - USN,Landing (descent or approach),Military / Government,Puerto Rico,Central America,0,0,0,0,0,0,0,Unknown
1967-02-21 00:00:00,United States Air Force - USAF,Flight,Military / Government,Laos,Asia,2,2,0,0,0,0,2,Terrorism
1967-02-23 00:00:00,Flugfélag Íslands,Landing (descent or approach),Commercial,Greenland,Europe,0,0,0,0,0,0,0,Unknown
1967-02-24 00:00:00,Northeast Airlines - USA,Flight,Commercial,United States of America,North America,14,5,0,9,0,0,14,Human Factor
1967-02-26 00:00:00,Private Chilean,Landing (descent or approach),Business,Chile,South America,2,2,0,0,0,0,2,Unknown
1967-03-01 00:00:00,Sadia Transportes Aéreos,Flight,Specialised Services,Brazil,South America,3,3,0,0,0,0,3,Technical Failure
1967-03-04 00:00:00,Aerocondor de Colombia - Aerovias Condor,Takeoff (climb),Operational,Colombia,South America,2,2,0,0,0,0,2,Unknown
1967-03-05 00:00:00,Skyway Air Cargo,Flight,Operational,World,World,2,1,0,1,0,0,2,Technical Failure
1967-03-05 00:00:00,Malaysia-Singapore Airlines - MSA,Landing (descent or approach),Commercial,Malaysia,Asia,0,0,0,0,0,0,0,Unknown
1967-03-06 00:00:00,Aeralpi,Landing (descent or approach),Operational,Italy,Europe,3,3,0,0,0,0,3,Human Factor
1967-03-10 00:00:00,United States Air Force - USAF,Taxiing,Military / Government,Japan,Asia,0,0,0,0,0,0,0,Unknown
1967-03-12 00:00:00,Boun Oum Airways,Takeoff (climb),Commercial,Laos,Asia,1,1,0,0,0,0,1,Unknown
1967-03-12 00:00:00,United States Air Force - USAF,Takeoff (climb),Military / Government,Vietnam,Asia,5,5,0,0,0,0,5,Human Factor
1967-03-15 00:00:00,Nicaraguayan Air Force - Fuerza Aérea - Ejercito de Nicaragua,Flight,Operational,Nicaragua,Central America,2,2,0,0,0,0,2,Unknown
1967-03-19 00:00:00,Private American,Takeoff (climb),Operational,Puerto Rico,Central America,3,3,0,0,0,0,3,Technical Failure
1967-03-21 00:00:00,Private American,Takeoff (climb),Business,Netherlands,Central America,1,1,0,0,0,0,1,Human Factor
1967-03-23 00:00:00,United States Air Force - USAF,Takeoff (climb),Military / Government,Vietnam,Asia,7,7,0,0,0,0,7,Terrorism
1967-03-24 00:00:00,Amerine Turkey Breeding Farms,Flight,Operational,United States of America,North America,2,2,0,0,0,0,2,Technical Failure
1967-04-04 00:00:00,Bristow Helicopters,Landing (descent or approach),Operational,Nigeria,Africa,2,2,0,0,0,0,2,Human Factor
1967-04-07 00:00:00,Private American,Flight,Operational,Argentina,South America,3,3,0,0,0,0,3,Technical Failure
1967-04-08 00:00:00,Hunting Surveys,Flight,Military / Government,Saudi Arabia,Asia,4,4,0,0,0,0,4,Technical Failure
1967-04-09 00:00:00,Continental Air Services,Flight,Military / Government,Laos,Asia,3,3,0,0,0,0,3,Human Factor
1967-04-11 00:00:00,Aeroflot - Russian International Airlines,Landing (descent or approach),Commercial,Russia,Asia,5,5,0,0,0,0,5,Human Factor
1967-04-11 00:00:00,Air America,Landing (descent or approach),Operational,Thailand,Asia,1,1,0,0,0,0,1,Technical Failure
1967-04-13 00:00:00,Compania Boliviana de Rutas Aéreas,,Operational,Bolivia,South America,0,0,0,0,0,0,0,Unknown
1967-04-14 00:00:00,Brazilian Air Force - Força Aérea Brasileira,Flight,Military / Government,Brazil,South America,3,3,0,0,0,0,3,Unknown
1967-04-14 00:00:00,SLM Surinam Airways - Surinaamse Luchtvaart Maatschappij,Landing (descent or approach),Commercial,Suriname,South America,2,2,0,0,0,0,2,Unknown
1967-04-15 00:00:00,Southern Scenic Air-Services,Landing (descent or approach),Commercial,New Zealand,Oceania,3,1,0,2,0,0,3,Technical Failure
1967-04-15 00:00:00,United States Air Force - USAF,Landing (descent or approach),Military / Government,Vietnam,Asia,5,5,0,0,0,0,5,Technical Failure
1967-04-17 00:00:00,Alaska Airlines,Landing (descent or approach),Commercial,United States of America,North America,32,4,0,28,0,0,32,Human Factor
1967-04-20 00:00:00,British Eagle International Airlines - BEIA,Landing (descent or approach),Commercial,United Kingdom,Europe,65,11,0,54,0,0,65,Technical Failure
1967-04-23 00:00:00,Auckland Flying School,Takeoff (climb),Humanitarian,New Zealand,Oceania,8,1,0,7,0,0,8,Technical Failure
1967-04-28 00:00:00,Royal Air Force - RAF,Takeoff (climb),Military / Government,Malaysia,Asia,0,0,0,0,0,0,0,Technical Failure
1967-04-30 00:00:00,United States Air Force - USAF,Landing (descent or approach),Military / Government,Japan,Asia,9,9,0,0,0,0,9,Technical Failure
1967-04-30 00:00:00,United Nations Organization,Landing (descent or approach),Humanitarian,Nepal,Asia,0,0,0,0,0,0,0,Unknown
1967-05-02 00:00:00,Aero Taxis Orientales,Flight,Commercial,Bolivia,South America,0,0,0,0,0,0,0,Unknown
1967-05-03 00:00:00,Gold Bond Stamps Company,Takeoff (climb),Business,United States of America,North America,2,1,0,1,0,0,2,Weather
1967-05-03 00:00:00,Channel Airways,Takeoff (climb),Specialised Services,United Kingdom,Europe,3,3,0,0,0,0,3,Technical Failure
1967-05-05 00:00:00,Airstar,Landing (descent or approach),Business,Argentina,South America,2,2,0,0,0,0,2,Human Factor
1967-05-06 00:00:00,Private American,Landing (descent or approach),Business,United States of America,North America,2,2,0,0,0,0,2,Technical Failure
1967-05-07 00:00:00,Skydivers Flying Club,Landing (descent or approach),Humanitarian,United Kingdom,Europe,3,3,0,0,0,0,3,Unknown
1967-05-08 00:00:00,United States Coast Guard - USCG,Landing (descent or approach),Operational,Guam Island,Asia,4,4,0,0,0,0,4,Unknown
1967-05-17 00:00:00,Malaysia-Singapore Airlines - MSA,Takeoff (climb),Commercial,Malaysia,Asia,0,0,0,0,0,0,0,Unknown
1967-05-17 00:00:00,Royal Air Force - RAF,Takeoff (climb),Military / Government,United Kingdom,Europe,0,0,0,0,0,0,0,Human Factor
1967-05-23 00:00:00,Aerocondor de Colombia - Aerovias Condor,Takeoff (climb),Commercial,Colombia,South America,22,3,0,19,0,0,22,Technical Failure
1967-05-23 00:00:00,Air Manila International,Landing (descent or approach),Commercial,Philippines,Asia,0,0,0,0,0,0,0,Unknown
1967-05-26 00:00:00,Lineas Aéreas Paraguayas - LAPSA,Landing (descent or approach),Commercial,Argentina,South America,24,6,0,18,0,0,24,Human Factor
1967-06-02 00:00:00,United States Air Force - USAF,Flight,Military / Government,Turkey,Asia,6,6,0,0,0,0,6,Technical Failure
1967-06-02 00:00:00,United States Air Force - USAF,Flight,Military / Government,Turkey,Asia,6,6,0,0,0,0,6,Technical Failure
1967-06-03 00:00:00,Rutas Aéreas Uncia,,Commercial,Bolivia,South America,0,0,0,0,0,0,0,Unknown
1967-06-04 00:00:00,Aeroflot - Russian International Airlines,Landing (descent or approach),Specialised Services,Russia,Asia,6,6,0,0,0,0,6,Technical Failure
1967-06-06 00:00:00,Iraqi Air Force - Al Quwwat al Jawwiya al Iraqiya,,Military / Government,Jordan,Asia,0,0,0,0,0,0,0,Unknown
1967-06-07 00:00:00,Private American,Landing (descent or approach),Business,United States of America,North America,3,1,0,2,0,0,3,Human Factor
1967-06-09 00:00:00,Royal Air Force - RAF,Takeoff (climb),Operational,United Kingdom,Europe,0,0,0,0,0,0,0,Technical Failure
1967-06-11 00:00:00,Air America,Landing (descent or approach),Commercial,Vietnam,Asia,0,0,0,0,0,0,0,Terrorism
1967-06-13 00:00:00,Portuguese Air Force - Força Aerea Portuguesa,Flight,Military / Government,Mozambique,Africa,15,3,0,12,0,0,15,Technical Failure
1967-06-21 00:00:00,Royal Air Force - RAF,Taxiing,Military / Government,Yemen,Asia,0,0,0,0,0,0,0,Terrorism
1967-06-22 00:00:00,United States Air Force - USAF,Landing (descent or approach),Military / Government,United States of America,North America,5,5,0,0,0,0,5,Unknown
1967-06-29 00:00:00,SAESA - Servicios Aéreos Especiales,,Commercial,Mexico,Central America,0,0,0,0,0,0,0,Unknown
1967-06-29 00:00:00,Transporte Aéreo Militar de Uruguay - TAMU,Landing (descent or approach),Military / Government,Uruguay,South America,2,2,0,0,0,0,2,Weather
1967-06-30 00:00:00,Air Cameroon,,Commercial,Cameroon,Africa,0,0,0,0,0,0,0,Unknown
1967-07-01 00:00:00,Private American,Landing (descent or approach),Business,United States of America,North America,2,1,0,1,0,0,2,Human Factor
1967-07-05 00:00:00,Royal Air Force - RAF,Takeoff (climb),Operational,United Kingdom,Europe,0,0,0,0,0,0,0,Technical Failure
1967-07-05 00:00:00,Japan Air Self-Defense Force - Kōkū Jieitai,Flight,Military / Government,Japan,Asia,22,2,0,20,0,0,22,Unknown
1967-07-05 00:00:00,British Army Air Corps,Landing (descent or approach),Operational,United Kingdom,Europe,0,0,0,0,0,0,0,Human Factor
1967-07-09 00:00:00,Air Guinée,Landing (descent or approach),Commercial,Morocco,Africa,102,7,0,95,0,0,102,Human Factor
1967-07-14 00:00:00,United States Navy - USN,Landing (descent or approach),Military / Government,United States of America,North America,0,0,0,0,0,0,0,Technical Failure
1967-07-25 00:00:00,Mellon Bank,Landing (descent or approach),Business,United States of America,North America,8,2,0,6,0,0,8,Human Factor
1967-07-26 00:00:00,Private American,Takeoff (climb),Military / Government,United States of America,North America,1,1,0,0,0,0,1,Technical Failure
1967-07-28 00:00:00,Austrian Air Force - Österreichische Luftstreitkräfte,Takeoff (climb),Operational,Austria,Europe,6,2,0,4,0,0,6,Technical Failure
1967-07-31 00:00:00,Niger Air Force - Forces aériennes nigériennes,,Military / Government,Niger,Africa,0,0,0,0,0,0,0,Unknown
1967-08-03 00:00:00,French Air Force - Armée de l'Air,Flight,Military / Government,France,Europe,0,0,0,0,0,0,0,Unknown
1967-08-08 00:00:00,United States Navy - USN,Takeoff (climb),Military / Government,World,World,5,5,0,0,0,0,5,Technical Failure
1967-08-13 00:00:00,Continental Air Services,Takeoff (climb),Commercial,Laos,Asia,6,2,0,4,0,0,6,Terrorism
1967-08-17 00:00:00,Boliviana de Aviación,,Operational,Bolivia,South America,0,0,0,0,0,0,0,Unknown
1967-08-22 00:00:00,Polish Navy - Lotnictwa Marynarki Wojenna,Flight,Military / Government,Poland,Europe,0,0,0,0,0,0,0,Technical Failure
1967-08-27 00:00:00,Provincetown-Boston Airline - PBA,Flight,Commercial,United States of America,North America,14,1,0,13,0,0,14,Technical Failure
1967-08-29 00:00:00,Aeroflite,Takeoff (climb),Humanitarian,United States of America,North America,2,2,0,0,0,0,2,Technical Failure
1967-08-30 00:00:00,Royal Australian Air Force - RAAF,Landing (descent or approach),Military / Government,Vietnam,Asia,2,2,0,0,0,0,2,Unknown
1967-09-13 00:00:00,Capitol Airways,Takeoff (climb),Commercial,Jamaica,Central America,4,2,0,2,0,0,4,Technical Failure
1967-09-14 00:00:00,Autair International Airways,Landing (descent or approach),Commercial,United Kingdom,Europe,69,5,0,64,0,0,69,Other
1967-09-19 00:00:00,Royal Air Force - RAF,Landing (descent or approach),Military / Government,Oman,Asia,4,4,0,0,0,0,4,Other
1967-09-21 00:00:00,Aer Lingus,Landing (descent or approach),Commercial,United Kingdom,Europe,21,4,0,17,0,0,21,Human Factor
1967-09-23 00:00:00,Bird Corporation,Takeoff (climb),Operational,United States of America,North America,2,2,0,0,0,0,2,Technical Failure
1967-09-27 00:00:00,United States Navy - USN,Flight,Military / Government,Vietnam,Asia,4,4,0,0,0,0,4,Technical Failure
1967-09-29 00:00:00,Royal Air Force - RAF,Flight,Operational,Malaysia,Asia,2,2,0,0,0,0,2,Technical Failure
1967-10-01 00:00:00,Trans Commerce Leasing,Landing (descent or approach),Business,Canada,North America,7,3,0,4,0,0,7,Technical Failure
1967-10-05 00:00:00,Japan Airlines,Landing (descent or approach),Operational,Japan,Asia,4,4,0,0,0,0,4,Technical Failure
1967-10-09 00:00:00,Polish Air Force - Polska Wojska Lotnicze i Obrony Powietrznej,,Military / Government,Poland,Europe,0,0,0,0,0,0,0,Unknown
1967-10-12 00:00:00,Royal Air Force - RAF,Landing (descent or approach),Military / Government,Yemen,Asia,0,0,0,0,0,0,0,Technical Failure
1967-10-12 00:00:00,United States Air Force - USAF,Takeoff (climb),Military / Government,Vietnam,Asia,4,4,0,0,0,0,4,Other
1967-10-14 00:00:00,VARIG - Viação Aérea Rio Grandense,,Commercial,Brazil,South America,0,0,0,0,0,0,0,Unknown
1967-10-14 00:00:00,Aguinaldo Development,Flight,Business,Philippines,Asia,0,0,0,0,0,0,0,Unknown
1967-10-25 00:00:00,Executive Jet Sales,Landing (descent or approach),Business,United States of America,North America,4,2,0,2,0,0,4,Weather
1967-11-03 00:00:00,Cessna Aircraft Company,Landing (descent or approach),Operational,United States of America,North America,3,1,0,2,0,0,3,Human Factor
1967-11-10 00:00:00,Private Canadian,,Business,Canada,North America,3,1,0,2,0,0,3,Unknown
1967-11-15 00:00:00,Air Trans Africa,,Other,Nigeria,Africa,0,0,0,0,0,0,0,Unknown
1967-11-17 00:00:00,Interflug,Landing (descent or approach),Commercial,Germany,Europe,0,0,0,0,0,0,0,Technical Failure
1967-11-21 00:00:00,Transportes Aéreos Littoral - TAL,,Other,Bolivia,South America,0,0,0,0,0,0,0,Unknown
1967-11-22 00:00:00,Private American,Landing (descent or approach),Business,United States of America,North America,5,1,0,4,0,0,5,Human Factor
1967-11-22 00:00:00,Aerolineas Abaroa - ALAS,,Operational,Bolivia,South America,0,0,0,0,0,0,0,Unknown
1967-11-28 00:00:00,United Airlines,Landing (descent or approach),Commercial,United States of America,North America,43,4,0,39,0,0,43,Technical Failure
1967-12-02 00:00:00,Private American,Takeoff (climb),Business,United States of America,North America,1,1,0,0,0,0,1,Technical Failure
1967-12-03 00:00:00,United States Navy - USN,Landing (descent or approach),Military / Government,United States of America,North America,0,0,0,0,0,0,0,Unknown
1967-12-04 00:00:00,British European Airways - BEA,Takeoff (climb),Operational,United Kingdom,Europe,3,3,0,0,0,0,3,Human Factor
1967-12-04 00:00:00,Private German,,Business,Pakistan,Asia,0,0,0,0,0,0,0,Unknown
1967-12-07 00:00:00,French Air Force - Armée de l'Air,Flight,Operational,France,Europe,2,2,0,0,0,0,2,Unknown
1967-12-08 00:00:00,Brazilian Air Force - Força Aérea Brasileira,Landing (descent or approach),Military / Government,Brazil,South America,18,4,0,14,0,0,18,Technical Failure
1967-12-08 00:00:00,United States Air Force - USAF,Flight,Military / Government,Vietnam,Asia,5,5,0,0,0,0,5,Human Factor
1967-12-09 00:00:00,Private American,Takeoff (climb),Business,United States of America,North America,5,2,0,3,0,0,5,Technical Failure
1967-12-09 00:00:00,Jet International,Landing (descent or approach),Operational,United States of America,North America,2,2,0,0,0,0,2,Human Factor
1967-12-11 00:00:00,United Airlines,Landing (descent or approach),Commercial,United States of America,North America,18,3,0,15,0,0,18,Human Factor
1967-12-12 00:00:00,Reading Aviation Service,Landing (descent or approach),Business,United States of America,North America,1,1,0,0,0,0,1,Human Factor
1967-12-13 00:00:00,United States Air Force - USAF,Flight,Military / Government,Vietnam,Asia,2,2,0,0,0,0,2,Terrorism
1967-12-13 00:00:00,Royal Thai Air Force - Kong Thap Akat Thai,Takeoff (climb),Military / Government,Thailand,Asia,1,1,0,0,0,0,1,Human Factor
1967-12-17 00:00:00,Flytransport,Landing (descent or approach),Commercial,Norway,Europe,6,1,0,5,0,0,6,Unknown
1967-12-21 00:00:00,Korda Kentucky Leasing,,Business,United States of America,North America,0,0,0,0,0,0,0,Unknown
1967-12-23 00:00:00,Sterling Airways,Landing (descent or approach),Commercial,Sweden,Europe,55,6,0,49,0,0,55,Human Factor
1967-12-31 00:00:00,Aeroflot - Russian International Airlines,Landing (descent or approach),Commercial,Russia,Asia,0,0,0,0,0,0,0,Human Factor
1967-12-31 00:00:00,Iraqi Air Force - Al Quwwat al Jawwiya al Iraqiya,Landing (descent or approach),Military / Government,Iraq,Asia,0,0,0,0,0,0,0,Unknown
1968-01-01 00:00:00,Southern Airways,Landing (descent or approach),Operational,United States of America,North America,3,3,0,0,0,0,3,Human Factor
1968-01-07 00:00:00,Royal Canadian Air Force - RCAF,Flight,Military / Government,Canada,North America,0,0,0,0,0,0,0,Unknown
1968-01-08 00:00:00,JAT Yugoslav Airlines - Jugoslovenski Aerotransport,Flight,Operational,Austria,Europe,4,4,0,0,0,0,4,Technical Failure
1968-01-09 00:00:00,Middle East Airlines - MEA,Landing (descent or approach),Commercial,Lebanon,Asia,49,10,0,39,0,0,49,Weather
1968-01-09 00:00:00,Aeroflot - Russian International Airlines,Landing (descent or approach),Commercial,Kazakhstan,Asia,0,0,0,0,0,0,0,Human Factor
1968-01-12 00:00:00,Texize Chemicals,Landing (descent or approach),Business,United States of America,North America,2,2,0,0,0,0,2,Technical Failure
1968-01-13 00:00:00,Hooker Air Service,Landing (descent or approach),Commercial,Canada,North America,3,1,0,2,0,0,3,Human Factor
1968-01-16 00:00:00,German Air Force - Deutsche Luftwaffe,Landing (descent or approach),Military / Government,Germany,Europe,2,2,0,0,0,0,2,Unknown
1968-01-20 00:00:00,Turkish Airlines - THY Türk Hava Yollari,Landing (descent or approach),Commercial,Germany,Europe,38,6,0,32,0,0,38,Technical Failure
1968-01-20 00:00:00,Brazilian Air Force - Força Aérea Brasileira,Flight,Operational,Brazil,South America,0,0,0,0,0,0,0,Unknown
1968-01-24 00:00:00,Private American,Landing (descent or approach),Business,United States of America,North America,3,2,0,1,0,0,3,Human Factor
1968-01-29 00:00:00,Aeroflot - Russian International Airlines,Landing (descent or approach),Commercial,Russia,Asia,0,0,0,0,0,0,0,Human Factor
1968-01-30 00:00:00,Golden Knights Parachute Team,Landing (descent or approach),Humanitarian,United States of America,North America,3,1,0,2,0,0,3,Human Factor
1968-02-10 00:00:00,Royal Air Force - RAF,Landing (descent or approach),Military / Government,Malaysia,Asia,0,0,0,0,0,0,0,Technical Failure
1968-02-12 00:00:00,Aeroflot - Russian International Airlines,Flight,Commercial,Kazakhstan,Asia,6,2,0,4,0,0,6,Human Factor
1968-02-17 00:00:00,Industrial Electric,Takeoff (climb),Business,United States of America,North America,4,1,0,3,0,0,4,Human Factor
1968-02-18 00:00:00,United States Air Force - USAF,Takeoff (climb),Military / Government,Vietnam,Asia,3,3,0,0,0,0,3,Human Factor
1968-02-19 00:00:00,Hawaiian Air Tour Service,Landing (descent or approach),Commercial,United States of America,North America,13,2,0,11,0,0,13,Human Factor
1968-02-23 00:00:00,Executive Airlines - 1968,Landing (descent or approach),Operational,United States of America,North America,1,1,0,0,0,0,1,Human Factor
1968-02-24 00:00:00,Aeroflot - Russian International Airlines,Takeoff (climb),Commercial,Ukraine,Europe,0,0,0,0,0,0,0,Unknown
1968-02-26 00:00:00,British Antarctic Survey - BAS,Takeoff (climb),Specialised Services,Antarctica,Antarctica,5,1,0,4,0,0,5,Unknown
1968-02-28 00:00:00,United States Air Force - USAF,Takeoff (climb),Military / Government,Vietnam,Asia,10,10,0,0,0,0,10,Terrorism
1968-02-29 00:00:00,Millers Aviation,Takeoff (climb),Operational,United States of America,North America,4,2,0,2,0,0,4,Human Factor
1968-03-01 00:00:00,United States Air Force - USAF,Takeoff (climb),Military / Government,Vietnam,Asia,10,4,0,6,0,0,10,Terrorism
1968-03-03 00:00:00,United States Air Force - USAF,Landing (descent or approach),Military / Government,Vietnam,Asia,6,6,0,0,0,0,6,Technical Failure
1968-03-06 00:00:00,United States Air Force - USAF,Parking,Military / Government,United States of America,North America,0,0,0,0,0,0,0,Unknown
1968-03-11 00:00:00,United States Air Force - USAF,Flight,Military / Government,Vietnam,Asia,6,6,0,0,0,0,6,Terrorism
1968-03-19 00:00:00,Private New Zealand,Flight,Military / Government,New Zealand,Oceania,1,1,0,0,0,0,1,Unknown
1968-03-20 00:00:00,Delta Airlines,Landing (descent or approach),Commercial,United States of America,North America,42,3,0,39,0,0,42,Technical Failure
1968-03-21 00:00:00,United Airlines,Takeoff (climb),Operational,United States of America,North America,3,3,0,0,0,0,3,Human Factor
1968-03-22 00:00:00,Private American,Landing (descent or approach),Business,United States of America,North America,2,1,0,1,0,0,2,Technical Failure
1968-03-22 00:00:00,Air America,Landing (descent or approach),Commercial,Vietnam,Asia,0,0,0,0,0,0,0,Unknown
1968-03-24 00:00:00,United States Air Force - USAF,Landing (descent or approach),Military / Government,Thailand,Asia,5,5,0,0,0,0,5,Terrorism
1968-03-28 00:00:00,Wideroe - Wideroe's Flyveselskap,Flight,Commercial,Norway,Europe,5,1,0,4,0,0,5,Human Factor
1968-04-01 00:00:00,Royal Air Force - RAF,Landing (descent or approach),Operational,United Kingdom,Europe,5,5,0,0,0,0,5,Technical Failure
1968-04-03 00:00:00,United States Navy - USN,Landing (descent or approach),Operational,Philippines,Asia,5,5,0,0,0,0,5,Unknown
1968-04-11 00:00:00,Zambian Air Cargoes,Taxiing,Operational,Zambia,Africa,4,4,0,0,0,0,4,Human Factor
1968-04-11 00:00:00,Zambian Air Cargoes,Parking,Operational,Zambia,Africa,0,0,0,0,0,0,0,Human Factor
1968-04-11 00:00:00,Royal Australian Air Force - RAAF,Landing (descent or approach),Specialised Services,United States of America,North America,4,4,0,0,0,0,4,Technical Failure
1968-04-16 00:00:00,United States Air Force - USAF,Landing (descent or approach),Military / Government,Vietnam,Asia,5,5,0,0,0,0,5,Human Factor
1968-04-19 00:00:00,Lloyd Aéreo Boliviano - LAB Airlines,Takeoff (climb),Commercial,Bolivia,South America,0,0,0,0,0,0,0,Technical Failure
1968-04-28 00:00:00,Capitol International Airways,Landing (descent or approach),Operational,United States of America,North America,4,4,0,0,0,0,4,Human Factor
1968-05-04 00:00:00,Channel Airways,Landing (descent or approach),Commercial,United Kingdom,Europe,83,4,0,79,0,0,83,Human Factor
1968-05-07 00:00:00,United States Air Force - USAF,Takeoff (climb),Military / Government,Vietnam,Asia,5,5,0,0,0,0,5,Technical Failure
1968-05-09 00:00:00,Air Manila International,Landing (descent or approach),Commercial,Philippines,Asia,0,0,0,0,0,0,0,Unknown
1968-05-12 00:00:00,United States Air Force - USAF,Landing (descent or approach),Military / Government,Vietnam,Asia,5,5,0,0,0,0,5,Terrorism
1968-05-12 00:00:00,Chilean Air Force - Fuerza Aérea de Chile,Landing (descent or approach),Military / Government,Argentina,South America,20,2,0,18,0,0,20,Technical Failure
1968-05-15 00:00:00,United States Air Force - USAF,Landing (descent or approach),Military / Government,Vietnam,Asia,7,7,0,0,0,0,7,Technical Failure
1968-05-16 00:00:00,AREA Ecuador - Aerovias Ecuatorianas,Landing (descent or approach),Operational,Ecuador,South America,6,6,0,0,0,0,6,Other
1968-05-18 00:00:00,Para Club de Tananarive,Takeoff (climb),Humanitarian,Madagascar,Africa,6,1,0,5,0,0,6,Unknown
1968-05-22 00:00:00,United States Air Force - USAF,Landing (descent or approach),Military / Government,United States of America,North America,3,3,0,0,0,0,3,Human Factor
1968-05-23 00:00:00,Air America,Landing (descent or approach),Operational,Laos,Asia,4,4,0,0,0,0,4,Human Factor
1968-05-28 00:00:00,Polish Navy - Lotnictwa Marynarki Wojenna,Landing (descent or approach),Military / Government,Poland,Europe,0,0,0,0,0,0,0,Unknown
1968-05-29 00:00:00,United States Air Force - USAF,Landing (descent or approach),Military / Government,Vietnam,Asia,30,4,0,26,0,0,30,Terrorism
1968-06-03 00:00:00,New England Propeller Service,Landing (descent or approach),Operational,United States of America,North America,1,1,0,0,0,0,1,Weather
1968-06-07 00:00:00,Aerodyne Engineering,Landing (descent or approach),Business,Mexico,Central America,10,2,0,8,0,0,10,Human Factor
1968-06-08 00:00:00,Portuguese Air Force - Força Aerea Portuguesa,,Military / Government,Angola,Africa,0,0,0,0,0,0,0,Unknown
1968-06-10 00:00:00,Royal Air Force - RAF,Landing (descent or approach),Military / Government,United Kingdom,Europe,0,0,0,0,0,0,0,Unknown
1968-06-12 00:00:00,Great Northern Airways,Landing (descent or approach),Commercial,Canada,North America,12,3,0,9,0,0,12,Technical Failure
1968-06-22 00:00:00,Aero Union,Flight,Humanitarian,United States of America,North America,1,1,0,0,0,0,1,Technical Failure
1968-06-25 00:00:00,United States Air Force - USAF,Landing (descent or approach),Military / Government,Vietnam,Asia,5,5,0,0,0,0,5,Terrorism
1968-06-26 00:00:00,United States Air Force - USAF,Landing (descent or approach),Military / Government,Vietnam,Asia,4,4,0,0,0,0,4,Unknown
1968-07-02 00:00:00,Universal Airlines,Landing (descent or approach),Operational,United States of America,North America,3,3,0,0,0,0,3,Human Factor
1968-07-03 00:00:00,British European Airways - BEA,Parking,Commercial,United Kingdom,Europe,0,0,0,0,0,0,0,Technical Failure
1968-07-09 00:00:00,Air Vac,Flight,Business,United States of America,North America,2,1,0,1,0,0,2,Technical Failure
1968-07-09 00:00:00,J. Fender %26 Partner,Landing (descent or approach),Business,United States of America,North America,4,1,0,3,0,0,4,Human Factor
1968-07-14 00:00:00,General Air,Landing (descent or approach),Operational,Germany,Europe,1,1,0,0,0,0,1,Unknown
1968-07-20 00:00:00,Omni Investment,Flight,Operational,United States of America,North America,1,1,0,0,0,0,1,Human Factor
1968-08-01 00:00:00,P. J. Pastoral Company,Flight,Business,Australia,Oceania,1,1,0,0,0,0,1,Weather
1968-08-08 00:00:00,Aeroflot - Russian International Airlines,Landing (descent or approach),Commercial,Russia,Asia,0,0,0,0,0,0,0,Technical Failure
1968-08-10 00:00:00,Buker Airways,Takeoff (climb),Operational,United States of America,North America,1,1,0,0,0,0,1,Other
1968-08-10 00:00:00,Austin Airways,Takeoff (climb),Commercial,Canada,North America,0,0,0,0,0,0,0,Human Factor
1968-08-25 00:00:00,Casement Aviation,Takeoff (climb),Commercial,United States of America,North America,12,2,0,10,0,0,12,Human Factor
1968-08-29 00:00:00,United States Air Force - USAF,Flight,Military / Government,Turkey,Asia,0,0,0,0,0,0,0,Unknown
1968-08-29 00:00:00,United States Air Force - USAF,Flight,Operational,United States of America,North America,7,7,0,0,0,0,7,Technical Failure
1968-09-03 00:00:00,Mercy Mission,Landing (descent or approach),Humanitarian,Nigeria,Africa,0,0,0,0,0,0,0,Technical Failure
1968-09-04 00:00:00,Nor-Fly,Flight,Commercial,Norway,Europe,0,0,0,0,0,0,0,Unknown
1968-09-05 00:00:00,Wat Henry Car Leasing Company,Flight,Business,United States of America,North America,1,1,0,0,0,0,1,Technical Failure
1968-09-07 00:00:00,Mobile Aircraft,Landing (descent or approach),Operational,United States of America,North America,2,2,0,0,0,0,2,Technical Failure
1968-09-12 00:00:00,United States Air Force - USAF,Landing (descent or approach),Military / Government,Vietnam,Asia,3,3,0,0,0,0,3,Technical Failure
1968-09-17 00:00:00,Sun Airlines,Takeoff (climb),Operational,United States of America,North America,3,2,0,1,0,0,3,Human Factor
1968-09-18 00:00:00,Miller Aviation,Takeoff (climb),Operational,United States of America,North America,1,1,0,0,0,0,1,Technical Failure
1968-09-26 00:00:00,Ford Motor Company,Takeoff (climb),Operational,United States of America,North America,2,2,0,0,0,0,2,Other
1968-09-27 00:00:00,Universal Airlines,Landing (descent or approach),Operational,United States of America,North America,3,3,0,0,0,0,3,Human Factor
1968-09-28 00:00:00,Willair International Airlines,Landing (descent or approach),Operational,United States of America,North America,11,3,0,8,0,0,11,Human Factor
1968-09-28 00:00:00,Eastern Provincial Airways - EPA,Landing (descent or approach),Commercial,Canada,North America,38,5,0,33,0,0,38,Human Factor
1968-09-30 00:00:00,Dan-Air Services,Landing (descent or approach),Operational,United Kingdom,Europe,2,2,0,0,0,0,2,Technical Failure
1968-10-06 00:00:00,Aeroflot - Russian International Airlines,Flight,Commercial,Turkmenistan,Asia,0,0,0,0,0,0,0,Technical Failure
1968-10-06 00:00:00,Royal Australian Air Force - RAAF,Landing (descent or approach),Military / Government,Papua New Guinea,Oceania,4,4,0,0,0,0,4,Unknown
1968-10-07 00:00:00,United States Air Force - USAF,Flight,Military / Government,Vietnam,Asia,3,3,0,0,0,0,3,Human Factor
1968-10-12 00:00:00,Munz Northern Airlines,Takeoff (climb),Commercial,United States of America,North America,2,1,0,1,0,0,2,Technical Failure
1968-10-15 00:00:00,Air America,Landing (descent or approach),Commercial,Vietnam,Asia,1,1,0,0,0,0,1,Technical Failure
1968-10-18 00:00:00,Private New Zealand,Flight,Military / Government,New Zealand,Oceania,1,1,0,0,0,0,1,Unknown
1968-10-20 00:00:00,Aeroflot - Russian International Airlines,Landing (descent or approach),Commercial,Russia,Asia,0,0,0,0,0,0,0,Human Factor
1968-10-24 00:00:00,Private American,Landing (descent or approach),Business,United States of America,North America,5,1,0,4,0,0,5,Human Factor
1968-10-24 00:00:00,Interflug,Landing (descent or approach),Operational,Germany,Europe,3,3,0,0,0,0,3,Technical Failure
1968-10-25 00:00:00,United States Air Force - USAF,Landing (descent or approach),Military / Government,United States of America,North America,0,0,0,0,0,0,0,Unknown
1968-11-06 00:00:00,VASP - Viação Aérea de São Paulo,Landing (descent or approach),Commercial,Brazil,South America,0,0,0,0,0,0,0,Human Factor
1968-11-07 00:00:00,Argentinian Air Force - Fuerza Aérea Argentina,Landing (descent or approach),Military / Government,Argentina,South America,24,3,0,21,0,0,24,Unknown
1968-11-11 00:00:00,Boliviana de Aviación,,Commercial,Bolivia,South America,0,0,0,0,0,0,0,Unknown
1968-11-12 00:00:00,Tex Johnson Inc.,Landing (descent or approach),Operational,United States of America,North America,4,3,0,1,0,0,4,Human Factor
1968-11-17 00:00:00,City Centre Air Taxi Services,Landing (descent or approach),Operational,Australia,Oceania,2,2,0,0,0,0,2,Human Factor
1968-11-18 00:00:00,Ortner Air Services,Takeoff (climb),Operational,United States of America,North America,4,2,0,2,0,0,4,Other
1968-11-22 00:00:00,Drydenair,Flight,Commercial,Canada,North America,0,0,0,0,0,0,0,Technical Failure
1968-11-25 00:00:00,Lesotho Flying Doctor Service,Flight,Humanitarian,Lesotho,Africa,0,0,0,0,0,0,0,Unknown
1968-11-27 00:00:00,Desoto Airlines,Landing (descent or approach),Operational,United States of America,North America,2,2,0,0,0,0,2,Human Factor
1968-11-27 00:00:00,Air America,Takeoff (climb),Commercial,Laos,Asia,0,0,0,0,0,0,0,Unknown
1968-11-28 00:00:00,United States Air Force - USAF,Landing (descent or approach),Military / Government,Vietnam,Asia,5,5,0,0,0,0,5,Technical Failure
1968-11-30 00:00:00,Air Melanesiæ,Landing (descent or approach),Commercial,Vanuatu,Oceania,9,1,0,8,0,0,9,Technical Failure
1968-12-02 00:00:00,Fieldair,Takeoff (climb),Military / Government,New Zealand,Oceania,1,1,0,0,0,0,1,Technical Failure
1968-12-03 00:00:00,United States Air Force - USAF,Landing (descent or approach),Military / Government,Japan,Asia,7,7,0,0,0,0,7,Unknown
1968-12-05 00:00:00,Island Airlines,Landing (descent or approach),Operational,United States of America,North America,1,1,0,0,0,0,1,Technical Failure
1968-12-05 00:00:00,CAAC - Civil Aviation Administration of China,,Commercial,China,Asia,0,0,0,0,0,0,0,Unknown
1968-12-06 00:00:00,Private American,Takeoff (climb),Operational,United States of America,North America,1,1,0,0,0,0,1,Technical Failure
1968-12-06 00:00:00,Royal Norwegian Air Force - Kongelige Norske Luftforsvaret,Landing (descent or approach),Military / Government,Norway,Europe,0,0,0,0,0,0,0,Human Factor
1968-12-09 00:00:00,Fly by Night Safaris,Takeoff (climb),Commercial,United States of America,North America,104,8,0,96,0,0,104,Human Factor
1968-12-09 00:00:00,Lambair - Lamb Airways,Flight,Commercial,Canada,North America,0,0,0,0,0,0,0,Technical Failure
1968-12-12 00:00:00,Private American,Landing (descent or approach),Business,Bahamas,Central America,11,2,0,9,0,0,11,Technical Failure
1968-12-13 00:00:00,United States Air Force - USAF,Landing (descent or approach),Military / Government,Vietnam,Asia,3,3,0,0,0,0,3,Human Factor
1968-12-15 00:00:00,PenAir - Peninsula Airways - Alaska Airlines Commuter,Takeoff (climb),Commercial,United States of America,North America,4,1,0,3,0,0,4,Human Factor
1968-12-15 00:00:00,Aeroflot - Russian International Airlines,Landing (descent or approach),Specialised Services,Antarctica,Antarctica,0,0,0,0,0,0,0,Unknown
1968-12-18 00:00:00,North Air,Landing (descent or approach),Commercial,United States of America,North America,9,2,0,7,0,0,9,Human Factor
1968-12-19 00:00:00,Spanish Air Force - Ejército del Aire,Flight,Military / Government,Spain,Europe,3,3,0,0,0,0,3,Technical Failure
1968-12-26 00:00:00,Brazilian Air Force - Força Aérea Brasileira,,Military / Government,Brazil,South America,0,0,0,0,0,0,0,Unknown
1968-12-27 00:00:00,Ozark Air Lines,Takeoff (climb),Commercial,United States of America,North America,68,4,0,64,0,0,68,Human Factor
1968-12-31 00:00:00,Aeropesca Colombia,,Commercial,Colombia,South America,0,0,0,0,0,0,0,Unknown
1968-12-31 00:00:00,Six T Ranch,Landing (descent or approach),Business,Suriname,South America,0,0,0,0,0,0,0,Human Factor
1968-12-31 00:00:00,RCMP - GRC Air Services,,Military / Government,Canada,North America,0,0,0,0,0,0,0,Unknown
1969-01-01 00:00:00,Royal Saudi Air Force,Landing (descent or approach),Operational,France,Europe,6,6,0,0,0,0,6,Unknown
1969-01-03 00:00:00,General Airlines,Landing (descent or approach),Operational,Greenland,Europe,1,1,0,0,0,0,1,Human Factor
1969-01-03 00:00:00,United States Navy - USN,Flight,Military / Government,United States of America,North America,0,0,0,0,0,0,0,Unknown
1969-01-04 00:00:00,Fieldair,Flight,Military / Government,New Zealand,Oceania,1,1,0,0,0,0,1,Unknown
1969-01-11 00:00:00,VASP - Viação Aérea de São Paulo,Landing (descent or approach),Commercial,Brazil,South America,0,0,0,0,0,0,0,Unknown
1969-01-13 00:00:00,United States Air Force - USAF,Landing (descent or approach),Military / Government,United States of America,North America,18,4,0,14,0,0,18,Weather
1969-01-13 00:00:00,Sud Aviación,,Other,Argentina,South America,0,0,0,0,0,0,0,Unknown
1969-01-14 00:00:00,British United Airways - BUA,Takeoff (climb),Commercial,Italy,Europe,33,7,0,26,0,0,33,Technical Failure
1969-01-15 00:00:00,Ariana Afghan Airlines,Taxiing,Commercial,Afghanistan,Asia,0,0,0,0,0,0,0,Unknown
1969-01-17 00:00:00,United States Air Force - USAF,Landing (descent or approach),Military / Government,Vietnam,Asia,5,5,0,0,0,0,5,Unknown
1969-01-24 00:00:00,LOT Polish Airlines - Polskie Linie Lotnicze,Landing (descent or approach),Commercial,Poland,Europe,48,4,0,44,0,0,48,Human Factor
1969-01-24 00:00:00,United States Air Force - USAF,Landing (descent or approach),Operational,United States of America,North America,0,0,0,0,0,0,0,Unknown
1969-02-01 00:00:00,Orion Airways,Takeoff (climb),Operational,United States of America,North America,2,2,0,0,0,0,2,Human Factor
1969-02-01 00:00:00,Bolivian Air System,,Operational,Bolivia,South America,0,0,0,0,0,0,0,Unknown
1969-02-02 00:00:00,Turkish Airlines - THY Türk Hava Yollari,Landing (descent or approach),Commercial,Turkey,Asia,26,4,0,22,0,0,26,Human Factor
1969-02-03 00:00:00,Carolina Aircraft Corporation,Landing (descent or approach),Operational,Brazil,South America,2,2,0,0,0,0,2,Technical Failure
1969-02-04 00:00:00,JAT Yugoslav Airlines - Jugoslovenski Aerotransport,Landing (descent or approach),Commercial,Montenegro,Europe,0,0,0,0,0,0,0,Unknown
1969-02-06 00:00:00,French Air Force - Armée de l'Air,Flight,Operational,France,Europe,0,0,0,0,0,0,0,Unknown
1969-02-08 00:00:00,Stanair,Landing (descent or approach),Commercial,Canada,North America,5,3,0,2,0,0,5,Human Factor
1969-02-12 00:00:00,United States Army,Flight,Military / Government,Cambodia,Asia,4,1,0,3,0,0,4,Terrorism
1969-02-13 00:00:00,Aeropesca Colombia,Takeoff (climb),Operational,Colombia,South America,3,3,0,0,0,0,3,Other
1969-02-14 00:00:00,Japan Air Self-Defense Force - Kōkū Jieitai,Takeoff (climb),Military / Government,Japan,Asia,0,0,0,0,0,0,0,Unknown
1969-02-15 00:00:00,Far Eastern Air Transport - FAT,,Commercial,Taiwan,Asia,0,0,0,0,0,0,0,Unknown
1969-02-18 00:00:00,Indian Airlines,Takeoff (climb),Commercial,India,Asia,30,4,0,26,0,0,30,Other
1969-02-20 00:00:00,British Midland Airways - BMA,Landing (descent or approach),Commercial,United Kingdom,Europe,53,5,0,48,0,0,53,Human Factor
1969-02-21 00:00:00,Indian Air Force - Bharatiya Vayu Sena,,Military / Government,India,Asia,0,0,0,0,0,0,0,Unknown
1969-02-23 00:00:00,Trans Isle Air,Flight,Operational,World,World,1,1,0,0,0,0,1,Technical Failure
1969-03-01 00:00:00,United States Navy - USN,Flight,Military / Government,World,World,0,0,0,0,0,0,0,Unknown
1969-03-01 00:00:00,United States Air Force - USAF,Landing (descent or approach),Military / Government,Vietnam,Asia,3,3,0,0,0,0,3,Human Factor
1969-03-02 00:00:00,National Steel Corp.,Takeoff (climb),Business,United States of America,North America,7,2,0,5,0,0,7,Human Factor
1969-03-03 00:00:00,British Antarctic Survey - BAS,Landing (descent or approach),Military / Government,Antarctica,Antarctica,0,0,0,0,0,0,0,Technical Failure
1969-03-08 00:00:00,Zamrud Aviation,Flight,Operational,World,World,3,3,0,0,0,0,3,Technical Failure
1969-03-16 00:00:00,Royal Canadian Air Force - RCAF,Landing (descent or approach),Military / Government,World,World,4,4,0,0,0,0,4,Technical Failure
1969-03-25 00:00:00,United States Air Force - USAF,Takeoff (climb),Operational,United States of America,North America,7,7,0,0,0,0,7,Technical Failure
1969-03-26 00:00:00,Trans American Leasing - TAL,Flight,Operational,Chile,South America,3,3,0,0,0,0,3,Technical Failure
1969-03-28 00:00:00,Libyan National Airways,Flight,Commercial,Libya,Africa,17,4,0,13,0,0,17,Unknown
1969-04-02 00:00:00,VASP - Viação Aérea de São Paulo,Landing (descent or approach),Commercial,Brazil,South America,0,0,0,0,0,0,0,Technical Failure
1969-04-07 00:00:00,United States Air Force - USAF,Flight,Military / Government,Germany,Europe,0,0,0,0,0,0,0,Unknown
1969-04-07 00:00:00,Imperial Iranian Air Force,Takeoff (climb),Operational,Iran,Asia,0,0,0,0,0,0,0,Technical Failure
1969-04-14 00:00:00,Fieldair,Takeoff (climb),Specialised Services,New Zealand,Oceania,2,2,0,0,0,0,2,Human Factor
1969-04-14 00:00:00,Air Manila International,Landing (descent or approach),Commercial,Philippines,Asia,0,0,0,0,0,0,0,Technical Failure
1969-04-14 00:00:00,Cruzeiro do Sul,Landing (descent or approach),Commercial,Brazil,South America,0,0,0,0,0,0,0,Unknown
1969-04-14 00:00:00,Indian Air Force - Bharatiya Vayu Sena,,Military / Government,India,Asia,0,0,0,0,0,0,0,Unknown
1969-04-23 00:00:00,Filipinas Orient Airways,Landing (descent or approach),Commercial,Philippines,Asia,31,3,0,28,0,0,31,Unknown
1969-04-24 00:00:00,Far Eastern Air Transport - FAT,Landing (descent or approach),Commercial,Vietnam,Asia,31,3,0,28,0,0,31,Human Factor
1969-04-27 00:00:00,LAN Chile - Linea Aérea Nacional de Chile,Landing (descent or approach),Commercial,Chile,South America,60,8,0,52,0,0,60,Human Factor
1969-04-28 00:00:00,Aeroflot - Russian International Airlines,Landing (descent or approach),Commercial,Russia,Asia,0,0,0,0,0,0,0,Human Factor
1969-04-29 00:00:00,United States Air Force - USAF,Landing (descent or approach),Military / Government,Vietnam,Asia,3,3,0,0,0,0,3,Terrorism
1969-05-01 00:00:00,Mobil Oil Corporation,Landing (descent or approach),Operational,United States of America,North America,4,4,0,0,0,0,4,Human Factor
1969-05-02 00:00:00,Private American,Takeoff (climb),Business,United States of America,North America,2,2,0,0,0,0,2,Other
1969-05-04 00:00:00,United States Navy - USN,Landing (descent or approach),Operational,United States of America,North America,5,5,0,0,0,0,5,Unknown
1969-05-05 00:00:00,Master Equipment Company,Flight,Military / Government,United States of America,North America,2,2,0,0,0,0,2,Technical Failure
1969-05-06 00:00:00,Executive Air Services,Landing (descent or approach),Commercial,Australia,Oceania,3,1,0,2,0,0,3,Human Factor
1969-05-08 00:00:00,Lineas Aéreas Paraguayas - LAPSA,Parking,Commercial,Paraguay,South America,0,0,0,0,0,0,0,Unknown
1969-05-08 00:00:00,United States Air Force - USAF,Landing (descent or approach),Operational,United States of America,North America,7,7,0,0,0,0,7,Unknown
1969-05-08 00:00:00,Nordchurchaid,Landing (descent or approach),Humanitarian,Nigeria,Africa,0,0,0,0,0,0,0,Unknown
1969-05-09 00:00:00,Seeley Flying Service,Takeoff (climb),Commercial,United States of America,North America,8,1,0,7,0,0,8,Human Factor
1969-05-20 00:00:00,Malagasy Air Force - Armée de l'Air Malgache,,Military / Government,Madagascar,Africa,0,0,0,0,0,0,0,Unknown
1969-05-23 00:00:00,French Air Force - Armée de l'Air,Landing (descent or approach),Military / Government,Portugal,Europe,5,5,0,0,0,0,5,Unknown
1969-05-27 00:00:00,United States Air Force - USAF,Landing (descent or approach),Military / Government,Vietnam,Asia,5,5,0,0,0,0,5,Terrorism
1969-05-28 00:00:00,Air France,Takeoff (climb),Operational,France,Europe,3,3,0,0,0,0,3,Human Factor
1969-05-30 00:00:00,United States Air Force - USAF,,Military / Government,United States of America,North America,0,0,0,0,0,0,0,Unknown
1969-06-03 00:00:00,United States Navy - USN,Takeoff (climb),Military / Government,United States of America,North America,8,8,0,0,0,0,8,Technical Failure
1969-06-04 00:00:00,French Air Force - Armée de l'Air,Flight,Operational,France,Europe,0,0,0,0,0,0,0,Unknown
1969-06-05 00:00:00,United States Navy - USN,Landing (descent or approach),Military / Government,United States of America,North America,0,0,0,0,0,0,0,Technical Failure
1969-06-07 00:00:00,United States Air Force - USAF,Takeoff (climb),Military / Government,Thailand,Asia,8,8,0,0,0,0,8,Technical Failure
1969-06-20 00:00:00,Mercy Mission,Flight,Humanitarian,Liberia,Africa,0,0,0,0,0,0,0,Unknown
1969-06-25 00:00:00,Aeroflot - Russian International Airlines,Landing (descent or approach),Operational,Russia,Asia,6,6,0,0,0,0,6,Technical Failure
1969-06-27 00:00:00,Aloha Airlines,Taxiing,Commercial,United States of America,North America,14,3,0,11,0,0,14,Human Factor
1969-06-28 00:00:00,Ciba-Pilatus Aerial Spraying Company,Flight,Military / Government,Indonesia,Asia,1,1,0,0,0,0,1,Unknown
1969-06-29 00:00:00,Affretair,Takeoff (climb),Operational,Nigeria,Africa,4,4,0,0,0,0,4,Human Factor
1969-07-01 00:00:00,French Air Force - Armée de l'Air,,Military / Government,French Polynesia,Oceania,0,0,0,0,0,0,0,Unknown
1969-07-09 00:00:00,Thai Airways International,Landing (descent or approach),Commercial,Thailand,Asia,75,7,0,68,0,0,75,Human Factor
1969-07-10 00:00:00,Ling-Temco-Vought,Landing (descent or approach),Business,United States of America,North America,7,2,0,5,0,0,7,Technical Failure
1969-07-10 00:00:00,J. H. Logsdon,Takeoff (climb),Commercial,Canada,North America,25,3,0,22,0,0,25,Human Factor
1969-07-11 00:00:00,Cogeair - Compagnie Générale Aérienne Africaine,Flight,Operational,Belgium,Europe,1,1,0,0,0,0,1,Technical Failure
1969-07-12 00:00:00,Royal Nepal Airlines,,Commercial,Nepal,Asia,0,0,0,0,0,0,0,Unknown
1969-07-15 00:00:00,Aerolineas Argentinas,Landing (descent or approach),Commercial,Argentina,South America,39,4,0,35,0,0,39,Human Factor
1969-07-15 00:00:00,Salvadorian Air Force - Fuerza Aérea Salvadoreña,Landing (descent or approach),Military / Government,Salvador,Central America,0,0,0,0,0,0,0,Terrorism
1969-07-16 00:00:00,Pacific Western Airlines - PWA,Landing (descent or approach),Operational,Peru,South America,4,4,0,0,0,0,4,Human Factor
1969-07-19 00:00:00,United States Air Force - USAF,Takeoff (climb),Military / Government,Thailand,Asia,6,6,0,0,0,0,6,Human Factor
1969-07-23 00:00:00,American Aviation,Takeoff (climb),Specialised Services,United States of America,North America,1,1,0,0,0,0,1,Technical Failure
1969-07-23 00:00:00,Air Djibouti,Flight,Operational,Djibouti,Africa,4,2,0,2,0,0,4,Other
1969-07-24 00:00:00,Ciba-Pilatus Aerial Spraying Company,Flight,Military / Government,Indonesia,Asia,0,0,0,0,0,0,0,Unknown
1969-07-25 00:00:00,United States Navy - USN,Takeoff (climb),Military / Government,Iceland,Europe,0,0,0,0,0,0,0,Unknown
1969-07-26 00:00:00,Air America,Landing (descent or approach),Commercial,Vietnam,Asia,8,1,0,7,0,0,8,Unknown
1969-07-26 00:00:00,BKS Air Transport,Landing (descent or approach),Operational,United Kingdom,Europe,8,3,0,5,0,0,8,Technical Failure
1969-07-31 00:00:00,Slov-Air,,Military / Government,Czech Republic,Europe,0,0,0,0,0,0,0,Unknown
1969-08-02 00:00:00,Alitalia - Linee Aeree Italiane,Landing (descent or approach),Commercial,France,Europe,45,8,0,37,0,0,45,Human Factor
1969-08-04 00:00:00,Trans Southern Corporation - TSC,Takeoff (climb),Operational,Brazil,South America,4,4,0,0,0,0,4,Human Factor
1969-08-12 00:00:00,Wien Consolidated Airlines,Landing (descent or approach),Commercial,United States of America,North America,9,1,0,8,0,0,9,Other
1969-08-13 00:00:00,Private Canadian,,Business,Canada,North America,0,0,0,0,0,0,0,Unknown
1969-08-20 00:00:00,Mexicana de Aviación,Landing (descent or approach),Commercial,Mexico,Central America,0,0,0,0,0,0,0,Unknown
1969-08-21 00:00:00,Royal Air Force - RAF,Flight,Operational,United Kingdom,Europe,2,2,0,0,0,0,2,Human Factor
1969-08-26 00:00:00,Colombian Air Force - Fuerza Aérea Colombiana,Landing (descent or approach),Military / Government,Colombia,South America,6,6,0,0,0,0,6,Unknown
1969-09-02 00:00:00,Hughes Tool Company,Landing (descent or approach),Business,United States of America,North America,16,2,0,14,0,0,16,Human Factor
1969-09-03 00:00:00,Brazilian Air Force - Força Aérea Brasileira,Flight,Military / Government,Brazil,South America,4,4,0,0,0,0,4,Technical Failure
1969-09-06 00:00:00,"Servicios Aéreos para el Negocios, Industria y Agricultura",,Commercial,Bolivia,South America,0,0,0,0,0,0,0,Unknown
1969-09-07 00:00:00,Aerotaxi Servicios Aéreos,Flight,Commercial,Colombia,South America,11,1,0,10,0,0,11,Technical Failure
1969-09-10 00:00:00,Aeroflot - Russian International Airlines,Landing (descent or approach),Commercial,Russia,Asia,0,0,0,0,0,0,0,Human Factor
1969-09-14 00:00:00,Chilean Air Force - Fuerza Aérea de Chile,Flight,Military / Government,Chile,South America,21,3,0,18,0,0,21,Unknown
1969-09-23 00:00:00,Centrais Eléctricas de São Paulo,,Business,Brazil,South America,0,0,0,0,0,0,0,Unknown
1969-09-29 00:00:00,British Steel Corporation - BSC,Landing (descent or approach),Operational,United Kingdom,Europe,3,2,0,1,0,0,3,Unknown
1969-09-30 00:00:00,United States Air Force - USAF,Landing (descent or approach),Military / Government,Vietnam,Asia,8,3,0,5,0,0,8,Technical Failure
1969-10-03 00:00:00,Río Táxi Aéreo,Landing (descent or approach),Operational,Brazil,South America,2,2,0,0,0,0,2,Unknown
1969-10-05 00:00:00,Sudanese Government,,Military / Government,South Sudan,Africa,0,0,0,0,0,0,0,Unknown
1969-10-12 00:00:00,Aeroflot - Russian International Airlines,Landing (descent or approach),Commercial,Russia,Asia,0,0,0,0,0,0,0,Other
1969-10-13 00:00:00,Colombian Air Force - Fuerza Aérea Colombiana,Flight,Commercial,Colombia,South America,12,2,0,10,0,0,12,Technical Failure
1969-10-15 00:00:00,Pacific Interconnect,Takeoff (climb),Business,Mexico,Central America,6,2,0,4,0,0,6,Other
1969-10-16 00:00:00,Seaboard World Airlines,Landing (descent or approach),Operational,United States of America,North America,5,5,0,0,0,0,5,Technical Failure
1969-10-16 00:00:00,Johnston R. Staples,Flight,Operational,United States of America,North America,2,2,0,0,0,0,2,Technical Failure
1969-10-17 00:00:00,United States Navy - USN,Landing (descent or approach),Military / Government,United States of America,North America,0,0,0,0,0,0,0,Unknown
1969-10-20 00:00:00,All Nippon Airways,Landing (descent or approach),Commercial,Japan,Asia,53,4,0,49,0,0,53,Human Factor
1969-10-21 00:00:00,United States Air Force - USAF,Landing (descent or approach),Operational,United States of America,North America,6,6,0,0,0,0,6,Unknown
1969-10-26 00:00:00,Arkia Israeli Airlines,Landing (descent or approach),Operational,Israel,Asia,3,3,0,0,0,0,3,Unknown
1969-10-31 00:00:00,Pan Alaska Airways,Landing (descent or approach),Commercial,United States of America,North America,10,2,0,8,0,0,10,Human Factor
1969-11-01 00:00:00,Linjeflyg,Takeoff (climb),Operational,Sweden,Europe,4,4,0,0,0,0,4,Human Factor
1969-11-03 00:00:00,Sky Tours Hawaii,Landing (descent or approach),Commercial,United States of America,North America,13,2,0,11,0,0,13,Human Factor
1969-11-10 00:00:00,Sudanese Air Force - Al Quwwat al-Jawwiya As-Sudaniya,Flight,Military / Government,Sudan,Africa,0,0,0,0,0,0,0,Unknown
1969-11-11 00:00:00,Aeroflot - Russian International Airlines,Flight,Commercial,Uzbekistan,Asia,0,0,0,0,0,0,0,Human Factor
1969-11-13 00:00:00,United States Air Force - USAF,Landing (descent or approach),Specialised Services,United States of America,North America,2,2,0,0,0,0,2,Unknown
1969-11-14 00:00:00,Bard Air Freight,Landing (descent or approach),Operational,United States of America,North America,1,1,0,0,0,0,1,Technical Failure
1969-11-19 00:00:00,Carroll Air Services,Flight,Operational,United States of America,North America,2,2,0,0,0,0,2,Human Factor
1969-11-19 00:00:00,Malév Hungarian Airlines - Magyar Légiközlekedési Vallalat,Landing (descent or approach),Commercial,Turkey,Asia,0,0,0,0,0,0,0,Weather
1969-11-20 00:00:00,Aerial Tours,,Commercial,Papua New Guinea,Oceania,0,0,0,0,0,0,0,Unknown
1969-11-21 00:00:00,United States Leasing Corporation,Landing (descent or approach),Business,United States of America,North America,1,1,0,0,0,0,1,Human Factor
1969-11-25 00:00:00,Spanish Air Force - Ejército del Aire,Flight,Military / Government,Spain,Europe,3,3,0,0,0,0,3,Unknown
1969-11-25 00:00:00,SAHSA - Servicios Aéreos de Honduras SA,Landing (descent or approach),Commercial,Honduras,Central America,18,3,0,15,0,0,18,Weather
1969-11-27 00:00:00,Aerolineas Argentinas,Landing (descent or approach),Commercial,Argentina,South America,28,4,0,24,0,0,28,Human Factor
1969-12-02 00:00:00,Líneas Aéreas del Estado - LADE,Landing (descent or approach),Military / Government,Antarctica,Antarctica,0,0,0,0,0,0,0,Technical Failure
1969-12-05 00:00:00,LAN Chile - Linea Aérea Nacional de Chile,Takeoff (climb),Operational,Chile,South America,3,3,0,0,0,0,3,Human Factor
1969-12-05 00:00:00,Malaysia-Singapore Airlines - MSA,Landing (descent or approach),Commercial,Malaysia,Asia,0,0,0,0,0,0,0,Unknown
1969-12-05 00:00:00,Malaysia-Singapore Airlines - MSA,Landing (descent or approach),Commercial,Malaysia,Asia,0,0,0,0,0,0,0,Unknown
1969-12-09 00:00:00,Private German,Landing (descent or approach),Business,Belgium,Europe,1,1,0,0,0,0,1,Unknown
1969-12-11 00:00:00,Korean Air,Landing (descent or approach),Commercial,North Korea,Asia,52,4,0,48,0,0,52,Terrorism
1969-12-12 00:00:00,Transportes Aéreos Littoral - TAL,Takeoff (climb),Commercial,Bolivia,South America,0,0,0,0,0,0,0,Unknown
1969-12-13 00:00:00,United States Air Force - USAF,Takeoff (climb),Military / Government,Vietnam,Asia,5,5,0,0,0,0,5,Technical Failure
1969-12-14 00:00:00,VARIG - Viação Aérea Rio Grandense,Landing (descent or approach),Commercial,Brazil,South America,9,5,0,4,0,0,9,Unknown
1969-12-15 00:00:00,Pilatus,,Operational,Bahrain,Asia,2,2,0,0,0,0,2,Unknown
1969-12-15 00:00:00,Albany Industrial Corporation,Flight,Business,World,World,0,0,0,0,0,0,0,Unknown
1969-12-17 00:00:00,Austral Lineas Aéreas,Takeoff (climb),Operational,Argentina,South America,2,2,0,0,0,0,2,Human Factor
1969-12-20 00:00:00,Great Northern Airways,Landing (descent or approach),Commercial,Canada,North America,0,0,0,0,0,0,0,Technical Failure
1969-12-22 00:00:00,Luxair,Landing (descent or approach),Commercial,Luxembourg,Europe,0,0,0,0,0,0,0,Weather
1969-12-27 00:00:00,Maersk Air,Takeoff (climb),Operational,Denmark,Europe,4,4,0,0,0,0,4,Human Factor
1969-12-30 00:00:00,Continental Air Services,Landing (descent or approach),Commercial,Laos,Asia,0,0,0,0,0,0,0,Unknown
1969-12-31 00:00:00,Aeroklub Polskiej Rzeczypospolitej Ludowej - APRL,,Operational,Poland,Europe,0,0,0,0,0,0,0,Unknown
1969-12-31 00:00:00,Ecuatoriana - Compañia Ecuatoriana de Aviacion,Parking,Commercial,Ecuador,South America,0,0,0,0,0,0,0,Unknown
1969-12-31 00:00:00,CAAC - Civil Aviation Administration of China,,Commercial,China,Asia,0,0,0,0,0,0,0,Unknown
1970-01-02 00:00:00,Sky King Inc.,Takeoff (climb),Operational,United States of America,North America,2,2,0,0,0,0,2,Human Factor
1970-01-03 00:00:00,United States Air Force - USAF,Landing (descent or approach),Military / Government,Vietnam,Asia,5,5,0,0,0,0,5,Technical Failure
1970-01-05 00:00:00,Iberia - Lineas Aéreas de Espana,Landing (descent or approach),Commercial,Spain,Europe,49,3,0,46,0,0,49,Unknown
1970-01-10 00:00:00,Sherman Aircraft Sales,Landing (descent or approach),Operational,Bahamas,Central America,1,1,0,0,0,0,1,Technical Failure
1970-01-12 00:00:00,Nigerian Air Force,Landing (descent or approach),Military / Government,Nigeria,Africa,0,0,0,0,0,0,0,Human Factor
1970-01-14 00:00:00,United Arab Airlines,Landing (descent or approach),Commercial,Ethiopia,Africa,14,9,0,5,0,0,14,Human Factor
1970-01-15 00:00:00,Air Alpes,Landing (descent or approach),Commercial,France,Europe,17,2,0,15,0,0,17,Human Factor
1970-01-16 00:00:00,Carmen Leasing,Landing (descent or approach),Business,United States of America,North America,5,1,0,4,0,0,5,Technical Failure
1970-01-17 00:00:00,Aspen Airways,Landing (descent or approach),Commercial,United States of America,North America,27,3,0,24,0,0,27,Human Factor
1970-01-18 00:00:00,Skyservice Aviation,Flight,Humanitarian,Australia,Oceania,9,1,0,8,0,0,9,Technical Failure
1970-01-19 00:00:00,Cambrian Airways,Landing (descent or approach),Commercial,United Kingdom,Europe,63,5,0,58,0,0,63,Unknown
1970-01-21 00:00:00,Israel Aerospace Industries - IAI,Flight,Specialised Services,Israel,Asia,4,4,0,0,0,0,4,Technical Failure
1970-01-22 00:00:00,British Midland Airways - BMA,Landing (descent or approach),Commercial,United Kingdom,Europe,42,5,0,37,0,0,42,Technical Failure
1970-01-30 00:00:00,United Arab Airlines,Landing (descent or approach),Commercial,Egypt,Africa,0,0,0,0,0,0,0,Technical Failure
1970-01-31 00:00:00,Colombian Air Force - Fuerza Aérea Colombiana,Takeoff (climb),Military / Government,Colombia,South America,15,2,0,13,0,0,15,Technical Failure
1970-02-05 00:00:00,VARIG - Viação Aérea Rio Grandense,Landing (descent or approach),Commercial,Brazil,South America,51,5,0,46,0,0,51,Human Factor
1970-02-09 00:00:00,United Arab Airlines,Takeoff (climb),Commercial,Germany,Europe,23,9,0,14,0,0,23,Weather
1970-02-09 00:00:00,Belgische-Nederlandse Zuidpool Expeditie,Landing (descent or approach),Specialised Services,Antarctica,Antarctica,0,0,0,0,0,0,0,Unknown
1970-02-12 00:00:00,TAM Bolivia - Transporte Aéreo Militar Boliviano,Landing (descent or approach),Military / Government,Bolivia,South America,5,4,0,1,0,0,5,Unknown
1970-02-12 00:00:00,Aero Aysen,Flight,Operational,Chile,South America,2,2,0,0,0,0,2,Technical Failure
1970-02-15 00:00:00,Air Congo,,Commercial,Democratic Republic of Congo,Africa,0,0,0,0,0,0,0,Unknown
1970-02-17 00:00:00,Turkish Airlines - THY Türk Hava Yollari,Landing (descent or approach),Commercial,Turkey,Asia,29,3,0,26,0,0,29,Human Factor
1970-02-19 00:00:00,United States Air Force - USAF,Landing (descent or approach),Military / Government,Vietnam,Asia,10,10,0,0,0,0,10,Technical Failure
1970-02-20 00:00:00,Jet International,Landing (descent or approach),Business,United States of America,North America,28,4,0,24,0,0,28,Technical Failure
1970-02-25 00:00:00,Servicios Aéreos Curtiss,Takeoff (climb),Operational,Bolivia,South America,2,2,0,0,0,0,2,Technical Failure
1970-02-26 00:00:00,Aeroflot - Russian International Airlines,Landing (descent or approach),Commercial,Russia,Asia,0,0,0,0,0,0,0,Human Factor
1970-03-02 00:00:00,Ciba-Pilatus Aerial Spraying Company,Flight,Military / Government,South Africa,Africa,1,1,0,0,0,0,1,Unknown
1970-03-04 00:00:00,Pakistan Air Force - Pakistan Fiza'ya,,Military / Government,Pakistan,Asia,0,0,0,0,0,0,0,Unknown
1970-03-05 00:00:00,Aeroflot - Russian International Airlines,Takeoff (climb),Operational,Russia,Asia,5,5,0,0,0,0,5,Human Factor
1970-03-12 00:00:00,Ethiopian Airlines,Landing (descent or approach),Operational,Eritrea,Africa,4,3,0,1,0,0,4,Human Factor
1970-03-14 00:00:00,United Arab Airlines,Landing (descent or approach),Commercial,Egypt,Africa,15,4,0,11,0,0,15,Technical Failure
1970-03-15 00:00:00,Aeropesca Colombia,,Other,Colombia,South America,0,0,0,0,0,0,0,Unknown
1970-03-22 00:00:00,Comisión Federal de Electricidad,,Military / Government,Mexico,Central America,0,0,0,0,0,0,0,Unknown
1970-04-03 00:00:00,United States Air Force - USAF,Landing (descent or approach),Operational,United States of America,North America,9,9,0,0,0,0,9,Unknown
1970-04-07 00:00:00,Britten-Norman,Landing (descent or approach),Operational,India,Asia,2,2,0,0,0,0,2,Other
1970-04-13 00:00:00,Air Taxi Company,Takeoff (climb),Commercial,Iran,Asia,25,2,0,23,0,0,25,Human Factor
1970-04-14 00:00:00,Continental Motors,Landing (descent or approach),Business,United States of America,North America,4,1,0,3,0,0,4,Human Factor
1970-04-16 00:00:00,Mid-Continent Airlines,Takeoff (climb),Operational,United States of America,North America,1,1,0,0,0,0,1,Technical Failure
1970-04-18 00:00:00,Skyway Aviation,Flight,Commercial,United States of America,North America,12,2,0,10,0,0,12,Human Factor
1970-04-19 00:00:00,Scandinavian Airlines System - SAS,Takeoff (climb),Commercial,Italy,Europe,65,11,0,54,0,0,65,Technical Failure
1970-04-24 00:00:00,Aeroflot - Russian International Airlines,Takeoff (climb),Commercial,Russia,Asia,0,0,0,0,0,0,0,Human Factor
1970-04-25 00:00:00,Winner Airways,Landing (descent or approach),Commercial,Vietnam,Asia,0,0,0,0,0,0,0,Unknown
1970-05-03 00:00:00,G. J. Douglas,Takeoff (climb),Business,Mexico,Central America,6,2,0,4,0,0,6,Unknown
1970-05-03 00:00:00,Wardair Canada,Landing (descent or approach),Commercial,Canada,North America,0,0,0,0,0,0,0,Unknown
1970-05-04 00:00:00,Aeroflot - Russian International Airlines,Flight,Other,Armenia,Asia,0,0,0,0,0,0,0,Human Factor
1970-05-05 00:00:00,North Slope Supply Company,Landing (descent or approach),Operational,United States of America,North America,3,3,0,0,0,0,3,Human Factor
1970-05-06 00:00:00,Arabesco Airlines,Takeoff (climb),Operational,United States of America,North America,2,2,0,0,0,0,2,Human Factor
1970-05-07 00:00:00,Domaire,Takeoff (climb),Operational,Dominican Republic,Central America,2,2,0,0,0,0,2,Technical Failure
1970-05-09 00:00:00,Delta Air Transport - DAT,Taxiing,Commercial,Netherlands,Europe,0,0,0,0,0,0,0,Human Factor
1970-05-10 00:00:00,Argentinian Air Force - Fuerza Aérea Argentina,Takeoff (climb),Operational,Argentina,South America,16,2,0,14,0,0,16,Unknown
1970-05-21 00:00:00,Club Aire,Flight,Business,United States of America,North America,3,2,0,1,0,0,3,Human Factor
1970-05-25 00:00:00,United States Air Force - USAF,Taxiing,Military / Government,United States of America,North America,5,5,0,0,0,0,5,Technical Failure
1970-05-25 00:00:00,United States Army,Landing (descent or approach),Military / Government,Vietnam,Asia,0,0,0,0,0,0,0,Unknown
1970-06-03 00:00:00,SAETA - Sociedad Anonima Ecuatoriana de Transportes Aéreos,Landing (descent or approach),Commercial,Ecuador,South America,0,0,0,0,0,0,0,Unknown
1970-06-04 00:00:00,Zamrud Aviation,,Operational,Indonesia,Asia,0,0,0,0,0,0,0,Unknown
1970-06-04 00:00:00,Royal Air Force - RAF,Landing (descent or approach),Operational,United Kingdom,Europe,5,5,0,0,0,0,5,Human Factor
1970-06-05 00:00:00,Aeroflot - Russian International Airlines,Takeoff (climb),Commercial,Uzbekistan,Asia,0,0,0,0,0,0,0,Human Factor
1970-06-07 00:00:00,Indian Airlines,Landing (descent or approach),Commercial,India,Asia,39,4,0,35,0,0,39,Human Factor
1970-06-07 00:00:00,International Aerodyne,Landing (descent or approach),Operational,Argentina,South America,5,5,0,0,0,0,5,Technical Failure
1970-06-08 00:00:00,French Air Force - Armée de l'Air,Flight,Military / Government,France,Europe,0,0,0,0,0,0,0,Unknown
1970-06-13 00:00:00,Conner Air Lines,Takeoff (climb),Operational,Puerto Rico,Central America,2,2,0,0,0,0,2,Human Factor
1970-06-15 00:00:00,J. H. Upton,Takeoff (climb),Business,United States of America,North America,1,1,0,0,0,0,1,Human Factor
1970-06-19 00:00:00,Austin Airways,Takeoff (climb),Commercial,Canada,North America,18,3,0,15,0,0,18,Unknown
1970-06-22 00:00:00,Reeve Aleutian Airways - RAA,Landing (descent or approach),Commercial,United States of America,North America,4,1,0,3,0,0,4,Other
1970-06-26 00:00:00,Rockwell Aircraft,Flight,Specialised Services,United States of America,North America,3,3,0,0,0,0,3,Technical Failure
1970-06-30 00:00:00,Kollmorgen Corp.,Takeoff (climb),Business,United States of America,North America,1,1,0,0,0,0,1,Human Factor
1970-07-01 00:00:00,Philippine Airlines - PAL,Landing (descent or approach),Commercial,Philippines,Asia,29,3,0,26,0,0,29,Unknown
1970-07-02 00:00:00,United Arab Emirates - Abu Dhabi Amiri Flight,Flight,Military / Government,United Arab Emirates,Asia,0,0,0,0,0,0,0,Unknown
1970-07-06 00:00:00,Spanish Air Force - Ejército del Aire,,Military / Government,Spain,Europe,0,0,0,0,0,0,0,Unknown
1970-07-10 00:00:00,BVBA Gebroeders,Landing (descent or approach),Business,Belgium,Europe,0,0,0,0,0,0,0,Unknown
1970-07-12 00:00:00,Aerotransportes Entre Rios,Landing (descent or approach),Operational,Argentina,South America,12,4,0,8,0,0,12,Human Factor
1970-07-12 00:00:00,Rentavia,,Business,Belgium,Europe,0,0,0,0,0,0,0,Unknown
1970-07-14 00:00:00,TAM Bolivia - Transporte Aéreo Militar Boliviano,Flight,Military / Government,Bolivia,South America,0,0,0,0,0,0,0,Unknown
1970-07-15 00:00:00,A. L. Gaffray,Landing (descent or approach),Business,Canada,North America,1,1,0,0,0,0,1,Technical Failure
1970-07-15 00:00:00,Servicios Aéreos Bolivianos - SAB,,Commercial,Bolivia,South America,0,0,0,0,0,0,0,Unknown
1970-07-15 00:00:00,SODEMAC,Landing (descent or approach),Operational,Democratic Republic of Congo,Africa,0,0,0,0,0,0,0,Unknown
1970-07-19 00:00:00,United Airlines,Takeoff (climb),Commercial,United States of America,North America,61,6,0,55,0,0,61,Technical Failure
1970-07-20 00:00:00,Tramaco Services,,Commercial,Democratic Republic of Congo,Africa,0,0,0,0,0,0,0,Unknown
1970-07-23 00:00:00,Xieng Khouang Air Transport,Landing (descent or approach),Commercial,Laos,Asia,0,0,0,0,0,0,0,Unknown
1970-07-25 00:00:00,Private American,Takeoff (climb),Business,United States of America,North America,3,1,0,2,0,0,3,Technical Failure
1970-07-25 00:00:00,Aeroflot - Russian International Airlines,Flight,Commercial,Russia,Asia,0,0,0,0,0,0,0,Technical Failure
1970-07-26 00:00:00,ARCO Bermuda,Landing (descent or approach),Operational,Ivory Coast,Africa,4,4,0,0,0,0,4,Technical Failure
1970-07-27 00:00:00,Rosenbalm Aviation,Flight,Humanitarian,United States of America,North America,2,2,0,0,0,0,2,Technical Failure
1970-08-02 00:00:00,Parachutes,Takeoff (climb),Humanitarian,United States of America,North America,10,1,0,9,0,0,10,Human Factor
1970-08-04 00:00:00,United States Air Force - USAF,Landing (descent or approach),Military / Government,Puerto Rico,Central America,0,0,0,0,0,0,0,Unknown
1970-08-08 00:00:00,K Airways,Landing (descent or approach),Commercial,United States of America,North America,9,1,0,8,0,0,9,Technical Failure
1970-08-08 00:00:00,Modern Air Transport - MAT,Landing (descent or approach),Operational,Mexico,Central America,8,8,0,0,0,0,8,Human Factor
1970-08-09 00:00:00,Aeroflot - Russian International Airlines,Flight,Other,Ukraine,Europe,0,0,0,0,0,0,0,Human Factor
1970-08-10 00:00:00,Argentinian Air Force - Fuerza Aérea Argentina,,Military / Government,Argentina,South America,0,0,0,0,0,0,0,Unknown
1970-08-18 00:00:00,Aviation Equipment Corporation of America,Landing (descent or approach),Operational,United States of America,North America,2,2,0,0,0,0,2,Human Factor
1970-08-18 00:00:00,CSA Czech Airlines - Československé Státní Aerolinie,Landing (descent or approach),Commercial,Switzerland,Europe,20,6,0,14,0,0,20,Human Factor
1970-08-20 00:00:00,Aeroflot - Russian International Airlines,Flight,Commercial,Uzbekistan,Asia,0,0,0,0,0,0,0,Technical Failure
1970-08-20 00:00:00,United States Air Force - USAF,,Military / Government,United States of America,North America,0,0,0,0,0,0,0,Unknown
1970-08-22 00:00:00,Cruzeiro do Sul,,Commercial,Brazil,South America,0,0,0,0,0,0,0,Unknown
1970-08-23 00:00:00,Aeroflot - Russian International Airlines,Landing (descent or approach),Commercial,Russia,Asia,0,0,0,0,0,0,0,Human Factor
1970-08-24 00:00:00,Universal Airlines,Takeoff (climb),Operational,United States of America,North America,3,3,0,0,0,0,3,Human Factor
1970-09-02 00:00:00,Japan Air Self-Defense Force - Kōkū Jieitai,,Military / Government,Japan,Asia,0,0,0,0,0,0,0,Unknown
1970-09-07 00:00:00,Walter Gehlaar,Takeoff (climb),Business,United States of America,North America,7,1,0,6,0,0,7,Human Factor
1970-09-15 00:00:00,Alitalia - Linee Aeree Italiane,Landing (descent or approach),Commercial,United States of America,North America,156,10,0,146,0,0,156,Human Factor
1970-09-16 00:00:00,British Army Air Corps,Takeoff (climb),Military / Government,United Arab Emirates,Asia,0,0,0,0,0,0,0,Unknown
1970-09-27 00:00:00,Aeroflot - Russian International Airlines,Landing (descent or approach),Commercial,Russia,Asia,0,0,0,0,0,0,0,Human Factor
1970-09-29 00:00:00,Lindner Aviation,Parking,Operational,United States of America,North America,2,2,0,0,0,0,2,Human Factor
1970-10-02 00:00:00,Kodiak Airways,Takeoff (climb),Operational,United States of America,North America,1,1,0,0,0,0,1,Human Factor
1970-10-02 00:00:00,Spantax,,Commercial,Spain,Europe,0,0,0,0,0,0,0,Unknown
1970-10-03 00:00:00,Baldwinsville Building Supply Company,Takeoff (climb),Business,United States of America,North America,1,1,0,0,0,0,1,Technical Failure
1970-10-06 00:00:00,Buffalo Airways,Takeoff (climb),Operational,Canada,North America,1,1,0,0,0,0,1,Human Factor
1970-10-06 00:00:00,Private Iranian,Flight,Business,Iran,Asia,2,2,0,0,0,0,2,Technical Failure
1970-10-07 00:00:00,Dan-Air London,Landing (descent or approach),Operational,United Kingdom,Europe,11,11,0,0,0,0,11,Human Factor
1970-10-07 00:00:00,Transair Canada,Flight,Commercial,Canada,North America,0,0,0,0,0,0,0,Unknown
1970-10-08 00:00:00,United States Navy - USN,Landing (descent or approach),Military / Government,Antarctica,Antarctica,80,12,0,68,0,0,80,Human Factor
1970-10-12 00:00:00,Luftfahrt-Service,Takeoff (climb),Commercial,France,Europe,8,2,0,6,0,0,8,Unknown
1970-10-13 00:00:00,LBK Investments Company,Takeoff (climb),Business,United States of America,North America,4,1,0,3,0,0,4,Human Factor
1970-10-14 00:00:00,Aeroflot - Russian International Airlines,Flight,Commercial,Ukraine,Europe,0,0,0,0,0,0,0,Human Factor
1970-10-16 00:00:00,Aeroflot - Russian International Airlines,Landing (descent or approach),Commercial,Ukraine,Europe,0,0,0,0,0,0,0,Technical Failure
1970-10-16 00:00:00,Aeroflot - Russian International Airlines,Takeoff (climb),Operational,Russia,Asia,0,0,0,0,0,0,0,Other
1970-10-22 00:00:00,Pan Alaska Airways,Flight,Operational,United States of America,North America,2,2,0,0,0,0,2,Technical Failure
1970-10-28 00:00:00,American Aviation,Takeoff (climb),Commercial,United States of America,North America,8,1,0,7,0,0,8,Other
1970-11-01 00:00:00,Air Vietnam,Flight,Commercial,Vietnam,Asia,0,0,0,0,0,0,0,Technical Failure
1970-11-02 00:00:00,Valley Airlines,Landing (descent or approach),Commercial,United States of America,North America,4,2,0,2,0,0,4,Human Factor
1970-11-04 00:00:00,Aerolinee Itavia,Landing (descent or approach),Operational,Italy,Europe,2,2,0,0,0,0,2,Technical Failure
1970-11-05 00:00:00,Olympic Airways,Landing (descent or approach),Commercial,Greece,Europe,67,5,0,62,0,0,67,Technical Failure
1970-11-06 00:00:00,Government of New Zealand,Takeoff (climb),Operational,New Zealand,Oceania,2,2,0,0,0,0,2,Human Factor
1970-11-09 00:00:00,Mississippi Valley Airlines,Landing (descent or approach),Commercial,United States of America,North America,6,2,0,4,0,0,6,Human Factor
1970-11-12 00:00:00,Rambar Aviation,Landing (descent or approach),Commercial,United States of America,North America,7,2,0,5,0,0,7,Human Factor
1970-11-14 00:00:00,Antilles Air Boats,Landing (descent or approach),Commercial,United States of America,Central America,2,2,0,0,0,0,2,Technical Failure
1970-11-14 00:00:00,CAAC - Civil Aviation Administration of China,,Other,China,Asia,0,0,0,0,0,0,0,Unknown
1970-11-16 00:00:00,Transportes Aéreos Latin America,Landing (descent or approach),Operational,Argentina,South America,4,4,0,0,0,0,4,Technical Failure
1970-11-29 00:00:00,Aeroflot - Russian International Airlines,Flight,Commercial,Russia,Asia,0,0,0,0,0,0,0,Human Factor
1970-11-30 00:00:00,Trans World Airlines - TWA,Takeoff (climb),Operational,Israel,Asia,3,3,0,0,0,0,3,Human Factor
1970-12-06 00:00:00,LASA - Engenharia e Prospecções,Flight,Business,Costa Rica,Central America,0,0,0,0,0,0,0,Unknown
1970-12-15 00:00:00,SAATAS - East Indonesian Air Charter,Takeoff (climb),Commercial,Indonesia,Asia,0,0,0,0,0,0,0,Technical Failure
1970-12-16 00:00:00,Instituto Nacional de Aviación Civil,,Military / Government,Argentina,South America,0,0,0,0,0,0,0,Unknown
1970-12-17 00:00:00,Aeroflot - Russian International Airlines,Flight,Commercial,Russia,Asia,0,0,0,0,0,0,0,Technical Failure
1970-12-18 00:00:00,General Air,Flight,Operational,Netherlands,Europe,2,2,0,0,0,0,2,Technical Failure
1970-12-19 00:00:00,Aerolineas Argentinas,Landing (descent or approach),Commercial,Argentina,South America,28,4,0,24,0,0,28,Unknown
1970-12-20 00:00:00,Sobelair,Landing (descent or approach),Operational,Spain,Europe,7,7,0,0,0,0,7,Technical Failure
1970-12-23 00:00:00,Fontana Aviation,Landing (descent or approach),Operational,United States of America,North America,2,2,0,0,0,0,2,Weather
1970-12-29 00:00:00,Air Libya,Takeoff (climb),Commercial,Libya,Africa,6,1,0,5,0,0,6,Technical Failure
1970-12-30 00:00:00,Zambia Airways,Landing (descent or approach),Commercial,Zambia,Africa,0,0,0,0,0,0,0,Unknown
1971-01-04 00:00:00,Federal Aviation Administration - FAA,Landing (descent or approach),Specialised Services,United States of America,North America,2,2,0,0,0,0,2,Weather
1971-01-10 00:00:00,Iraq Petroleum Transport Company,,Business,Iraq,Asia,0,0,0,0,0,0,0,Unknown
1971-01-12 00:00:00,Rio Airways,Landing (descent or approach),Commercial,United States of America,North America,15,2,0,13,0,0,15,Human Factor
1971-01-13 00:00:00,United States Air Force - USAF,Flight,Military / Government,Vietnam,Asia,4,4,0,0,0,0,4,Human Factor
1971-01-21 00:00:00,Aeroflot - Russian International Airlines,Flight,Commercial,Russia,Asia,0,0,0,0,0,0,0,Technical Failure
1971-01-22 00:00:00,Ghana Airways,Landing (descent or approach),Operational,Ghana,Africa,3,3,0,0,0,0,3,Human Factor
1971-01-23 00:00:00,Air India,Takeoff (climb),Operational,India,Asia,5,5,0,0,0,0,5,Human Factor
1971-01-29 00:00:00,Kysor Industrial Corporation,Landing (descent or approach),Business,United States of America,North America,3,1,0,2,0,0,3,Human Factor
1971-02-02 00:00:00,Indian Airlines,Parking,Commercial,Pakistan,Asia,32,4,0,28,0,0,32,Terrorism
1971-02-07 00:00:00,Aeroflot - Russian International Airlines,Landing (descent or approach),Commercial,Russia,Asia,0,0,0,0,0,0,0,Unknown
1971-02-10 00:00:00,Reeve Aleutian Airways - RAA,Landing (descent or approach),Operational,United States of America,North America,2,2,0,0,0,0,2,Human Factor
1971-02-14 00:00:00,Patterson McCarthy Leasing,Takeoff (climb),Commercial,United States of America,North America,29,2,0,27,0,0,29,Technical Failure
1971-02-14 00:00:00,Aerospace Products,Takeoff (climb),Humanitarian,United States of America,North America,11,1,0,10,0,0,11,Human Factor
1971-02-14 00:00:00,All Nippon Airways,,Operational,Japan,Asia,0,0,0,0,0,0,0,Unknown
1971-02-14 00:00:00,All Nippon Airways,,Operational,Japan,Asia,0,0,0,0,0,0,0,Unknown
1971-02-15 00:00:00,United States Navy - USN,Takeoff (climb),Military / Government,Antarctica,Antarctica,0,0,0,0,0,0,0,Human Factor
1971-02-16 00:00:00,Aeroflot - Russian International Airlines,Landing (descent or approach),Operational,Russia,Asia,5,5,0,0,0,0,5,Human Factor
1971-02-18 00:00:00,Hawkins Construction Company,Landing (descent or approach),Business,United States of America,North America,4,1,0,3,0,0,4,Human Factor
1971-02-19 00:00:00,E. W. Brown,Takeoff (climb),Specialised Services,United States of America,North America,2,2,0,0,0,0,2,Human Factor
1971-02-22 00:00:00,Lucille Rushing,Flight,Business,Guyana,South America,0,0,0,0,0,0,0,Unknown
1971-02-27 00:00:00,Royal Air Lao,Landing (descent or approach),Commercial,Laos,Asia,0,0,0,0,0,0,0,Unknown
1971-02-28 00:00:00,Air Afrique,Landing (descent or approach),Operational,Chad,Africa,3,3,0,0,0,0,3,Human Factor
1971-03-02 00:00:00,Aerovias Las Minas,,Commercial,Bolivia,South America,0,0,0,0,0,0,0,Unknown
1971-03-02 00:00:00,Transportes Aéreos Orientales - TAO,,Commercial,Ecuador,South America,0,0,0,0,0,0,0,Unknown
1971-03-05 00:00:00,Norte Taxi Aéreo,,Commercial,Brazil,South America,0,0,0,0,0,0,0,Unknown
1971-03-11 00:00:00,Federal Aviation Administration - FAA,Takeoff (climb),Specialised Services,United States of America,North America,3,3,0,0,0,0,3,Human Factor
1971-03-18 00:00:00,British Air Ferries - BAF,Landing (descent or approach),Commercial,France,Europe,18,7,0,11,0,0,18,Technical Failure
1971-03-19 00:00:00,United States Air Force - USAF,Landing (descent or approach),Military / Government,Vietnam,Asia,4,4,0,0,0,0,4,Technical Failure
1971-03-22 00:00:00,Saint-Félicien Air Service,Landing (descent or approach),Commercial,Canada,North America,4,1,0,3,0,0,4,Unknown
1971-03-25 00:00:00,Italian Air Force - Aeronautica Militare Italiana,Landing (descent or approach),Military / Government,Italy,Europe,0,0,0,0,0,0,0,Unknown
1971-03-26 00:00:00,Vanderpool Flying Service,Landing (descent or approach),Business,United States of America,North America,2,2,0,0,0,0,2,Other
1971-03-30 00:00:00,SATENA - Servicio de Aeronavegacion a Territorios Nacionales,,Military / Government,Colombia,South America,0,0,0,0,0,0,0,Unknown
1971-03-31 00:00:00,Aeroflot - Russian International Airlines,Landing (descent or approach),Operational,Russia,Asia,5,5,0,0,0,0,5,Human Factor
1971-04-01 00:00:00,Merpati Nusantara Airlines - MNA,Takeoff (climb),Operational,Indonesia,Asia,3,3,0,0,0,0,3,Unknown
1971-04-02 00:00:00,Continental Air Services,Flight,Commercial,Laos,Asia,0,0,0,0,0,0,0,Unknown
1971-04-04 00:00:00,Nigeria Airways,Landing (descent or approach),Commercial,Nigeria,Africa,41,3,0,38,0,0,41,Human Factor
1971-04-05 00:00:00,Vinair,Landing (descent or approach),Operational,British Virgin Islands,Central America,3,2,0,1,0,0,3,Human Factor
1971-04-06 00:00:00,Kenyan Government,Landing (descent or approach),Specialised Services,Kenya,Africa,3,3,0,0,0,0,3,Unknown
1971-04-11 00:00:00,Aeroflot - Russian International Airlines,Takeoff (climb),Commercial,Turkmenistan,Asia,0,0,0,0,0,0,0,Unknown
1971-04-15 00:00:00,Continental Air Services,Flight,Military / Government,Laos,Asia,0,0,0,0,0,0,0,Technical Failure
1971-04-20 00:00:00,Air America,Flight,Military / Government,Thailand,Asia,3,1,0,2,0,0,3,Unknown
1971-04-24 00:00:00,Airland,Landing (descent or approach),Operational,New Zealand,Oceania,1,1,0,0,0,0,1,Technical Failure
1971-04-28 00:00:00,Private American,Landing (descent or approach),Business,United States of America,North America,1,1,0,0,0,0,1,Human Factor
1971-04-29 00:00:00,Aeroflot - Russian International Airlines,Flight,Commercial,Ukraine,Europe,0,0,0,0,0,0,0,Technical Failure
1971-05-04 00:00:00,United States Air Force - USAF,Flight,Military / Government,Vietnam,Asia,5,2,0,3,0,0,5,Terrorism
1971-05-04 00:00:00,TAM Bolivia - Transporte Aéreo Militar Boliviano,Takeoff (climb),Military / Government,Bolivia,South America,3,2,0,1,0,0,3,Unknown
1971-05-06 00:00:00,Rainy Lake Airways,Landing (descent or approach),Commercial,Canada,North America,6,1,0,5,0,0,6,Unknown
1971-05-07 00:00:00,Thai Airways International,Landing (descent or approach),Commercial,Thailand,Asia,21,3,0,18,0,0,21,Unknown
1971-05-10 00:00:00,Japan Air Self-Defense Force - Kōkū Jieitai,Landing (descent or approach),Operational,Japan,Asia,2,2,0,0,0,0,2,Unknown
1971-05-13 00:00:00,Northwest Territorial Airways,Landing (descent or approach),Operational,Canada,North America,2,2,0,0,0,0,2,Human Factor
1971-05-14 00:00:00,United States Government,Takeoff (climb),Military / Government,United States of America,North America,3,3,0,0,0,0,3,Technical Failure
1971-05-15 00:00:00,Río Táxi Aéreo,Landing (descent or approach),Operational,Brazil,South America,2,2,0,0,0,0,2,Technical Failure
1971-05-15 00:00:00,JAT Yugoslav Airlines - Jugoslovenski Aerotransport,Landing (descent or approach),Commercial,Montenegro,Europe,0,0,0,0,0,0,0,Unknown
1971-05-17 00:00:00,Windward Island Airways,Landing (descent or approach),Commercial,Netherlands,Central America,0,0,0,0,0,0,0,Weather
1971-05-19 00:00:00,Village Airways,Landing (descent or approach),Operational,United States of America,North America,2,2,0,0,0,0,2,Weather
1971-05-24 00:00:00,Spanish Air Force - Ejército del Aire,Flight,Military / Government,Portugal,Europe,6,6,0,0,0,0,6,Unknown
1971-05-24 00:00:00,Aeroflot - Russian International Airlines,Takeoff (climb),Commercial,Russia,Asia,0,0,0,0,0,0,0,Other
1971-05-25 00:00:00,Aeroflot - Russian International Airlines,Landing (descent or approach),Operational,Russia,Asia,8,6,0,2,0,0,8,Technical Failure
1971-05-27 00:00:00,Argentinian Air Force - Fuerza Aérea Argentina,,Military / Government,Argentina,South America,0,0,0,0,0,0,0,Unknown
1971-06-01 00:00:00,Aeroflot - Russian International Airlines,Flight,Operational,Russia,Asia,5,5,0,0,0,0,5,Human Factor
1971-06-03 00:00:00,Moormanair,Landing (descent or approach),Commercial,United Kingdom,Europe,36,4,0,32,0,0,36,Human Factor
1971-06-13 00:00:00,Air Taxi Company,,Commercial,Iran,Asia,0,0,0,0,0,0,0,Unknown
1971-06-15 00:00:00,Private Canadian,Takeoff (climb),Business,Canada,North America,6,1,0,5,0,0,6,Unknown
1971-06-18 00:00:00,Private Canadian,,Business,Canada,North America,0,0,0,0,0,0,0,Unknown
1971-06-25 00:00:00,West End International,Takeoff (climb),Business,United States of America,North America,1,1,0,0,0,0,1,Technical Failure
1971-06-30 00:00:00,Lao Airlines,,Commercial,Laos,Asia,0,0,0,0,0,0,0,Unknown
1971-07-03 00:00:00,Soviet Navy - Voyenno-morskoy flot CCCP,Parking,Military / Government,Russia,Asia,0,0,0,0,0,0,0,Human Factor
1971-07-05 00:00:00,General Transportation Company,Landing (descent or approach),Operational,United States of America,North America,2,2,0,0,0,0,2,Human Factor
1971-07-12 00:00:00,Aero Union,Flight,Humanitarian,United States of America,North America,2,2,0,0,0,0,2,Technical Failure
1971-07-15 00:00:00,Private American,Flight,Business,United States of America,North America,4,1,0,3,0,0,4,Technical Failure
1971-07-15 00:00:00,Portuguese Air Force - Força Aerea Portuguesa,Flight,Military / Government,Angola,Africa,0,0,0,0,0,0,0,Unknown
1971-07-16 00:00:00,New England Propeller Service,Landing (descent or approach),Operational,United States of America,North America,3,3,0,0,0,0,3,Human Factor
1971-07-22 00:00:00,Iraqi Government,Landing (descent or approach),Military / Government,Saudi Arabia,Asia,0,0,0,0,0,0,0,Unknown
1971-07-28 00:00:00,Aeroflot - Russian International Airlines,Landing (descent or approach),Commercial,Russia,Asia,0,0,0,0,0,0,0,Human Factor
1971-07-29 00:00:00,Gilley Airways,Flight,Operational,United States of America,North America,2,2,0,0,0,0,2,Technical Failure
1971-07-29 00:00:00,Aeroflot - Russian International Airlines,Landing (descent or approach),Operational,India,Asia,7,7,0,0,0,0,7,Human Factor
1971-07-30 00:00:00,Raymond A. Conant,,Business,Canada,North America,0,0,0,0,0,0,0,Unknown
1971-07-31 00:00:00,French Navy,Landing (descent or approach),Operational,France,Europe,2,2,0,0,0,0,2,Unknown
1971-08-07 00:00:00,Argentinian Air Force - Fuerza Aérea Argentina,Takeoff (climb),Military / Government,Argentina,South America,0,0,0,0,0,0,0,Technical Failure
1971-08-08 00:00:00,Aloha Airlines,Landing (descent or approach),Commercial,United States of America,North America,25,3,0,22,0,0,25,Technical Failure
1971-08-09 00:00:00,Indian Airlines,Landing (descent or approach),Commercial,India,Asia,27,4,0,23,0,0,27,Human Factor
1971-08-20 00:00:00,Allegheny Airlines,Landing (descent or approach),Commercial,United States of America,North America,53,3,0,50,0,0,53,Technical Failure
1971-08-21 00:00:00,Indian Air Force - Bharatiya Vayu Sena,,Military / Government,India,Asia,0,0,0,0,0,0,0,Unknown
1971-08-24 00:00:00,Sociedad Angolana de Taxis Aéreos,Flight,Operational,Angola,Africa,1,1,0,0,0,0,1,Technical Failure
1971-09-06 00:00:00,Royal Australian Air Force - RAAF,Landing (descent or approach),Military / Government,Australia,Oceania,0,0,0,0,0,0,0,Technical Failure
1971-09-11 00:00:00,Youngstown Cartage Company,Landing (descent or approach),Business,United States of America,North America,6,2,0,4,0,0,6,Human Factor
1971-09-12 00:00:00,Transportes Aéreos Mercantiles Ecuatorianos - TAME,Flight,Commercial,Ecuador,South America,0,0,0,0,0,0,0,Unknown
1971-09-16 00:00:00,ALG Aeroleasing,Landing (descent or approach),Operational,Switzerland,Europe,2,2,0,0,0,0,2,Human Factor
1971-09-17 00:00:00,Air Caicos,Landing (descent or approach),Business,United States of America,North America,2,2,0,0,0,0,2,Human Factor
1971-09-25 00:00:00,Aeroflot - Russian International Airlines,Flight,Commercial,Russia,Asia,0,0,0,0,0,0,0,Technical Failure
1971-09-27 00:00:00,Banco Real,Takeoff (climb),Business,Brazil,South America,5,1,0,4,0,0,5,Unknown
1971-09-27 00:00:00,RCMP - GRC Air Services,Flight,Military / Government,Canada,North America,0,0,0,0,0,0,0,Unknown
1971-10-02 00:00:00,Island Gem Enterprises,Landing (descent or approach),Operational,Netherlands,Central America,3,2,0,1,0,0,3,Technical Failure
1971-10-07 00:00:00,International Sky Cab Airlines,Flight,Operational,World,World,1,1,0,0,0,0,1,Human Factor
1971-10-12 00:00:00,Aeroflot - Russian International Airlines,Landing (descent or approach),Commercial,Moldova,Europe,0,0,0,0,0,0,0,Unknown
1971-10-15 00:00:00,Aviones de Panama,,Commercial,Panama,Central America,0,0,0,0,0,0,0,Unknown
1971-10-15 00:00:00,Moose Nose Lake Airways,Flight,Commercial,Canada,North America,0,0,0,0,0,0,0,Technical Failure
1971-10-16 00:00:00,Sudanese Government,Takeoff (climb),Military / Government,South Sudan,Africa,7,2,0,5,0,0,7,Unknown
1971-10-17 00:00:00,Aeroflot - Russian International Airlines,Flight,Commercial,Ukraine,Europe,0,0,0,0,0,0,0,Technical Failure
1971-10-22 00:00:00,Europe Aéro Service - EAS,Landing (descent or approach),Operational,France,Europe,3,3,0,0,0,0,3,Human Factor
1971-11-06 00:00:00,Private Colombian,Takeoff (climb),Business,Colombia,South America,0,0,0,0,0,0,0,Unknown
1971-11-07 00:00:00,VASP - Viação Aérea de São Paulo,Landing (descent or approach),Commercial,Brazil,South America,0,0,0,0,0,0,0,Unknown
1971-11-14 00:00:00,Alaska Aeronautical Industries,Landing (descent or approach),Specialised Services,United States of America,North America,2,1,0,1,0,0,2,Technical Failure
1971-11-15 00:00:00,TAROM - Transporturile Aeriene Române,Landing (descent or approach),Commercial,Romania,Europe,22,4,0,18,0,0,22,Human Factor
1971-11-20 00:00:00,Norving,Flight,Commercial,Norway,Europe,0,0,0,0,0,0,0,Unknown
1971-11-20 00:00:00,Michel Duc,Landing (descent or approach),Business,France,Europe,0,0,0,0,0,0,0,Unknown
1971-11-22 00:00:00,Aeroflot - Russian International Airlines,Landing (descent or approach),Commercial,Armenia,Asia,0,0,0,0,0,0,0,Human Factor
1971-11-23 00:00:00,Malaysia-Singapore Airlines - MSA,Landing (descent or approach),Operational,Malaysia,Asia,2,2,0,0,0,0,2,Human Factor
1971-11-29 00:00:00,Mercury Aircraft,Landing (descent or approach),Business,United States of America,North America,1,1,0,0,0,0,1,Human Factor
1971-11-29 00:00:00,Sterling Airways,Takeoff (climb),Operational,Denmark,Europe,2,2,0,0,0,0,2,Unknown
1971-12-01 00:00:00,Continental Air Services,Flight,Commercial,Laos,Asia,0,0,0,0,0,0,0,Unknown
1971-12-04 00:00:00,Overhead Door Company,Landing (descent or approach),Business,United States of America,North America,5,1,0,4,0,0,5,Human Factor
1971-12-09 00:00:00,Aeroflot - Russian International Airlines,Landing (descent or approach),Commercial,Uzbekistan,Asia,0,0,0,0,0,0,0,Weather
1971-12-10 00:00:00,Morris Air Transport,Landing (descent or approach),Business,United States of America,North America,2,1,0,1,0,0,2,Human Factor
1971-12-12 00:00:00,Aeroflot - Russian International Airlines,Flight,Commercial,Russia,Asia,0,0,0,0,0,0,0,Unknown
1971-12-15 00:00:00,Instituto Nacional de Aviación Civil,,Military / Government,Argentina,South America,0,0,0,0,0,0,0,Unknown
1971-12-15 00:00:00,Pakistan International Airlines - PIA,Landing (descent or approach),Operational,China,Asia,5,5,0,0,0,0,5,Human Factor
1971-12-16 00:00:00,Private Austrian,,Business,Ireland,Europe,0,0,0,0,0,0,0,Unknown
1971-12-16 00:00:00,Private Austrian,,Business,Ireland,Europe,0,0,0,0,0,0,0,Unknown
1971-12-19 00:00:00,United States Air Force - USAF,Flight,Military / Government,United States of America,North America,3,3,0,0,0,0,3,Technical Failure
1971-12-21 00:00:00,Vieques Air Link,Landing (descent or approach),Commercial,Puerto Rico,Central America,8,1,0,7,0,0,8,Human Factor
1971-12-24 00:00:00,Richard E. Ross,Landing (descent or approach),Operational,United States of America,North America,2,1,0,1,0,0,2,Human Factor
1971-12-24 00:00:00,Air America,Landing (descent or approach),Commercial,Laos,Asia,5,1,0,4,0,0,5,Unknown
1971-12-27 00:00:00,Universal Aviation Company,Landing (descent or approach),Business,Bahamas,Central America,1,1,0,0,0,0,1,Technical Failure
1971-12-28 00:00:00,Aeroflot - Russian International Airlines,Takeoff (climb),Commercial,Russia,Asia,35,2,0,33,0,0,35,Human Factor
1971-12-28 00:00:00,Air Inter,Takeoff (climb),Operational,France,Europe,2,2,0,0,0,0,2,Human Factor
1971-12-31 00:00:00,Gayle Air,Landing (descent or approach),Commercial,Canada,North America,0,0,0,0,0,0,0,Unknown
1972-01-05 00:00:00,Mackenzie Air Service,,Commercial,Canada,North America,0,0,0,0,0,0,0,Unknown
1972-01-07 00:00:00,Saudi Arabian Airlines - SAUDIA,Landing (descent or approach),Commercial,Saudi Arabia,Asia,15,3,0,12,0,0,15,Technical Failure
1972-01-09 00:00:00,Air Manila International,Landing (descent or approach),Operational,Philippines,Asia,4,4,0,0,0,0,4,Unknown
1972-01-15 00:00:00,United States Navy - USN,Takeoff (climb),Specialised Services,United States of America,North America,3,3,0,0,0,0,3,Technical Failure
1972-01-17 00:00:00,Private American,Takeoff (climb),Business,United States of America,North America,1,1,0,0,0,0,1,Human Factor
1972-01-25 00:00:00,Bakhtar Afghan Airlines,Landing (descent or approach),Commercial,Afghanistan,Asia,0,0,0,0,0,0,0,Human Factor
1972-01-26 00:00:00,Khmer Air Force,,Military / Government,Cambodia,Asia,0,0,0,0,0,0,0,Unknown
1972-01-26 00:00:00,Air Botswana,Flight,Commercial,Botswana,Africa,9,1,0,8,0,0,9,Technical Failure
1972-01-26 00:00:00,Colman %26 Eckert,Landing (descent or approach),Business,Greenland,Europe,2,2,0,0,0,0,2,Technical Failure
1972-01-27 00:00:00,Línea Aérea Taxpa,Landing (descent or approach),Operational,Chile,South America,2,2,0,0,0,0,2,Unknown
1972-01-28 00:00:00,Airwork - UK,Landing (descent or approach),Operational,United Kingdom,Europe,2,2,0,0,0,0,2,Human Factor
1972-01-28 00:00:00,British Caledonian Airways,Landing (descent or approach),Operational,United Kingdom,Europe,4,4,0,0,0,0,4,Unknown
1972-02-01 00:00:00,CSA Czech Airlines - Československé Státní Aerolinie,Landing (descent or approach),Commercial,Czech Republic,Europe,0,0,0,0,0,0,0,Human Factor
1972-02-02 00:00:00,Luthi Aviation,Flight,Operational,United States of America,North America,1,1,0,0,0,0,1,Human Factor
1972-02-02 00:00:00,Aeroactividades Venezolanas,,Commercial,Venezuela,South America,0,0,0,0,0,0,0,Unknown
1972-02-04 00:00:00,Saudi Arabian Airlines - SAUDIA,Landing (descent or approach),Commercial,Yemen,Asia,0,0,0,0,0,0,0,Technical Failure
1972-02-07 00:00:00,Private American,Takeoff (climb),Business,United States of America,North America,9,1,0,8,0,0,9,Weather
1972-02-09 00:00:00,VARIG - Viação Aérea Rio Grandense,Takeoff (climb),Operational,Brazil,South America,2,2,0,0,0,0,2,Human Factor
1972-02-11 00:00:00,Frigorifico Reyes,,Operational,Bolivia,South America,0,0,0,0,0,0,0,Unknown
1972-02-15 00:00:00,Spanish Air Force - Ejército del Aire,,Military / Government,Spain,Europe,0,0,0,0,0,0,0,Unknown
1972-02-20 00:00:00,Fred-Air,Landing (descent or approach),Business,Switzerland,Europe,5,3,0,2,0,0,5,Human Factor
1972-02-21 00:00:00,Smith International,Takeoff (climb),Business,United States of America,North America,5,1,0,4,0,0,5,Technical Failure
1972-02-22 00:00:00,Aeroflot - Russian International Airlines,Landing (descent or approach),Commercial,Russia,Asia,13,4,0,9,0,0,13,Human Factor
1972-02-27 00:00:00,Aeroflot - Russian International Airlines,Landing (descent or approach),Commercial,Russia,Asia,47,4,0,43,0,0,47,Human Factor
1972-03-01 00:00:00,Finnwings,Takeoff (climb),Business,Canada,North America,6,3,0,3,0,0,6,Weather
1972-03-02 00:00:00,Luthi Aviation,Landing (descent or approach),Operational,United States of America,North America,1,1,0,0,0,0,1,Human Factor
1972-03-04 00:00:00,Private American,Flight,Business,United States of America,North America,2,1,0,1,0,0,2,Technical Failure
1972-03-13 00:00:00,United States Air Force - USAF,Landing (descent or approach),Operational,United States of America,North America,5,5,0,0,0,0,5,Human Factor
1972-03-19 00:00:00,Universal Airlines,Landing (descent or approach),Operational,United States of America,North America,3,3,0,0,0,0,3,Technical Failure
1972-03-19 00:00:00,Aeroflot - Russian International Airlines,Landing (descent or approach),Commercial,Russia,Asia,0,0,0,0,0,0,0,Human Factor
1972-03-25 00:00:00,Niles Machine,Takeoff (climb),Business,United States of America,North America,2,1,0,1,0,0,2,Human Factor
1972-03-26 00:00:00,Aeroflot - Russian International Airlines,Flight,Commercial,Russia,Asia,0,0,0,0,0,0,0,Weather
1972-03-29 00:00:00,Air Pacific,Flight,Operational,World,World,2,2,0,0,0,0,2,Technical Failure
1972-03-30 00:00:00,United States Air Force - USAF,Flight,Military / Government,Laos,Asia,15,15,0,0,0,0,15,Terrorism
1972-04-05 00:00:00,Air America,Takeoff (climb),Commercial,Laos,Asia,3,1,0,2,0,0,3,Terrorism
1972-04-07 00:00:00,Royal Air Force - RAF,Landing (descent or approach),Operational,United Kingdom,Europe,7,7,0,0,0,0,7,Unknown
1972-04-10 00:00:00,Inair Panama - Internacional de Aviación,Landing (descent or approach),Operational,Brazil,South America,3,3,0,0,0,0,3,Human Factor
1972-04-11 00:00:00,Trans Australia Airlines - TAA,Landing (descent or approach),Operational,Papua New Guinea,Oceania,3,2,0,1,0,0,3,Technical Failure
1972-04-18 00:00:00,United States Air Force - USAF,Flight,Military / Government,Vietnam,Asia,5,5,0,0,0,0,5,Terrorism
1972-04-19 00:00:00,Jim's Flying Service,Takeoff (climb),Operational,United States of America,North America,1,1,0,0,0,0,1,Human Factor
1972-04-20 00:00:00,Don H. Novas,Takeoff (climb),Business,United States of America,North America,3,1,0,2,0,0,3,Technical Failure
1972-04-20 00:00:00,Trans Island Airways - Bahamas,Landing (descent or approach),Commercial,Bahamas,Central America,0,0,0,0,0,0,0,Technical Failure
1972-04-22 00:00:00,Transportes Aéreos Benianos - TABSA,,Operational,Bolivia,South America,0,0,0,0,0,0,0,Unknown
1972-05-07 00:00:00,Lineas Aéreas La Urraca,Landing (descent or approach),Commercial,Colombia,South America,32,4,0,28,0,0,32,Technical Failure
1972-05-08 00:00:00,United States Air Force - USAF,Landing (descent or approach),Operational,United States of America,North America,6,6,0,0,0,0,6,Weather
1972-05-10 00:00:00,United States Air Force - USAF,Takeoff (climb),Specialised Services,United States of America,North America,2,2,0,0,0,0,2,Technical Failure
1972-05-10 00:00:00,Sudan Airways,Landing (descent or approach),Operational,Sudan,Africa,4,4,0,0,0,0,4,Technical Failure
1972-05-12 00:00:00,Aeroflot - Russian International Airlines,Flight,Commercial,Russia,Asia,0,0,0,0,0,0,0,Technical Failure
1972-05-18 00:00:00,Eastern Airlines,Landing (descent or approach),Commercial,United States of America,North America,10,4,0,6,0,0,10,Human Factor
1972-05-20 00:00:00,RCR Development Company,Takeoff (climb),Humanitarian,United States of America,North America,10,1,0,9,0,0,10,Human Factor
1972-05-23 00:00:00,Sabourin Lake Airways,Flight,Commercial,Canada,North America,0,0,0,0,0,0,0,Unknown
1972-05-29 00:00:00,Aerotaxi Servicios Aéreos,Takeoff (climb),Commercial,Colombia,South America,7,1,0,6,0,0,7,Human Factor
1972-06-10 00:00:00,Private American,Takeoff (climb),Business,United States of America,North America,1,1,0,0,0,0,1,Human Factor
1972-06-15 00:00:00,Transportes Aéreos de Tete,Landing (descent or approach),Commercial,Mozambique,Africa,4,1,0,3,0,0,4,Unknown
1972-06-16 00:00:00,Egyptair,Landing (descent or approach),Commercial,Egypt,Africa,59,12,0,47,0,0,59,Human Factor
1972-06-26 00:00:00,Royal Navy,Flight,Military / Government,United Kingdom,Europe,11,3,0,8,0,0,11,Human Factor
1972-06-28 00:00:00,Aeroflot - Russian International Airlines,Flight,Military / Government,Kazakhstan,Asia,2,2,0,0,0,0,2,Human Factor
1972-07-02 00:00:00,Rousseau Aviation,Landing (descent or approach),Operational,Greenland,Europe,0,0,0,0,0,0,0,Unknown
1972-07-07 00:00:00,Lost River Mining Corp,Takeoff (climb),Business,United States of America,North America,2,2,0,0,0,0,2,Human Factor
1972-07-07 00:00:00,Cambodia Air Commercial,Landing (descent or approach),Operational,Cambodia,Asia,2,2,0,0,0,0,2,Technical Failure
1972-07-10 00:00:00,Saudi Arabian Airlines - SAUDIA,Landing (descent or approach),Commercial,Saudi Arabia,Asia,0,0,0,0,0,0,0,Unknown
1972-07-16 00:00:00,BC Yukon Air Service,Flight,Commercial,Canada,North America,0,0,0,0,0,0,0,Unknown
1972-07-17 00:00:00,GOSNII GA - Gosudarstvenny Issledovatelny Institut Grazhdanskoi Aviatsii,Landing (descent or approach),Specialised Services,Russia,Asia,5,5,0,0,0,0,5,Human Factor
1972-07-17 00:00:00,Ansett Airlines of Papua New Guinea,Landing (descent or approach),Operational,Papua New Guinea,Oceania,2,2,0,0,0,0,2,Technical Failure
1972-07-17 00:00:00,Ansett Airlines of Papua New Guinea,Landing (descent or approach),Operational,Papua New Guinea,Oceania,2,2,0,0,0,0,2,Technical Failure
1972-07-17 00:00:00,United States Navy - USN,Flight,Military / Government,Puerto Rico,Central America,0,0,0,0,0,0,0,Unknown
1972-07-21 00:00:00,Acme Leasing,Landing (descent or approach),Operational,Colombia,South America,2,2,0,0,0,0,2,Human Factor
1972-07-24 00:00:00,Donald R. Robertson,Takeoff (climb),Business,Mexico,Central America,2,1,0,1,0,0,2,Technical Failure
1972-07-26 00:00:00,Beech Aircraft Corporation,Landing (descent or approach),Business,United States of America,North America,2,1,0,1,0,0,2,Human Factor
1972-07-26 00:00:00,French Air Force - Armée de l'Air,Landing (descent or approach),Military / Government,France,Europe,5,2,0,3,0,0,5,Human Factor
1972-07-27 00:00:00,Hawkins %26 Powers Aviation,Landing (descent or approach),Humanitarian,United States of America,North America,2,2,0,0,0,0,2,Technical Failure
1972-07-28 00:00:00,Aeroflot - Russian International Airlines,Flight,Commercial,Russia,Asia,0,0,0,0,0,0,0,Technical Failure
1972-08-01 00:00:00,Lagoon Aviation,Landing (descent or approach),Commercial,Marshall Islands,Oceania,4,1,0,3,0,0,4,Technical Failure
1972-08-03 00:00:00,Beta Leasing,Landing (descent or approach),Business,United States of America,North America,3,1,0,2,0,0,3,Technical Failure
1972-08-04 00:00:00,Aeroflot - Russian International Airlines,Takeoff (climb),Commercial,Russia,Asia,6,6,0,0,0,0,6,Technical Failure
1972-08-04 00:00:00,Mercer Airlines,Takeoff (climb),Operational,United States of America,North America,3,3,0,0,0,0,3,Technical Failure
1972-08-04 00:00:00,Placido Nieves Diaz,Landing (descent or approach),Business,Netherlands,Central America,2,1,0,1,0,0,2,Unknown
1972-08-04 00:00:00,South African Air Force,Takeoff (climb),Military / Government,South Africa,Africa,0,0,0,0,0,0,0,Technical Failure
1972-08-08 00:00:00,American Philippine Indonesian Malaysian Enterprises,Takeoff (climb),Business,Philippines,Asia,12,2,0,10,0,0,12,Human Factor
1972-08-08 00:00:00,United States Navy - USN,Flight,Military / Government,World,World,0,0,0,0,0,0,0,Unknown
1972-08-08 00:00:00,United States Navy - USN,Flight,Military / Government,Japan,Asia,4,4,0,0,0,0,4,Unknown
1972-08-11 00:00:00,Pars Air,Landing (descent or approach),Commercial,Iran,Asia,0,0,0,0,0,0,0,Unknown
1972-08-13 00:00:00,Aeroflot - Russian International Airlines,Flight,Commercial,Russia,Asia,0,0,0,0,0,0,0,Technical Failure
1972-08-15 00:00:00,James E. Stewart,Landing (descent or approach),Business,Monaco,Europe,5,2,0,3,0,0,5,Technical Failure
1972-08-18 00:00:00,Turkish Airlines - THY Türk Hava Yollari,Landing (descent or approach),Commercial,Turkey,Asia,40,3,0,37,0,0,40,Unknown
1972-08-19 00:00:00,Sultan of Oman Air Force,,Military / Government,Oman,Asia,0,0,0,0,0,0,0,Unknown
1972-08-20 00:00:00,Zamrud Aviation,,Operational,Indonesia,Asia,0,0,0,0,0,0,0,Unknown
1972-08-21 00:00:00,Island Airlines,Takeoff (climb),Commercial,United States of America,North America,16,1,0,15,0,0,16,Technical Failure
1972-08-24 00:00:00,Union of Burma Airways,Landing (descent or approach),Commercial,Myanmar,Asia,43,5,0,38,0,0,43,Human Factor
1972-08-26 00:00:00,Aeroflot - Russian International Airlines,Landing (descent or approach),Commercial,Russia,Asia,0,0,0,0,0,0,0,Human Factor
1972-08-26 00:00:00,Air-Glaciers,Flight,Commercial,Switzerland,Europe,0,0,0,0,0,0,0,Unknown
1972-08-29 00:00:00,Lineas Aéreas de Nicaragua - LANICA,Landing (descent or approach),Commercial,Nicaragua,Central America,0,0,0,0,0,0,0,Technical Failure
1972-08-30 00:00:00,Aeroflot - Russian International Airlines,Flight,Operational,Russia,Asia,0,0,0,0,0,0,0,Technical Failure
1972-08-31 00:00:00,Servicios Aéreos Bolivianos - SAB,Takeoff (climb),Operational,Bolivia,South America,3,3,0,0,0,0,3,Unknown
1972-09-03 00:00:00,Transportes Aéreos Benianos - TABSA,Takeoff (climb),Operational,Bolivia,South America,4,2,0,2,0,0,4,Technical Failure
1972-09-08 00:00:00,United States Air Force - USAF,Landing (descent or approach),Military / Government,United States of America,North America,0,0,0,0,0,0,0,Unknown
1972-09-12 00:00:00,Air America,Flight,Operational,Laos,Asia,2,1,0,1,0,0,2,Unknown
1972-09-12 00:00:00,Royal Air Force - RAF,Landing (descent or approach),Military / Government,Norway,Europe,12,12,0,0,0,0,12,Human Factor
1972-09-13 00:00:00,Trans World Airlines - TWA,Takeoff (climb),Operational,United States of America,North America,3,3,0,0,0,0,3,Technical Failure
1972-09-13 00:00:00,Aeroflot - Russian International Airlines,Takeoff (climb),Commercial,Kazakhstan,Asia,0,0,0,0,0,0,0,Human Factor
1972-09-17 00:00:00,Aerolineas Abaroa - ALAS,Takeoff (climb),Operational,Bolivia,South America,4,3,0,1,0,0,4,Human Factor
1972-09-19 00:00:00,Nigeria Airways,Landing (descent or approach),Commercial,Nigeria,Africa,0,0,0,0,0,0,0,Unknown
1972-09-24 00:00:00,Japan Airlines,Landing (descent or approach),Commercial,India,Asia,122,14,0,108,0,0,122,Human Factor
1972-09-24 00:00:00,Austin Airways,Landing (descent or approach),Commercial,Canada,North America,16,3,0,13,0,0,16,Technical Failure
1972-09-25 00:00:00,TAM Bolivia - Transporte Aéreo Militar Boliviano,Landing (descent or approach),Operational,Bolivia,South America,2,2,0,0,0,0,2,Technical Failure
1972-10-01 00:00:00,Rousseau Aviation,,Other,France,Europe,0,0,0,0,0,0,0,Unknown
1972-10-06 00:00:00,Aeroflot - Russian International Airlines,Flight,Commercial,Russia,Asia,0,0,0,0,0,0,0,Technical Failure
1972-10-07 00:00:00,Nasco Leasing Company,Takeoff (climb),Operational,United States of America,North America,2,2,0,0,0,0,2,Human Factor
1972-10-10 00:00:00,Río Táxi Aéreo,Landing (descent or approach),Operational,Brazil,South America,2,2,0,0,0,0,2,Unknown
1972-10-15 00:00:00,Mar Pon Inc.,Landing (descent or approach),Business,United States of America,North America,8,2,0,6,0,0,8,Human Factor
1972-10-15 00:00:00,United States Air Force - USAF,Landing (descent or approach),Military / Government,Thailand,Asia,6,6,0,0,0,0,6,Unknown
1972-10-18 00:00:00,Cruzeiro do Sul,Landing (descent or approach),Commercial,Brazil,South America,0,0,0,0,0,0,0,Human Factor
1972-10-25 00:00:00,Norving,Landing (descent or approach),Commercial,Norway,Europe,0,0,0,0,0,0,0,Unknown
1972-10-28 00:00:00,Centre de Parachutisme de Lille,Flight,Humanitarian,Belgium,Europe,0,0,0,0,0,0,0,Unknown
1972-10-30 00:00:00,Ansett Airlines of Papua New Guinea,Landing (descent or approach),Commercial,Papua New Guinea,Oceania,0,0,0,0,0,0,0,Technical Failure
1972-10-30 00:00:00,Interflug,Landing (descent or approach),Commercial,Germany,Europe,0,0,0,0,0,0,0,Technical Failure
1972-11-01 00:00:00,Yemenia Yemen Airways,Landing (descent or approach),Commercial,Yemen,Asia,0,0,0,0,0,0,0,Unknown
1972-11-04 00:00:00,Aeroflot - Russian International Airlines,Landing (descent or approach),Operational,Russia,Asia,3,3,0,0,0,0,3,Human Factor
1972-11-06 00:00:00,Air America,Flight,Operational,Laos,Asia,4,4,0,0,0,0,4,Terrorism
1972-11-08 00:00:00,Lee's Air Taxi,Landing (descent or approach),Operational,United States of America,North America,1,1,0,0,0,0,1,Technical Failure
1972-11-14 00:00:00,Aeroflot - Russian International Airlines,Flight,Commercial,Russia,Asia,0,0,0,0,0,0,0,Unknown
1972-11-15 00:00:00,Rousseau Aviation,,Commercial,France,Europe,0,0,0,0,0,0,0,Unknown
1972-11-20 00:00:00,JAT Yugoslav Airlines - Jugoslovenski Aerotransport,Landing (descent or approach),Commercial,Serbia,Europe,0,0,0,0,0,0,0,Human Factor
1972-11-21 00:00:00,Aeroflot - Russian International Airlines,Landing (descent or approach),Operational,Russia,Asia,8,6,0,2,0,0,8,Human Factor
1972-11-22 00:00:00,United States Air Force - USAF,Flight,Military / Government,Thailand,Asia,6,6,0,0,0,0,6,Terrorism
1972-11-22 00:00:00,Aeroflot - Russian International Airlines,Takeoff (climb),Commercial,Russia,Asia,18,3,0,15,0,0,18,Weather
1972-11-28 00:00:00,Philippine Airlines - PAL,Landing (descent or approach),Commercial,Philippines,Asia,28,4,0,24,0,0,28,Human Factor
1972-12-03 00:00:00,Aeroflot - Russian International Airlines,Flight,Commercial,Russia,Asia,0,0,0,0,0,0,0,Technical Failure
1972-12-05 00:00:00,Latin Carga - Latinamericana Aérea de Carga,Landing (descent or approach),Operational,Colombia,South America,3,3,0,0,0,0,3,Unknown
1972-12-06 00:00:00,Superior Airways,Flight,Operational,Canada,North America,3,3,0,0,0,0,3,Human Factor
1972-12-12 00:00:00,Marathon Oil Corp.,Landing (descent or approach),Business,United States of America,North America,7,2,0,5,0,0,7,Human Factor
1972-12-14 00:00:00,Private Guatemalan,Landing (descent or approach),Business,United States of America,North America,1,1,0,0,0,0,1,Human Factor
1972-12-14 00:00:00,Iraanse Aardolie Exploratie en Productie Mij,Taxiing,Other,Iran,Asia,1,1,0,0,0,0,1,Human Factor
1972-12-15 00:00:00,Linea Aérea Sud Americana,Landing (descent or approach),Operational,Chile,South America,5,5,0,0,0,0,5,Technical Failure
1972-12-18 00:00:00,United States Air Force - USAF,Flight,Military / Government,Thailand,Asia,7,7,0,0,0,0,7,Terrorism
1972-12-19 00:00:00,Indonesian Air Force - TNI-AU Tentara Nasional Indonesia - Angkatan Udara,,Military / Government,Indonesia,Asia,0,0,0,0,0,0,0,Unknown
1972-12-20 00:00:00,Delta Airlines,Taxiing,Commercial,United States of America,North America,93,7,0,86,0,0,93,Human Factor
1972-12-20 00:00:00,Nordair,Flight,Commercial,Canada,North America,0,0,0,0,0,0,0,Unknown
1972-12-20 00:00:00,United States Air Force - USAF,Flight,Military / Government,Thailand,Asia,6,6,0,0,0,0,6,Terrorism
1972-12-21 00:00:00,United States Air Force - USAF,Flight,Military / Government,Vietnam,Asia,6,6,0,0,0,0,6,Terrorism
1972-12-26 00:00:00,Philippine Air Force - Hukbong Himpapawid NG Pilipinas,Flight,Military / Government,Philippines,Asia,0,0,0,0,0,0,0,Terrorism
1972-12-27 00:00:00,United States Air Force - USAF,Landing (descent or approach),Military / Government,Thailand,Asia,6,6,0,0,0,0,6,Terrorism
1972-12-28 00:00:00,Iberia - Lineas Aéreas de Espana,Landing (descent or approach),Operational,Spain,Europe,4,4,0,0,0,0,4,Human Factor
1972-12-31 00:00:00,Aeroflot - Russian International Airlines,Takeoff (climb),Commercial,Russia,Asia,24,3,0,21,0,0,24,Human Factor
1972-12-31 00:00:00,Congolese Air Force - Force Aérienne de la République Démocratique du Congo,,Military / Government,Democratic Republic of Congo,Africa,0,0,0,0,0,0,0,Unknown
1972-12-31 00:00:00,Uruguayan Navy,,Military / Government,Uruguay,South America,0,0,0,0,0,0,0,Unknown
1973-01-03 00:00:00,United States Air Force - USAF,Flight,Military / Government,Vietnam,Asia,6,6,0,0,0,0,6,Terrorism
1973-01-03 00:00:00,Yewlands Engineering Company,Landing (descent or approach),Business,United Kingdom,Europe,2,1,0,1,0,0,2,Human Factor
1973-01-06 00:00:00,Royal Thai Air Force - Kong Thap Akat Thai,Flight,Operational,Thailand,Asia,2,2,0,0,0,0,2,Unknown
1973-01-13 00:00:00,United States Air Force - USAF,Landing (descent or approach),Military / Government,Vietnam,Asia,6,6,0,0,0,0,6,Terrorism
1973-01-19 00:00:00,Trans Nusantara Airways,Landing (descent or approach),Operational,Indonesia,Asia,4,4,0,0,0,0,4,Unknown
1973-01-20 00:00:00,Seaboard International,Takeoff (climb),Operational,United States of America,North America,2,1,0,1,0,0,2,Other
1973-01-20 00:00:00,Servicios Aéreos Bolivianos - SAB,,Operational,Bolivia,South America,0,0,0,0,0,0,0,Unknown
1973-01-25 00:00:00,Reindeer Air Service,Landing (descent or approach),Operational,Canada,North America,2,2,0,0,0,0,2,Unknown
1973-01-28 00:00:00,United States Navy - USN,Landing (descent or approach),Military / Government,Antarctica,Antarctica,8,3,0,5,0,0,8,Unknown
1973-01-29 00:00:00,VASP - Viação Aérea de São Paulo,Landing (descent or approach),Commercial,Brazil,South America,0,0,0,0,0,0,0,Unknown
1973-01-30 00:00:00,Scandinavian Airlines System - SAS,Takeoff (climb),Commercial,Norway,Europe,33,4,0,29,0,0,33,Technical Failure
1973-02-05 00:00:00,Kar-Air - Karhumäki Airways,Flight,Commercial,Finland,Europe,18,3,0,15,0,0,18,Weather
1973-02-10 00:00:00,Investigo Africa,,Commercial,Kenya,Africa,0,0,0,0,0,0,0,Unknown
1973-02-12 00:00:00,Kenting Aviation,Takeoff (climb),Operational,Canada,North America,3,2,0,1,0,0,3,Technical Failure
1973-02-17 00:00:00,Aeroflot - Russian International Airlines,Landing (descent or approach),Commercial,Russia,Asia,0,0,0,0,0,0,0,Unknown
1973-02-27 00:00:00,Vaengir,Landing (descent or approach),Operational,Iceland,Europe,1,1,0,0,0,0,1,Unknown
1973-03-02 00:00:00,Arute International Air,Landing (descent or approach),Commercial,Bahamas,Central America,23,3,0,20,0,0,23,Human Factor
1973-03-02 00:00:00,Argentinian Navy - Armada Argentina,,Military / Government,Argentina,South America,0,0,0,0,0,0,0,Unknown
1973-03-06 00:00:00,Aeroflot - Russian International Airlines,Landing (descent or approach),Operational,Russia,Asia,7,5,0,2,0,0,7,Unknown
1973-03-06 00:00:00,Aeroflot - Russian International Airlines,Flight,Commercial,Russia,Asia,0,0,0,0,0,0,0,Technical Failure
1973-03-07 00:00:00,Joe T. Poston,Flight,Business,United States of America,North America,3,1,0,2,0,0,3,Technical Failure
1973-03-07 00:00:00,Aeroflot - Russian International Airlines,Flight,Commercial,Russia,Asia,0,0,0,0,0,0,0,Technical Failure
1973-03-08 00:00:00,United States Air Force - USAF,Taxiing,Operational,United States of America,North America,5,5,0,0,0,0,5,Human Factor
1973-03-09 00:00:00,Golden West Airlines,Landing (descent or approach),Business,United States of America,North America,7,2,0,5,0,0,7,Human Factor
1973-03-11 00:00:00,Aeroflot - Russian International Airlines,Landing (descent or approach),Military / Government,Russia,Asia,0,0,0,0,0,0,0,Technical Failure
1973-03-16 00:00:00,Khmer Air Force,Takeoff (climb),Military / Government,Cambodia,Asia,1,1,0,0,0,0,1,Unknown
1973-03-29 00:00:00,James Aviation,Flight,Military / Government,New Zealand,Oceania,1,1,0,0,0,0,1,Unknown
1973-03-31 00:00:00,Portuguese Air Force - Força Aerea Portuguesa,Flight,Military / Government,Angola,Africa,0,0,0,0,0,0,0,Terrorism
1973-04-02 00:00:00,United States Navy - USN,,Military / Government,United States of America,North America,0,0,0,0,0,0,0,Unknown
1973-04-03 00:00:00,Aircraft Airframe,Taxiing,Operational,United States of America,North America,3,3,0,0,0,0,3,Technical Failure
1973-04-04 00:00:00,Bernard L. Morgan,Flight,Operational,United States of America,North America,2,1,0,1,0,0,2,Technical Failure
1973-04-06 00:00:00,Aeroflot - Russian International Airlines,Flight,Commercial,Lithuania,Europe,0,0,0,0,0,0,0,Technical Failure
1973-04-06 00:00:00,Transaéreos Frimo - Frigorifico Movima,,Operational,Bolivia,South America,0,0,0,0,0,0,0,Unknown
1973-04-07 00:00:00,Private Danish,,Business,Denmark,Europe,0,0,0,0,0,0,0,Unknown
1973-04-10 00:00:00,AiResearch Aviation,Landing (descent or approach),Commercial,Canada,North America,8,2,0,6,0,0,8,Human Factor
1973-04-17 00:00:00,Iraqi Airways,Landing (descent or approach),Commercial,Iraq,Asia,33,6,0,27,0,0,33,Technical Failure
1973-04-18 00:00:00,Israeli Air Force - Heyl Ha'avir,Parking,Specialised Services,Israel,Asia,3,3,0,0,0,0,3,Human Factor
1973-04-18 00:00:00,Portalia Air-Cargo,Takeoff (climb),Operational,Djibouti,Africa,2,2,0,0,0,0,2,Technical Failure
1973-04-25 00:00:00,Aeromar,Takeoff (climb),Operational,Dominican Republic,Central America,4,4,0,0,0,0,4,Technical Failure
1973-04-28 00:00:00,Gary D. Lewis,Landing (descent or approach),Humanitarian,United States of America,North America,1,1,0,0,0,0,1,Technical Failure
1973-04-30 00:00:00,Lineas Aéreas Orientales,Landing (descent or approach),Commercial,Colombia,South America,0,0,0,0,0,0,0,Technical Failure
1973-05-03 00:00:00,Jim French,Takeoff (climb),Business,Mexico,Central America,2,2,0,0,0,0,2,Technical Failure
1973-05-03 00:00:00,Aeroflot - Russian International Airlines,Taxiing,Specialised Services,Canada,North America,9,6,0,3,0,0,9,Technical Failure
1973-05-07 00:00:00,Aeroflot - Russian International Airlines,Takeoff (climb),Operational,Russia,Asia,4,4,0,0,0,0,4,Technical Failure
1973-05-07 00:00:00,Continental Air Services,Flight,Commercial,Laos,Asia,7,1,0,6,0,0,7,Terrorism
1973-05-10 00:00:00,Joel Guinn,Takeoff (climb),Operational,United States of America,North America,2,2,0,0,0,0,2,Technical Failure
1973-05-10 00:00:00,Thai Airways International,Landing (descent or approach),Commercial,Nepal,Asia,110,10,0,100,0,0,110,Human Factor
1973-05-11 00:00:00,Walker's International Airlines,Landing (descent or approach),Operational,United States of America,North America,1,1,0,0,0,0,1,Technical Failure
1973-05-11 00:00:00,Aeroflot - Russian International Airlines,Flight,Commercial,Russia,Asia,0,0,0,0,0,0,0,Technical Failure
1973-05-14 00:00:00,Aeroflot - Russian International Airlines,Flight,Commercial,Russia,Asia,0,0,0,0,0,0,0,Other
1973-05-15 00:00:00,Jimmy T. Thompson,Takeoff (climb),Operational,United States of America,North America,2,2,0,0,0,0,2,Technical Failure
1973-05-15 00:00:00,Sultan of Oman Air Force,Flight,Military / Government,Oman,Asia,0,0,0,0,0,0,0,Unknown
1973-05-15 00:00:00,VASP - Viação Aérea de São Paulo,Landing (descent or approach),Commercial,Brazil,South America,0,0,0,0,0,0,0,Unknown
1973-05-15 00:00:00,Air Gabon,,Commercial,Gabon,Africa,0,0,0,0,0,0,0,Unknown
1973-05-26 00:00:00,Private American,Flight,Operational,United States of America,North America,3,2,0,1,0,0,3,Technical Failure
1973-05-28 00:00:00,Pakistan International Airlines - PIA,Landing (descent or approach),Commercial,Pakistan,Asia,40,6,0,34,0,0,40,Human Factor
1973-06-07 00:00:00,Aerolineas TAO,Landing (descent or approach),Commercial,Colombia,South America,0,0,0,0,0,0,0,Unknown
1973-06-15 00:00:00,Arctic Air,,Commercial,Canada,North America,0,0,0,0,0,0,0,Unknown
1973-06-15 00:00:00,Air Gabon,,Commercial,Gabon,Africa,0,0,0,0,0,0,0,Unknown
1973-06-16 00:00:00,Northern Air Service - USA,Takeoff (climb),Business,United States of America,North America,1,1,0,0,0,0,1,Human Factor
1973-06-17 00:00:00,Aerolineas Colonia,Landing (descent or approach),Commercial,Uruguay,South America,42,3,0,39,0,0,42,Human Factor
1973-06-23 00:00:00,SAHSA - Servicios Aéreos de Honduras SA,Takeoff (climb),Commercial,Honduras,Central America,10,2,0,8,0,0,10,Unknown
1973-06-25 00:00:00,Aeroflot - Russian International Airlines,Flight,Commercial,Russia,Asia,0,0,0,0,0,0,0,Human Factor
1973-07-02 00:00:00,Khmer Air Force,Landing (descent or approach),Military / Government,Cambodia,Asia,0,0,0,0,0,0,0,Unknown
1973-07-03 00:00:00,Indian Airlines,Landing (descent or approach),Commercial,India,Asia,15,7,0,8,0,0,15,Human Factor
1973-07-04 00:00:00,Portuguese Air Force - Força Aerea Portuguesa,,Military / Government,Mozambique,Africa,0,0,0,0,0,0,0,Unknown
1973-07-05 00:00:00,Avianca,Landing (descent or approach),Commercial,Colombia,South America,44,4,0,40,0,0,44,Other
1973-07-05 00:00:00,Avianca,Landing (descent or approach),Commercial,Colombia,South America,44,4,0,40,0,0,44,Other
1973-07-10 00:00:00,Fairbanks Air Services,Landing (descent or approach),Operational,United States of America,North America,3,3,0,0,0,0,3,Human Factor
1973-07-14 00:00:00,Faucett,Flight,Commercial,Peru,South America,0,0,0,0,0,0,0,Unknown
1973-07-14 00:00:00,Sterling Airways,Taxiing,Commercial,Sweden,Europe,0,0,0,0,0,0,0,Unknown
1973-07-17 00:00:00,SATA - Société Anonyme de Transport Aérien Genève,Landing (descent or approach),Commercial,Norway,Europe,60,4,0,56,0,0,60,Human Factor
1973-07-19 00:00:00,Israeli Air Force - Heyl Ha'avir,Landing (descent or approach),Operational,Israel,Asia,2,2,0,0,0,0,2,Unknown
1973-07-26 00:00:00,Aeroflot - Russian International Airlines,Flight,Commercial,Russia,Asia,0,0,0,0,0,0,0,Human Factor
1973-07-28 00:00:00,SAESA - Servicios Aéreos Especiales,Landing (descent or approach),Operational,Mexico,Central America,3,3,0,0,0,0,3,Human Factor
1973-07-30 00:00:00,Robert Wilmarth,Flight,Business,United States of America,North America,1,1,0,0,0,0,1,Human Factor
1973-07-30 00:00:00,Air-Rep Service,Landing (descent or approach),Operational,Australia,Oceania,2,1,0,1,0,0,2,Unknown
1973-07-31 00:00:00,Aeroflot - Russian International Airlines,Takeoff (climb),Commercial,Russia,Asia,0,0,0,0,0,0,0,Human Factor
1973-08-02 00:00:00,Aeroflot - Russian International Airlines,Flight,Commercial,Russia,Asia,0,0,0,0,0,0,0,Technical Failure
1973-08-02 00:00:00,Aeroflot - Russian International Airlines,Landing (descent or approach),Commercial,Russia,Asia,0,0,0,0,0,0,0,Unknown
1973-08-05 00:00:00,Happy Hours Air Travel Club,Flight,Operational,United States of America,North America,8,5,0,3,0,0,8,Human Factor
1973-08-07 00:00:00,Indian Air Force - Bharatiya Vayu Sena,,Military / Government,India,Asia,0,0,0,0,0,0,0,Unknown
1973-08-08 00:00:00,Finnish Air Force - Suomen Ilmavoimat,Landing (descent or approach),Military / Government,Finland,Europe,0,0,0,0,0,0,0,Unknown
1973-08-14 00:00:00,Kenting Aviation,Flight,Commercial,Canada,North America,2,2,0,0,0,0,2,Unknown
1973-08-15 00:00:00,Royal Netherlands Navy - Marineluchtvaartdienst,Flight,Military / Government,Netherlands,Europe,14,14,0,0,0,0,14,Technical Failure
1973-08-16 00:00:00,Aeroflot - Russian International Airlines,Flight,Commercial,Russia,Asia,0,0,0,0,0,0,0,Human Factor
1973-08-17 00:00:00,National Agricultural Organisation,,Military / Government,Sudan,Africa,0,0,0,0,0,0,0,Unknown
1973-08-21 00:00:00,AVENSA - Aerovias Venezolanas,Landing (descent or approach),Commercial,Venezuela,South America,0,0,0,0,0,0,0,Technical Failure
1973-08-22 00:00:00,Transportes Aéreos Tropicales - TAT Colombia,Landing (descent or approach),Commercial,Colombia,South America,0,0,0,0,0,0,0,Unknown
1973-08-25 00:00:00,FTI Aviation,Landing (descent or approach),Operational,United States of America,North America,1,1,0,0,0,0,1,Human Factor
1973-08-29 00:00:00,CSA Czech Airlines - Československé Státní Aerolinie,Landing (descent or approach),Commercial,Cyprus,Europe,70,8,0,62,0,0,70,Human Factor
1973-08-29 00:00:00,Aeroflot - Russian International Airlines,Flight,Commercial,Russia,Asia,0,0,0,0,0,0,0,Human Factor
1973-08-30 00:00:00,Aeroflot - Russian International Airlines,Flight,Commercial,Russia,Asia,0,0,0,0,0,0,0,Human Factor
1973-08-30 00:00:00,Aeroklub Polskiej Rzeczypospolitej Ludowej - APRL,,Commercial,Poland,Europe,0,0,0,0,0,0,0,Unknown
1973-08-31 00:00:00,Avia-Taxi,Flight,Specialised Services,France,Europe,2,2,0,0,0,0,2,Technical Failure
1973-09-03 00:00:00,Spanish Air Force - Ejército del Aire,Flight,Military / Government,Spain,Europe,6,6,0,0,0,0,6,Technical Failure
1973-09-06 00:00:00,Air Manila International,Takeoff (climb),Commercial,Philippines,Asia,24,4,0,20,0,0,24,Technical Failure
1973-09-10 00:00:00,California Airmotive Corporation,Landing (descent or approach),Operational,Guam Island,Asia,4,4,0,0,0,0,4,Human Factor
1973-09-12 00:00:00,Lane Xang Airlines,Landing (descent or approach),Commercial,Cambodia,Asia,0,0,0,0,0,0,0,Unknown
1973-09-14 00:00:00,Media Aviation,Flight,Business,Mexico,Central America,3,1,0,2,0,0,3,Unknown
1973-09-15 00:00:00,Aeroflot - Russian International Airlines,Takeoff (climb),Military / Government,Uzbekistan,Asia,0,0,0,0,0,0,0,Human Factor
1973-09-17 00:00:00,MIAT Mongolian Airlines - Mongolyn Irgeniy Agaaryn Teever,Landing (descent or approach),Commercial,Mongolia,Asia,0,0,0,0,0,0,0,Unknown
1973-09-20 00:00:00,Dolbeau Air Service,Flight,Commercial,Canada,North America,4,1,0,3,0,0,4,Unknown
1973-09-23 00:00:00,Air Algérie,Landing (descent or approach),Commercial,Algeria,Africa,0,0,0,0,0,0,0,Unknown
1973-09-24 00:00:00,The Holy Nation of Islam,Landing (descent or approach),Operational,United States of America,North America,5,5,0,0,0,0,5,Human Factor
1973-09-26 00:00:00,Brent W. Jensen,Landing (descent or approach),Business,United States of America,North America,1,1,0,0,0,0,1,Technical Failure
1973-09-26 00:00:00,Bahamasair,Flight,Specialised Services,Bahamas,Central America,1,1,0,0,0,0,1,Human Factor
1973-09-27 00:00:00,Turkish Air Force - Türk Hava Kuvvetleri,Landing (descent or approach),Military / Government,Turkey,Asia,0,0,0,0,0,0,0,Unknown
1973-10-05 00:00:00,Aeroflot - Russian International Airlines,Flight,Military / Government,Russia,Asia,8,3,0,5,0,0,8,Human Factor
1973-10-06 00:00:00,South Central Airlines - SCA,Takeoff (climb),Commercial,United States of America,North America,7,1,0,6,0,0,7,Human Factor
1973-10-11 00:00:00,Aeroflot - Russian International Airlines,Flight,Commercial,Armenia,Asia,0,0,0,0,0,0,0,Human Factor
1973-10-20 00:00:00,Mexicana de Aviación,Landing (descent or approach),Commercial,Mexico,Central America,123,6,0,117,0,0,123,Unknown
1973-10-21 00:00:00,Israeli Air Force - Heyl Ha'avir,Flight,Military / Government,Egypt,Africa,3,3,0,0,0,0,3,Terrorism
1973-10-25 00:00:00,Span East Airlines,Flight,Operational,United States of America,North America,3,3,0,0,0,0,3,Technical Failure
1973-10-25 00:00:00,Aeroflot - Russian International Airlines,Takeoff (climb),Commercial,Russia,Asia,0,0,0,0,0,0,0,Other
1973-10-26 00:00:00,Aerocosta Colombia,Flight,Operational,Colombia,South America,3,2,0,1,0,0,3,Other
1973-10-27 00:00:00,Aeroflot - Russian International Airlines,Takeoff (climb),Commercial,Russia,Asia,0,0,0,0,0,0,0,Weather
1973-10-29 00:00:00,Private New Zealand,Flight,Military / Government,New Zealand,Oceania,1,1,0,0,0,0,1,Unknown
1973-10-30 00:00:00,Air America,Landing (descent or approach),Operational,Vietnam,Asia,1,1,0,0,0,0,1,Technical Failure
1973-11-01 00:00:00,Private Bolivian,Flight,Business,Bolivia,South America,0,0,0,0,0,0,0,Technical Failure
1973-11-04 00:00:00,Aeroflot - Russian International Airlines,Flight,Commercial,Russia,Asia,0,0,0,0,0,0,0,Technical Failure
1973-11-06 00:00:00,Khmer Air Force,Takeoff (climb),Military / Government,Cambodia,Asia,0,0,0,0,0,0,0,Unknown
1973-11-10 00:00:00,Private Nicaraguan,Flight,Business,Nicaragua,Central America,2,1,0,1,0,0,2,Unknown
1973-11-12 00:00:00,Rousseau Aviation,Flight,Operational,France,Europe,5,5,0,0,0,0,5,Technical Failure
1973-11-17 00:00:00,Compania STOL,Flight,Commercial,Panama,Central America,0,0,0,0,0,0,0,Unknown
1973-11-20 00:00:00,Aeroflot - Russian International Airlines,Landing (descent or approach),Commercial,Russia,Asia,0,0,0,0,0,0,0,Unknown
1973-11-21 00:00:00,United States Navy - USN,Flight,Military / Government,Iceland,Europe,7,7,0,0,0,0,7,Weather
1973-11-25 00:00:00,Air America,Landing (descent or approach),Commercial,Laos,Asia,8,1,0,7,0,0,8,Unknown
1973-11-27 00:00:00,Eastern Airlines,Landing (descent or approach),Commercial,United States of America,North America,26,5,0,21,0,0,26,Human Factor
1973-11-27 00:00:00,Delta Airlines,Landing (descent or approach),Commercial,United States of America,North America,79,5,0,74,0,0,79,Human Factor
1973-11-27 00:00:00,Royal Air Force - RAF,Landing (descent or approach),Operational,United Kingdom,Europe,3,3,0,0,0,0,3,Human Factor
1973-11-28 00:00:00,WSK - Wytwórnia Sprzętu Komunikacyjnego,Flight,Specialised Services,Poland,Europe,0,0,0,0,0,0,0,Unknown
1973-11-29 00:00:00,Opa Locka Flight Service,Landing (descent or approach),Business,Mexico,Central America,2,1,0,1,0,0,2,Technical Failure
1973-12-03 00:00:00,Sultan of Oman Air Force,,Military / Government,Oman,Asia,0,0,0,0,0,0,0,Unknown
1973-12-03 00:00:00,Air Union Laos,Takeoff (climb),Commercial,Cambodia,Asia,0,0,0,0,0,0,0,Unknown
1973-12-04 00:00:00,Austral Lineas Aéreas,Takeoff (climb),Commercial,Argentina,South America,74,6,0,68,0,0,74,Human Factor
1973-12-05 00:00:00,Karns International Airlines,Landing (descent or approach),Operational,United States of America,North America,1,1,0,0,0,0,1,Technical Failure
1973-12-07 00:00:00,British Army Air Corps,Takeoff (climb),Military / Government,Germany,Europe,2,1,0,1,0,0,2,Human Factor
1973-12-07 00:00:00,Transaéreos Illimani,Landing (descent or approach),Operational,Bolivia,South America,4,3,0,1,0,0,4,Technical Failure
1973-12-12 00:00:00,Fred. Olsen's Air Transport - Fred. Olsen Flyselskap,Takeoff (climb),Business,United Kingdom,Europe,9,3,0,6,0,0,9,Other
1973-12-13 00:00:00,Aerolineas Comerciales Nacionales - ALCON,Landing (descent or approach),Commercial,Bolivia,South America,33,4,0,29,0,0,33,Human Factor
1973-12-13 00:00:00,Yemenia Yemen Airways,Landing (descent or approach),Commercial,Yemen,Asia,0,0,0,0,0,0,0,Unknown
1973-12-14 00:00:00,Rhoades International,Takeoff (climb),Business,United States of America,North America,2,1,0,1,0,0,2,Human Factor
1973-12-15 00:00:00,Air Union Laos,Landing (descent or approach),Commercial,Cambodia,Asia,0,0,0,0,0,0,0,Technical Failure
1973-12-15 00:00:00,UC Leasing Company,Flight,Business,Mexico,Central America,0,0,0,0,0,0,0,Unknown
1973-12-17 00:00:00,Iberia - Lineas Aéreas de Espana,Landing (descent or approach),Commercial,United States of America,North America,168,14,0,154,0,0,168,Weather
1973-12-17 00:00:00,Air Gaspé,Landing (descent or approach),Commercial,Canada,North America,8,1,0,7,0,0,8,Unknown
1973-12-20 00:00:00,Tricon Airlines,Takeoff (climb),Operational,United States of America,North America,1,1,0,0,0,0,1,Other
1973-12-20 00:00:00,Lufthansa,Landing (descent or approach),Commercial,India,Asia,109,11,0,98,0,0,109,Human Factor
1973-12-21 00:00:00,Seventy Airways,Takeoff (climb),Business,United States of America,North America,5,1,0,4,0,0,5,Human Factor
1973-12-21 00:00:00,Aeroflot - Russian International Airlines,Landing (descent or approach),Commercial,Armenia,Asia,0,0,0,0,0,0,0,Human Factor
1973-12-22 00:00:00,Adastra Airways - Adastra Aerial Surveys,Takeoff (climb),Operational,Australia,Oceania,2,2,0,0,0,0,2,Technical Failure
1973-12-23 00:00:00,Cruzeiro do Sul,Landing (descent or approach),Commercial,Brazil,South America,58,5,0,53,0,0,58,Human Factor
1973-12-27 00:00:00,Shawnee Airlines,Landing (descent or approach),Commercial,United States of America,North America,33,3,0,30,0,0,33,Technical Failure
1973-12-28 00:00:00,Island Air Transport,Takeoff (climb),Operational,United States of America,North America,1,1,0,0,0,0,1,Technical Failure
1973-12-29 00:00:00,Carson Helicopters,Takeoff (climb),Business,United States of America,North America,5,1,0,4,0,0,5,Human Factor
1973-12-29 00:00:00,Rousseau Aviation,Landing (descent or approach),Commercial,France,Europe,0,0,0,0,0,0,0,Unknown
1973-12-29 00:00:00,Air America,Landing (descent or approach),Commercial,Vietnam,Asia,9,3,0,6,0,0,9,Unknown
1973-12-31 00:00:00,Linea Aeropostal Venezolana - LAV,Landing (descent or approach),Commercial,Venezuela,South America,0,0,0,0,0,0,0,Unknown
1973-12-31 00:00:00,Ray Geophysical,Flight,Specialised Services,Mali,Africa,6,2,0,4,0,0,6,Technical Failure
1973-12-31 00:00:00,Aerangol,Landing (descent or approach),Commercial,Angola,Africa,0,0,0,0,0,0,0,Human Factor
1974-01-04 00:00:00,National Agricultural Organisation,,Military / Government,Sudan,Africa,0,0,0,0,0,0,0,Unknown
1974-01-05 00:00:00,Aeropesca Colombia,Landing (descent or approach),Operational,Colombia,South America,5,5,0,0,0,0,5,Technical Failure
1974-01-07 00:00:00,Indian Air Force - Bharatiya Vayu Sena,Takeoff (climb),Military / Government,India,Asia,6,6,0,0,0,0,6,Human Factor
1974-01-08 00:00:00,Portuguese Air Force - Força Aerea Portuguesa,Landing (descent or approach),Military / Government,Mozambique,Africa,0,0,0,0,0,0,0,Terrorism
1974-01-11 00:00:00,Yingling Aircraft,Takeoff (climb),Operational,United States of America,North America,2,1,0,1,0,0,2,Human Factor
1974-01-11 00:00:00,Florida Airways International,Landing (descent or approach),Humanitarian,United States of America,North America,1,1,0,0,0,0,1,Human Factor
1974-01-16 00:00:00,Trans World Airlines - TWA,Landing (descent or approach),Commercial,United States of America,North America,63,7,0,56,0,0,63,Human Factor
1974-01-18 00:00:00,Federal Express - FedEx,Landing (descent or approach),Business,United States of America,North America,2,2,0,0,0,0,2,Human Factor
1974-01-18 00:00:00,Khmer Air Force,Landing (descent or approach),Military / Government,Cambodia,Asia,0,0,0,0,0,0,0,Unknown
1974-01-18 00:00:00,Chilean Air Force - Fuerza Aérea de Chile,Flight,Military / Government,Chile,South America,0,0,0,0,0,0,0,Unknown
1974-01-19 00:00:00,TAM Bolivia - Transporte Aéreo Militar Boliviano,Landing (descent or approach),Military / Government,Bolivia,South America,0,0,0,0,0,0,0,Technical Failure
1974-01-21 00:00:00,Garuda Indonesian Airways,Landing (descent or approach),Commercial,Australia,Oceania,3,3,0,0,0,0,3,Weather
1974-01-31 00:00:00,Khmer Air Force,Takeoff (climb),Military / Government,Cambodia,Asia,0,0,0,0,0,0,0,Unknown
1974-01-31 00:00:00,Khmer Air Force,Flight,Military / Government,Cambodia,Asia,0,0,0,0,0,0,0,Unknown
1974-02-02 00:00:00,Transbrasil,Landing (descent or approach),Commercial,Brazil,South America,88,6,0,82,0,0,88,Weather
1974-02-05 00:00:00,Aeroflot - Russian International Airlines,Flight,Commercial,Russia,Asia,0,0,0,0,0,0,0,Human Factor
1974-02-06 00:00:00,Aerolineas Comerciales Nacionales - ALCON,Landing (descent or approach),Operational,Bolivia,South America,4,4,0,0,0,0,4,Technical Failure
1974-02-14 00:00:00,Semo Aviation,Landing (descent or approach),Operational,United States of America,North America,2,2,0,0,0,0,2,Technical Failure
1974-02-15 00:00:00,Roberto Suarez,,Business,Bolivia,South America,0,0,0,0,0,0,0,Unknown
1974-02-23 00:00:00,Taxi Aéreo El Llanero,Flight,Operational,Colombia,South America,2,2,0,0,0,0,2,Technical Failure
1974-02-23 00:00:00,Khmer Air Force,Flight,Military / Government,Cambodia,Asia,0,0,0,0,0,0,0,Unknown
1974-03-01 00:00:00,Great Western Airlines,Flight,Operational,United States of America,North America,1,1,0,0,0,0,1,Technical Failure
1974-03-03 00:00:00,Aer Turas,Landing (descent or approach),Operational,United Kingdom,Europe,10,4,0,6,0,0,10,Human Factor
1974-03-03 00:00:00,L. Eduardo,Flight,Operational,Bolivia,South America,2,2,0,0,0,0,2,Technical Failure
1974-03-05 00:00:00,Pacific Southwest Airlines - PSA,Flight,Operational,United States of America,North America,4,4,0,0,0,0,4,Human Factor
1974-03-21 00:00:00,Bolivian Air Force - Fuerza Aérea Boliviana,,Military / Government,Bolivia,South America,0,0,0,0,0,0,0,Unknown
1974-03-23 00:00:00,Cim Associates,Landing (descent or approach),Operational,Paraguay,South America,2,2,0,0,0,0,2,Unknown
1974-03-31 00:00:00,Air South,Taxiing,Commercial,United States of America,North America,4,2,0,2,0,0,4,Technical Failure
1974-04-03 00:00:00,Munz Northern Airlines,Landing (descent or approach),Commercial,United States of America,North America,2,1,0,1,0,0,2,Human Factor
1974-04-06 00:00:00,Aeroflot - Russian International Airlines,Landing (descent or approach),Commercial,Russia,Asia,18,3,0,15,0,0,18,Human Factor
1974-04-07 00:00:00,Air Zaïre,Landing (descent or approach),Commercial,Democratic Republic of Congo,Africa,0,0,0,0,0,0,0,Weather
1974-04-09 00:00:00,Aeroflot - Russian International Airlines,Takeoff (climb),Commercial,Russia,Asia,34,3,0,31,0,0,34,Human Factor
1974-04-12 00:00:00,Great Western Airlines,Landing (descent or approach),Operational,United States of America,North America,1,1,0,0,0,0,1,Human Factor
1974-04-16 00:00:00,Aeroflot - Russian International Airlines,Flight,Commercial,Georgia,Asia,0,0,0,0,0,0,0,Weather
1974-04-18 00:00:00,Robert C. Taylor,,Humanitarian,Jamaica,Central America,2,2,0,0,0,0,2,Unknown
1974-04-20 00:00:00,Air Union Laos,Landing (descent or approach),Operational,Cambodia,Asia,6,3,0,3,0,0,6,Unknown
1974-04-26 00:00:00,Indian Air Force - Bharatiya Vayu Sena,,Military / Government,India,Asia,0,0,0,0,0,0,0,Unknown
1974-04-28 00:00:00,Air America,Landing (descent or approach),Commercial,Laos,Asia,10,2,0,8,0,0,10,Human Factor
1974-04-30 00:00:00,Burma Airways,Landing (descent or approach),Commercial,Myanmar,Asia,40,4,0,36,0,0,40,Human Factor
1974-05-03 00:00:00,Lease Adventure,Takeoff (climb),Commercial,United States of America,North America,7,1,0,6,0,0,7,Human Factor
1974-05-05 00:00:00,Tulakes Aviation Company,Takeoff (climb),Business,Jamaica,Central America,2,1,0,1,0,0,2,Terrorism
1974-05-06 00:00:00,Portuguese Air Force - Força Aerea Portuguesa,Flight,Military / Government,Mozambique,Africa,12,5,0,7,0,0,12,Terrorism
1974-05-09 00:00:00,Aeroflot - Russian International Airlines,Landing (descent or approach),Commercial,Ukraine,Europe,65,8,0,57,0,0,65,Human Factor
1974-05-13 00:00:00,Air America,Flight,Operational,Vietnam,Asia,4,4,0,0,0,0,4,Terrorism
1974-05-13 00:00:00,Aeroflot - Russian International Airlines,Flight,Commercial,Ukraine,Europe,0,0,0,0,0,0,0,Human Factor
1974-05-15 00:00:00,Kenyan Government,Flight,Military / Government,Ethiopia,Africa,0,0,0,0,0,0,0,Unknown
1974-05-19 00:00:00,U.S. Department of the Interior,Takeoff (climb),Humanitarian,United States of America,North America,6,6,0,0,0,0,6,Human Factor
1974-05-19 00:00:00,Royal Canadian Air Force - RCAF,Flight,Military / Government,United States of America,North America,0,0,0,0,0,0,0,Unknown
1974-05-19 00:00:00,Aeroflot - Russian International Airlines,Takeoff (climb),Commercial,Uzbekistan,Asia,0,0,0,0,0,0,0,Unknown
1974-05-28 00:00:00,Air Union Laos,Landing (descent or approach),Commercial,Cambodia,Asia,0,0,0,0,0,0,0,Unknown
1974-05-30 00:00:00,United States Air Force - USAF,Landing (descent or approach),Operational,United States of America,North America,7,7,0,0,0,0,7,Technical Failure
1974-05-31 00:00:00,East West Airlines - Australia,Landing (descent or approach),Commercial,Australia,Oceania,34,4,0,30,0,0,34,Weather
1974-05-31 00:00:00,Airstream West,Takeoff (climb),Commercial,United States of America,North America,7,1,0,6,0,0,7,Technical Failure
1974-06-10 00:00:00,Aeroflot - Russian International Airlines,Taxiing,Commercial,Russia,Asia,0,0,0,0,0,0,0,Unknown
1974-06-12 00:00:00,Pleasant Financing Company,Flight,Operational,United States of America,North America,1,1,0,0,0,0,1,Technical Failure
1974-06-13 00:00:00,Private South African,Landing (descent or approach),Business,South Africa,Africa,2,1,0,1,0,0,2,Technical Failure
1974-06-20 00:00:00,Aeroflot - Russian International Airlines,,Commercial,Russia,Asia,0,0,0,0,0,0,0,Unknown
1974-06-22 00:00:00,Transavia,Taxiing,Commercial,Netherlands,Europe,0,0,0,0,0,0,0,Unknown
1974-07-01 00:00:00,Continental Air Services,,Commercial,Laos,Asia,0,0,0,0,0,0,0,Unknown
1974-07-05 00:00:00,Aeroflot - Russian International Airlines,,Other,Uzbekistan,Asia,0,0,0,0,0,0,0,Unknown
1974-07-08 00:00:00,Duncan Aviation,Landing (descent or approach),Operational,United States of America,North America,3,3,0,0,0,0,3,Technical Failure
1974-07-09 00:00:00,Wyman Pilot Services,Takeoff (climb),Operational,United States of America,North America,1,1,0,0,0,0,1,Human Factor
1974-07-09 00:00:00,Intermountain Aviation,Takeoff (climb),Humanitarian,United States of America,North America,3,1,0,2,0,0,3,Human Factor
1974-07-10 00:00:00,Peruvian Air Force - Fuerza Aérea del Perú,,Military / Government,Peru,South America,0,0,0,0,0,0,0,Unknown
1974-07-15 00:00:00,China Airlines,,Commercial,Cambodia,Asia,0,0,0,0,0,0,0,Unknown
1974-07-19 00:00:00,Aeroflot - Russian International Airlines,Flight,Commercial,Uzbekistan,Asia,0,0,0,0,0,0,0,Technical Failure
1974-07-20 00:00:00,Turkish Air Force - Türk Hava Kuvvetleri,Flight,Military / Government,Cyprus,Europe,0,0,0,0,0,0,0,Terrorism
1974-07-23 00:00:00,Aeroklub Polskiej Rzeczypospolitej Ludowej - APRL,,Commercial,Poland,Europe,0,0,0,0,0,0,0,Unknown
1974-07-25 00:00:00,French Air Force - Armée de l'Air,Landing (descent or approach),Military / Government,Chad,Africa,0,0,0,0,0,0,0,Unknown
1974-08-01 00:00:00,Aeroflot - Russian International Airlines,Takeoff (climb),Commercial,Russia,Asia,0,0,0,0,0,0,0,Human Factor
1974-08-01 00:00:00,United States Navy - USN,Takeoff (climb),Operational,United States of America,North America,0,0,0,0,0,0,0,Unknown
1974-08-05 00:00:00,Ethiopian Airlines,Landing (descent or approach),Commercial,Ethiopia,Africa,0,0,0,0,0,0,0,Unknown
1974-08-06 00:00:00,Aeroflot - Russian International Airlines,Flight,Commercial,Kazakhstan,Asia,0,0,0,0,0,0,0,Human Factor
1974-08-07 00:00:00,Bard Air Freight,Takeoff (climb),Operational,United States of America,North America,1,1,0,0,0,0,1,Human Factor
1974-08-20 00:00:00,Zaire Air Force - Force Aérienne Zaïroise,Landing (descent or approach),Military / Government,Democratic Republic of Congo,Africa,0,0,0,0,0,0,0,Human Factor
1974-08-24 00:00:00,Emric Air Services,Takeoff (climb),Operational,South Africa,Africa,1,1,0,0,0,0,1,Unknown
1974-08-28 00:00:00,Aeroflot - Russian International Airlines,Landing (descent or approach),Commercial,Russia,Asia,12,2,0,10,0,0,12,Human Factor
1974-08-29 00:00:00,Masin Aircraft Company,Landing (descent or approach),Operational,France,Europe,2,2,0,0,0,0,2,Technical Failure
1974-08-30 00:00:00,ZUA - Zakładu Usług Agrolotniczych - AET Agroaviation Services,Flight,Military / Government,Poland,Europe,0,0,0,0,0,0,0,Unknown
1974-08-30 00:00:00,ZUA - Zakładu Usług Agrolotniczych - AET Agroaviation Services,Flight,Military / Government,Poland,Europe,0,0,0,0,0,0,0,Unknown
1974-09-13 00:00:00,Conair of Scandinavia,Landing (descent or approach),Commercial,Denmark,Europe,0,0,0,0,0,0,0,Human Factor
1974-09-14 00:00:00,Aeroflot - Russian International Airlines,,Other,Russia,Asia,0,0,0,0,0,0,0,Unknown
1974-09-17 00:00:00,Sultan of Oman Air Force,Flight,Military / Government,Oman,Asia,0,0,0,0,0,0,0,Unknown
1974-09-20 00:00:00,INA Aviation,Landing (descent or approach),Business,United States of America,North America,1,1,0,0,0,0,1,Human Factor
1974-09-27 00:00:00,United States Air Force - USAF,Landing (descent or approach),Operational,United States of America,North America,5,5,0,0,0,0,5,Technical Failure
1974-09-28 00:00:00,Aeroflot - Russian International Airlines,Takeoff (climb),Specialised Services,Russia,Asia,0,0,0,0,0,0,0,Technical Failure
1974-09-30 00:00:00,Imperial Iranian Air Force,,Military / Government,Iran,Asia,0,0,0,0,0,0,0,Unknown
1974-09-30 00:00:00,United States Air Force - USAF,Landing (descent or approach),Military / Government,Japan,Asia,0,0,0,0,0,0,0,Technical Failure
1974-10-04 00:00:00,Delta Air Transport - DAT,Takeoff (climb),Commercial,United Kingdom,Europe,105,6,0,99,0,0,105,Human Factor
1974-10-08 00:00:00,Khmer Airlines,Takeoff (climb),Operational,Cambodia,Asia,5,5,0,0,0,0,5,Human Factor
1974-10-09 00:00:00,Swedish Air Force - Flygvapnet,Landing (descent or approach),Military / Government,Sweden,Europe,27,3,0,24,0,0,27,Weather
1974-10-11 00:00:00,Argentinian Air Force - Fuerza Aérea Argentina,Landing (descent or approach),Military / Government,Argentina,South America,0,0,0,0,0,0,0,Unknown
1974-10-15 00:00:00,Air Inter Gabon,,Commercial,Gabon,Africa,0,0,0,0,0,0,0,Unknown
1974-10-20 00:00:00,Holloway Construction,Takeoff (climb),Business,United States of America,North America,1,1,0,0,0,0,1,Human Factor
1974-10-26 00:00:00,Corporacion Turistica Melia,Flight,Commercial,Panama,Central America,0,0,0,0,0,0,0,Unknown
1974-11-01 00:00:00,Royal Air Force - RAF,Takeoff (climb),Operational,United Kingdom,Europe,2,2,0,0,0,0,2,Technical Failure
1974-11-05 00:00:00,Turkish Air Force - Türk Hava Kuvvetleri,,Military / Government,Turkey,Asia,0,0,0,0,0,0,0,Unknown
1974-11-05 00:00:00,Aeroflot - Russian International Airlines,Landing (descent or approach),Commercial,Russia,Asia,0,0,0,0,0,0,0,Unknown
1974-11-11 00:00:00,TAM Bolivia - Transporte Aéreo Militar Boliviano,Flight,Military / Government,Bolivia,South America,0,0,0,0,0,0,0,Unknown
1974-11-15 00:00:00,Tanzania Peoples Defence Forces,Flight,Military / Government,Tanzania,Africa,0,0,0,0,0,0,0,Unknown
1974-11-23 00:00:00,JAT Yugoslav Airlines - Jugoslovenski Aerotransport,Landing (descent or approach),Commercial,Serbia,Europe,50,6,0,44,0,0,50,Human Factor
1974-12-01 00:00:00,Coal Resources,Takeoff (climb),Business,United States of America,North America,4,1,0,3,0,0,4,Human Factor
1974-12-02 00:00:00,Private American,Takeoff (climb),Business,United States of America,North America,3,1,0,2,0,0,3,Technical Failure
1974-12-04 00:00:00,Aeroflot - Russian International Airlines,Landing (descent or approach),Operational,Russia,Asia,7,7,0,0,0,0,7,Human Factor
1974-12-05 00:00:00,Ciba-Pilatus Aerial Spraying Company,Flight,Military / Government,Sudan,Africa,1,1,0,0,0,0,1,Human Factor
1974-12-08 00:00:00,Aeroflot - Russian International Airlines,Takeoff (climb),Commercial,Ukraine,Europe,0,0,0,0,0,0,0,Technical Failure
1974-12-08 00:00:00,International Leasing Corporation,Flight,Business,Colombia,South America,0,0,0,0,0,0,0,Technical Failure
1974-12-09 00:00:00,Aeroflot - Russian International Airlines,Takeoff (climb),Operational,Russia,Asia,0,0,0,0,0,0,0,Other
1974-12-10 00:00:00,Fairbanks Air Services,Landing (descent or approach),Operational,United States of America,North America,3,3,0,0,0,0,3,Human Factor
1974-12-12 00:00:00,R. Lewis West,Takeoff (climb),Business,United States of America,North America,1,1,0,0,0,0,1,Human Factor
1974-12-15 00:00:00,Khemara Air,,Commercial,Cambodia,Asia,0,0,0,0,0,0,0,Unknown
1974-12-22 00:00:00,Tradewinds Airways,Landing (descent or approach),Operational,Zambia,Africa,5,5,0,0,0,0,5,Human Factor
1974-12-24 00:00:00,British Island Airways - BIA,Landing (descent or approach),Commercial,United Kingdom,Europe,53,4,0,49,0,0,53,Human Factor
1974-12-25 00:00:00,South Vietnamese Air Force,Landing (descent or approach),Military / Government,Vietnam,Asia,0,0,0,0,0,0,0,Terrorism
1974-12-27 00:00:00,Aeroflot - Russian International Airlines,Takeoff (climb),Commercial,Russia,Asia,22,2,0,20,0,0,22,Human Factor
1974-12-27 00:00:00,Taiwanese Government,Flight,Military / Government,Taiwan,Asia,0,0,0,0,0,0,0,Unknown
1974-12-28 00:00:00,Safari Air Services,Landing (descent or approach),Commercial,Kenya,Africa,0,0,0,0,0,0,0,Unknown
1975-01-01 00:00:00,Air O'Hare,Landing (descent or approach),Business,United States of America,North America,3,2,0,1,0,0,3,Technical Failure
1975-01-02 00:00:00,Transvall Corporation,Takeoff (climb),Operational,United States of America,North America,3,3,0,0,0,0,3,Human Factor
1975-01-04 00:00:00,Private German,Landing (descent or approach),Business,Germany,Europe,0,0,0,0,0,0,0,Unknown
1975-01-07 00:00:00,Air Zaïre,Landing (descent or approach),Commercial,Democratic Republic of Congo,Africa,38,4,0,34,0,0,38,Human Factor
1975-01-15 00:00:00,CSA Czech Airlines - Československé Státní Aerolinie,,Commercial,Czech Republic,Europe,0,0,0,0,0,0,0,Unknown
1975-01-17 00:00:00,Falcon Airways - USA,Landing (descent or approach),Operational,United States of America,North America,2,2,0,0,0,0,2,Human Factor
1975-01-25 00:00:00,Maersk Air,Landing (descent or approach),Commercial,Denmark,Europe,26,4,0,22,0,0,26,Unknown
1975-01-27 00:00:00,Territory Airlines,Flight,Commercial,Papua New Guinea,Oceania,0,0,0,0,0,0,0,Unknown
1975-01-28 00:00:00,Wanganui Aero Work,Flight,Military / Government,New Zealand,Oceania,1,1,0,0,0,0,1,Unknown
1975-01-28 00:00:00,Aeroflot - Russian International Airlines,Takeoff (climb),Commercial,Ukraine,Europe,17,3,0,14,0,0,17,Human Factor
1975-01-31 00:00:00,Air Midwest,Landing (descent or approach),Commercial,United States of America,North America,3,2,0,1,0,0,3,Human Factor
1975-02-01 00:00:00,Mandala Airlines,Landing (descent or approach),Operational,Taiwan,Asia,5,5,0,0,0,0,5,Unknown
1975-02-02 00:00:00,Transniger,Flight,Commercial,Niger,Africa,0,0,0,0,0,0,0,Unknown
1975-02-04 00:00:00,Indian Air Force - Bharatiya Vayu Sena,,Military / Government,India,Asia,0,0,0,0,0,0,0,Unknown
1975-02-09 00:00:00,Nancy M. Ackley,Flight,Business,United States of America,North America,1,1,0,0,0,0,1,Technical Failure
1975-02-09 00:00:00,Jet Travel,Takeoff (climb),Commercial,United States of America,North America,44,6,0,38,0,0,44,Human Factor
1975-02-10 00:00:00,Royal Australian Navy,Landing (descent or approach),Operational,Australia,Oceania,4,4,0,0,0,0,4,Human Factor
1975-02-12 00:00:00,Aeroflot - Russian International Airlines,Landing (descent or approach),Commercial,Russia,Asia,0,0,0,0,0,0,0,Human Factor
1975-02-13 00:00:00,Baron Air,Landing (descent or approach),Commercial,Sweden,Europe,8,1,0,7,0,0,8,Technical Failure
1975-02-15 00:00:00,JAT Agricultural Aviation,,Military / Government,Croatia,Europe,0,0,0,0,0,0,0,Unknown
1975-02-19 00:00:00,General Air,Landing (descent or approach),Commercial,Germany,Europe,16,4,0,12,0,0,16,Human Factor
1975-02-19 00:00:00,Marconi-Elliott Avionic Systems,Takeoff (climb),Business,United Kingdom,Europe,4,1,0,3,0,0,4,Other
1975-02-21 00:00:00,Air Force of Zimbabwe,Landing (descent or approach),Military / Government,Zimbabwe,Africa,3,3,0,0,0,0,3,Technical Failure
1975-02-28 00:00:00,Masin Aircraft Company,,Business,Spain,Europe,0,0,0,0,0,0,0,Unknown
1975-03-04 00:00:00,Ling-Temco-Vought,Takeoff (climb),Business,United States of America,North America,5,2,0,3,0,0,5,Human Factor
1975-03-11 00:00:00,Wilbur's Flight Operations,Takeoff (climb),Commercial,United States of America,North America,0,0,0,0,0,0,0,Human Factor
1975-03-13 00:00:00,Cimarron Industries,Landing (descent or approach),Business,United States of America,North America,7,2,0,5,0,0,7,Human Factor
1975-03-13 00:00:00,Royal Air Lao,Flight,Operational,Laos,Asia,2,2,0,0,0,0,2,Unknown
1975-03-14 00:00:00,Ethiopian Airlines,Landing (descent or approach),Commercial,Ethiopia,Africa,0,0,0,0,0,0,0,Terrorism
1975-03-17 00:00:00,Peruvian Air Force - Fuerza Aérea del Perú,,Military / Government,Peru,South America,0,0,0,0,0,0,0,Unknown
1975-03-23 00:00:00,Geyserland Airways,Flight,Operational,World,World,2,2,0,0,0,0,2,Technical Failure
1975-03-26 00:00:00,San Francisco Servicios Aéreos,Landing (descent or approach),Operational,Bolivia,South America,3,3,0,0,0,0,3,Unknown
1975-03-26 00:00:00,China Airlines,Flight,Commercial,Cambodia,Asia,0,0,0,0,0,0,0,Unknown
1975-03-27 00:00:00,Fairbanks Air Services,Landing (descent or approach),Operational,United States of America,North America,2,2,0,0,0,0,2,Human Factor
1975-03-27 00:00:00,Federal Aviation Administration - FAA,Takeoff (climb),Military / Government,United States of America,North America,11,3,0,8,0,0,11,Human Factor
1975-03-27 00:00:00,Zambia Flying Doctor Service,,Humanitarian,Zambia,Africa,0,0,0,0,0,0,0,Unknown
1975-03-28 00:00:00,Guillermo Hoyos,Flight,Business,Colombia,South America,0,0,0,0,0,0,0,Unknown
1975-03-29 00:00:00,Air Manila International,Landing (descent or approach),Operational,Philippines,Asia,5,5,0,0,0,0,5,Technical Failure
1975-03-29 00:00:00,Aeroflot - Russian International Airlines,Takeoff (climb),Commercial,Russia,Asia,0,0,0,0,0,0,0,Human Factor
1975-03-31 00:00:00,Western Airlines,Landing (descent or approach),Commercial,United States of America,North America,99,6,0,93,0,0,99,Human Factor
1975-03-31 00:00:00,Thomas L. Stinson,Flight,Business,Colombia,South America,2,2,0,0,0,0,2,Unknown
1975-04-06 00:00:00,United States Air Force - USAF,Landing (descent or approach),Military / Government,Vietnam,Asia,0,0,0,0,0,0,0,Unknown
1975-04-09 00:00:00,Aerolinee Itavia,Takeoff (climb),Commercial,Italy,Europe,31,4,0,27,0,0,31,Technical Failure
1975-04-11 00:00:00,United States Navy - USN,,Military / Government,United States of America,North America,0,0,0,0,0,0,0,Unknown
1975-04-14 00:00:00,Bulgarian Air Force - Bulgarski Voennov Azdushni Sili,Flight,Military / Government,Bulgaria,Europe,0,0,0,0,0,0,0,Unknown
1975-04-18 00:00:00,Mackenzie Air Service,Takeoff (climb),Commercial,Canada,North America,0,0,0,0,0,0,0,Technical Failure
1975-04-18 00:00:00,ZUA - Zakładu Usług Agrolotniczych - AET Agroaviation Services,Flight,Military / Government,Poland,Europe,0,0,0,0,0,0,0,Unknown
1975-04-18 00:00:00,Haywards Aviation,Takeoff (climb),Commercial,United Kingdom,Europe,0,0,0,0,0,0,0,Unknown
1975-04-19 00:00:00,Air Liberia,Takeoff (climb),Commercial,Liberia,Africa,25,4,0,21,0,0,25,Technical Failure
1975-04-24 00:00:00,Munz Northern Airlines,Landing (descent or approach),Commercial,United States of America,North America,2,1,0,1,0,0,2,Human Factor
1975-04-25 00:00:00,Aeroflot - Russian International Airlines,Landing (descent or approach),Commercial,Ukraine,Europe,11,4,0,7,0,0,11,Human Factor
1975-04-27 00:00:00,Indian Air Force - Bharatiya Vayu Sena,Flight,Military / Government,India,Asia,0,0,0,0,0,0,0,Unknown
1975-04-28 00:00:00,Aircraft Specialties Company,Landing (descent or approach),Humanitarian,United States of America,North America,2,2,0,0,0,0,2,Human Factor
1975-04-29 00:00:00,Air America,Landing (descent or approach),Military / Government,Thailand,Asia,0,0,0,0,0,0,0,Unknown
1975-04-30 00:00:00,Zantop International Airlines,Landing (descent or approach),Operational,United States of America,North America,3,3,0,0,0,0,3,Human Factor
1975-04-30 00:00:00,Aeroflot - Russian International Airlines,Flight,Military / Government,Russia,Asia,2,2,0,0,0,0,2,Human Factor
1975-05-03 00:00:00,Virgil A. Kelley Jr.,Landing (descent or approach),Business,Mexico,Central America,1,1,0,0,0,0,1,Unknown
1975-05-10 00:00:00,Philippine Airlines - PAL,Takeoff (climb),Commercial,Philippines,Asia,43,4,0,39,0,0,43,Technical Failure
1975-05-11 00:00:00,PLUNA Uruguay - Primeras Lineas Uruguayas de Navegacion Aérea,Landing (descent or approach),Commercial,Argentina,South America,57,4,0,53,0,0,57,Unknown
1975-05-15 00:00:00,Ford Construction Company,Takeoff (climb),Business,United States of America,North America,6,1,0,5,0,0,6,Technical Failure
1975-05-18 00:00:00,Aeroflot - Russian International Airlines,Flight,Commercial,Russia,Asia,0,0,0,0,0,0,0,Technical Failure
1975-05-19 00:00:00,Aeroflot - Russian International Airlines,Takeoff (climb),Commercial,Georgia,Asia,0,0,0,0,0,0,0,Weather
1975-05-19 00:00:00,Indian Air Force - Bharatiya Vayu Sena,,Military / Government,India,Asia,0,0,0,0,0,0,0,Unknown
1975-05-26 00:00:00,Rex Air Charter,,Commercial,New Zealand,Oceania,0,0,0,0,0,0,0,Unknown
1975-05-28 00:00:00,TOA Domestic Airlines,Landing (descent or approach),Commercial,Japan,Asia,22,4,0,18,0,0,22,Technical Failure
1975-06-03 00:00:00,Sky Truck International,Landing (descent or approach),Operational,Martinique,Central America,3,3,0,0,0,0,3,Technical Failure
1975-06-06 00:00:00,Transaéreos Illimani,Takeoff (climb),Operational,Bolivia,South America,4,3,0,1,0,0,4,Unknown
1975-06-08 00:00:00,ERA Aviation,Flight,Business,United States of America,North America,2,1,0,1,0,0,2,Technical Failure
1975-06-09 00:00:00,Frigorifico Santa Rita,Landing (descent or approach),Operational,Bolivia,South America,3,3,0,0,0,0,3,Technical Failure
1975-06-12 00:00:00,Air France,Taxiing,Commercial,India,Asia,402,18,0,384,0,0,402,Technical Failure
1975-06-12 00:00:00,George A. Sanborn,Landing (descent or approach),Humanitarian,United States of America,North America,1,1,0,0,0,0,1,Technical Failure
1975-06-14 00:00:00,Kerr-McGee Corporation,Takeoff (climb),Business,United States of America,North America,6,2,0,4,0,0,6,Other
1975-06-15 00:00:00,Wilderness Airlines,Flight,Commercial,Canada,North America,0,0,0,0,0,0,0,Unknown
1975-06-17 00:00:00,Indian Airlines,Landing (descent or approach),Commercial,India,Asia,93,6,0,87,0,0,93,Human Factor
1975-06-19 00:00:00,Aeroflot - Russian International Airlines,Flight,Commercial,Russia,Asia,0,0,0,0,0,0,0,Human Factor
1975-06-22 00:00:00,Lineas Aéreas La Urraca,Takeoff (climb),Operational,Colombia,South America,3,2,0,1,0,0,3,Technical Failure
1975-06-25 00:00:00,Colombian Air Force - Fuerza Aérea Colombiana,Flight,Humanitarian,Ecuador,South America,3,3,0,0,0,0,3,Terrorism
1975-06-27 00:00:00,Kurfiss Aviation,,Commercial,Germany,Europe,0,0,0,0,0,0,0,Unknown
1975-06-28 00:00:00,Aeroflot - Russian International Airlines,Flight,Commercial,Kazakhstan,Asia,0,0,0,0,0,0,0,Human Factor
1975-07-03 00:00:00,South Central Aviation,Takeoff (climb),Business,United States of America,North America,8,2,0,6,0,0,8,Human Factor
1975-07-09 00:00:00,Interivoire,,Commercial,Ivory Coast,Africa,0,0,0,0,0,0,0,Unknown
1975-07-10 00:00:00,Aerocosta Colombia,Parking,Operational,Colombia,South America,0,0,0,0,0,0,0,Human Factor
1975-07-11 00:00:00,Collins Radio Company,Landing (descent or approach),Business,United States of America,North America,9,2,0,7,0,0,9,Weather
1975-07-15 00:00:00,Aircraft Specialties Company,Flight,Humanitarian,United States of America,North America,0,0,0,0,0,0,0,Unknown
1975-07-16 00:00:00,Aerotal Colombia - Aerolineas Territoriales de Colombia,Landing (descent or approach),Commercial,Colombia,South America,8,3,0,5,0,0,8,Technical Failure
1975-07-17 00:00:00,Royal Canadian Air Force - RCAF,Takeoff (climb),Military / Government,Canada,North America,7,2,0,5,0,0,7,Human Factor
1975-07-18 00:00:00,Aviatia Utilitara,Flight,Military / Government,Romania,Europe,0,0,0,0,0,0,0,Unknown
1975-07-23 00:00:00,Aeroflot - Russian International Airlines,Flight,Military / Government,Uzbekistan,Asia,2,2,0,0,0,0,2,Human Factor
1975-07-25 00:00:00,Saint-Félicien Air Service,Flight,Commercial,Canada,North America,24,4,0,20,0,0,24,Technical Failure
1975-07-26 00:00:00,Linne E. Hedstrom,Takeoff (climb),Business,United States of America,North America,6,1,0,5,0,0,6,Human Factor
1975-07-31 00:00:00,Channel Flying Services,Landing (descent or approach),Operational,United States of America,North America,1,1,0,0,0,0,1,Human Factor
1975-08-02 00:00:00,William B. Archer,Flight,Business,United States of America,North America,2,1,0,1,0,0,2,Technical Failure
1975-08-03 00:00:00,Robert L. Vaughn,Landing (descent or approach),Business,Belize,Central America,0,0,0,0,0,0,0,Technical Failure
1975-08-07 00:00:00,Continental Airlines,Takeoff (climb),Commercial,United States of America,North America,131,7,0,124,0,0,131,Weather
1975-08-07 00:00:00,Agence et Messageries Aériennes du Zaïre - AMAZ,Flight,Commercial,Democratic Republic of Congo,Africa,0,0,0,0,0,0,0,Technical Failure
1975-08-08 00:00:00,Rich International Airways,Landing (descent or approach),Operational,Puerto Rico,Central America,2,2,0,0,0,0,2,Technical Failure
1975-08-08 00:00:00,Servicios Aéreos SA,Landing (descent or approach),Commercial,Panama,Central America,0,0,0,0,0,0,0,Unknown
1975-08-09 00:00:00,Hawkins %26 Powers Aviation,Landing (descent or approach),Operational,Canada,North America,2,2,0,0,0,0,2,Technical Failure
1975-08-14 00:00:00,Service de Formation Aéronautique %26 de Contrôle Technique - SFACT,Landing (descent or approach),Specialised Services,France,Europe,4,4,0,0,0,0,4,Unknown
1975-08-14 00:00:00,Aerial Tours,Flight,Commercial,Papua New Guinea,Oceania,0,0,0,0,0,0,0,Unknown
1975-08-16 00:00:00,Somali Airlines,Takeoff (climb),Commercial,Somalia,Africa,11,3,0,8,0,0,11,Human Factor
1975-08-22 00:00:00,TANA Colombia - Transportes Aéreos Nacionales de Colombia,Takeoff (climb),Commercial,Colombia,South America,17,3,0,14,0,0,17,Unknown
1975-08-23 00:00:00,ZUA - Zakładu Usług Agrolotniczych - AET Agroaviation Services,Flight,Military / Government,Poland,Europe,0,0,0,0,0,0,0,Unknown
1975-08-26 00:00:00,ZUA - Zakładu Usług Agrolotniczych - AET Agroaviation Services,Flight,Military / Government,Poland,Europe,0,0,0,0,0,0,0,Unknown
1975-08-27 00:00:00,East African Airways,Landing (descent or approach),Commercial,Tanzania,Africa,19,3,0,16,0,0,19,Human Factor
1975-08-28 00:00:00,Crowley Airways,Flight,Commercial,Papua New Guinea,Oceania,0,0,0,0,0,0,0,Unknown
1975-08-30 00:00:00,Aeroflot - Russian International Airlines,Landing (descent or approach),Commercial,Russia,Asia,0,0,0,0,0,0,0,Technical Failure
1975-08-30 00:00:00,Transportes Aéreos Benianos - TABSA,Landing (descent or approach),Operational,Bolivia,South America,3,3,0,0,0,0,3,Technical Failure
1975-09-02 00:00:00,Ciba-Pilatus Aerial Spraying Company,,Military / Government,Algeria,Africa,0,0,0,0,0,0,0,Unknown
1975-09-04 00:00:00,Auburn Adventist Academy,Takeoff (climb),Business,United States of America,North America,6,1,0,5,0,0,6,Human Factor
1975-09-05 00:00:00,Harrison Airways,Landing (descent or approach),Commercial,Canada,North America,0,0,0,0,0,0,0,Unknown
1975-09-13 00:00:00,Brazilian Air Force - Força Aérea Brasileira,Flight,Specialised Services,Brazil,South America,2,2,0,0,0,0,2,Technical Failure
1975-09-15 00:00:00,Red Eye Express,Landing (descent or approach),Business,United States of America,North America,8,2,0,6,0,0,8,Technical Failure
1975-09-15 00:00:00,British Airways,Takeoff (climb),Commercial,Spain,Europe,117,7,0,110,0,0,117,Other
1975-09-15 00:00:00,Dorado Wings,Taxiing,Commercial,Puerto Rico,Central America,1,1,0,0,0,0,1,Human Factor
1975-09-16 00:00:00,Alyemda Yemen Airlines,Landing (descent or approach),Commercial,Yemen,Asia,0,0,0,0,0,0,0,Unknown
1975-09-17 00:00:00,Asiatic International Airways,Landing (descent or approach),Specialised Services,Singapore,Asia,2,2,0,0,0,0,2,Human Factor
1975-09-22 00:00:00,ZUA - Zakładu Usług Agrolotniczych - AET Agroaviation Services,Landing (descent or approach),Military / Government,Macedonia,Europe,0,0,0,0,0,0,0,Unknown
1975-09-22 00:00:00,ZUA - Zakładu Usług Agrolotniczych - AET Agroaviation Services,Parking,Commercial,Macedonia,Europe,0,0,0,0,0,0,0,Unknown
1975-09-25 00:00:00,Laurentian Air Services,Landing (descent or approach),Operational,Canada,North America,2,2,0,0,0,0,2,Unknown
1975-10-06 00:00:00,Aeroflot - Russian International Airlines,Takeoff (climb),Commercial,Russia,Asia,32,4,0,28,0,0,32,Technical Failure
1975-10-07 00:00:00,Dirgantara Air Service,Flight,Commercial,Indonesia,Asia,0,0,0,0,0,0,0,Unknown
1975-10-08 00:00:00,Ontario Central Airlines,Landing (descent or approach),Commercial,Canada,North America,0,0,0,0,0,0,0,Human Factor
1975-10-12 00:00:00,Instituto Nacional de Aviación Civil,Flight,Military / Government,Argentina,South America,0,0,0,0,0,0,0,Unknown
1975-10-17 00:00:00,Aer Arann,Landing (descent or approach),Commercial,Ireland,Europe,7,1,0,6,0,0,7,Unknown
1975-11-03 00:00:00,Kenting Aviation,Flight,Commercial,Canada,North America,26,3,0,23,0,0,26,Technical Failure
1975-11-05 00:00:00,Adnas Air Service,Landing (descent or approach),Commercial,Ethiopia,Africa,6,1,0,5,0,0,6,Unknown
1975-11-12 00:00:00,Overseas National Airways - ONA,Takeoff (climb),Operational,United States of America,North America,139,11,0,128,0,0,139,Other
1975-11-13 00:00:00,Aeroflot - Russian International Airlines,Flight,Commercial,Russia,Asia,0,0,0,0,0,0,0,Human Factor
1975-11-15 00:00:00,Aerolineas Argentinas,Landing (descent or approach),Commercial,Argentina,South America,60,4,0,56,0,0,60,Human Factor
1975-11-20 00:00:00,Hawker Siddeley Aircraft,Takeoff (climb),Operational,United Kingdom,Europe,9,2,0,7,0,0,9,Other
1975-11-24 00:00:00,James Aviation,Flight,Military / Government,Solomon Islands,Oceania,1,1,0,0,0,0,1,Unknown
1975-12-02 00:00:00,Argentinian Air Force - Fuerza Aérea Argentina,,Military / Government,Argentina,South America,0,0,0,0,0,0,0,Unknown
1975-12-03 00:00:00,Pacific Resorts,,Commercial,Tonga,Oceania,0,0,0,0,0,0,0,Unknown
1975-12-10 00:00:00,Midwest Air Charter,Landing (descent or approach),Operational,United States of America,North America,1,1,0,0,0,0,1,Human Factor
1975-12-10 00:00:00,Aeroflot - Russian International Airlines,Flight,Commercial,Russia,Asia,0,0,0,0,0,0,0,Human Factor
1975-12-12 00:00:00,Dorado Wings,Landing (descent or approach),Commercial,United States of America,Central America,7,1,0,6,0,0,7,Technical Failure
1975-12-15 00:00:00,Centre de Parachutisme de Nevers,Flight,Operational,France,Europe,1,1,0,0,0,0,1,Human Factor
1975-12-15 00:00:00,Balkan Bulgarian Airlines,Landing (descent or approach),Operational,Libya,Africa,5,5,0,0,0,0,5,Human Factor
1975-12-15 00:00:00,Aeroflot - Russian International Airlines,Takeoff (climb),Commercial,Uzbekistan,Asia,6,6,0,0,0,0,6,Human Factor
1975-12-17 00:00:00,Royal Flying Doctor Service - RFDS,Takeoff (climb),Humanitarian,Australia,Oceania,4,1,0,3,0,0,4,Unknown
1975-12-20 00:00:00,United States Navy - USN,Landing (descent or approach),Military / Government,Iceland,Europe,0,0,0,0,0,0,0,Technical Failure
1975-12-22 00:00:00,Trans World Airlines - TWA,Landing (descent or approach),Commercial,Italy,Europe,122,9,0,113,0,0,122,Human Factor
1975-12-31 00:00:00,United States Army,,Military / Government,Marshall Islands,Oceania,0,0,0,0,0,0,0,Unknown
1975-12-31 00:00:00,Aeroflot - Russian International Airlines,Landing (descent or approach),Commercial,Russia,Asia,0,0,0,0,0,0,0,Human Factor
1975-12-31 00:00:00,TsKB po SPK,Landing (descent or approach),Specialised Services,Russia,Asia,0,0,0,0,0,0,0,Human Factor
1976-01-02 00:00:00,Overseas National Airways - ONA,Landing (descent or approach),Commercial,Turkey,Asia,376,12,0,364,0,0,376,Human Factor
1976-01-06 00:00:00,Caspair,,Commercial,Tanzania,Africa,0,0,0,0,0,0,0,Unknown
1976-01-07 00:00:00,Mandala Airlines,Landing (descent or approach),Commercial,Indonesia,Asia,16,3,0,13,0,0,16,Human Factor
1976-01-10 00:00:00,Private American,Landing (descent or approach),Humanitarian,United States of America,North America,1,1,0,0,0,0,1,Human Factor
1976-01-13 00:00:00,Aeroflot - Russian International Airlines,Landing (descent or approach),Commercial,Russia,Asia,44,5,0,39,0,0,44,Human Factor
1976-01-17 00:00:00,Royal Malaysian Air Force - Tentera Udara Diraja Malaysia,Landing (descent or approach),Military / Government,Malaysia,Asia,25,3,0,22,0,0,25,Technical Failure
1976-01-22 00:00:00,Japan Maritime Self-Defense Force - Kaijō Jieitai,,Military / Government,Japan,Asia,0,0,0,0,0,0,0,Unknown
1976-01-23 00:00:00,Bouraq Indonesia Airlines,Landing (descent or approach),Commercial,Indonesia,Asia,32,5,0,27,0,0,32,Unknown
1976-01-31 00:00:00,Private Bolivian,Takeoff (climb),Business,Bolivia,South America,0,0,0,0,0,0,0,Other
1976-02-06 00:00:00,Estramed,Takeoff (climb),Operational,Italy,Europe,2,2,0,0,0,0,2,Other
1976-02-15 00:00:00,Sultan of Oman Air Force,,Military / Government,Oman,Asia,0,0,0,0,0,0,0,Unknown
1976-02-16 00:00:00,Chadian Air Force - Force Aérienne Tchadienne,,Military / Government,Chad,Africa,0,0,0,0,0,0,0,Unknown
1976-02-20 00:00:00,Procuraduría General de la República,Flight,Military / Government,Mexico,Central America,0,0,0,0,0,0,0,Unknown
1976-02-22 00:00:00,Fabergé,Landing (descent or approach),Business,United States of America,North America,4,3,0,1,0,0,4,Human Factor
1976-02-25 00:00:00,Lineas Aéreas de Nicaragua - LANICA,Landing (descent or approach),Commercial,Nicaragua,Central America,0,0,0,0,0,0,0,Technical Failure
1976-02-29 00:00:00,Security Air Transport,Flight,Commercial,United States of America,North America,3,3,0,0,0,0,3,Human Factor
1976-03-06 00:00:00,Swift Air Charter,Flight,Business,United States of America,North America,2,1,0,1,0,0,2,Technical Failure
1976-03-10 00:00:00,Aeroflot - Russian International Airlines,Landing (descent or approach),Commercial,Russia,Asia,57,5,0,52,0,0,57,Human Factor
1976-03-12 00:00:00,Great Northern Airlines,Landing (descent or approach),Operational,United States of America,North America,3,3,0,0,0,0,3,Human Factor
1976-03-16 00:00:00,Command Airways,Takeoff (climb),Commercial,United States of America,North America,9,2,0,7,0,0,9,Human Factor
1976-03-18 00:00:00,Cubana de Aviación,Landing (descent or approach),Commercial,Cuba,Central America,29,16,0,13,0,0,29,Human Factor
1976-03-21 00:00:00,Gary K. Brage,Takeoff (climb),Humanitarian,United States of America,North America,2,2,0,0,0,0,2,Human Factor
1976-04-10 00:00:00,Catalina Airlines,Flight,Commercial,United States of America,North America,10,1,0,9,0,0,10,Technical Failure
1976-04-15 00:00:00,Private American,Landing (descent or approach),Business,Puerto Rico,Central America,2,2,0,0,0,0,2,Human Factor
1976-04-15 00:00:00,Carter Aircraft,Flight,Business,United States of America,North America,2,1,0,1,0,0,2,Technical Failure
1976-04-17 00:00:00,Kenai Air Services,Flight,Commercial,United States of America,North America,5,2,0,3,0,0,5,Human Factor
1976-04-22 00:00:00,Aeroflot - Russian International Airlines,Flight,Commercial,Russia,Asia,0,0,0,0,0,0,0,Human Factor
1976-04-22 00:00:00,US Global of Florida,Landing (descent or approach),Operational,Colombia,South America,4,4,0,0,0,0,4,Human Factor
1976-04-23 00:00:00,Private Venezuelan,,Business,Venezuela,South America,0,0,0,0,0,0,0,Unknown
1976-04-25 00:00:00,Private American,Flight,Business,United States of America,North America,6,1,0,5,0,0,6,Technical Failure
1976-04-27 00:00:00,Horizon Air Service,Flight,Operational,United States of America,North America,2,1,0,1,0,0,2,Technical Failure
1976-04-28 00:00:00,Uganda Police Air Wing,Landing (descent or approach),Operational,Uganda,Africa,2,2,0,0,0,0,2,Human Factor
1976-05-02 00:00:00,TACA International Airlines - Transportes Aéreos Centro Americanos,Landing (descent or approach),Operational,Guatemala,Central America,3,3,0,0,0,0,3,Human Factor
1976-05-02 00:00:00,Kanaf-Arkia Airlines,Flight,Commercial,Israel,Asia,0,0,0,0,0,0,0,Technical Failure
1976-05-12 00:00:00,Private French,,Business,France,Europe,0,0,0,0,0,0,0,Unknown
1976-05-14 00:00:00,La Ronge Aviation Services,Takeoff (climb),Commercial,Canada,North America,9,1,0,8,0,0,9,Human Factor
1976-05-15 00:00:00,Western Aerial Contractors,Flight,Business,United States of America,North America,1,1,0,0,0,0,1,Technical Failure
1976-05-17 00:00:00,Arthur E. Dean Jr.,Landing (descent or approach),Business,United States of America,North America,1,1,0,0,0,0,1,Technical Failure
1976-05-19 00:00:00,Aeroflot - Russian International Airlines,Flight,Commercial,Armenia,Asia,0,0,0,0,0,0,0,Unknown
1976-05-19 00:00:00,F %26 B Livestock Corporation,Landing (descent or approach),Operational,Belize,Central America,3,3,0,0,0,0,3,Technical Failure
1976-05-20 00:00:00,Survair,,Commercial,Canada,North America,0,0,0,0,0,0,0,Unknown
1976-05-20 00:00:00,Air Haïti,Landing (descent or approach),Commercial,Bahamas,Central America,0,0,0,0,0,0,0,Technical Failure
1976-05-23 00:00:00,Aeroflot - Russian International Airlines,Landing (descent or approach),Commercial,Russia,Asia,0,0,0,0,0,0,0,Unknown
1976-05-28 00:00:00,South Florida Airlines,Landing (descent or approach),Operational,Bahamas,Central America,3,1,0,2,0,0,3,Human Factor
1976-05-31 00:00:00,Ethiopian Airlines,Landing (descent or approach),Commercial,Eritrea,Africa,0,0,0,0,0,0,0,Terrorism
1976-06-01 00:00:00,Spanish Air Force - Ejército del Aire,,Military / Government,Spain,Europe,0,0,0,0,0,0,0,Unknown
1976-06-09 00:00:00,Aeroflot - Russian International Airlines,Flight,Commercial,Russia,Asia,0,0,0,0,0,0,0,Unknown
1976-06-10 00:00:00,Topeka Shawnee County Civil Defense,Flight,Military / Government,United States of America,North America,5,2,0,3,0,0,5,Human Factor
1976-06-22 00:00:00,Private American,Flight,Business,United States of America,North America,2,2,0,0,0,0,2,Technical Failure
1976-06-22 00:00:00,Austrian Airtransport,Takeoff (climb),Operational,Austria,Europe,3,3,0,0,0,0,3,Human Factor
1976-06-23 00:00:00,Allegheny Airlines,Landing (descent or approach),Commercial,United States of America,North America,106,4,0,102,0,0,106,Human Factor
1976-06-28 00:00:00,Alas Colombia,Flight,Operational,Colombia,South America,2,2,0,0,0,0,2,Unknown
1976-07-11 00:00:00,Aeroflot - Russian International Airlines,Flight,Commercial,Ukraine,Europe,0,0,0,0,0,0,0,Unknown
1976-07-14 00:00:00,MAP - Ministerstvo Aviatsionnoi Promyshlennosti - Minaviaprom,Takeoff (climb),Military / Government,Uzbekistan,Asia,0,0,0,0,0,0,0,Human Factor
1976-07-15 00:00:00,Aeroflot - Russian International Airlines,Landing (descent or approach),Commercial,Russia,Asia,0,0,0,0,0,0,0,Technical Failure
1976-07-17 00:00:00,Aeroflot - Russian International Airlines,Takeoff (climb),Commercial,Russia,Asia,117,7,0,110,0,0,117,Other
1976-07-23 00:00:00,Thermo Dyne,Landing (descent or approach),Business,United States of America,North America,3,1,0,2,0,0,3,Technical Failure
1976-07-23 00:00:00,Ontario Ministry of Natural Resources,Takeoff (climb),Military / Government,Canada,North America,5,1,0,4,0,0,5,Human Factor
1976-07-24 00:00:00,Indian Airlines,Landing (descent or approach),Commercial,India,Asia,23,4,0,19,0,0,23,Human Factor
1976-07-26 00:00:00,Aeroflot - Russian International Airlines,Flight,Commercial,Russia,Asia,0,0,0,0,0,0,0,Human Factor
1976-07-28 00:00:00,Transportes Aéreos Continentais,Takeoff (climb),Commercial,Portugal,Europe,0,0,0,0,0,0,0,Other
1976-08-05 00:00:00,Dothan Aviation Corporation,Flight,Military / Government,United States of America,North America,2,2,0,0,0,0,2,Technical Failure
1976-08-08 00:00:00,Aero Paraclub Spa,,Operational,Belgium,Europe,0,0,0,0,0,0,0,Unknown
1976-08-10 00:00:00,Falkland Islands Government Air Service - FIGAS,Taxiing,Other,Falkland Islands,South America,1,1,0,0,0,0,1,Unknown
1976-08-13 00:00:00,Aeroflot - Russian International Airlines,Landing (descent or approach),Commercial,Russia,Asia,0,0,0,0,0,0,0,Human Factor
1976-08-13 00:00:00,Aeroflot - Russian International Airlines,Landing (descent or approach),Commercial,Kazakhstan,Asia,43,5,0,38,0,0,43,Human Factor
1976-08-15 00:00:00,Private American,Landing (descent or approach),Humanitarian,United States of America,North America,1,1,0,0,0,0,1,Human Factor
1976-08-16 00:00:00,Bar Harbor Airlines,Landing (descent or approach),Operational,United States of America,North America,1,1,0,0,0,0,1,Human Factor
1976-08-16 00:00:00,Avianca,Landing (descent or approach),Commercial,Mexico,Central America,127,6,0,121,0,0,127,Unknown
1976-08-18 00:00:00,RCMP - GRC Air Services,Flight,Military / Government,Canada,North America,2,1,0,1,0,0,2,Technical Failure
1976-08-18 00:00:00,Private New Zealand,Landing (descent or approach),Operational,Pakistan,Asia,0,0,0,0,0,0,0,Unknown
1976-08-19 00:00:00,Ontario Central Airlines,Landing (descent or approach),Operational,Canada,North America,1,1,0,0,0,0,1,Human Factor
1976-08-21 00:00:00,Orient Pacific Airways,Takeoff (climb),Operational,Singapore,Asia,9,9,0,0,0,0,9,Human Factor
1976-08-27 00:00:00,Aeroflot - Russian International Airlines,Flight,Commercial,Russia,Asia,0,0,0,0,0,0,0,Human Factor
1976-08-28 00:00:00,Air Molokai,Takeoff (climb),Commercial,United States of America,North America,9,1,0,8,0,0,9,Human Factor
1976-09-02 00:00:00,AeroMéxico,Landing (descent or approach),Commercial,Mexico,Central America,24,4,0,20,0,0,24,Unknown
1976-09-04 00:00:00,Air Mahé,Takeoff (climb),Commercial,Seychelles,Asia,0,0,0,0,0,0,0,Technical Failure
1976-09-07 00:00:00,Kelowna Flightcraft Air Charter,Flight,Commercial,Canada,North America,28,2,0,26,0,0,28,Technical Failure
1976-09-16 00:00:00,Geosurvey International,Flight,Specialised Services,Tanzania,Africa,0,0,0,0,0,0,0,Unknown
1976-09-17 00:00:00,Government of Madhya Pradesh,Takeoff (climb),Military / Government,India,Asia,10,2,0,8,0,0,10,Human Factor
1976-09-23 00:00:00,Royal Thai Air Force - Kong Thap Akat Thai,Takeoff (climb),Military / Government,Thailand,Asia,0,0,0,0,0,0,0,Unknown
1976-10-02 00:00:00,Aeroflot - Russian International Airlines,Flight,Commercial,Russia,Asia,0,0,0,0,0,0,0,Human Factor
1976-10-13 00:00:00,Ethiopian Airlines,Takeoff (climb),Commercial,Eritrea,Africa,0,0,0,0,0,0,0,Technical Failure
1976-10-24 00:00:00,William B. Peeler,Landing (descent or approach),Business,United States of America,North America,6,2,0,4,0,0,6,Human Factor
1976-10-28 00:00:00,United Arab Emirates - Abu Dhabi Amiri Flight,Flight,Military / Government,United Arab Emirates,Asia,0,0,0,0,0,0,0,Unknown
1976-10-30 00:00:00,Aeroflot - Russian International Airlines,Landing (descent or approach),Commercial,Uzbekistan,Asia,97,8,0,89,0,0,97,Weather
1976-11-02 00:00:00,ZUA - Zakładu Usług Agrolotniczych - AET Agroaviation Services,,Military / Government,Poland,Europe,0,0,0,0,0,0,0,Unknown
1976-11-12 00:00:00,Taxi Aéreo Jaraguá,Landing (descent or approach),Business,Brazil,South America,8,2,0,6,0,0,8,Human Factor
1976-11-12 00:00:00,R.J. Reynolds Tobacco Company,Takeoff (climb),Business,United States of America,North America,11,2,0,9,0,0,11,Other
1976-11-12 00:00:00,Alyemda Yemen Airlines,Landing (descent or approach),Commercial,Yemen,Asia,0,0,0,0,0,0,0,Unknown
1976-11-12 00:00:00,Indian Air Force - Bharatiya Vayu Sena,,Military / Government,India,Asia,0,0,0,0,0,0,0,Unknown
1976-11-12 00:00:00,TAM Brasil - Taxi Aéreo Marilia - Transportes Aéreos Regionais,Landing (descent or approach),Commercial,Brazil,South America,5,2,0,3,0,0,5,Unknown
1976-11-16 00:00:00,Texas International Airlines,Takeoff (climb),Commercial,United States of America,North America,86,5,0,81,0,0,86,Technical Failure
1976-11-19 00:00:00,Midwest Air Carrier,Flight,Operational,United States of America,North America,1,1,0,0,0,0,1,Technical Failure
1976-11-22 00:00:00,Gulf Air,Flight,Operational,United Arab Emirates,Asia,2,2,0,0,0,0,2,Technical Failure
1976-11-23 00:00:00,Aerolineas La Paz,Landing (descent or approach),Operational,Bolivia,South America,4,3,0,1,0,0,4,Human Factor
1976-11-30 00:00:00,OMCO Petroleum Company,Takeoff (climb),Business,Egypt,Africa,0,0,0,0,0,0,0,Technical Failure
1976-12-04 00:00:00,Royal Moroccan Air Force - Forces Royales Air,Takeoff (climb),Military / Government,Western Sahara,Africa,0,0,0,0,0,0,0,Terrorism
1976-12-07 00:00:00,Aeroflot - Russian International Airlines,Landing (descent or approach),Commercial,Russia,Asia,29,4,0,25,0,0,29,Technical Failure
1976-12-09 00:00:00,Andan G. Oscar,Landing (descent or approach),Humanitarian,United States of America,North America,1,1,0,0,0,0,1,Human Factor
1976-12-10 00:00:00,Austin Airways,Takeoff (climb),Commercial,Canada,North America,8,2,0,6,0,0,8,Unknown
1976-12-12 00:00:00,Arnold Zohn,Flight,Business,United States of America,North America,2,1,0,1,0,0,2,Technical Failure
1976-12-14 00:00:00,Ethiopian Airlines,Landing (descent or approach),Commercial,Ethiopia,Africa,8,3,0,5,0,0,8,Technical Failure
1976-12-15 00:00:00,Peruvian Air Force - Fuerza Aérea del Perú,Flight,Military / Government,Peru,South America,0,0,0,0,0,0,0,Unknown
1976-12-16 00:00:00,Air Trine,Takeoff (climb),Operational,United States of America,North America,3,3,0,0,0,0,3,Other
1976-12-16 00:00:00,Airwest Airlines,Landing (descent or approach),Commercial,Canada,North America,16,2,0,14,0,0,16,Human Factor
1976-12-21 00:00:00,Business Flyers,Landing (descent or approach),Business,Switzerland,Europe,2,1,0,1,0,0,2,Human Factor
1976-12-23 00:00:00,African Overland Safaris,Takeoff (climb),Commercial,South Africa,Africa,0,0,0,0,0,0,0,Unknown
1976-12-28 00:00:00,Festus Flying Service,Takeoff (climb),Operational,United States of America,North America,1,1,0,0,0,0,1,Human Factor
1976-12-30 00:00:00,Bali International Air Service,Flight,Commercial,Indonesia,Asia,0,0,0,0,0,0,0,Unknown
1976-12-31 00:00:00,Private American,Landing (descent or approach),Business,United States of America,North America,6,1,0,5,0,0,6,Human Factor
1976-12-31 00:00:00,Air-Glaciers,Takeoff (climb),Humanitarian,Switzerland,Europe,9,1,0,8,0,0,9,Human Factor
1976-12-31 00:00:00,Aeroflot - Russian International Airlines,Landing (descent or approach),Operational,Ukraine,Europe,4,4,0,0,0,0,4,Human Factor
1976-12-31 00:00:00,Aeroflot - Russian International Airlines,Landing (descent or approach),Commercial,Ukraine,Europe,0,0,0,0,0,0,0,Unknown
1976-12-31 00:00:00,Zambia Air Force,,Military / Government,Zambia,Africa,0,0,0,0,0,0,0,Unknown
1977-01-02 00:00:00,CSA Czech Airlines - Československé Státní Aerolinie,Landing (descent or approach),Commercial,Czech Republic,Europe,48,6,0,42,0,0,48,Human Factor
1977-01-04 00:00:00,Transbrasil,Landing (descent or approach),Commercial,Brazil,South America,43,5,0,38,0,0,43,Technical Failure
1977-01-06 00:00:00,Transportes Aéreos Itenez,Flight,Operational,Bolivia,South America,4,2,0,2,0,0,4,Technical Failure
1977-01-10 00:00:00,Bali International Air Service,Flight,Commercial,Indonesia,Asia,0,0,0,0,0,0,0,Unknown
1977-01-11 00:00:00,Royal Thai Air Force - Kong Thap Akat Thai,Takeoff (climb),Operational,Thailand,Asia,4,4,0,0,0,0,4,Unknown
1977-01-12 00:00:00,Marchwiel Plant %26 Engineering,Landing (descent or approach),Business,United Kingdom,Europe,5,1,0,4,0,0,5,Human Factor
1977-01-15 00:00:00,Air Sunshine,Takeoff (climb),Commercial,United States of America,North America,33,3,0,30,0,0,33,Human Factor
1977-01-19 00:00:00,North East Bolivian Airways - NEBA,Takeoff (climb),Operational,Bolivia,South America,4,4,0,0,0,0,4,Other
1977-01-20 00:00:00,CAMBA Transportes Aéreos - Comercializadora Aérea Mixta Boliviana,Landing (descent or approach),Operational,Bolivia,South America,6,4,0,2,0,0,6,Other
1977-01-24 00:00:00,British Antarctic Survey - BAS,Landing (descent or approach),Military / Government,Antarctica,Antarctica,5,2,0,3,0,0,5,Human Factor
1977-01-26 00:00:00,Frigorifico Reyes,Takeoff (climb),Operational,Bolivia,South America,7,3,0,4,0,0,7,Technical Failure
1977-02-01 00:00:00,Aeroflot - Russian International Airlines,Flight,Commercial,Uzbekistan,Asia,3,2,0,1,0,0,3,Technical Failure
1977-02-01 00:00:00,Caspair,Landing (descent or approach),Commercial,Tanzania,Africa,0,0,0,0,0,0,0,Unknown
1977-02-01 00:00:00,Servicios Aéreos Bolivianos - SAB,Flight,Operational,Bolivia,South America,2,2,0,0,0,0,2,Technical Failure
1977-02-03 00:00:00,San Francisco Servicios Aéreos,Flight,Operational,Bolivia,South America,4,3,0,1,0,0,4,Technical Failure
1977-02-04 00:00:00,Malawi Police Air Wing,Flight,Military / Government,Malawi,Africa,0,0,0,0,0,0,0,Unknown
1977-02-07 00:00:00,Merpati Nusantara Airlines - MNA,,Commercial,Indonesia,Asia,0,0,0,0,0,0,0,Unknown
1977-02-08 00:00:00,Aerolineas Argo,Takeoff (climb),Operational,Puerto Rico,Central America,2,2,0,0,0,0,2,Human Factor
1977-02-08 00:00:00,Cim Associates,Flight,Business,Nicaragua,Central America,0,0,0,0,0,0,0,Technical Failure
1977-02-09 00:00:00,Bouraq Indonesia Airlines,Landing (descent or approach),Commercial,Indonesia,Asia,51,5,0,46,0,0,51,Human Factor
1977-02-14 00:00:00,Johnston Airways,Takeoff (climb),Operational,United States of America,North America,1,1,0,0,0,0,1,Human Factor
1977-02-15 00:00:00,CAAC - Civil Aviation Administration of China,,Commercial,China,Asia,0,0,0,0,0,0,0,Unknown
1977-02-17 00:00:00,SATENA - Servicio de Aeronavegacion a Territorios Nacionales,Takeoff (climb),Commercial,Colombia,South America,29,4,0,25,0,0,29,Other
1977-02-19 00:00:00,Munz Northern Airlines,Landing (descent or approach),Commercial,United States of America,North America,3,1,0,2,0,0,3,Human Factor
1977-02-21 00:00:00,Priester Aviation,Takeoff (climb),Business,United States of America,North America,2,2,0,0,0,0,2,Human Factor
1977-02-22 00:00:00,Maya Airways,Flight,Operational,Belize,Central America,1,1,0,0,0,0,1,Technical Failure
1977-02-27 00:00:00,Air Dale,Takeoff (climb),Operational,Canada,North America,2,2,0,0,0,0,2,Unknown
1977-02-28 00:00:00,German Air Force - Deutsche Luftwaffe,,Military / Government,Germany,Europe,0,0,0,0,0,0,0,Unknown
1977-03-01 00:00:00,Talair,Landing (descent or approach),Commercial,Papua New Guinea,Oceania,9,1,0,8,0,0,9,Unknown
1977-03-03 00:00:00,Interamerica Air Lease,Landing (descent or approach),Humanitarian,United States of America,North America,3,3,0,0,0,0,3,Human Factor
1977-03-07 00:00:00,Spanish Air Force - Ejército del Aire,Taxiing,Operational,Spain,Europe,3,3,0,0,0,0,3,Other
1977-03-10 00:00:00,Williams Patent Crusher %26 Pulverizer Company,Landing (descent or approach),Business,United States of America,North America,5,2,0,3,0,0,5,Human Factor
1977-03-12 00:00:00,Tech International Engineering,Landing (descent or approach),Business,United States of America,North America,1,1,0,0,0,0,1,Technical Failure
1977-03-16 00:00:00,TAM Bolivia - Transporte Aéreo Militar Boliviano,Flight,Military / Government,Bolivia,South America,0,0,0,0,0,0,0,Unknown
1977-03-16 00:00:00,Peruvian Air Force - Fuerza Aérea del Perú,,Military / Government,Peru,South America,0,0,0,0,0,0,0,Unknown
1977-03-17 00:00:00,Miller Air Travel,Landing (descent or approach),Operational,United States of America,North America,1,1,0,0,0,0,1,Technical Failure
1977-03-17 00:00:00,British Airtours,Takeoff (climb),Operational,United Kingdom,Europe,4,4,0,0,0,0,4,Human Factor
1977-03-17 00:00:00,Private American,Landing (descent or approach),Humanitarian,United States of America,North America,1,1,0,0,0,0,1,Human Factor
1977-03-18 00:00:00,Burlington Air Express,Landing (descent or approach),Operational,United States of America,North America,1,1,0,0,0,0,1,Human Factor
1977-03-18 00:00:00,Private New Zealand,Flight,Military / Government,New Zealand,Oceania,1,1,0,0,0,0,1,Unknown
1977-03-23 00:00:00,Royal Australian Army,Landing (descent or approach),Military / Government,Australia,Oceania,0,0,0,0,0,0,0,Human Factor
1977-03-25 00:00:00,Island Traders,Landing (descent or approach),Operational,United States of America,Central America,0,0,0,0,0,0,0,Human Factor
1977-03-29 00:00:00,Emery Worldwide Airlines,Taxiing,Operational,United States of America,North America,2,2,0,0,0,0,2,Weather
1977-04-01 00:00:00,Swish Manufacturing Company,Landing (descent or approach),Operational,United States of America,North America,2,2,0,0,0,0,2,Technical Failure
1977-04-02 00:00:00,Central Air Charter,Landing (descent or approach),Operational,Canada,North America,1,1,0,0,0,0,1,Technical Failure
1977-04-02 00:00:00,Taxi Aéreo El Venado,,Operational,Colombia,South America,2,2,0,0,0,0,2,Unknown
1977-04-04 00:00:00,Master Craft Engineering,Landing (descent or approach),Business,United States of America,North America,2,2,0,0,0,0,2,Human Factor
1977-04-05 00:00:00,International Air Freight,Landing (descent or approach),Operational,Bahamas,Central America,2,1,0,1,0,0,2,Technical Failure
1977-04-09 00:00:00,American Velodur Metal Company,Flight,Business,United States of America,North America,5,2,0,3,0,0,5,Human Factor
1977-04-11 00:00:00,Spanish Air Force - Ejército del Aire,Landing (descent or approach),Operational,Spain,Europe,3,3,0,0,0,0,3,Weather
1977-04-12 00:00:00,Superior Airways,Takeoff (climb),Operational,Canada,North America,3,3,0,0,0,0,3,Human Factor
1977-04-14 00:00:00,United States Army,,Military / Government,United States of America,North America,0,0,0,0,0,0,0,Unknown
1977-04-15 00:00:00,Brennan Air,Parking,Operational,United States of America,North America,1,1,0,0,0,0,1,Human Factor
1977-04-16 00:00:00,Far Eastern Air Transport - FAT,Landing (descent or approach),Commercial,Taiwan,Asia,0,0,0,0,0,0,0,Technical Failure
1977-04-17 00:00:00,Buffalo Airways,Landing (descent or approach),Commercial,Canada,North America,2,1,0,1,0,0,2,Human Factor
1977-04-18 00:00:00,Philippine Airlines - PAL,Takeoff (climb),Commercial,Japan,Asia,140,13,0,127,0,0,140,Technical Failure
1977-04-21 00:00:00,TAROM - Transporturile Aeriene Române,Landing (descent or approach),Operational,Romania,Europe,5,5,0,0,0,0,5,Human Factor
1977-04-23 00:00:00,Brazilian Air Force - Força Aérea Brasileira,Landing (descent or approach),Military / Government,Brazil,South America,0,0,0,0,0,0,0,Unknown
1977-04-25 00:00:00,Nigeria Airways,Landing (descent or approach),Commercial,Nigeria,Africa,23,4,0,19,0,0,23,Human Factor
1977-04-26 00:00:00,Allstates Aviation,Flight,Operational,United States of America,North America,1,1,0,0,0,0,1,Technical Failure
1977-04-27 00:00:00,Rockwell Aircraft,Landing (descent or approach),Operational,United States of America,North America,2,2,0,0,0,0,2,Human Factor
1977-04-27 00:00:00,Aviateca,Takeoff (climb),Commercial,Guatemala,Central America,28,6,0,22,0,0,28,Human Factor
1977-04-28 00:00:00,United States Air Force - USAF,Landing (descent or approach),Operational,United States of America,North America,7,7,0,0,0,0,7,Other
1977-04-29 00:00:00,Cruzeiro do Sul,Landing (descent or approach),Operational,Brazil,South America,2,2,0,0,0,0,2,Human Factor
1977-05-03 00:00:00,Talimena Aircraft,Flight,Business,United States of America,North America,1,1,0,0,0,0,1,Technical Failure
1977-05-06 00:00:00,Inter Air Cargo Services,Takeoff (climb),Operational,United States of America,North America,3,2,0,1,0,0,3,Technical Failure
1977-05-06 00:00:00,Civil Aviation Flying Unit,Landing (descent or approach),Operational,Nigeria,Africa,2,2,0,0,0,0,2,Unknown
1977-05-09 00:00:00,Air North - New Zealand,Landing (descent or approach),Operational,New Zealand,Oceania,1,1,0,0,0,0,1,Human Factor
1977-05-12 00:00:00,Patricia Air Transport,Landing (descent or approach),Humanitarian,Canada,North America,2,1,0,1,0,0,2,Unknown
1977-05-20 00:00:00,Transalaska Produce Corporation,Landing (descent or approach),Humanitarian,United States of America,North America,1,1,0,0,0,0,1,Human Factor
1977-05-21 00:00:00,Douglas Airways,Takeoff (climb),Commercial,Papua New Guinea,Oceania,0,0,0,0,0,0,0,Unknown
1977-05-25 00:00:00,Indian Air Force - Bharatiya Vayu Sena,,Military / Government,India,Asia,0,0,0,0,0,0,0,Unknown
1977-05-26 00:00:00,Chrysler Corporation,Landing (descent or approach),Business,United States of America,North America,2,2,0,0,0,0,2,Human Factor
1977-05-26 00:00:00,WSK - Wytwórnia Sprzętu Komunikacyjnego,,Other,Poland,Europe,0,0,0,0,0,0,0,Unknown
1977-05-27 00:00:00,Société Aviaffaires %26 Cook International,,Business,France,Europe,0,0,0,0,0,0,0,Unknown
1977-05-28 00:00:00,Adrian H. Meredith,Landing (descent or approach),Humanitarian,United States of America,North America,4,1,0,3,0,0,4,Technical Failure
1977-06-06 00:00:00,Sudan Airways,Takeoff (climb),Commercial,Sudan,Africa,39,4,0,35,0,0,39,Technical Failure
1977-06-08 00:00:00,Soviet Air Force - Voyenno-vozdushnye sily CCCP,Takeoff (climb),Military / Government,Russia,Asia,0,0,0,0,0,0,0,Technical Failure
1977-06-10 00:00:00,Aeroflot - Russian International Airlines,Flight,Commercial,Uzbekistan,Asia,0,0,0,0,0,0,0,Technical Failure
1977-06-10 00:00:00,Air Niger,Flight,Commercial,Niger,Africa,21,2,0,19,0,0,21,Technical Failure
1977-06-12 00:00:00,Tony Perez,Flight,Humanitarian,United States of America,North America,2,2,0,0,0,0,2,Technical Failure
1977-06-13 00:00:00,Hall Mining Company,Landing (descent or approach),Humanitarian,United States of America,North America,2,1,0,1,0,0,2,Human Factor
1977-06-13 00:00:00,Argentinian Air Force - Fuerza Aérea Argentina,Takeoff (climb),Military / Government,Argentina,South America,0,0,0,0,0,0,0,Technical Failure
1977-06-14 00:00:00,Japan Air Self-Defense Force - Kōkū Jieitai,Landing (descent or approach),Military / Government,Japan,Asia,0,0,0,0,0,0,0,Unknown
1977-06-15 00:00:00,Venezuelan Government,Landing (descent or approach),Military / Government,Venezuela,South America,8,1,0,7,0,0,8,Technical Failure
1977-06-17 00:00:00,Taxi Aéreo Nacional,Takeoff (climb),Commercial,Colombia,South America,0,0,0,0,0,0,0,Technical Failure
1977-06-19 00:00:00,Pan Adria,Taxiing,Commercial,Croatia,Europe,47,4,0,43,0,0,47,Unknown
1977-06-20 00:00:00,Pacific Missionary Aviation,Landing (descent or approach),Commercial,Micronesia,Oceania,4,1,0,3,0,0,4,Weather
1977-06-21 00:00:00,Aeronorte Colombia - Aerovias del Norte,Takeoff (climb),Operational,Colombia,South America,3,3,0,0,0,0,3,Technical Failure
1977-06-21 00:00:00,Royal Thai Air Force - Kong Thap Akat Thai,Parking,Military / Government,Thailand,Asia,0,0,0,0,0,0,0,Unknown
1977-06-21 00:00:00,Air Méditerranée - Zaïre,Flight,Commercial,Democratic Republic of Congo,Africa,0,0,0,0,0,0,0,Unknown
1977-06-27 00:00:00,Royal Thai Air Force - Kong Thap Akat Thai,Landing (descent or approach),Military / Government,Thailand,Asia,9,2,0,7,0,0,9,Unknown
1977-06-28 00:00:00,United States Army,Takeoff (climb),Military / Government,Marshall Islands,Oceania,16,4,0,12,0,0,16,Unknown
1977-07-01 00:00:00,Island Airlines,Takeoff (climb),Commercial,United States of America,North America,3,1,0,2,0,0,3,Human Factor
1977-07-08 00:00:00,J. D. Mullican Construction Company,Landing (descent or approach),Business,United States of America,North America,1,1,0,0,0,0,1,Technical Failure
1977-07-12 00:00:00,Hollywood Flying Service,Flight,Business,Puerto Rico,Central America,1,1,0,0,0,0,1,Technical Failure
1977-07-14 00:00:00,Aeroflot - Russian International Airlines,Flight,Commercial,Russia,Asia,0,0,0,0,0,0,0,Other
1977-07-15 00:00:00,Peace Air,,Commercial,Canada,North America,0,0,0,0,0,0,0,Unknown
1977-07-15 00:00:00,Instituto Nacional de Aviación Civil,Flight,Military / Government,Argentina,South America,0,0,0,0,0,0,0,Unknown
1977-07-17 00:00:00,Philippine Airlines - PAL,Landing (descent or approach),Commercial,Philippines,Asia,25,4,0,21,0,0,25,Technical Failure
1977-07-19 00:00:00,Aeroflot - Russian International Airlines,Landing (descent or approach),Commercial,Kyrgyzstan,Asia,0,0,0,0,0,0,0,Unknown
1977-07-19 00:00:00,Lineas Aéreas Orientales,Landing (descent or approach),Commercial,Colombia,South America,10,3,0,7,0,0,10,Unknown
1977-07-21 00:00:00,Aeroflot - Russian International Airlines,Takeoff (climb),Commercial,Uzbekistan,Asia,0,0,0,0,0,0,0,Other
1977-08-02 00:00:00,Aeroflot - Russian International Airlines,Takeoff (climb),Commercial,Russia,Asia,24,1,0,23,0,0,24,Other
1977-08-05 00:00:00,Jon W. Myers,Landing (descent or approach),Business,United States of America,North America,2,1,0,1,0,0,2,Other
1977-08-09 00:00:00,Pearl Air,Landing (descent or approach),Operational,Yemen,Asia,3,3,0,0,0,0,3,Human Factor
1977-08-13 00:00:00,Intercontinental Oil Company,Landing (descent or approach),Business,United States of America,North America,4,2,0,2,0,0,4,Human Factor
1977-08-14 00:00:00,Ethiopian Airlines,Taxiing,Operational,Eritrea,Africa,5,3,0,2,0,0,5,Terrorism
1977-08-15 00:00:00,Private American,Takeoff (climb),Business,United States of America,North America,1,1,0,0,0,0,1,Human Factor
1977-08-17 00:00:00,Flight Express Cargo,Takeoff (climb),Operational,United States of America,North America,2,2,0,0,0,0,2,Technical Failure
1977-08-18 00:00:00,Aeroflot - Russian International Airlines,Landing (descent or approach),Commercial,Russia,Asia,0,0,0,0,0,0,0,Human Factor
1977-08-19 00:00:00,Custom Executive Aviation,Landing (descent or approach),Commercial,United States of America,North America,2,1,0,1,0,0,2,Technical Failure
1977-08-23 00:00:00,Airgava,Landing (descent or approach),Commercial,Canada,North America,2,1,0,1,0,0,2,Human Factor
1977-08-23 00:00:00,Air Inter Gabon,,Commercial,Gabon,Africa,0,0,0,0,0,0,0,Unknown
1977-08-24 00:00:00,Quarterwins Aviation,Flight,Operational,Guadeloupe,Central America,4,2,0,2,0,0,4,Technical Failure
1977-08-28 00:00:00,Parachutes,Takeoff (climb),Humanitarian,United States of America,North America,10,1,0,9,0,0,10,Technical Failure
1977-08-29 00:00:00,Aeroflot - Russian International Airlines,Flight,Commercial,Russia,Asia,0,0,0,0,0,0,0,Human Factor
1977-08-30 00:00:00,Aeroflot - Russian International Airlines,Flight,Commercial,Lithuania,Europe,0,0,0,0,0,0,0,Technical Failure
1977-08-31 00:00:00,Aeroflot - Russian International Airlines,Flight,Commercial,Russia,Asia,0,0,0,0,0,0,0,Human Factor
1977-09-07 00:00:00,Ron Proulx,Landing (descent or approach),Business,Canada,North America,2,1,0,1,0,0,2,Unknown
1977-09-15 00:00:00,Royal Canadian Air Force - RCAF,Flight,Humanitarian,Canada,North America,4,4,0,0,0,0,4,Unknown
1977-09-21 00:00:00,New Jersey Airlines - NJ Airlines,Landing (descent or approach),Operational,Greenland,Europe,2,2,0,0,0,0,2,Technical Failure
1977-09-24 00:00:00,Alaska Central Airlines,Takeoff (climb),Commercial,United States of America,North America,6,1,0,5,0,0,6,Technical Failure
1977-09-25 00:00:00,Partnair,Takeoff (climb),Commercial,Norway,Europe,2,1,0,1,0,0,2,Unknown
1977-09-26 00:00:00,State Aerial Survey Corporation,Flight,Military / Government,Indonesia,Asia,1,1,0,0,0,0,1,Unknown
1977-09-27 00:00:00,Aeroflot - Russian International Airlines,Flight,Commercial,Uzbekistan,Asia,0,0,0,0,0,0,0,Human Factor
1977-09-27 00:00:00,Salvadorian Air Force - Fuerza Aérea Salvadoreña,Landing (descent or approach),Military / Government,Salvador,Central America,0,0,0,0,0,0,0,Unknown
1977-09-28 00:00:00,National Agricultural Organisation,Landing (descent or approach),Military / Government,Sudan,Africa,0,0,0,0,0,0,0,Unknown
1977-09-29 00:00:00,North Coast Air Services,Flight,Operational,Canada,North America,2,2,0,0,0,0,2,Technical Failure
1977-09-30 00:00:00,Interconair - Irish Intercon Cattle Meats,Landing (descent or approach),Operational,Ireland,Europe,6,4,0,2,0,0,6,Unknown
1977-10-01 00:00:00,Blackhawk Airways,Flight,Operational,United States of America,North America,1,1,0,0,0,0,1,Technical Failure
1977-10-02 00:00:00,Jack Lenhardt,Flight,Humanitarian,Colombia,South America,2,2,0,0,0,0,2,Terrorism
1977-10-05 00:00:00,Private American,Takeoff (climb),Business,United States of America,North America,3,2,0,1,0,0,3,Human Factor
1977-10-05 00:00:00,Private Brazilian,,Business,Barbados,Central America,1,1,0,0,0,0,1,Unknown
1977-10-06 00:00:00,Aerovias Las Minas,Landing (descent or approach),Military / Government,Bolivia,South America,3,3,0,0,0,0,3,Technical Failure
1977-10-08 00:00:00,Southern Aviation - South Africa,Flight,Operational,South Africa,Africa,2,2,0,0,0,0,2,Human Factor
1977-10-11 00:00:00,United States Air Force - USAF,Landing (descent or approach),Military / Government,United States of America,North America,0,0,0,0,0,0,0,Technical Failure
1977-10-18 00:00:00,Aeroflot - Russian International Airlines,Takeoff (climb),Commercial,Russia,Asia,5,2,0,3,0,0,5,Technical Failure
1977-10-27 00:00:00,Aeroflot - Russian International Airlines,Flight,Military / Government,Russia,Asia,11,7,0,4,0,0,11,Human Factor
1977-10-28 00:00:00,Costarican Government,Flight,Specialised Services,Costa Rica,Central America,6,2,0,4,0,0,6,Technical Failure
1977-10-30 00:00:00,Airwest Airlines,,Commercial,Canada,North America,0,0,0,0,0,0,0,Unknown
1977-11-03 00:00:00,Savin Aviation,Landing (descent or approach),Operational,United States of America,North America,1,1,0,0,0,0,1,Human Factor
1977-11-04 00:00:00,AVENSA - Aerovias Venezolanas,Landing (descent or approach),Commercial,Venezuela,South America,34,4,0,30,0,0,34,Unknown
1977-11-05 00:00:00,Colombian Air Force - Fuerza Aérea Colombiana,Flight,Military / Government,Ecuador,South America,4,1,0,3,0,0,4,Unknown
1977-11-07 00:00:00,M.C. Correia Holdings,Landing (descent or approach),Business,Guyana,South America,0,0,0,0,0,0,0,Unknown
1977-11-15 00:00:00,Private German,Flight,Business,Germany,Europe,0,0,0,0,0,0,0,Unknown
1977-11-19 00:00:00,Global Aircraft,Takeoff (climb),Operational,United States of America,North America,3,1,0,2,0,0,3,Other
1977-11-20 00:00:00,SATENA - Servicio de Aeronavegacion a Territorios Nacionales,Flight,Military / Government,Colombia,South America,0,0,0,0,0,0,0,Unknown
1977-11-20 00:00:00,SATENA - Servicio de Aeronavegacion a Territorios Nacionales,,Military / Government,Colombia,South America,0,0,0,0,0,0,0,Unknown
1977-11-22 00:00:00,Interflug,Landing (descent or approach),Commercial,Germany,Europe,74,5,0,69,0,0,74,Human Factor
1977-11-23 00:00:00,Malév Hungarian Airlines - Magyar Légiközlekedési Vallalat,Taxiing,Commercial,Romania,Europe,0,0,0,0,0,0,0,Human Factor
1977-11-26 00:00:00,D %26 H Corporation,Flight,Business,United States of America,North America,2,1,0,1,0,0,2,Technical Failure
1977-11-26 00:00:00,Bureau de Prospection Forestière,Flight,Military / Government,Gabon,Africa,0,0,0,0,0,0,0,Unknown
1977-11-28 00:00:00,Aeroflot - Russian International Airlines,Flight,Commercial,Russia,Asia,0,0,0,0,0,0,0,Unknown
1977-12-01 00:00:00,Airwest Airlines,Landing (descent or approach),Commercial,Canada,North America,14,2,0,12,0,0,14,Human Factor
1977-12-09 00:00:00,Aerotour - France,Landing (descent or approach),Commercial,Morocco,Africa,0,0,0,0,0,0,0,Technical Failure
1977-12-13 00:00:00,Worldwide Aviation Distributors,Takeoff (climb),Operational,United States of America,North America,2,1,0,1,0,0,2,Technical Failure
1977-12-14 00:00:00,TAC Colombia - Transportes Aéreos del Cesar,Landing (descent or approach),Commercial,Colombia,South America,22,4,0,18,0,0,22,Human Factor
1977-12-16 00:00:00,E. L. Jarman,Flight,Business,United States of America,North America,1,1,0,0,0,0,1,Technical Failure
1977-12-17 00:00:00,Statewide Air,Takeoff (climb),Operational,United States of America,North America,1,1,0,0,0,0,1,Technical Failure
1977-12-19 00:00:00,Aeroflot - Russian International Airlines,Flight,Commercial,Russia,Asia,0,0,0,0,0,0,0,Human Factor
1977-12-20 00:00:00,Aeroflot - Russian International Airlines,Flight,Commercial,Russia,Asia,0,0,0,0,0,0,0,Technical Failure
1977-12-23 00:00:00,Iliamna Air Taxi,Takeoff (climb),Commercial,United States of America,North America,8,1,0,7,0,0,8,Human Factor
1977-12-23 00:00:00,Aeroflot - Russian International Airlines,Flight,Commercial,Russia,Asia,0,0,0,0,0,0,0,Other
1977-12-28 00:00:00,Brazilian Air Force - Força Aérea Brasileira,Takeoff (climb),Military / Government,Brazil,South America,6,6,0,0,0,0,6,Technical Failure
1977-12-31 00:00:00,Gifford Aviation,Landing (descent or approach),Operational,United States of America,North America,2,2,0,0,0,0,2,Human Factor
1977-12-31 00:00:00,Soviet Air Force - Voyenno-vozdushnye sily CCCP,Landing (descent or approach),Military / Government,Ukraine,Europe,0,0,0,0,0,0,0,Human Factor
1977-12-31 00:00:00,Consolidated Air Services,,Operational,United States of America,North America,0,0,0,0,0,0,0,Unknown
1978-01-02 00:00:00,Aero Virgin Islands,Flight,Commercial,Puerto Rico,Central America,5,3,0,2,0,0,5,Technical Failure
1978-01-04 00:00:00,Lonnie Russell Leasing %26 Rental,Landing (descent or approach),Business,United States of America,North America,7,2,0,5,0,0,7,Other
1978-01-09 00:00:00,Transportes Colombiana de Aviacion - TAVINA,Flight,Commercial,Colombia,South America,18,2,0,16,0,0,18,Technical Failure
1978-01-19 00:00:00,Southwire Company,Landing (descent or approach),Business,United States of America,North America,7,2,0,5,0,0,7,Human Factor
1978-01-20 00:00:00,Japan Maritime Self-Defense Force - Kaijō Jieitai,Landing (descent or approach),Military / Government,Japan,Asia,0,0,0,0,0,0,0,Unknown
1978-01-22 00:00:00,Private Australian,Landing (descent or approach),Humanitarian,Australia,Oceania,2,2,0,0,0,0,2,Human Factor
1978-01-24 00:00:00,TAM Bolivia - Transporte Aéreo Militar Boliviano,Landing (descent or approach),Military / Government,Bolivia,South America,0,0,0,0,0,0,0,Technical Failure
1978-01-29 00:00:00,Chadian Air Force - Force Aérienne Tchadienne,Flight,Military / Government,Chad,Africa,5,5,0,0,0,0,5,Terrorism
1978-02-06 00:00:00,Transcommuter Airlines,Landing (descent or approach),Commercial,British Virgin Islands,Central America,0,0,0,0,0,0,0,Unknown
1978-02-08 00:00:00,Aero Service Corporation - USA,Landing (descent or approach),Business,Algeria,Africa,3,3,0,0,0,0,3,Human Factor
1978-02-09 00:00:00,Private American,Landing (descent or approach),Operational,United States of America,North America,2,2,0,0,0,0,2,Technical Failure
1978-02-15 00:00:00,SABENA - Société Anonyme Belge d'Exploitation de la Navigation Aérienne,Landing (descent or approach),Commercial,Spain,Europe,198,9,0,189,0,0,198,Technical Failure
1978-02-16 00:00:00,Air Alpes,,Commercial,France,Europe,0,0,0,0,0,0,0,Unknown
1978-02-17 00:00:00,Flight Express Cargo,Takeoff (climb),Operational,United States of America,North America,1,1,0,0,0,0,1,Human Factor
1978-02-17 00:00:00,Skyways International,Flight,Operational,Honduras,Central America,3,3,0,0,0,0,3,Technical Failure
1978-02-18 00:00:00,Aeroflot - Russian International Airlines,Parking,Commercial,Russia,Asia,0,0,0,0,0,0,0,Technical Failure
1978-02-23 00:00:00,United States Navy - USN,Landing (descent or approach),Military / Government,United States of America,North America,5,5,0,0,0,0,5,Technical Failure
1978-02-24 00:00:00,West Indies Air Transport,Landing (descent or approach),Operational,Puerto Rico,Central America,3,3,0,0,0,0,3,Human Factor
1978-02-25 00:00:00,Air Service Company,Landing (descent or approach),Commercial,Iran,Asia,0,0,0,0,0,0,0,Human Factor
1978-03-02 00:00:00,Wyman Pilot Services,Takeoff (climb),Operational,United States of America,North America,1,1,0,0,0,0,1,Human Factor
1978-03-02 00:00:00,Aeropol,Flight,Operational,Poland,Europe,0,0,0,0,0,0,0,Unknown
1978-03-03 00:00:00,Iberia - Lineas Aéreas de Espana,Landing (descent or approach),Commercial,Spain,Europe,223,12,0,211,0,0,223,Human Factor
1978-03-15 00:00:00,United States Air Force - USAF,Taxiing,Military / Government,Iceland,Europe,17,17,0,0,0,0,17,Technical Failure
1978-03-15 00:00:00,Royal Thai Air Force - Kong Thap Akat Thai,Landing (descent or approach),Military / Government,Thailand,Asia,10,2,0,8,0,0,10,Technical Failure
1978-03-16 00:00:00,Brazilian Air Force - Força Aérea Brasileira,Takeoff (climb),Military / Government,Brazil,South America,5,5,0,0,0,0,5,Human Factor
1978-03-21 00:00:00,Florida Aircraft Leasing Corporation,Landing (descent or approach),Business,United States of America,North America,4,2,0,2,0,0,4,Technical Failure
1978-03-27 00:00:00,Lisle Aircraft,Flight,Business,Canada,North America,1,1,0,0,0,0,1,Technical Failure
1978-03-28 00:00:00,Private Venezuelan,Landing (descent or approach),Business,Saint-Barthélemy,Central America,0,0,0,0,0,0,0,Unknown
1978-03-30 00:00:00,National Jets,Landing (descent or approach),Commercial,United States of America,North America,5,3,0,2,0,0,5,Technical Failure
1978-03-30 00:00:00,Unionair,Landing (descent or approach),Operational,Australia,Oceania,2,2,0,0,0,0,2,Unknown
1978-03-30 00:00:00,United States Army,,Military / Government,United States of America,North America,0,0,0,0,0,0,0,Unknown
1978-03-30 00:00:00,ZUA - Zakładu Usług Agrolotniczych - AET Agroaviation Services,,Military / Government,Poland,Europe,0,0,0,0,0,0,0,Unknown
1978-04-01 00:00:00,Thrifty Threads,Flight,Operational,Colombia,South America,2,2,0,0,0,0,2,Unknown
1978-04-02 00:00:00,VASP - Viação Aérea de São Paulo,Landing (descent or approach),Commercial,Brazil,South America,44,7,0,37,0,0,44,Technical Failure
1978-04-04 00:00:00,SABENA - Société Anonyme Belge d'Exploitation de la Navigation Aérienne,Takeoff (climb),Operational,Belgium,Europe,3,3,0,0,0,0,3,Other
1978-04-04 00:00:00,Aeroflot - Russian International Airlines,Takeoff (climb),Commercial,Russia,Asia,0,0,0,0,0,0,0,Unknown
1978-04-07 00:00:00,Nepalese Army,,Military / Government,Nepal,Asia,0,0,0,0,0,0,0,Unknown
1978-04-08 00:00:00,Aeroflot - Russian International Airlines,Takeoff (climb),Commercial,Russia,Asia,17,5,0,12,0,0,17,Unknown
1978-04-11 00:00:00,Digital Equipment Corporation,Landing (descent or approach),Operational,United States of America,North America,1,1,0,0,0,0,1,Technical Failure
1978-04-18 00:00:00,Panavia Cargo Development,Landing (descent or approach),Operational,Turks and Caicos Islands,Central America,6,2,0,4,0,0,6,Human Factor
1978-04-19 00:00:00,LOT Polish Airlines - Polskie Linie Lotnicze,Flight,Operational,Poland,Europe,0,0,0,0,0,0,0,Unknown
1978-04-22 00:00:00,Sanford Schwartz,Landing (descent or approach),Humanitarian,United States of America,North America,1,1,0,0,0,0,1,Human Factor
1978-04-24 00:00:00,Larry Johnson Air Services,Flight,Commercial,Mexico,Central America,3,1,0,2,0,0,3,Unknown
1978-04-25 00:00:00,German Navy - Deutsche Marine,Landing (descent or approach),Operational,Germany,Europe,3,3,0,0,0,0,3,Human Factor
1978-04-26 00:00:00,Merlin Flite,Flight,Commercial,Denmark,Europe,0,0,0,0,0,0,0,Technical Failure
1978-04-28 00:00:00,Leslie L. Sexton,Takeoff (climb),Business,United States of America,North America,6,1,0,5,0,0,6,Human Factor
1978-04-30 00:00:00,Jim McGeorge,Landing (descent or approach),Business,United States of America,North America,0,0,0,0,0,0,0,Unknown
1978-05-01 00:00:00,Aeroflot - Russian International Airlines,Flight,Commercial,Russia,Asia,0,0,0,0,0,0,0,Human Factor
1978-05-03 00:00:00,Caspair,Flight,Commercial,Sudan,Africa,0,0,0,0,0,0,0,Unknown
1978-05-05 00:00:00,SLM Surinam Airways - Surinaamse Luchtvaart Maatschappij,Landing (descent or approach),Operational,Suriname,South America,3,3,0,0,0,0,3,Human Factor
1978-05-09 00:00:00,Botswana Defence Force - Air Wing,Flight,Operational,Botswana,Africa,2,2,0,0,0,0,2,Terrorism
1978-05-12 00:00:00,Argosy Air Lines,Flight,Operational,United States of America,North America,3,3,0,0,0,0,3,Technical Failure
1978-05-12 00:00:00,Gifford Aviation,Takeoff (climb),Commercial,United States of America,North America,3,1,0,2,0,0,3,Human Factor
1978-05-16 00:00:00,Fieldair,Flight,Military / Government,New Zealand,Oceania,1,1,0,0,0,0,1,Unknown
1978-05-18 00:00:00,Carlie W. Smith,Landing (descent or approach),Business,United States of America,North America,3,1,0,2,0,0,3,Human Factor
1978-05-25 00:00:00,Groth Air,Takeoff (climb),Business,United States of America,North America,6,3,0,3,0,0,6,Human Factor
1978-05-26 00:00:00,Comstock International,Landing (descent or approach),Business,Canada,North America,3,2,0,1,0,0,3,Human Factor
1978-05-28 00:00:00,British Army Air Corps,Takeoff (climb),Military / Government,Canada,North America,5,1,0,4,0,0,5,Unknown
1978-05-29 00:00:00,Aeroflot - Russian International Airlines,Landing (descent or approach),Commercial,Belarus,Europe,5,2,0,3,0,0,5,Human Factor
1978-05-29 00:00:00,ZUA - Zakładu Usług Agrolotniczych - AET Agroaviation Services,Flight,Military / Government,Poland,Europe,1,1,0,0,0,0,1,Unknown
1978-05-30 00:00:00,Martin Aviation,Landing (descent or approach),Commercial,United States of America,North America,2,1,0,1,0,0,2,Weather
1978-05-30 00:00:00,Oneida,Flight,Operational,Guatemala,Central America,4,4,0,0,0,0,4,Unknown
1978-06-04 00:00:00,Antilles Air Boats,Takeoff (climb),Commercial,United States of America,Central America,11,1,0,10,0,0,11,Human Factor
1978-06-04 00:00:00,Commercial Air Transport,Landing (descent or approach),Operational,Philippines,Asia,2,2,0,0,0,0,2,Unknown
1978-06-08 00:00:00,Aeroflot - Russian International Airlines,Flight,Military / Government,Russia,Asia,2,2,0,0,0,0,2,Human Factor
1978-06-10 00:00:00,West Africa Air Cargo,Landing (descent or approach),Operational,Liberia,Africa,4,4,0,0,0,0,4,Technical Failure
1978-06-19 00:00:00,Great Western Airlines,Landing (descent or approach),Operational,United States of America,North America,2,2,0,0,0,0,2,Technical Failure
1978-06-22 00:00:00,Tennessee Valley Authority,Landing (descent or approach),Business,United States of America,North America,6,2,0,4,0,0,6,Human Factor
1978-06-25 00:00:00,Aeroflot - Russian International Airlines,Flight,Military / Government,Russia,Asia,2,2,0,0,0,0,2,Human Factor
1978-07-02 00:00:00,Aeroflot - Russian International Airlines,Flight,Commercial,Kyrgyzstan,Asia,0,0,0,0,0,0,0,Technical Failure
1978-07-03 00:00:00,Southeast Skyways,Flight,Commercial,United States of America,North America,3,1,0,2,0,0,3,Human Factor
1978-07-05 00:00:00,PCD Corporation,Takeoff (climb),Business,United States of America,North America,2,1,0,1,0,0,2,Technical Failure
1978-07-05 00:00:00,ZUA - Zakładu Usług Agrolotniczych - AET Agroaviation Services,Flight,Military / Government,Poland,Europe,0,0,0,0,0,0,0,Unknown
1978-07-06 00:00:00,Tradewinds Airways,Landing (descent or approach),Operational,Kenya,Africa,4,4,0,0,0,0,4,Technical Failure
1978-07-09 00:00:00,Allegheny Airlines,Landing (descent or approach),Commercial,United States of America,North America,77,4,0,73,0,0,77,Human Factor
1978-07-09 00:00:00,Private American,Takeoff (climb),Humanitarian,United States of America,North America,42,2,0,40,0,0,42,Technical Failure
1978-07-10 00:00:00,Speedair,Takeoff (climb),Operational,Australia,Oceania,3,2,0,1,0,0,3,Technical Failure
1978-07-11 00:00:00,Island Air Inc.,Flight,Operational,United States of America,North America,1,1,0,0,0,0,1,Human Factor
1978-07-11 00:00:00,Aeroflot - Russian International Airlines,Takeoff (climb),Commercial,Russia,Asia,0,0,0,0,0,0,0,Technical Failure
1978-07-12 00:00:00,Country Boy Company,Takeoff (climb),Military / Government,United States of America,North America,1,1,0,0,0,0,1,Human Factor
1978-07-12 00:00:00,Grady O'Hara Associates,Takeoff (climb),Specialised Services,United States of America,North America,1,1,0,0,0,0,1,Technical Failure
1978-07-14 00:00:00,Private Argentinian,,Business,Peru,South America,0,0,0,0,0,0,0,Unknown
1978-07-14 00:00:00,Private Bolivian,Landing (descent or approach),Business,Bolivia,South America,0,0,0,0,0,0,0,Unknown
1978-07-14 00:00:00,09 Charlie,Flight,Business,Turks and Caicos Islands,Central America,0,0,0,0,0,0,0,Unknown
1978-07-15 00:00:00,Congolese Government,Flight,Military / Government,Congo,Africa,0,0,0,0,0,0,0,Unknown
1978-07-17 00:00:00,La Sarre Air Services,Flight,Commercial,Canada,North America,1,1,0,0,0,0,1,Technical Failure
1978-07-18 00:00:00,Hellenic Air Force - Elleniki Polemiki Aeroporia,Landing (descent or approach),Humanitarian,Greece,Europe,2,2,0,0,0,0,2,Technical Failure
1978-07-19 00:00:00,Ciba-Pilatus Aerial Spraying Company,Flight,Military / Government,Saudi Arabia,Asia,0,0,0,0,0,0,0,Unknown
1978-07-20 00:00:00,Aero Express - Guatemala,Landing (descent or approach),Operational,Guatemala,Central America,3,3,0,0,0,0,3,Unknown
1978-07-21 00:00:00,Mauritanian Air Force - Force Aérienne Islamique de Mauritanie,Flight,Military / Government,Western Sahara,Africa,0,0,0,0,0,0,0,Terrorism
1978-07-22 00:00:00,DR %26 M,Takeoff (climb),Operational,United States of America,North America,3,3,0,0,0,0,3,Technical Failure
1978-07-22 00:00:00,Maxson Aviation,Flight,Operational,United States of America,North America,1,1,0,0,0,0,1,Human Factor
1978-07-25 00:00:00,North Central Airlines,Takeoff (climb),Commercial,United States of America,North America,43,3,0,40,0,0,43,Other
1978-07-26 00:00:00,Aviateca,Takeoff (climb),Commercial,Guatemala,Central America,0,0,0,0,0,0,0,Other
1978-07-28 00:00:00,W. J. Medical Consulting,Takeoff (climb),Business,United States of America,North America,2,1,0,1,0,0,2,Human Factor
1978-07-30 00:00:00,Casper Air Service,Takeoff (climb),Commercial,United States of America,North America,3,1,0,2,0,0,3,Technical Failure
1978-07-30 00:00:00,Private American,Flight,Humanitarian,Colombia,South America,0,0,0,0,0,0,0,Human Factor
1978-07-31 00:00:00,Bahamasair,Takeoff (climb),Commercial,Bahamas,Central America,0,0,0,0,0,0,0,Unknown
1978-08-03 00:00:00,LAN Chile - Linea Aérea Nacional de Chile,Landing (descent or approach),Commercial,Argentina,South America,63,8,0,55,0,0,63,Human Factor
1978-08-03 00:00:00,Private American,Landing (descent or approach),Business,United States of America,North America,5,1,0,4,0,0,5,Human Factor
1978-08-03 00:00:00,Private American,Landing (descent or approach),Humanitarian,United States of America,North America,1,1,0,0,0,0,1,Human Factor
1978-08-04 00:00:00,W. W. Williams Company,Landing (descent or approach),Business,United States of America,North America,3,1,0,2,0,0,3,Human Factor
1978-08-07 00:00:00,Montauk Caribbean Airways,Landing (descent or approach),Operational,United States of America,North America,2,2,0,0,0,0,2,Human Factor
1978-08-08 00:00:00,Blackhawk Airways,Landing (descent or approach),Operational,United States of America,North America,1,1,0,0,0,0,1,Human Factor
1978-08-11 00:00:00,J. Ray McDermott %26 Company,Flight,Business,Nigeria,Africa,0,0,0,0,0,0,0,Technical Failure
1978-08-13 00:00:00,Tejas Airlines,Landing (descent or approach),Commercial,United States of America,North America,18,2,0,16,0,0,18,Human Factor
1978-08-14 00:00:00,West Coast Air Services,Landing (descent or approach),Commercial,Canada,North America,1,1,0,0,0,0,1,Unknown
1978-08-16 00:00:00,Aeroflot - Russian International Airlines,Flight,Commercial,Uzbekistan,Asia,0,0,0,0,0,0,0,Human Factor
1978-08-16 00:00:00,Sécurité civile française,Flight,Operational,France,Europe,2,2,0,0,0,0,2,Technical Failure
1978-08-16 00:00:00,Suidwes Lugdiens - South West Airways,Takeoff (climb),Commercial,Namibia,Africa,3,1,0,2,0,0,3,Unknown
1978-08-17 00:00:00,Skyways Cargo Airline,Takeoff (climb),Operational,United Kingdom,Europe,3,2,0,1,0,0,3,Unknown
1978-08-22 00:00:00,Hawk Aviation,Takeoff (climb),Business,United States of America,North America,1,1,0,0,0,0,1,Technical Failure
1978-08-26 00:00:00,Kenton Utilities %26 Developments,Landing (descent or approach),Business,Spain,Europe,4,1,0,3,0,0,4,Unknown
1978-08-28 00:00:00,Romanian Government,Landing (descent or approach),Military / Government,Romania,Europe,6,6,0,0,0,0,6,Technical Failure
1978-08-31 00:00:00,Southeast Airmotive,Takeoff (climb),Operational,United States of America,North America,2,2,0,0,0,0,2,Human Factor
1978-09-01 00:00:00,Brennan Air,Takeoff (climb),Operational,United States of America,North America,1,1,0,0,0,0,1,Technical Failure
1978-09-06 00:00:00,North East Bolivian Airways - NEBA,Takeoff (climb),Commercial,Bolivia,South America,0,0,0,0,0,0,0,Technical Failure
1978-09-07 00:00:00,Cochise Airlines,Flight,Commercial,United States of America,North America,2,1,0,1,0,0,2,Human Factor
1978-09-07 00:00:00,Air Ceylon,Parking,Operational,Sri Lanka,Asia,2,2,0,0,0,0,2,Terrorism
1978-09-12 00:00:00,William Catalina,Flight,Business,Bahamas,Central America,2,1,0,1,0,0,2,Technical Failure
1978-09-13 00:00:00,Aeroservicios Especiales de Colombia - AE Colombia,Landing (descent or approach),Commercial,Colombia,South America,10,2,0,8,0,0,10,Other
1978-09-14 00:00:00,Royal Netherlands Navy - Marineluchtvaartdienst,Flight,Military / Government,United Kingdom,Europe,14,14,0,0,0,0,14,Technical Failure
1978-09-14 00:00:00,ZUA - Zakładu Usług Agrolotniczych - AET Agroaviation Services,Flight,Military / Government,Cameroon,Africa,0,0,0,0,0,0,0,Unknown
1978-09-18 00:00:00,Kenn Borek Air,Landing (descent or approach),Operational,Canada,North America,2,2,0,0,0,0,2,Human Factor
1978-09-19 00:00:00,Appalachian Flying Service,Landing (descent or approach),Operational,United States of America,North America,1,1,0,0,0,0,1,Technical Failure
1978-09-24 00:00:00,Conoco,Landing (descent or approach),Business,United States of America,North America,20,2,0,18,0,0,20,Technical Failure
1978-09-24 00:00:00,Warbirds of Great Britain,Flight,Operational,Sudan,Africa,2,2,0,0,0,0,2,Technical Failure
1978-09-29 00:00:00,Aeroflot - Russian International Airlines,Flight,Commercial,Mongolia,Asia,0,0,0,0,0,0,0,Human Factor
1978-10-02 00:00:00,Aeroflot - Russian International Airlines,Landing (descent or approach),Commercial,Georgia,Asia,30,4,0,26,0,0,30,Technical Failure
1978-10-07 00:00:00,Rico Taxi Aéreo - Rondonia Importaçao e Comercio,Landing (descent or approach),Commercial,Brazil,South America,19,3,0,16,0,0,19,Technical Failure
1978-10-11 00:00:00,Wyman Pilot Services,Landing (descent or approach),Operational,United States of America,North America,1,1,0,0,0,0,1,Human Factor
1978-10-13 00:00:00,Aeroflot - Russian International Airlines,Flight,Commercial,Turkmenistan,Asia,0,0,0,0,0,0,0,Other
1978-10-15 00:00:00,Ethiopian Airlines,Landing (descent or approach),Commercial,Ethiopia,Africa,32,3,0,29,0,0,32,Technical Failure
1978-10-17 00:00:00,Don E. Hansen,Landing (descent or approach),Business,United States of America,North America,2,1,0,1,0,0,2,Human Factor
1978-10-17 00:00:00,ATESA - Aero Taxis Ecuatorianos,Flight,Commercial,Ecuador,South America,0,0,0,0,0,0,0,Unknown
1978-10-18 00:00:00,Aeroflot - Russian International Airlines,Takeoff (climb),Commercial,Russia,Asia,0,0,0,0,0,0,0,Human Factor
1978-10-24 00:00:00,Qualitron Aero Services,Takeoff (climb),Operational,United States of America,North America,2,2,0,0,0,0,2,Human Factor
1978-10-25 00:00:00,Aeroflot - Russian International Airlines,Flight,Commercial,Russia,Asia,0,0,0,0,0,0,0,Technical Failure
1978-10-25 00:00:00,Ethiopian Airlines,Landing (descent or approach),Commercial,Ethiopia,Africa,13,4,0,9,0,0,13,Unknown
1978-10-30 00:00:00,Bush Air,Takeoff (climb),Commercial,United States of America,North America,7,1,0,6,0,0,7,Technical Failure
1978-11-03 00:00:00,Wyman Pilot Services,Taxiing,Operational,United States of America,North America,1,1,0,0,0,0,1,Human Factor
1978-11-04 00:00:00,Nordeste Linhas Aéreas Regionais,Landing (descent or approach),Commercial,Brazil,South America,0,0,0,0,0,0,0,Unknown
1978-11-05 00:00:00,Antilles Air Boats,Flight,Specialised Services,United States of America,Central America,3,1,0,2,0,0,3,Technical Failure
1978-11-11 00:00:00,La Jolla Properties,Flight,Business,United States of America,North America,1,1,0,0,0,0,1,Human Factor
1978-11-14 00:00:00,Yemenia Yemen Airways,Landing (descent or approach),Commercial,Yemen,Asia,0,0,0,0,0,0,0,Human Factor
1978-11-18 00:00:00,Lisle Aircraft,Flight,Business,Venezuela,South America,3,2,0,1,0,0,3,Technical Failure
1978-11-28 00:00:00,Aeroflot - Russian International Airlines,Flight,Commercial,Russia,Asia,0,0,0,0,0,0,0,Technical Failure
1978-11-30 00:00:00,Aeroflot - Russian International Airlines,Flight,Commercial,Russia,Asia,0,0,0,0,0,0,0,Weather
1978-12-02 00:00:00,SMB Stage Line,Landing (descent or approach),Operational,United States of America,North America,2,2,0,0,0,0,2,Human Factor
1978-12-07 00:00:00,Aeroflot - Russian International Airlines,Flight,Commercial,Russia,Asia,0,0,0,0,0,0,0,Unknown
1978-12-08 00:00:00,Norberto Salmon,,Business,Bolivia,South America,0,0,0,0,0,0,0,Unknown
1978-12-14 00:00:00,Jose Rodriguez,Landing (descent or approach),Humanitarian,United States of America,North America,1,1,0,0,0,0,1,Human Factor
1978-12-15 00:00:00,Gulf Air - Canada,Landing (descent or approach),Operational,Canada,North America,1,1,0,0,0,0,1,Unknown
1978-12-18 00:00:00,Allegheny Commuter,Landing (descent or approach),Commercial,United States of America,North America,17,2,0,15,0,0,17,Human Factor
1978-12-18 00:00:00,Private German,Flight,Business,World,World,1,1,0,0,0,0,1,Unknown
1978-12-20 00:00:00,Flight Training Center,Takeoff (climb),Business,United States of America,North America,7,2,0,5,0,0,7,Human Factor
1978-12-20 00:00:00,Air Central,Takeoff (climb),Commercial,United States of America,North America,7,1,0,6,0,0,7,Human Factor
1978-12-26 00:00:00,TAM Brasil - Taxi Aéreo Marilia - Transportes Aéreos Regionais,Takeoff (climb),Commercial,Brazil,South America,6,2,0,4,0,0,6,Technical Failure
1979-01-05 00:00:00,Great Northern Airlines,Landing (descent or approach),Commercial,United States of America,North America,15,6,0,9,0,0,15,Human Factor
1979-01-05 00:00:00,Nicaraguayan Air Force - Fuerza Aérea - Ejercito de Nicaragua,Takeoff (climb),Military / Government,Nicaragua,Central America,0,0,0,0,0,0,0,Unknown
1979-01-10 00:00:00,Waggoner Aircraft,Landing (descent or approach),Business,United States of America,North America,1,1,0,0,0,0,1,Human Factor
1979-01-12 00:00:00,Transportes Aéreos Kantuta - Trak Airways,Flight,Commercial,Bolivia,South America,0,0,0,0,0,0,0,Unknown
1979-01-14 00:00:00,Ed H. Woolsey,Landing (descent or approach),Business,United States of America,North America,3,1,0,2,0,0,3,Technical Failure
1979-01-14 00:00:00,Trans Catalina Airlines,Takeoff (climb),Commercial,United States of America,North America,11,2,0,9,0,0,11,Human Factor
1979-01-15 00:00:00,William Kelly,Flight,Business,United States of America,North America,2,1,0,1,0,0,2,Technical Failure
1979-01-15 00:00:00,Danish Inter Flight,Landing (descent or approach),Commercial,Denmark,Europe,0,0,0,0,0,0,0,Technical Failure
1979-01-17 00:00:00,Brazilian Air Force - Força Aérea Brasileira,Landing (descent or approach),Military / Government,Brazil,South America,2,2,0,0,0,0,2,Technical Failure
1979-01-17 00:00:00,French Navy,Takeoff (climb),Military / Government,France,Europe,0,0,0,0,0,0,0,Technical Failure
1979-01-19 00:00:00,Aeroflot - Russian International Airlines,Flight,Operational,Russia,Asia,4,3,0,1,0,0,4,Technical Failure
1979-01-20 00:00:00,Boise Air Services,Landing (descent or approach),Operational,United States of America,North America,1,1,0,0,0,0,1,Human Factor
1979-01-23 00:00:00,Tyee Airlines,Flight,Operational,United States of America,North America,2,2,0,0,0,0,2,Human Factor
1979-01-23 00:00:00,WMD Inc.,Landing (descent or approach),Business,United States of America,North America,3,1,0,2,0,0,3,Human Factor
1979-01-23 00:00:00,Italian Air Force - Aeronautica Militare Italiana,Parking,Specialised Services,Italy,Europe,0,0,0,0,0,0,0,Human Factor
1979-01-24 00:00:00,Italian Air Force - Aeronautica Militare Italiana,Landing (descent or approach),Operational,Italy,Europe,0,0,0,0,0,0,0,Human Factor
1979-01-26 00:00:00,Big Six General Partnership,Landing (descent or approach),Business,United States of America,North America,10,2,0,8,0,0,10,Human Factor
1979-01-27 00:00:00,Ingatoro,Flight,Operational,Bolivia,South America,1,1,0,0,0,0,1,Technical Failure
1979-01-29 00:00:00,Nicaraguayan Air Force - Fuerza Aérea - Ejercito de Nicaragua,,Military / Government,Nicaragua,Central America,0,0,0,0,0,0,0,Unknown
1979-02-01 00:00:00,Private Australian,Takeoff (climb),Operational,Australia,Oceania,2,1,0,1,0,0,2,Human Factor
1979-02-07 00:00:00,Cessna Aircraft Company,Flight,Specialised Services,United States of America,North America,1,1,0,0,0,0,1,Human Factor
1979-02-09 00:00:00,Eastern Airlines,Takeoff (climb),Operational,United States of America,North America,5,4,0,1,0,0,5,Human Factor
1979-02-13 00:00:00,Pan-Air,Flight,Operational,Australia,Oceania,1,1,0,0,0,0,1,Technical Failure
1979-02-17 00:00:00,Aeroflot - Russian International Airlines,Flight,Commercial,Russia,Asia,0,0,0,0,0,0,0,Technical Failure
1979-02-19 00:00:00,Québecair,Landing (descent or approach),Commercial,Saint Lucia,Central America,171,9,0,162,0,0,171,Weather
1979-02-23 00:00:00,Great Western Airlines,Taxiing,Operational,United States of America,North America,1,1,0,0,0,0,1,Human Factor
1979-02-23 00:00:00,Hammonds Flying Service,Flight,Operational,United States of America,North America,2,1,0,1,0,0,2,Technical Failure
1979-02-27 00:00:00,Burlington Air Express,Takeoff (climb),Operational,United States of America,North America,2,2,0,0,0,0,2,Other
1979-03-05 00:00:00,Polish Air Force - Polska Wojska Lotnicze i Obrony Powietrznej,,Military / Government,Poland,Europe,0,0,0,0,0,0,0,Unknown
1979-03-12 00:00:00,Air France,Taxiing,Commercial,Germany,Europe,41,6,0,35,0,0,41,Human Factor
1979-03-14 00:00:00,Air Mauritanie,Landing (descent or approach),Commercial,Mauritania,Africa,0,0,0,0,0,0,0,Unknown
1979-03-15 00:00:00,Pakistan Air Force - Pakistan Fiza'ya,Taxiing,Military / Government,Pakistan,Asia,0,0,0,0,0,0,0,Unknown
1979-03-15 00:00:00,Pakistan Air Force - Pakistan Fiza'ya,Taxiing,Military / Government,Pakistan,Asia,0,0,0,0,0,0,0,Unknown
1979-03-20 00:00:00,Aeroflot - Russian International Airlines,Landing (descent or approach),Commercial,Turkmenistan,Asia,35,5,0,30,0,0,35,Other
1979-03-22 00:00:00,Aerovias Guayana - Aguaysa,Takeoff (climb),Commercial,Venezuela,South America,7,1,0,6,0,0,7,Other
1979-03-30 00:00:00,Private German,Landing (descent or approach),Business,Germany,Europe,6,1,0,5,0,0,6,Human Factor
1979-03-30 00:00:00,Aéro-Service,Landing (descent or approach),Commercial,Congo,Africa,0,0,0,0,0,0,0,Unknown
1979-03-31 00:00:00,Para Centrum Provincie,Flight,Humanitarian,Belgium,Europe,0,0,0,0,0,0,0,Unknown
1979-03-31 00:00:00,Abelag Aviation,Takeoff (climb),Commercial,Belgium,Europe,0,0,0,0,0,0,0,Unknown
1979-04-03 00:00:00,Burlington Air Express,Takeoff (climb),Operational,United States of America,North America,1,1,0,0,0,0,1,Human Factor
1979-04-04 00:00:00,Providence Air Charter,Landing (descent or approach),Operational,United States of America,North America,1,1,0,0,0,0,1,Human Factor
1979-04-09 00:00:00,International Business Aircraft,Landing (descent or approach),Business,United States of America,North America,3,2,0,1,0,0,3,Other
1979-04-10 00:00:00,Green Aero,Landing (descent or approach),Operational,United States of America,North America,1,1,0,0,0,0,1,Human Factor
1979-04-11 00:00:00,World Photography Corporation,Landing (descent or approach),Humanitarian,United States of America,North America,1,1,0,0,0,0,1,Human Factor
1979-04-12 00:00:00,McCollum Aviation,Takeoff (climb),Humanitarian,United States of America,North America,2,2,0,0,0,0,2,Human Factor
1979-04-15 00:00:00,COMAG - Companhia Moçambicana de Aviação Geral,Flight,Commercial,Mozambique,Africa,5,1,0,4,0,0,5,Terrorism
1979-04-16 00:00:00,Jose Benitez,Landing (descent or approach),Business,United States of America,North America,2,2,0,0,0,0,2,Technical Failure
1979-04-20 00:00:00,Aeronor-Chile - Transportes Aero Norte-Sur,Takeoff (climb),Commercial,Chile,South America,5,3,0,2,0,0,5,Technical Failure
1979-04-23 00:00:00,Aero Facilities Corporation,Landing (descent or approach),Humanitarian,United States of America,North America,1,1,0,0,0,0,1,Human Factor
1979-04-26 00:00:00,Indian Airlines,Landing (descent or approach),Commercial,India,Asia,67,6,0,61,0,0,67,Terrorism
1979-04-26 00:00:00,Bali International Air Service,Flight,Commercial,Indonesia,Asia,2,2,0,0,0,0,2,Unknown
1979-05-01 00:00:00,MIAT Mongolian Airlines - Mongolyn Irgeniy Agaaryn Teever,Landing (descent or approach),Commercial,Mongolia,Asia,0,0,0,0,0,0,0,Unknown
1979-05-10 00:00:00,Aeroflot - Russian International Airlines,Takeoff (climb),Commercial,Russia,Asia,79,7,0,72,0,0,79,Human Factor
1979-05-10 00:00:00,Aeroflot - Russian International Airlines,Flight,Commercial,Ukraine,Europe,0,0,0,0,0,0,0,Other
1979-05-13 00:00:00,WSK - Wytwórnia Sprzętu Komunikacyjnego,,Other,Poland,Europe,0,0,0,0,0,0,0,Unknown
1979-05-15 00:00:00,Biegert Aviation,Takeoff (climb),Specialised Services,United States of America,North America,2,2,0,0,0,0,2,Human Factor
1979-05-15 00:00:00,Soviet Air Force - Voyenno-vozdushnye sily CCCP,Flight,Military / Government,Russia,Asia,0,0,0,0,0,0,0,Unknown
1979-05-15 00:00:00,Loganair,Landing (descent or approach),Commercial,United Kingdom,Europe,0,0,0,0,0,0,0,Unknown
1979-05-15 00:00:00,TAAG Angola Airlines - Transportes Aéreos de Angola,Landing (descent or approach),Operational,São Tomé and Principe,Africa,5,4,0,1,0,0,5,Unknown
1979-05-17 00:00:00,Palm Beach Aviation,Takeoff (climb),Operational,Bahamas,Central America,1,1,0,0,0,0,1,Technical Failure
1979-05-19 00:00:00,Aeroflot - Russian International Airlines,Landing (descent or approach),Commercial,Kazakhstan,Asia,0,0,0,0,0,0,0,Technical Failure
1979-05-19 00:00:00,Aeroflot - Russian International Airlines,Landing (descent or approach),Commercial,Russia,Asia,89,6,0,83,0,0,89,Human Factor
1979-05-22 00:00:00,Aeroflot - Russian International Airlines,Flight,Commercial,Russia,Asia,0,0,0,0,0,0,0,Technical Failure
1979-05-24 00:00:00,Aeroflot - Russian International Airlines,Flight,Commercial,Russia,Asia,0,0,0,0,0,0,0,Human Factor
1979-05-27 00:00:00,Jet Aviation,Landing (descent or approach),Commercial,Switzerland,Europe,7,1,0,6,0,0,7,Human Factor
1979-05-29 00:00:00,Combs FreightAir,Landing (descent or approach),Operational,United States of America,North America,2,2,0,0,0,0,2,Other
1979-05-30 00:00:00,Business Jets - Australias Jet Charter Airline,Landing (descent or approach),Commercial,Australia,Oceania,3,1,0,2,0,0,3,Human Factor
1979-05-31 00:00:00,Fairchild Aircraft Corporation,Landing (descent or approach),Specialised Services,United States of America,North America,4,4,0,0,0,0,4,Human Factor
1979-05-31 00:00:00,Aeroflot - Russian International Airlines,Landing (descent or approach),Operational,Russia,Asia,5,5,0,0,0,0,5,Technical Failure
1979-06-01 00:00:00,Aero Trades,Takeoff (climb),Operational,Canada,North America,2,2,0,0,0,0,2,Technical Failure
1979-06-01 00:00:00,OTRAG Range Air Services - ORAS,Landing (descent or approach),Operational,Democratic Republic of Congo,Africa,0,0,0,0,0,0,0,Human Factor
1979-06-02 00:00:00,Private Swiss,Landing (descent or approach),Business,Italy,Europe,0,0,0,0,0,0,0,Unknown
1979-06-03 00:00:00,Private German,Flight,Business,Germany,Europe,0,0,0,0,0,0,0,Unknown
1979-06-05 00:00:00,J%26J Automotive,Landing (descent or approach),Business,United States of America,North America,1,1,0,0,0,0,1,Technical Failure
1979-06-06 00:00:00,Private Nicaraguan,Landing (descent or approach),Humanitarian,United States of America,North America,3,3,0,0,0,0,3,Human Factor
1979-06-06 00:00:00,ZUA - Zakładu Usług Agrolotniczych - AET Agroaviation Services,Flight,Military / Government,Poland,Europe,0,0,0,0,0,0,0,Unknown
1979-06-07 00:00:00,British Army Air Corps,Landing (descent or approach),Military / Government,Canada,North America,4,1,0,3,0,0,4,Unknown
1979-06-11 00:00:00,Airborne Express,Landing (descent or approach),Operational,United States of America,North America,2,2,0,0,0,0,2,Human Factor
1979-06-11 00:00:00,Eastern Distribution Inc.,Flight,Operational,United States of America,North America,2,2,0,0,0,0,2,Technical Failure
1979-06-16 00:00:00,Aeroflot - Russian International Airlines,Flight,Business,Russia,Asia,1,1,0,0,0,0,1,Human Factor
1979-06-18 00:00:00,Brazilian Air Force - Força Aérea Brasileira,Landing (descent or approach),Operational,Brazil,South America,2,2,0,0,0,0,2,Unknown
1979-06-21 00:00:00,Beaver Air Spray,Landing (descent or approach),Military / Government,Canada,North America,4,4,0,0,0,0,4,Technical Failure
1979-06-29 00:00:00,Alpha Aviation - USA,Flight,Military / Government,United States of America,North America,2,2,0,0,0,0,2,Human Factor
1979-06-29 00:00:00,Shane Aviation,Landing (descent or approach),Operational,United States of America,North America,2,2,0,0,0,0,2,Human Factor
1979-07-02 00:00:00,East German Air Force - Luftstreitkräfte der Nationalen Volksarmee,Takeoff (climb),Operational,Germany,Europe,2,2,0,0,0,0,2,Technical Failure
1979-07-05 00:00:00,Transport Aérien Transrégional - TAT,Parking,Commercial,France,Europe,18,3,0,15,0,0,18,Unknown
1979-07-06 00:00:00,Gifford Aviation,Takeoff (climb),Operational,United States of America,North America,5,2,0,3,0,0,5,Human Factor
1979-07-06 00:00:00,ZUA - Zakładu Usług Agrolotniczych - AET Agroaviation Services,Flight,Military / Government,Poland,Europe,0,0,0,0,0,0,0,Unknown
1979-07-07 00:00:00,Aggadir Ltd,Flight,Operational,Netherlands,Central America,3,2,0,1,0,0,3,Technical Failure
1979-07-08 00:00:00,Vernair Transport Services,Landing (descent or approach),Operational,Pakistan,Asia,2,2,0,0,0,0,2,Unknown
1979-07-09 00:00:00,Aeroflot - Russian International Airlines,Takeoff (climb),Commercial,Russia,Asia,0,0,0,0,0,0,0,Unknown
1979-07-11 00:00:00,Eagle Air - USA,Landing (descent or approach),Operational,United States of America,North America,1,1,0,0,0,0,1,Technical Failure
1979-07-13 00:00:00,M. J. Supply Inc.,Flight,Operational,United States of America,North America,2,2,0,0,0,0,2,Technical Failure
1979-07-13 00:00:00,Air Caribbean,Landing (descent or approach),Humanitarian,Puerto Rico,Central America,1,1,0,0,0,0,1,Human Factor
1979-07-15 00:00:00,Austin Airways,Parking,Operational,Canada,North America,2,2,0,0,0,0,2,Technical Failure
1979-07-20 00:00:00,DuPont Oil Company,Landing (descent or approach),Humanitarian,United States of America,North America,1,1,0,0,0,0,1,Human Factor
1979-07-20 00:00:00,Aerotal Colombia - Aerolineas Territoriales de Colombia,Landing (descent or approach),Commercial,Colombia,South America,57,6,0,51,0,0,57,Technical Failure
1979-07-23 00:00:00,Missionary Aviation Fellowship - MAF,Flight,Humanitarian,Indonesia,Asia,0,0,0,0,0,0,0,Unknown
1979-07-24 00:00:00,Wiregrass Aviation,Landing (descent or approach),Operational,United States of America,North America,3,2,0,1,0,0,3,Human Factor
1979-07-25 00:00:00,Aerial Agriculture,Flight,Military / Government,Australia,Oceania,1,1,0,0,0,0,1,Unknown
1979-07-26 00:00:00,Aerial Agriculture,Flight,Military / Government,Australia,Oceania,1,1,0,0,0,0,1,Unknown
1979-08-02 00:00:00,Aeroflot - Russian International Airlines,Takeoff (climb),Specialised Services,Russia,Asia,0,0,0,0,0,0,0,Human Factor
1979-08-05 00:00:00,Cooper-Bregstein Realty Company,Landing (descent or approach),Business,United States of America,North America,2,1,0,1,0,0,2,Technical Failure
1979-08-07 00:00:00,Harvest Air,Landing (descent or approach),Other,Greenland,Europe,0,0,0,0,0,0,0,Unknown
1979-08-09 00:00:00,Private German,Flight,Business,Germany,Europe,0,0,0,0,0,0,0,Unknown
1979-08-19 00:00:00,Cyprus Airways,Landing (descent or approach),Commercial,Bahrain,Asia,81,8,0,73,0,0,81,Human Factor
1979-08-23 00:00:00,Líder Taxi Aéreo,Landing (descent or approach),Operational,Brazil,South America,2,2,0,0,0,0,2,Human Factor
1979-08-26 00:00:00,Cornerstone Construction,Landing (descent or approach),Humanitarian,Puerto Rico,Central America,3,2,0,1,0,0,3,Technical Failure
1979-08-31 00:00:00,Air North - Yukon Air Service,Takeoff (climb),Operational,United States of America,North America,2,2,0,0,0,0,2,Human Factor
1979-09-01 00:00:00,Lao Aviation,Landing (descent or approach),Commercial,Laos,Asia,74,6,0,68,0,0,74,Weather
1979-09-03 00:00:00,A. M. Leyendecker,Takeoff (climb),Specialised Services,United States of America,North America,2,2,0,0,0,0,2,Human Factor
1979-09-09 00:00:00,Yung Shing Airlines,Taxiing,Commercial,Taiwan,Asia,6,2,0,4,0,0,6,Human Factor
1979-09-09 00:00:00,Taiwan Airlines,Takeoff (climb),Commercial,Taiwan,Asia,10,2,0,8,0,0,10,Human Factor
1979-09-10 00:00:00,Aeroflot - Russian International Airlines,Flight,Commercial,Russia,Asia,0,0,0,0,0,0,0,Technical Failure
1979-09-12 00:00:00,Rich International Airways,Takeoff (climb),Operational,Turks and Caicos Islands,Central America,3,2,0,1,0,0,3,Technical Failure
1979-09-18 00:00:00,United States Air Force - USAF,Landing (descent or approach),Operational,United States of America,North America,6,6,0,0,0,0,6,Technical Failure
1979-09-21 00:00:00,Ethiopian Airlines,Takeoff (climb),Commercial,Eritrea,Africa,0,0,0,0,0,0,0,Unknown
1979-09-24 00:00:00,Aeroflot - Russian International Airlines,Flight,Military / Government,Turkmenistan,Asia,2,2,0,0,0,0,2,Human Factor
1979-09-25 00:00:00,Aeroflot - Russian International Airlines,Flight,Commercial,Russia,Asia,0,0,0,0,0,0,0,Technical Failure
1979-09-28 00:00:00,Miami Air Lease,Flight,Operational,Bahamas,Central America,2,2,0,0,0,0,2,Technical Failure
1979-10-01 00:00:00,Methow Aviation,Flight,Commercial,United States of America,North America,2,1,0,1,0,0,2,Weather
1979-10-01 00:00:00,GATX Aircraft Corporation,Landing (descent or approach),Business,United States of America,North America,1,1,0,0,0,0,1,Human Factor
1979-10-03 00:00:00,French Air Force - Armée de l'Air,Flight,Military / Government,France,Europe,0,0,0,0,0,0,0,Unknown
1979-10-04 00:00:00,John Cary,Flight,Business,United States of America,North America,3,1,0,2,0,0,3,Technical Failure
1979-10-08 00:00:00,Trans-Provincial Airlines - TPA,Takeoff (climb),Commercial,Canada,North America,0,0,0,0,0,0,0,Other
1979-10-10 00:00:00,ALAS - Atlantida Linea Aérea Sudamericana,Landing (descent or approach),Operational,Uruguay,South America,6,4,0,2,0,0,6,Technical Failure
1979-10-13 00:00:00,Aeroflot - Russian International Airlines,Takeoff (climb),Commercial,Russia,Asia,5,2,0,3,0,0,5,Technical Failure
1979-10-16 00:00:00,Futura Aviation,Flight,Operational,Canada,North America,1,1,0,0,0,0,1,Technical Failure
1979-10-18 00:00:00,Aviateca,Landing (descent or approach),Commercial,Guatemala,Central America,0,0,0,0,0,0,0,Technical Failure
1979-10-19 00:00:00,Aeroflot - Russian International Airlines,Flight,Commercial,Russia,Asia,0,0,0,0,0,0,0,Human Factor
1979-10-20 00:00:00,Dirgantara Air Service,Flight,Commercial,Indonesia,Asia,0,0,0,0,0,0,0,Unknown
1979-10-22 00:00:00,Sky of Siam,Flight,Humanitarian,Thailand,Asia,0,0,0,0,0,0,0,Technical Failure
1979-10-23 00:00:00,Aviatia Utilitara,Flight,Military / Government,Romania,Europe,0,0,0,0,0,0,0,Unknown
1979-10-25 00:00:00,Guernsey Airlines,Landing (descent or approach),Commercial,United Kingdom,Europe,51,4,0,47,0,0,51,Human Factor
1979-10-25 00:00:00,Interair Services,Flight,Business,Bahamas,Central America,1,1,0,0,0,0,1,Technical Failure
1979-10-25 00:00:00,Aeroflot - Russian International Airlines,Flight,Commercial,Russia,Asia,0,0,0,0,0,0,0,Other
1979-10-31 00:00:00,Aeroflot - Russian International Airlines,Flight,Operational,Russia,Asia,5,5,0,0,0,0,5,Human Factor
1979-11-03 00:00:00,Stewart Lake Air Service,Flight,Commercial,Canada,North America,2,1,0,1,0,0,2,Technical Failure
1979-11-05 00:00:00,South Pacific Island Airways - SPIA,Landing (descent or approach),Commercial,Samoa Islands (Western Samoa),Oceania,18,2,0,16,0,0,18,Human Factor
1979-11-06 00:00:00,Transmandu - Transportes Aéreos Manduca,,Commercial,Venezuela,South America,0,0,0,0,0,0,0,Unknown
1979-11-07 00:00:00,National Agricultural Organisation,Flight,Military / Government,Sudan,Africa,0,0,0,0,0,0,0,Technical Failure
1979-11-13 00:00:00,Lambair - Lamb Airways,Landing (descent or approach),Operational,Canada,North America,2,2,0,0,0,0,2,Technical Failure
1979-11-13 00:00:00,Consultoria Tecnical e Operacional de Aviaçao - CTOA,Flight,Commercial,Brazil,South America,0,0,0,0,0,0,0,Unknown
1979-11-14 00:00:00,Dale Rodenbeek,Takeoff (climb),Business,United States of America,North America,3,2,0,1,0,0,3,Unknown
1979-11-16 00:00:00,Nevada Airlines,Takeoff (climb),Commercial,United States of America,North America,44,3,0,41,0,0,44,Technical Failure
1979-11-18 00:00:00,Biman Bangladesh Airlines,Flight,Operational,Bangladesh,Asia,4,4,0,0,0,0,4,Technical Failure
1979-11-24 00:00:00,Mackey International Airlines,Landing (descent or approach),Commercial,Bahamas,Central America,46,3,0,43,0,0,46,Technical Failure
1979-11-25 00:00:00,Thomas Rex Long,Landing (descent or approach),Business,United States of America,North America,8,1,0,7,0,0,8,Human Factor
1979-11-26 00:00:00,Private British,Flight,Business,United Kingdom,Europe,4,1,0,3,0,0,4,Unknown
1979-11-27 00:00:00,Irish Air Corps - Aer Chór na hÉireann,Takeoff (climb),Operational,Ireland,Europe,3,3,0,0,0,0,3,Other
1979-11-29 00:00:00,General Air Swaziland,,Commercial,Tanzania,Africa,0,0,0,0,0,0,0,Unknown
1979-11-30 00:00:00,Saudi Arabian Airlines - SAUDIA,Landing (descent or approach),Commercial,Saudi Arabia,Asia,0,0,0,0,0,0,0,Unknown
1979-12-01 00:00:00,Refinadora Costarricense de Petróleo,Landing (descent or approach),Business,Costa Rica,Central America,2,1,0,1,0,0,2,Technical Failure
1979-12-02 00:00:00,Coca Cola Company,Landing (descent or approach),Business,United States of America,North America,4,1,0,3,0,0,4,Human Factor
1979-12-02 00:00:00,ERA Aviation,Takeoff (climb),Commercial,United States of America,North America,6,2,0,4,0,0,6,Human Factor
1979-12-07 00:00:00,Aeroflot - Russian International Airlines,Flight,Commercial,Russia,Asia,0,0,0,0,0,0,0,Human Factor
1979-12-10 00:00:00,Pacific Aerospace,Flight,Specialised Services,New Zealand,Oceania,1,1,0,0,0,0,1,Technical Failure
1979-12-20 00:00:00,Horizon Partners,Flight,Humanitarian,Colombia,South America,2,2,0,0,0,0,2,Unknown
1979-12-31 00:00:00,Nicaraguayan Air Force - Fuerza Aérea - Ejercito de Nicaragua,,Military / Government,Nicaragua,Central America,0,0,0,0,0,0,0,Unknown
1980-01-05 00:00:00,Fred C. Sorenson,Landing (descent or approach),Business,United States of America,North America,9,2,0,7,0,0,9,Human Factor
1980-01-11 00:00:00,Carga Aéreo Transportadora,Takeoff (climb),Operational,Bolivia,South America,2,2,0,0,0,0,2,Technical Failure
1980-01-13 00:00:00,Garuda Indonesian Airways,Landing (descent or approach),Commercial,Indonesia,Asia,126,5,0,121,0,0,126,Human Factor
1980-01-15 00:00:00,Corporate Air - USA,Flight,Operational,United States of America,North America,1,1,0,0,0,0,1,Technical Failure
1980-01-18 00:00:00,Eastern Caribbean Airways,Takeoff (climb),Commercial,United States of America,Central America,10,1,0,9,0,0,10,Technical Failure
1980-01-22 00:00:00,Lloyd Aéreo Boliviano - LAB Airlines,Landing (descent or approach),Commercial,Bolivia,South America,30,5,0,25,0,0,30,Unknown
1980-01-23 00:00:00,LOT Polish Airlines - Polskie Linie Lotnicze,Landing (descent or approach),Commercial,Poland,Europe,0,0,0,0,0,0,0,Unknown
1980-01-26 00:00:00,Aeroflot - Russian International Airlines,Flight,Commercial,Russia,Asia,0,0,0,0,0,0,0,Technical Failure
1980-01-27 00:00:00,Avianca,Landing (descent or approach),Commercial,Ecuador,South America,0,0,0,0,0,0,0,Human Factor
1980-01-29 00:00:00,Airsprinter,Landing (descent or approach),Business,France,Europe,8,2,0,6,0,0,8,Unknown
1980-01-30 00:00:00,French Navy,,Military / Government,France,Europe,0,0,0,0,0,0,0,Unknown
1980-02-04 00:00:00,EuroAir,Landing (descent or approach),Operational,United Kingdom,Europe,1,1,0,0,0,0,1,Human Factor
1980-02-08 00:00:00,Private New Zealand,Flight,Military / Government,New Zealand,Oceania,1,1,0,0,0,0,1,Unknown
1980-02-21 00:00:00,United States Navy - USN,,Military / Government,United States of America,North America,0,0,0,0,0,0,0,Unknown
1980-02-24 00:00:00,Dirgantara Air Service,,Commercial,Indonesia,Asia,0,0,0,0,0,0,0,Unknown
1980-02-29 00:00:00,Amick Airways,Flight,Commercial,United States of America,North America,2,1,0,1,0,0,2,Technical Failure
1980-03-01 00:00:00,Aeroflot - Russian International Airlines,Landing (descent or approach),Commercial,Russia,Asia,161,9,0,152,0,0,161,Human Factor
1980-03-06 00:00:00,Kodiak Western Alaska Airlines,Landing (descent or approach),Operational,United States of America,North America,1,1,0,0,0,0,1,Human Factor
1980-03-06 00:00:00,Airmore Aviation,Landing (descent or approach),Business,France,Europe,0,0,0,0,0,0,0,Unknown
1980-03-07 00:00:00,ZUA - Zakładu Usług Agrolotniczych - AET Agroaviation Services,Flight,Military / Government,Poland,Europe,0,0,0,0,0,0,0,Unknown
1980-03-08 00:00:00,Aeroflot - Russian International Airlines,Takeoff (climb),Commercial,Russia,Asia,0,0,0,0,0,0,0,Unknown
1980-03-13 00:00:00,Aerolineas La Paz,Takeoff (climb),Commercial,Bolivia,South America,0,0,0,0,0,0,0,Technical Failure
1980-03-15 00:00:00,MAP - Ministerstvo Aviatsionnoi Promyshlennosti - Minaviaprom,Taxiing,Military / Government,Russia,Asia,0,0,0,0,0,0,0,Technical Failure
1980-03-17 00:00:00,Texas International Airlines,Landing (descent or approach),Commercial,United States of America,North America,50,4,0,46,0,0,50,Human Factor
1980-03-18 00:00:00,Ethiopian Airlines,Landing (descent or approach),Operational,Ethiopia,Africa,3,3,0,0,0,0,3,Technical Failure
1980-03-23 00:00:00,American Aviation Group Services,Flight,Business,Bahamas,Central America,0,0,0,0,0,0,0,Unknown
1980-03-23 00:00:00,Aeroflot - Russian International Airlines,Takeoff (climb),Humanitarian,Russia,Asia,2,2,0,0,0,0,2,Human Factor
1980-03-25 00:00:00,Air Traffic,Landing (descent or approach),Business,Libya,Africa,3,2,0,1,0,0,3,Human Factor
1980-03-29 00:00:00,Inair Panama - Internacional de Aviación,Landing (descent or approach),Operational,Panama,Central America,4,4,0,0,0,0,4,Weather
1980-03-31 00:00:00,Royal New Zealand Air Force - RNZAF,Taxiing,Operational,New Zealand,Oceania,2,2,0,0,0,0,2,Technical Failure
1980-03-31 00:00:00,Air Guinée,Landing (descent or approach),Commercial,Guinea,Africa,35,8,0,27,0,0,35,Unknown
1980-04-02 00:00:00,Retzer %26 Retzer,Takeoff (climb),Business,United States of America,North America,5,1,0,4,0,0,5,Technical Failure
1980-04-03 00:00:00,Aeroflot - Russian International Airlines,Takeoff (climb),Commercial,Russia,Asia,0,0,0,0,0,0,0,Technical Failure
1980-04-03 00:00:00,Biman Bangladesh Airlines,Takeoff (climb),Commercial,Singapore,Asia,78,7,0,71,0,0,78,Unknown
1980-04-05 00:00:00,Liberian Government,Flight,Military / Government,Liberia,Africa,0,0,0,0,0,0,0,Unknown
1980-04-06 00:00:00,George H. Bailey Company,Landing (descent or approach),Humanitarian,United States of America,North America,2,1,0,1,0,0,2,Technical Failure
1980-04-13 00:00:00,Aeroflot - Russian International Airlines,Landing (descent or approach),Specialised Services,Russia,Asia,5,2,0,3,0,0,5,Other
1980-04-18 00:00:00,Aeroflot - Russian International Airlines,Takeoff (climb),Commercial,Russia,Asia,48,6,0,42,0,0,48,Human Factor
1980-04-21 00:00:00,Aeroservicios Internacionales,Flight,Business,Mexico,Central America,0,0,0,0,0,0,0,Unknown
1980-04-23 00:00:00,Florida Preferred Equity,Landing (descent or approach),Business,United States of America,North America,8,2,0,6,0,0,8,Human Factor
1980-04-25 00:00:00,Private American,Landing (descent or approach),Humanitarian,United States of America,North America,2,1,0,1,0,0,2,Human Factor
1980-04-26 00:00:00,Aeroflot - Russian International Airlines,Takeoff (climb),Commercial,Russia,Asia,12,2,0,10,0,0,12,Human Factor
1980-04-28 00:00:00,Transportes Aéreos Kantuta - Trak Airways,Flight,Operational,Bolivia,South America,5,3,0,2,0,0,5,Technical Failure
1980-04-28 00:00:00,Compagnie Aérienne du Languedoc,Landing (descent or approach),Commercial,France,Europe,13,2,0,11,0,0,13,Human Factor
1980-05-04 00:00:00,Junta Nacional de Carnes,Flight,Military / Government,Argentina,South America,2,1,0,1,0,0,2,Unknown
1980-05-09 00:00:00,PZL-Mielec - WSK Mielec - Wytwórni Sprzetu Komunikacyjnego,,Specialised Services,Poland,Europe,0,0,0,0,0,0,0,Unknown
1980-05-11 00:00:00,Tanzania Peoples Defence Forces,Flight,Military / Government,Tanzania,Africa,0,0,0,0,0,0,0,Unknown
1980-05-11 00:00:00,Zaïre International Cargo Air System - ZICAS,Landing (descent or approach),Operational,Cameroon,Africa,3,3,0,0,0,0,3,Weather
1980-05-12 00:00:00,J %26 R Enterprises,Landing (descent or approach),Business,United States of America,North America,2,1,0,1,0,0,2,Technical Failure
1980-05-13 00:00:00,Skywest Airlines - Australia,Landing (descent or approach),Commercial,Australia,Oceania,12,1,0,11,0,0,12,Technical Failure
1980-05-13 00:00:00,Airfast Indonesia,,Commercial,Indonesia,Asia,0,0,0,0,0,0,0,Unknown
1980-05-16 00:00:00,Lineas Aéreas de Nicaragua - LANICA,Landing (descent or approach),Commercial,Nicaragua,Central America,0,0,0,0,0,0,0,Human Factor
1980-05-23 00:00:00,Aeroflot - Russian International Airlines,Flight,Commercial,Russia,Asia,0,0,0,0,0,0,0,Human Factor
1980-05-24 00:00:00,Central Air Transport - Canada,Takeoff (climb),Commercial,Canada,North America,8,1,0,7,0,0,8,Technical Failure
1980-05-28 00:00:00,SAHSA - Servicios Aéreos de Honduras SA,Landing (descent or approach),Commercial,Honduras,Central America,0,0,0,0,0,0,0,Human Factor
1980-05-31 00:00:00,PZL-Mielec - WSK Mielec - Wytwórni Sprzetu Komunikacyjnego,Flight,Specialised Services,Poland,Europe,0,0,0,0,0,0,0,Unknown
1980-06-04 00:00:00,Air Activities,Flight,Humanitarian,United States of America,North America,1,1,0,0,0,0,1,Technical Failure
1980-06-09 00:00:00,Aeroflot - Russian International Airlines,Flight,Commercial,Russia,Asia,0,0,0,0,0,0,0,Human Factor
1980-06-12 00:00:00,Czech Air Force - Ceské Vojenské Letectvo,Takeoff (climb),Military / Government,Czech Republic,Europe,0,0,0,0,0,0,0,Unknown
1980-06-14 00:00:00,Soviet Air Force - Voyenno-vozdushnye sily CCCP,Landing (descent or approach),Military / Government,Afghanistan,Asia,0,0,0,0,0,0,0,Unknown
1980-06-15 00:00:00,Aviones de Panama,Flight,Humanitarian,Salvador,Central America,2,2,0,0,0,0,2,Human Factor
1980-06-16 00:00:00,Aeroflot - Russian International Airlines,Flight,Commercial,Ukraine,Europe,0,0,0,0,0,0,0,Technical Failure
1980-06-17 00:00:00,Soviet Air Force - Voyenno-vozdushnye sily CCCP,Landing (descent or approach),Military / Government,Afghanistan,Asia,0,0,0,0,0,0,0,Unknown
1980-06-19 00:00:00,McDonnell Douglas Industries,Landing (descent or approach),Specialised Services,United States of America,North America,3,3,0,0,0,0,3,Human Factor
1980-06-19 00:00:00,Airborne Express,Landing (descent or approach),Operational,United States of America,North America,4,3,0,1,0,0,4,Human Factor
1980-06-21 00:00:00,Thai Airways International,Landing (descent or approach),Commercial,Thailand,Asia,21,5,0,16,0,0,21,Unknown
1980-06-27 00:00:00,Transavio,Flight,Commercial,Italy,Europe,3,2,0,1,0,0,3,Technical Failure
1980-07-02 00:00:00,Sports Air,Landing (descent or approach),Business,United States of America,North America,1,1,0,0,0,0,1,Human Factor
1980-07-05 00:00:00,Gifford Aviation,Landing (descent or approach),Operational,United States of America,North America,2,2,0,0,0,0,2,Technical Failure
1980-07-07 00:00:00,Kara Leasing Group,Takeoff (climb),Business,United States of America,North America,3,1,0,2,0,0,3,Human Factor
1980-07-07 00:00:00,Aer Arann,Takeoff (climb),Commercial,Ireland,Europe,5,1,0,4,0,0,5,Technical Failure
1980-07-08 00:00:00,Private Colombian,Takeoff (climb),Business,Colombia,South America,6,1,0,5,0,0,6,Technical Failure
1980-07-11 00:00:00,Leonard Stoller,Landing (descent or approach),Business,United States of America,North America,2,1,0,1,0,0,2,Technical Failure
1980-07-14 00:00:00,Aerolineas Condor,Landing (descent or approach),Operational,Ecuador,South America,2,2,0,0,0,0,2,Human Factor
1980-07-17 00:00:00,Alidair Scotland,Landing (descent or approach),Commercial,United Kingdom,Europe,62,4,0,58,0,0,62,Technical Failure
1980-07-18 00:00:00,Pacific Missionary Aviation,Flight,Business,Micronesia,Oceania,7,1,0,6,0,0,7,Technical Failure
1980-07-18 00:00:00,Aeroflot - Russian International Airlines,Landing (descent or approach),Commercial,Russia,Asia,27,4,0,23,0,0,27,Human Factor
1980-07-23 00:00:00,Private Dominican,Landing (descent or approach),Humanitarian,United States of America,North America,0,0,0,0,0,0,0,Unknown
1980-07-25 00:00:00,Aeroflot - Russian International Airlines,Flight,Commercial,Russia,Asia,0,0,0,0,0,0,0,Technical Failure
1980-07-30 00:00:00,Aeroflot - Russian International Airlines,Landing (descent or approach),Military / Government,Russia,Asia,0,0,0,0,0,0,0,Human Factor
1980-07-31 00:00:00,ZUA - Zakładu Usług Agrolotniczych - AET Agroaviation Services,Flight,Military / Government,Poland,Europe,0,0,0,0,0,0,0,Unknown
1980-08-01 00:00:00,Jerry Rule,Takeoff (climb),Operational,United States of America,North America,3,1,0,2,0,0,3,Human Factor
1980-08-01 00:00:00,Transportes Aéreos de Magallanes - TAMA,Takeoff (climb),Commercial,Chile,South America,11,1,0,10,0,0,11,Technical Failure
1980-08-02 00:00:00,Aeroflot - Russian International Airlines,Takeoff (climb),Commercial,Russia,Asia,0,0,0,0,0,0,0,Unknown
1980-08-09 00:00:00,Aeroflot - Russian International Airlines,Flight,Commercial,Russia,Asia,0,0,0,0,0,0,0,Technical Failure
1980-08-10 00:00:00,Aeroflot - Russian International Airlines,Takeoff (climb),Commercial,Armenia,Asia,0,0,0,0,0,0,0,Weather
1980-08-14 00:00:00,Aeroflot - Russian International Airlines,Flight,Commercial,Russia,Asia,0,0,0,0,0,0,0,Human Factor
1980-08-19 00:00:00,Burma Airways,Landing (descent or approach),Commercial,Myanmar,Asia,28,4,0,24,0,0,28,Unknown
1980-08-25 00:00:00,Crowley Maritime Corporation,Landing (descent or approach),Business,United States of America,North America,6,1,0,5,0,0,6,Human Factor
1980-08-27 00:00:00,Bush Air,Flight,Operational,United States of America,North America,1,1,0,0,0,0,1,Technical Failure
1980-08-27 00:00:00,Private American,Takeoff (climb),Business,United States of America,North America,2,1,0,1,0,0,2,Technical Failure
1980-08-27 00:00:00,Hawkins %26 Powers Aviation,Takeoff (climb),Humanitarian,United States of America,North America,2,2,0,0,0,0,2,Technical Failure
1980-08-28 00:00:00,Huns Air,Landing (descent or approach),Commercial,India,Asia,29,5,0,24,0,0,29,Unknown
1980-08-29 00:00:00,Air Trans Association,Landing (descent or approach),Commercial,United States of America,North America,2,1,0,1,0,0,2,Technical Failure
1980-09-02 00:00:00,Transportes Aéreos Mercantiles Ecuatorianos - TAME,Flight,Military / Government,Ecuador,South America,7,3,0,4,0,0,7,Unknown
1980-09-03 00:00:00,Pan American World Airways - PAA,Landing (descent or approach),Commercial,Costa Rica,Central America,73,6,0,67,0,0,73,Human Factor
1980-09-05 00:00:00,United States Navy - USN,Landing (descent or approach),Military / Government,United States of America,North America,6,6,0,0,0,0,6,Unknown
1980-09-06 00:00:00,Mauritanian Air Force - Force Aérienne Islamique de Mauritanie,Flight,Military / Government,Mauritania,Africa,0,0,0,0,0,0,0,Unknown
1980-09-07 00:00:00,Mark Elliott,Flight,Humanitarian,United States of America,North America,1,1,0,0,0,0,1,Unknown
1980-09-08 00:00:00,ABC Airlines,Takeoff (climb),Operational,United States of America,North America,1,1,0,0,0,0,1,Human Factor
1980-09-09 00:00:00,International Aero Sales,Takeoff (climb),Operational,United States of America,North America,2,1,0,1,0,0,2,Human Factor
1980-09-13 00:00:00,Seaback Homes,Landing (descent or approach),Humanitarian,United States of America,North America,1,1,0,0,0,0,1,Human Factor
1980-09-15 00:00:00,Aeroflot - Russian International Airlines,Landing (descent or approach),Commercial,Russia,Asia,20,4,0,16,0,0,20,Technical Failure
1980-09-17 00:00:00,Aeroflot - Russian International Airlines,Flight,Commercial,Kazakhstan,Asia,0,0,0,0,0,0,0,Human Factor
1980-09-18 00:00:00,Northwestern Flying Services,Takeoff (climb),Commercial,Canada,North America,0,0,0,0,0,0,0,Unknown
1980-09-19 00:00:00,Private American,Landing (descent or approach),Business,United States of America,North America,2,1,0,1,0,0,2,Technical Failure
1980-09-20 00:00:00,Aerolineas Argo,Landing (descent or approach),Humanitarian,Colombia,South America,6,6,0,0,0,0,6,Unknown
1980-09-22 00:00:00,Private Paraguayan,Landing (descent or approach),Humanitarian,United States of America,North America,2,2,0,0,0,0,2,Human Factor
1980-09-26 00:00:00,National Bumper Exchange,Flight,Humanitarian,Colombia,South America,2,1,0,1,0,0,2,Technical Failure
1980-09-28 00:00:00,Joseph Lynch,Takeoff (climb),Humanitarian,United States of America,North America,2,1,0,1,0,0,2,Human Factor
1980-09-28 00:00:00,Winward Passage Aviation,Takeoff (climb),Commercial,United States of America,North America,2,1,0,1,0,0,2,Human Factor
1980-10-01 00:00:00,Escuela Nacional de Aeronautica,,Operational,Spain,Europe,0,0,0,0,0,0,0,Unknown
1980-10-04 00:00:00,International Trade %26 Investments,Takeoff (climb),Business,United States of America,North America,5,1,0,4,0,0,5,Human Factor
1980-10-06 00:00:00,Lineas Aéreas de Nicaragua - LANICA,Landing (descent or approach),Operational,Panama,Central America,2,2,0,0,0,0,2,Technical Failure
1980-10-08 00:00:00,Aeroflot - Russian International Airlines,Landing (descent or approach),Commercial,Russia,Asia,184,10,0,174,0,0,184,Human Factor
1980-10-13 00:00:00,Pelita Air Service,Flight,Operational,Indonesia,Asia,4,4,0,0,0,0,4,Technical Failure
1980-10-14 00:00:00,Brazilian Air Force - Força Aérea Brasileira,Takeoff (climb),Military / Government,Brazil,South America,4,3,0,1,0,0,4,Technical Failure
1980-10-15 00:00:00,Transportes Aéreos Bolivar - TAB,Takeoff (climb),Operational,Bolivia,South America,2,2,0,0,0,0,2,Unknown
1980-10-17 00:00:00,Cay International,Landing (descent or approach),Business,United States of America,North America,2,1,0,1,0,0,2,Technical Failure
1980-10-27 00:00:00,Stewart Island Air Services,Landing (descent or approach),Operational,New Zealand,Oceania,1,1,0,0,0,0,1,Weather
1980-10-29 00:00:00,United States Air Force - USAF,Landing (descent or approach),Operational,United States of America,North America,4,4,0,0,0,0,4,Human Factor
1980-10-31 00:00:00,Hemet Exploration,Landing (descent or approach),Specialised Services,Mali,Africa,2,2,0,0,0,0,2,Other
1980-11-01 00:00:00,Harry A. Zellers,Flight,Business,United States of America,North America,2,1,0,1,0,0,2,Technical Failure
1980-11-02 00:00:00,Aeroflot - Russian International Airlines,Flight,Military / Government,Russia,Asia,2,2,0,0,0,0,2,Human Factor
1980-11-04 00:00:00,Cyprus Airways,Landing (descent or approach),Operational,Cyprus,Europe,3,3,0,0,0,0,3,Technical Failure
1980-11-05 00:00:00,Private American,Landing (descent or approach),Humanitarian,United States of America,North America,1,1,0,0,0,0,1,Human Factor
1980-11-05 00:00:00,TAAG Angola Airlines - Transportes Aéreos de Angola,Landing (descent or approach),Commercial,Angola,Africa,134,6,0,128,0,0,134,Human Factor
1980-11-09 00:00:00,Coastal Community,Landing (descent or approach),Business,United States of America,North America,3,1,0,2,0,0,3,Human Factor
1980-11-11 00:00:00,Aeroflot - Russian International Airlines,Flight,Commercial,Ukraine,Europe,0,0,0,0,0,0,0,Human Factor
1980-11-12 00:00:00,Aeroklub Polskiej Rzeczypospolitej Ludowej - APRL,Flight,Operational,Poland,Europe,0,0,0,0,0,0,0,Unknown
1980-11-13 00:00:00,SATENA - Servicio de Aeronavegacion a Territorios Nacionales,Flight,Military / Government,Colombia,South America,23,4,0,19,0,0,23,Technical Failure
1980-11-15 00:00:00,BWI Leasing,Landing (descent or approach),Operational,Bahamas,Central America,2,1,0,1,0,0,2,Human Factor
1980-11-18 00:00:00,Private American,Takeoff (climb),Humanitarian,United States of America,North America,1,1,0,0,0,0,1,Human Factor
1980-11-20 00:00:00,Fishing %26 Marine Salvage,Takeoff (climb),Military / Government,France,Europe,0,0,0,0,0,0,0,Unknown
1980-11-21 00:00:00,Air Micronesia,Landing (descent or approach),Commercial,Micronesia,Oceania,73,6,0,67,0,0,73,Human Factor
1980-11-21 00:00:00,Soviet Air Force - Voyenno-vozdushnye sily CCCP,Flight,Military / Government,Angola,Africa,6,6,0,0,0,0,6,Terrorism
1980-11-26 00:00:00,Standard Machine %26 Equipment Company,Takeoff (climb),Business,United States of America,North America,2,1,0,1,0,0,2,Technical Failure
1980-11-28 00:00:00,Royal Australian Army,Flight,Military / Government,Australia,Oceania,0,0,0,0,0,0,0,Human Factor
1980-11-29 00:00:00,Royal Malaysian Air Force - Tentera Udara Diraja Malaysia,Takeoff (climb),Military / Government,Malaysia,Asia,3,3,0,0,0,0,3,Technical Failure
1980-11-30 00:00:00,Gulf Capital Corporation,Landing (descent or approach),Business,United States of America,North America,7,1,0,6,0,0,7,Technical Failure
1980-11-30 00:00:00,Trans World Airlines - TWA,Landing (descent or approach),Commercial,United States of America,North America,133,7,0,126,0,0,133,Technical Failure
1980-12-04 00:00:00,Peruvian Air Force - Fuerza Aérea del Perú,Flight,Military / Government,Peru,South America,0,0,0,0,0,0,0,Unknown
1980-12-13 00:00:00,Deral D. Browning,Takeoff (climb),Business,United States of America,North America,1,1,0,0,0,0,1,Human Factor
1980-12-15 00:00:00,TsKB po SPK,Takeoff (climb),Specialised Services,World,World,0,0,0,0,0,0,0,Human Factor
1980-12-18 00:00:00,Malaysian Air Charter,Taxiing,Commercial,Malaysia,Asia,0,0,0,0,0,0,0,Human Factor
1980-12-18 00:00:00,Malaysian Air Charter,Taxiing,Commercial,Malaysia,Asia,0,0,0,0,0,0,0,Human Factor
1980-12-18 00:00:00,Air Force of Zimbabwe,,Military / Government,Zimbabwe,Africa,0,0,0,0,0,0,0,Unknown
1980-12-20 00:00:00,Aerotal Colombia - Aerolineas Territoriales de Colombia,Landing (descent or approach),Operational,Colombia,South America,4,4,0,0,0,0,4,Human Factor
1980-12-23 00:00:00,M. Negoescu,Takeoff (climb),Business,Australia,Oceania,1,1,0,0,0,0,1,Unknown
1980-12-24 00:00:00,Zaire Air Force - Force Aérienne Zaïroise,Landing (descent or approach),Military / Government,Democratic Republic of Congo,Africa,0,0,0,0,0,0,0,Unknown
1980-12-25 00:00:00,Soviet Air Force - Voyenno-vozdushnye sily CCCP,Landing (descent or approach),Military / Government,Russia,Asia,6,6,0,0,0,0,6,Technical Failure
1980-12-31 00:00:00,Aero Services - USA,Flight,Humanitarian,Colombia,South America,0,0,0,0,0,0,0,Terrorism
1980-12-31 00:00:00,Private Australian,Flight,Military / Government,Australia,Oceania,1,1,0,0,0,0,1,Unknown
1980-12-31 00:00:00,Farm-Kem,Landing (descent or approach),Humanitarian,Colombia,South America,0,0,0,0,0,0,0,Human Factor
1980-12-31 00:00:00,Tanzania Peoples Defence Forces,Landing (descent or approach),Military / Government,Tanzania,Africa,0,0,0,0,0,0,0,Unknown
1981-01-06 00:00:00,Aeroflot - Russian International Airlines,Landing (descent or approach),Operational,Russia,Asia,6,6,0,0,0,0,6,Human Factor
1981-01-08 00:00:00,Pakistan International Airlines - PIA,Landing (descent or approach),Commercial,Pakistan,Asia,79,7,0,72,0,0,79,Technical Failure
1981-01-08 00:00:00,Turkish Air Force - Türk Hava Kuvvetleri,Landing (descent or approach),Military / Government,Turkey,Asia,0,0,0,0,0,0,0,Unknown
1981-01-11 00:00:00,Ethiopian Airlines,Landing (descent or approach),Operational,Ethiopia,Africa,4,3,0,1,0,0,4,Technical Failure
1981-01-12 00:00:00,Sun Valley Aviation,,Business,Mexico,Central America,0,0,0,0,0,0,0,Unknown
1981-01-14 00:00:00,Safe Air,Landing (descent or approach),Operational,New Zealand,Oceania,4,2,0,2,0,0,4,Technical Failure
1981-01-18 00:00:00,United States Navy - USN,Landing (descent or approach),Operational,United States of America,North America,7,7,0,0,0,0,7,Human Factor
1981-01-21 00:00:00,Colonial Leasing Company,Landing (descent or approach),Specialised Services,United States of America,North America,3,2,0,1,0,0,3,Human Factor
1981-01-23 00:00:00,Private American,Flight,Specialised Services,World,World,2,1,0,1,0,0,2,Technical Failure
1981-01-26 00:00:00,Harken Oil %26 Gas,Takeoff (climb),Business,United States of America,North America,4,1,0,3,0,0,4,Human Factor
1981-01-28 00:00:00,SUDENE - Superintendência do Desenvolvimento do Nordeste,,Other,Brazil,South America,0,0,0,0,0,0,0,Unknown
1981-02-02 00:00:00,Express Airways,Landing (descent or approach),Operational,United States of America,North America,2,2,0,0,0,0,2,Human Factor
1981-02-10 00:00:00,Desert Pacific Airlines,Takeoff (climb),Commercial,United States of America,North America,10,2,0,8,0,0,10,Human Factor
1981-02-15 00:00:00,Peterborough Parachute Centre,Takeoff (climb),Humanitarian,United Kingdom,Europe,10,1,0,9,0,0,10,Human Factor
1981-02-17 00:00:00,Air California - Air Cal,Landing (descent or approach),Commercial,United States of America,North America,110,5,0,105,0,0,110,Human Factor
1981-02-21 00:00:00,Aeroflot - Russian International Airlines,Flight,Commercial,Russia,Asia,0,0,0,0,0,0,0,Unknown
1981-03-01 00:00:00,Private American,Flight,Business,United States of America,North America,2,1,0,1,0,0,2,Technical Failure
1981-03-02 00:00:00,T. T. Hughes,Landing (descent or approach),Business,United States of America,North America,2,1,0,1,0,0,2,Human Factor
1981-03-08 00:00:00,Aeroflot - Russian International Airlines,Landing (descent or approach),Operational,Russia,Asia,5,5,0,0,0,0,5,Human Factor
1981-03-11 00:00:00,Catawissa Lumber %26 Specialty Company,Takeoff (climb),Business,United States of America,North America,2,1,0,1,0,0,2,Unknown
1981-03-11 00:00:00,Ghana Airways,Landing (descent or approach),Operational,Ghana,Africa,2,2,0,0,0,0,2,Human Factor
1981-03-11 00:00:00,Nihon Naigai Koku,Flight,Operational,Japan,Asia,0,0,0,0,0,0,0,Unknown
1981-03-11 00:00:00,Flugfélag Austurlands,Takeoff (climb),Commercial,Iceland,Europe,0,0,0,0,0,0,0,Unknown
1981-03-15 00:00:00,Douanes Françaises,,Military / Government,France,Europe,0,0,0,0,0,0,0,Unknown
1981-03-15 00:00:00,Bradley Air Services,Landing (descent or approach),Specialised Services,Greenland,Europe,0,0,0,0,0,0,0,Other
1981-03-16 00:00:00,Air Inuit,Landing (descent or approach),Operational,Canada,North America,2,2,0,0,0,0,2,Unknown
1981-03-18 00:00:00,Crutcher Resources Corporation,Takeoff (climb),Operational,United States of America,North America,2,2,0,0,0,0,2,Technical Failure
1981-03-24 00:00:00,Fairchild Aircraft Corporation,Landing (descent or approach),Specialised Services,United States of America,North America,4,4,0,0,0,0,4,Human Factor
1981-03-25 00:00:00,Sun Valley Aviation,Flight,Commercial,Mexico,Central America,0,0,0,0,0,0,0,Unknown
1981-03-26 00:00:00,Vietnam Airlines,Flight,Commercial,Vietnam,Asia,0,0,0,0,0,0,0,Unknown
1981-03-26 00:00:00,Libyan Arab Airlines,Landing (descent or approach),Commercial,Libya,Africa,0,0,0,0,0,0,0,Unknown
1981-03-29 00:00:00,Alco Aviation,Landing (descent or approach),Business,United Kingdom,Europe,9,2,0,7,0,0,9,Human Factor
1981-03-29 00:00:00,Club Aéronautique de Paris,Landing (descent or approach),Business,United Kingdom,Europe,7,2,0,5,0,0,7,Technical Failure
1981-03-29 00:00:00,Sobelair,Landing (descent or approach),Commercial,Belgium,Europe,117,7,0,110,0,0,117,Technical Failure
1981-03-30 00:00:00,United States Army,Landing (descent or approach),Operational,United States of America,North America,2,2,0,0,0,0,2,Unknown
1981-03-30 00:00:00,Inversiones Rizo Compañía Aérea,Flight,Business,Venezuela,South America,0,0,0,0,0,0,0,Unknown
1981-04-02 00:00:00,Bush Pilots Airways,Takeoff (climb),Operational,Australia,Oceania,1,1,0,0,0,0,1,Unknown
1981-04-03 00:00:00,Aeroflot - Russian International Airlines,Flight,Commercial,Russia,Asia,0,0,0,0,0,0,0,Technical Failure
1981-04-03 00:00:00,Private American,Takeoff (climb),Business,Canada,North America,0,0,0,0,0,0,0,Unknown
1981-04-14 00:00:00,Air BC - Air British Colombia,Takeoff (climb),Operational,Canada,North America,1,1,0,0,0,0,1,Technical Failure
1981-04-24 00:00:00,Peruvian Air Force - Fuerza Aérea del Perú,Flight,Military / Government,Peru,South America,0,0,0,0,0,0,0,Technical Failure
1981-04-27 00:00:00,Tasair,Landing (descent or approach),Commercial,Australia,Oceania,6,1,0,5,0,0,6,Technical Failure
1981-05-01 00:00:00,Private American,Takeoff (climb),Humanitarian,United States of America,North America,1,1,0,0,0,0,1,Technical Failure
1981-05-01 00:00:00,Mandala Airlines,Landing (descent or approach),Commercial,Indonesia,Asia,44,4,0,40,0,0,44,Unknown
1981-05-09 00:00:00,PropAir,Flight,Operational,Canada,North America,0,0,0,0,0,0,0,Unknown
1981-05-09 00:00:00,Skytrain Air,Landing (descent or approach),Operational,Mexico,Central America,2,2,0,0,0,0,2,Unknown
1981-05-10 00:00:00,Private German,Flight,Business,Germany,Europe,0,0,0,0,0,0,0,Unknown
1981-05-13 00:00:00,Private American,Flight,Specialised Services,United States of America,North America,2,1,0,1,0,0,2,Technical Failure
1981-05-14 00:00:00,St Andrews Airways,Takeoff (climb),Operational,Canada,North America,1,1,0,0,0,0,1,Technical Failure
1981-05-15 00:00:00,Gifford Aviation,Landing (descent or approach),Operational,United States of America,North America,2,2,0,0,0,0,2,Human Factor
1981-05-17 00:00:00,Phillip H. Taylor,Landing (descent or approach),Business,Cayman Islands,Central America,2,2,0,0,0,0,2,Technical Failure
1981-05-20 00:00:00,Aeroflot - Russian International Airlines,Landing (descent or approach),Operational,Russia,Asia,0,0,0,0,0,0,0,Human Factor
1981-05-21 00:00:00,Aeroflot - Russian International Airlines,Flight,Commercial,Russia,Asia,9,2,0,7,0,0,9,Technical Failure
1981-05-22 00:00:00,George M. Campbell Oil %26 Gas Company,Landing (descent or approach),Business,United States of America,North America,2,1,0,1,0,0,2,Human Factor
1981-05-27 00:00:00,Crown Industrial Products,Flight,Business,United States of America,North America,1,1,0,0,0,0,1,Technical Failure
1981-05-31 00:00:00,Safari Air Services,Landing (descent or approach),Commercial,Kenya,Africa,0,0,0,0,0,0,0,Unknown
1981-06-02 00:00:00,Pinders Charter Service,Flight,Commercial,Bahamas,Central America,1,1,0,0,0,0,1,Technical Failure
1981-06-04 00:00:00,Command Aviation,Landing (descent or approach),Operational,United States of America,North America,3,2,0,1,0,0,3,Technical Failure
1981-06-05 00:00:00,Pakistan International Airlines - PIA,Landing (descent or approach),Operational,Pakistan,Asia,3,3,0,0,0,0,3,Human Factor
1981-06-07 00:00:00,Aeroflot - Russian International Airlines,Flight,Business,Ukraine,Europe,1,1,0,0,0,0,1,Human Factor
1981-06-07 00:00:00,Burma Airways,Landing (descent or approach),Operational,Myanmar,Asia,4,4,0,0,0,0,4,Weather
1981-06-11 00:00:00,VARIG - Viação Aérea Rio Grandense,Landing (descent or approach),Operational,Brazil,South America,3,3,0,0,0,0,3,Human Factor
1981-06-12 00:00:00,Aero Taxi - USA,Takeoff (climb),Operational,United States of America,North America,1,1,0,0,0,0,1,Technical Failure
1981-06-13 00:00:00,Aeroflot - Russian International Airlines,Landing (descent or approach),Commercial,Russia,Asia,118,7,0,111,0,0,118,Technical Failure
1981-06-15 00:00:00,Aéro-Service,,Commercial,Congo,Africa,0,0,0,0,0,0,0,Unknown
1981-06-16 00:00:00,Indian Airlines,Takeoff (climb),Commercial,India,Asia,28,4,0,24,0,0,28,Weather
1981-06-17 00:00:00,Aeroflot - Russian International Airlines,Landing (descent or approach),Commercial,Russia,Asia,4,2,0,2,0,0,4,Unknown
1981-06-24 00:00:00,Nathaniel Hawthorne College,Takeoff (climb),Operational,United States of America,North America,2,2,0,0,0,0,2,Human Factor
1981-06-25 00:00:00,SATENA - Servicio de Aeronavegacion a Territorios Nacionales,,Military / Government,Colombia,South America,0,0,0,0,0,0,0,Unknown
1981-06-27 00:00:00,Hawkins %26 Powers Aviation,Flight,Humanitarian,United States of America,North America,6,2,0,4,0,0,6,Technical Failure
1981-06-28 00:00:00,Aeroflot - Russian International Airlines,Landing (descent or approach),Commercial,Ukraine,Europe,65,6,0,59,0,0,65,Technical Failure
1981-06-28 00:00:00,International Society of Independent Pilots,Takeoff (climb),Business,France,Europe,1,1,0,0,0,0,1,Unknown
1981-06-29 00:00:00,Aeroflot - Russian International Airlines,Flight,Military / Government,Kazakhstan,Asia,2,2,0,0,0,0,2,Human Factor
1981-07-04 00:00:00,Royal Flying Doctor Service - RFDS,Landing (descent or approach),Humanitarian,Australia,Oceania,2,1,0,1,0,0,2,Human Factor
1981-07-12 00:00:00,The Flying Fireman,Landing (descent or approach),Humanitarian,Canada,North America,2,2,0,0,0,0,2,Unknown
1981-07-15 00:00:00,Aeroflot - Russian International Airlines,Landing (descent or approach),Operational,Russia,Asia,2,2,0,0,0,0,2,Human Factor
1981-07-17 00:00:00,Soren Edward Jensen Jr.,Landing (descent or approach),Humanitarian,United States of America,North America,1,1,0,0,0,0,1,Human Factor
1981-07-20 00:00:00,Dorado Wings,Takeoff (climb),Commercial,Puerto Rico,Central America,5,1,0,4,0,0,5,Human Factor
1981-07-21 00:00:00,Aviatia Utilitara,Flight,Military / Government,Romania,Europe,2,2,0,0,0,0,2,Unknown
1981-08-03 00:00:00,SATENA - Servicio de Aeronavegacion a Territorios Nacionales,Takeoff (climb),Specialised Services,Colombia,South America,4,4,0,0,0,0,4,Technical Failure
1981-08-04 00:00:00,Aeroflot - Russian International Airlines,Landing (descent or approach),Military / Government,Kazakhstan,Asia,2,1,0,1,0,0,2,Human Factor
1981-08-05 00:00:00,Private American,Landing (descent or approach),Business,United States of America,North America,1,1,0,0,0,0,1,Human Factor
1981-08-07 00:00:00,Private American,Landing (descent or approach),Business,United States of America,North America,6,1,0,5,0,0,6,Technical Failure
1981-08-07 00:00:00,South East Alaska Airlines,Landing (descent or approach),Commercial,United States of America,North America,6,1,0,5,0,0,6,Human Factor
1981-08-07 00:00:00,Aerolineas Cordillera,,Commercial,Chile,South America,0,0,0,0,0,0,0,Unknown
1981-08-09 00:00:00,R. J. Mellon,Landing (descent or approach),Business,United States of America,North America,4,1,0,3,0,0,4,Human Factor
1981-08-11 00:00:00,Private American,Flight,Humanitarian,United States of America,North America,1,1,0,0,0,0,1,Human Factor
1981-08-11 00:00:00,Sociedad Aérea del Caqueta - Sadelca Colombia,Landing (descent or approach),Commercial,Colombia,South America,0,0,0,0,0,0,0,Technical Failure
1981-08-12 00:00:00,Wilbur's Flight Operations,Takeoff (climb),Operational,United States of America,North America,1,1,0,0,0,0,1,Human Factor
1981-08-18 00:00:00,Indian Airlines,Landing (descent or approach),Commercial,India,Asia,26,4,0,22,0,0,26,Human Factor
1981-08-18 00:00:00,Grand Canyon Airlines,Takeoff (climb),Commercial,United States of America,North America,7,1,0,6,0,0,7,Technical Failure
1981-08-25 00:00:00,Lesotho Airways,Takeoff (climb),Commercial,Lesotho,Africa,6,1,0,5,0,0,6,Unknown
1981-08-26 00:00:00,Private Argentinian,Landing (descent or approach),Business,Argentina,South America,4,1,0,3,0,0,4,Technical Failure
1981-08-27 00:00:00,RRC Air Service,Landing (descent or approach),Humanitarian,Ethiopia,Africa,0,0,0,0,0,0,0,Technical Failure
1981-09-07 00:00:00,Gifford Aviation,Landing (descent or approach),Operational,United States of America,North America,2,2,0,0,0,0,2,Technical Failure
1981-09-07 00:00:00,Questor Surveys,,Military / Government,Canada,North America,0,0,0,0,0,0,0,Unknown
1981-09-09 00:00:00,Aeroflot - Russian International Airlines,Flight,Military / Government,Uzbekistan,Asia,2,2,0,0,0,0,2,Technical Failure
1981-09-09 00:00:00,ZUA - Zakładu Usług Agrolotniczych - AET Agroaviation Services,Flight,Military / Government,Poland,Europe,0,0,0,0,0,0,0,Unknown
1981-09-13 00:00:00,Aeroflot - Russian International Airlines,Flight,Other,Russia,Asia,0,0,0,0,0,0,0,Unknown
1981-09-16 00:00:00,Aeroflot - Russian International Airlines,Landing (descent or approach),Operational,Russia,Asia,2,2,0,0,0,0,2,Human Factor
1981-09-16 00:00:00,Parsons Airways Northern,Flight,Commercial,Canada,North America,9,1,0,8,0,0,9,Human Factor
1981-09-18 00:00:00,Jersey European Airways - JEA,Landing (descent or approach),Commercial,United Kingdom,Europe,8,1,0,7,0,0,8,Technical Failure
1981-09-19 00:00:00,Private American,Flight,Humanitarian,United States of America,North America,1,1,0,0,0,0,1,Technical Failure
1981-09-21 00:00:00,Royal Australian Army,Takeoff (climb),Military / Government,Australia,Oceania,0,0,0,0,0,0,0,Unknown
1981-10-04 00:00:00,Richard Robert,Takeoff (climb),Business,United States of America,North America,5,1,0,4,0,0,5,Technical Failure
1981-10-07 00:00:00,Ethiopian Airlines,Landing (descent or approach),Commercial,Ethiopia,Africa,0,0,0,0,0,0,0,Technical Failure
1981-10-15 00:00:00,Masin Aircraft Company,,Business,Switzerland,Europe,0,0,0,0,0,0,0,Unknown
1981-10-16 00:00:00,Charles R. Killian,Flight,Operational,United States of America,North America,1,1,0,0,0,0,1,Human Factor
1981-10-21 00:00:00,Malév Hungarian Airlines - Magyar Légiközlekedési Vallalat,Landing (descent or approach),Commercial,Czech Republic,Europe,81,6,0,75,0,0,81,Human Factor
1981-10-21 00:00:00,Aeropesca Colombia,Landing (descent or approach),Operational,Colombia,South America,9,3,0,6,0,0,9,Terrorism
1981-10-23 00:00:00,TMA of Lebanon - Trans Mediterranean Airways,Landing (descent or approach),Operational,Japan,Asia,3,3,0,0,0,0,3,Human Factor
1981-10-28 00:00:00,Air Liberia,Flight,Commercial,Liberia,Africa,0,0,0,0,0,0,0,Unknown
1981-10-31 00:00:00,MIAT Mongolian Airlines - Mongolyn Irgeniy Agaaryn Teever,Flight,Commercial,Mongolia,Asia,0,0,0,0,0,0,0,Unknown
1981-11-04 00:00:00,Newfoundland %26 Labrador Air Transport,Landing (descent or approach),Commercial,Canada,North America,0,0,0,0,0,0,0,Unknown
1981-11-09 00:00:00,ZUA - Zakładu Usług Agrolotniczych - AET Agroaviation Services,Flight,Military / Government,Sudan,Africa,0,0,0,0,0,0,0,Unknown
1981-11-10 00:00:00,Aeroflot - Russian International Airlines,Landing (descent or approach),Military / Government,Russia,Asia,0,0,0,0,0,0,0,Human Factor
1981-11-25 00:00:00,French Air Force - Armée de l'Air,Flight,Military / Government,France,Europe,0,0,0,0,0,0,0,Unknown
1981-11-28 00:00:00,Libyan Arab Airlines,Flight,Commercial,Libya,Africa,0,0,0,0,0,0,0,Technical Failure
1981-11-30 00:00:00,SS Airways,Flight,Business,United States of America,North America,5,1,0,4,0,0,5,Technical Failure
1981-12-02 00:00:00,Aero Trades,Landing (descent or approach),Operational,Canada,North America,3,3,0,0,0,0,3,Human Factor
1981-12-03 00:00:00,Traid-a-Plane,Flight,Operational,United States of America,North America,1,1,0,0,0,0,1,Technical Failure
1981-12-10 00:00:00,Servicios Ejecutivos Nacionales - SENSA,Landing (descent or approach),Commercial,United States of America,North America,10,2,0,8,0,0,10,Human Factor
1981-12-11 00:00:00,Centravia Servicios Aéreos,,Commercial,Guatemala,Central America,0,0,0,0,0,0,0,Unknown
1981-12-12 00:00:00,CMI Corporation,Landing (descent or approach),Business,United States of America,North America,8,1,0,7,0,0,8,Human Factor
1981-12-13 00:00:00,Líder Taxi Aéreo,,Business,Brazil,South America,0,0,0,0,0,0,0,Unknown
1981-12-16 00:00:00,Hispaniola Airways,Landing (descent or approach),Operational,United States of America,North America,5,5,0,0,0,0,5,Technical Failure
1981-12-18 00:00:00,Aeroflot - Russian International Airlines,Flight,Commercial,Russia,Asia,3,3,0,0,0,0,3,Technical Failure
1981-12-29 00:00:00,Eastern Provincial Airways - EPA,Taxiing,Commercial,Canada,North America,18,3,0,15,0,0,18,Technical Failure
1981-12-31 00:00:00,International Jet Aviation,Landing (descent or approach),Commercial,United States of America,North America,4,1,0,3,0,0,4,Technical Failure
1981-12-31 00:00:00,Chilean Air Force - Fuerza Aérea de Chile,Landing (descent or approach),Military / Government,Chile,South America,0,0,0,0,0,0,0,Unknown
1981-12-31 00:00:00,GAF International Service,,Operational,Bahamas,Central America,0,0,0,0,0,0,0,Unknown
1981-12-31 00:00:00,Angola Air Force - Força Aérea Nacional Angolana,,Military / Government,Angola,Africa,0,0,0,0,0,0,0,Unknown
1982-01-03 00:00:00,Sunbird Aviation,,Commercial,Kenya,Africa,0,0,0,0,0,0,0,Unknown
1982-01-12 00:00:00,Eltro Enterprises,Flight,Business,United States of America,North America,3,1,0,2,0,0,3,Human Factor
1982-01-13 00:00:00,Air Mistassini,Takeoff (climb),Commercial,Canada,North America,4,1,0,3,0,0,4,Technical Failure
1982-01-15 00:00:00,Brazilian Air Force - Força Aérea Brasileira,,Military / Government,Brazil,South America,0,0,0,0,0,0,0,Unknown
1982-01-16 00:00:00,Aeroflot - Russian International Airlines,Landing (descent or approach),Operational,Kazakhstan,Asia,3,3,0,0,0,0,3,Technical Failure
1982-01-17 00:00:00,Island Airlines,Takeoff (climb),Operational,United States of America,North America,3,3,0,0,0,0,3,Technical Failure
1982-01-17 00:00:00,Derral Christensen,Landing (descent or approach),Business,United States of America,North America,3,1,0,2,0,0,3,Human Factor
1982-01-18 00:00:00,United States Coast Guard - USCG,Landing (descent or approach),Operational,United States of America,North America,8,8,0,0,0,0,8,Unknown
1982-01-19 00:00:00,Baker Marine Construction Corporation,Landing (descent or approach),Business,United States of America,North America,2,2,0,0,0,0,2,Human Factor
1982-01-19 00:00:00,Aeroservicios Ecuatorianos,Landing (descent or approach),Operational,United States of America,North America,6,4,0,2,0,0,6,Technical Failure
1982-01-21 00:00:00,Cook Inlet Aviation,Landing (descent or approach),Operational,United States of America,North America,1,1,0,0,0,0,1,Human Factor
1982-01-21 00:00:00,Tursair,Takeoff (climb),Operational,United States of America,North America,2,2,0,0,0,0,2,Human Factor
1982-01-25 00:00:00,Texaco Petroleum Company,,Business,Ecuador,South America,0,0,0,0,0,0,0,Unknown
1982-01-26 00:00:00,Alyemda Yemen Airlines,Landing (descent or approach),Operational,Syria,Asia,3,3,0,0,0,0,3,Terrorism
1982-02-01 00:00:00,Pilgrim Airlines,Landing (descent or approach),Commercial,United States of America,North America,7,2,0,5,0,0,7,Weather
1982-02-03 00:00:00,J. A. Baldwin Manufacturing Company,Landing (descent or approach),Business,United States of America,North America,6,2,0,4,0,0,6,Technical Failure
1982-02-04 00:00:00,Private Venezuelan,,Business,Venezuela,South America,0,0,0,0,0,0,0,Unknown
1982-02-06 00:00:00,Aircraft Maintenance Corporation,Landing (descent or approach),Humanitarian,United States of America,North America,2,1,0,1,0,0,2,Human Factor
1982-02-10 00:00:00,Spirit of the South,Landing (descent or approach),Business,United States of America,North America,5,1,0,4,0,0,5,Human Factor
1982-02-20 00:00:00,Red Dodge,Flight,Operational,United States of America,North America,2,2,0,0,0,0,2,Technical Failure
1982-02-20 00:00:00,Army Parachute Association,Takeoff (climb),Operational,United Kingdom,Europe,9,1,0,8,0,0,9,Technical Failure
1982-02-23 00:00:00,Aeroflot - Russian International Airlines,Takeoff (climb),Operational,Russia,Asia,3,3,0,0,0,0,3,Human Factor
1982-03-03 00:00:00,ATESA - Aero Taxis Ecuatorianos,,Commercial,Ecuador,South America,0,0,0,0,0,0,0,Unknown
1982-03-08 00:00:00,Federated Air Freight,Takeoff (climb),Humanitarian,United States of America,North America,1,1,0,0,0,0,1,Human Factor
1982-03-10 00:00:00,Heron Air Charter,,Commercial,Papua New Guinea,Oceania,0,0,0,0,0,0,0,Unknown
1982-03-10 00:00:00,Aircraft Facilities,Flight,Business,Portugal,Europe,1,1,0,0,0,0,1,Technical Failure
1982-03-15 00:00:00,Indian Air Force - Bharatiya Vayu Sena,Landing (descent or approach),Operational,India,Asia,0,0,0,0,0,0,0,Unknown
1982-03-17 00:00:00,Air France,Takeoff (climb),Commercial,Yemen,Asia,124,13,0,111,0,0,124,Technical Failure
1982-03-23 00:00:00,Gimbel Aviation,Takeoff (climb),Operational,United States of America,North America,2,2,0,0,0,0,2,Technical Failure
1982-04-05 00:00:00,Aircraft Service Center,Flight,Business,United States of America,North America,5,1,0,4,0,0,5,Technical Failure
1982-04-11 00:00:00,Aeroflot - Russian International Airlines,Landing (descent or approach),Commercial,Russia,Asia,0,0,0,0,0,0,0,Unknown
1982-04-14 00:00:00,Magnum Airlines,,Commercial,South Africa,Africa,0,0,0,0,0,0,0,Unknown
1982-04-16 00:00:00,Private American,Flight,Humanitarian,Colombia,South America,2,2,0,0,0,0,2,Unknown
1982-04-17 00:00:00,Air Bridge Carriers,Landing (descent or approach),Operational,United Kingdom,Europe,2,2,0,0,0,0,2,Technical Failure
1982-04-22 00:00:00,Iraqi Airways,Landing (descent or approach),Commercial,Iraq,Asia,0,0,0,0,0,0,0,Unknown
1982-04-24 00:00:00,Aeroflot - Russian International Airlines,Takeoff (climb),Operational,Russia,Asia,7,7,0,0,0,0,7,Human Factor
1982-04-25 00:00:00,Joanne Lecraw,Landing (descent or approach),Business,United States of America,North America,3,1,0,2,0,0,3,Human Factor
1982-04-26 00:00:00,Aeroflot - Russian International Airlines,Flight,Military / Government,Kazakhstan,Asia,2,2,0,0,0,0,2,Human Factor
1982-04-29 00:00:00,Robert R. Gunn,Landing (descent or approach),Business,United States of America,North America,1,1,0,0,0,0,1,Human Factor
1982-05-05 00:00:00,Transportes Aéreos Unidos,Takeoff (climb),Operational,Bolivia,South America,4,3,0,1,0,0,4,Technical Failure
1982-05-07 00:00:00,Kenn Borek Air,Takeoff (climb),Commercial,Canada,North America,0,0,0,0,0,0,0,Other
1982-05-09 00:00:00,Panarctic Oils,Landing (descent or approach),Commercial,World,World,9,2,0,7,0,0,9,Other
1982-05-11 00:00:00,Aeroflot - Russian International Airlines,Flight,Military / Government,Germany,Europe,2,2,0,0,0,0,2,Technical Failure
1982-05-15 00:00:00,Clayton V. Curtis,Landing (descent or approach),Operational,United States of America,North America,2,2,0,0,0,0,2,Human Factor
1982-05-16 00:00:00,TAM Brasil - Taxi Aéreo Marilia - Transportes Aéreos Regionais,Landing (descent or approach),Commercial,Brazil,South America,10,2,0,8,0,0,10,Technical Failure
1982-05-16 00:00:00,Gifford Aviation,Landing (descent or approach),Commercial,United States of America,North America,8,2,0,6,0,0,8,Human Factor
1982-05-22 00:00:00,Rio-Sul Serviços Aéreos Regionais,Landing (descent or approach),Commercial,Brazil,South America,4,2,0,2,0,0,4,Unknown
1982-05-27 00:00:00,French Air Force - Armée de l'Air,Flight,Military / Government,France,Europe,0,0,0,0,0,0,0,Unknown
1982-05-29 00:00:00,Transportes Colombiana de Aviacion - TAVINA,Takeoff (climb),Commercial,Colombia,South America,7,2,0,5,0,0,7,Human Factor
1982-05-29 00:00:00,French Air Force - Armée de l'Air,Landing (descent or approach),Military / Government,France,Europe,4,2,0,2,0,0,4,Unknown
1982-05-31 00:00:00,Aeroflot - Russian International Airlines,Landing (descent or approach),Commercial,Ukraine,Europe,35,4,0,31,0,0,35,Human Factor
1982-06-02 00:00:00,Colombian Air Force - Fuerza Aérea Colombiana,Takeoff (climb),Military / Government,Colombia,South America,22,3,0,19,0,0,22,Unknown
1982-06-03 00:00:00,Aeroflot - Russian International Airlines,Flight,Commercial,Russia,Asia,0,0,0,0,0,0,0,Human Factor
1982-06-04 00:00:00,Aeroflot - Russian International Airlines,Flight,Military / Government,Russia,Asia,2,2,0,0,0,0,2,Human Factor
1982-06-04 00:00:00,Aeroflot - Russian International Airlines,Flight,Military / Government,Russia,Asia,2,2,0,0,0,0,2,Human Factor
1982-06-06 00:00:00,Fromhagen Aviation,Takeoff (climb),Operational,United States of America,North America,5,2,0,3,0,0,5,Technical Failure
1982-06-06 00:00:00,Fly-In Service,Landing (descent or approach),Commercial,Canada,North America,0,0,0,0,0,0,0,Unknown
1982-06-09 00:00:00,Trans Australia Airlines - TAA,Landing (descent or approach),Operational,Australia,Oceania,3,3,0,0,0,0,3,Human Factor
1982-06-11 00:00:00,Brush Electrical Machines,Takeoff (climb),Business,Switzerland,Europe,4,1,0,3,0,0,4,Human Factor
1982-06-11 00:00:00,Aeroflot - Russian International Airlines,Taxiing,Military / Government,Russia,Asia,2,2,0,0,0,0,2,Unknown
1982-06-18 00:00:00,Western States Express,Takeoff (climb),Operational,United States of America,North America,1,1,0,0,0,0,1,Human Factor
1982-06-29 00:00:00,Norcanair - North Canada Air,Landing (descent or approach),Operational,Canada,North America,2,2,0,0,0,0,2,Technical Failure
1982-07-01 00:00:00,Aeroflot - Russian International Airlines,Takeoff (climb),Commercial,Russia,Asia,12,2,0,10,0,0,12,Technical Failure
1982-07-05 00:00:00,Ralph E. Phillips Consulting Engineers,Takeoff (climb),Business,United States of America,North America,1,1,0,0,0,0,1,Technical Failure
1982-07-06 00:00:00,Malaysian Airlines System - MAS,Landing (descent or approach),Commercial,Malaysia,Asia,0,0,0,0,0,0,0,Unknown
1982-07-08 00:00:00,United States Navy - USN,Flight,Operational,United States of America,North America,6,6,0,0,0,0,6,Human Factor
1982-07-13 00:00:00,Sierra West Investment Company,Takeoff (climb),Business,United States of America,North America,2,1,0,1,0,0,2,Human Factor
1982-07-16 00:00:00,Aeroflot - Russian International Airlines,Takeoff (climb),Commercial,Russia,Asia,3,2,0,1,0,0,3,Human Factor
1982-07-17 00:00:00,Sheridan Flying Service,Landing (descent or approach),Specialised Services,United States of America,North America,1,1,0,0,0,0,1,Human Factor
1982-07-22 00:00:00,Private American,Takeoff (climb),Business,Bahamas,Central America,0,0,0,0,0,0,0,Technical Failure
1982-07-30 00:00:00,Pronto Aviation Services,Takeoff (climb),Operational,United States of America,North America,3,2,0,1,0,0,3,Technical Failure
1982-08-01 00:00:00,We McLaughlin,Landing (descent or approach),Specialised Services,United States of America,North America,1,1,0,0,0,0,1,Human Factor
1982-08-03 00:00:00,Kenai Air Alaska,Flight,Commercial,United States of America,North America,6,1,0,5,0,0,6,Human Factor
1982-08-04 00:00:00,Aerotal Colombia - Aerolineas Territoriales de Colombia,Landing (descent or approach),Commercial,Colombia,South America,50,7,0,43,0,0,50,Human Factor
1982-08-05 00:00:00,Royal Thai Police,Flight,Military / Government,Thailand,Asia,3,1,0,2,0,0,3,Unknown
1982-08-06 00:00:00,Kenneth L. Linn,Takeoff (climb),Business,United States of America,North America,5,1,0,4,0,0,5,Human Factor
1982-08-06 00:00:00,Desarollo New York Panamanian Corporation,Flight,Business,Bahamas,Central America,3,1,0,2,0,0,3,Technical Failure
1982-08-07 00:00:00,Deelgroei,Landing (descent or approach),Business,South Africa,Africa,0,0,0,0,0,0,0,Technical Failure
1982-08-13 00:00:00,Fitness Marketing Association,Landing (descent or approach),Humanitarian,United States of America,North America,2,2,0,0,0,0,2,Human Factor
1982-08-14 00:00:00,Aeroflot - Russian International Airlines,Takeoff (climb),Commercial,Georgia,Asia,82,6,0,76,0,0,82,Human Factor
1982-08-19 00:00:00,Aeroflot - Russian International Airlines,Flight,Commercial,Russia,Asia,0,0,0,0,0,0,0,Human Factor
1982-08-23 00:00:00,J. Floch,Landing (descent or approach),Business,Mayotte,Africa,0,0,0,0,0,0,0,Unknown
1982-08-24 00:00:00,Ethiopian Airlines,Takeoff (climb),Commercial,Ethiopia,Africa,0,0,0,0,0,0,0,Technical Failure
1982-08-25 00:00:00,National Flights Services,Flight,Operational,United States of America,North America,2,2,0,0,0,0,2,Human Factor
1982-08-25 00:00:00,Slov-Air,,Commercial,Czech Republic,Europe,0,0,0,0,0,0,0,Unknown
1982-08-26 00:00:00,Southwest Air Lines,Landing (descent or approach),Commercial,Japan,Asia,138,5,0,133,0,0,138,Human Factor
1982-08-27 00:00:00,Salmon Air,Takeoff (climb),Commercial,United States of America,North America,7,1,0,6,0,0,7,Technical Failure
1982-08-27 00:00:00,Slov-Air,Flight,Business,Czech Republic,Europe,0,0,0,0,0,0,0,Human Factor
1982-08-28 00:00:00,Iraqi Airways,Takeoff (climb),Commercial,Iraq,Asia,0,0,0,0,0,0,0,Technical Failure
1982-09-09 00:00:00,Aeroflot - Russian International Airlines,Flight,Military / Government,Uzbekistan,Asia,2,2,0,0,0,0,2,Technical Failure
1982-09-09 00:00:00,Aeroflot - Russian International Airlines,Flight,Military / Government,Azerbaijan,Asia,0,0,0,0,0,0,0,Technical Failure
1982-09-10 00:00:00,Sudan Airways,Landing (descent or approach),Operational,Sudan,Africa,11,11,0,0,0,0,11,Technical Failure
1982-09-12 00:00:00,Israeli Air Force - Heyl Ha'avir,Takeoff (climb),Military / Government,Israel,Asia,1,1,0,0,0,0,1,Technical Failure
1982-09-15 00:00:00,Private American,Flight,Humanitarian,United States of America,North America,0,0,0,0,0,0,0,Unknown
1982-09-17 00:00:00,Japan Airlines,Landing (descent or approach),Commercial,China,Asia,124,11,0,113,0,0,124,Technical Failure
1982-09-20 00:00:00,Royal Thai Air Force - Kong Thap Akat Thai,Takeoff (climb),Military / Government,Thailand,Asia,8,2,0,6,0,0,8,Technical Failure
1982-09-28 00:00:00,Aeroflot - Russian International Airlines,Landing (descent or approach),Commercial,Kazakhstan,Asia,0,0,0,0,0,0,0,Unknown
1982-10-03 00:00:00,Para-Sport-Club Triegen,Flight,Humanitarian,Switzerland,Europe,2,1,0,1,0,0,2,Technical Failure
1982-10-05 00:00:00,Sudan Airways,Landing (descent or approach),Commercial,Sudan,Africa,20,3,0,17,0,0,20,Unknown
1982-10-08 00:00:00,SAN Ecuador - Servicios Aéreos Nacionales,Landing (descent or approach),Commercial,Ecuador,South America,0,0,0,0,0,0,0,Human Factor
1982-10-09 00:00:00,Comair - South Africa,Flight,Commercial,South Africa,Africa,30,3,0,27,0,0,30,Technical Failure
1982-10-17 00:00:00,Egyptair,Landing (descent or approach),Commercial,Switzerland,Europe,184,10,0,174,0,0,184,Human Factor
1982-10-18 00:00:00,Voyageur Airways,Landing (descent or approach),Commercial,Canada,North America,0,0,0,0,0,0,0,Unknown
1982-10-31 00:00:00,Ilford Riverton Airways,Taxiing,Operational,Canada,North America,2,2,0,0,0,0,2,Unknown
1982-11-01 00:00:00,Darne,Landing (descent or approach),Business,United States of America,North America,3,1,0,2,0,0,3,Human Factor
1982-11-01 00:00:00,Aviones de Panama,,Commercial,Panama,Central America,0,0,0,0,0,0,0,Unknown
1982-11-04 00:00:00,Talair,Takeoff (climb),Operational,Papua New Guinea,Oceania,1,1,0,0,0,0,1,Technical Failure
1982-11-06 00:00:00,Duncan Aviation,Landing (descent or approach),Operational,United States of America,North America,4,4,0,0,0,0,4,Human Factor
1982-11-06 00:00:00,Venezuelan Government,,Military / Government,Venezuela,South America,0,0,0,0,0,0,0,Unknown
1982-11-06 00:00:00,Penina,Flight,Commercial,Portugal,Europe,4,1,0,3,0,0,4,Unknown
1982-11-08 00:00:00,Deraya Air Taxi,Flight,Commercial,Indonesia,Asia,0,0,0,0,0,0,0,Unknown
1982-11-12 00:00:00,Danair,Landing (descent or approach),Commercial,Denmark,Europe,15,2,0,13,0,0,15,Technical Failure
1982-11-12 00:00:00,Cessna Aircraft Company,Landing (descent or approach),Humanitarian,United States of America,North America,1,1,0,0,0,0,1,Human Factor
1982-11-13 00:00:00,Bright Maintenance Corporation,Takeoff (climb),Business,United States of America,North America,1,1,0,0,0,0,1,Human Factor
1982-11-13 00:00:00,Private German,Flight,Business,Germany,Europe,4,1,0,3,0,0,4,Technical Failure
1982-11-15 00:00:00,Renley %26 Crockett International,Flight,Humanitarian,Jamaica,Central America,2,2,0,0,0,0,2,Human Factor
1982-11-16 00:00:00,Soviet Air Force - Voyenno-vozdushnye sily CCCP,Takeoff (climb),Military / Government,Russia,Asia,0,0,0,0,0,0,0,Human Factor
1982-11-18 00:00:00,Newtron Inc,Landing (descent or approach),Business,United States of America,North America,1,1,0,0,0,0,1,Human Factor
1982-11-18 00:00:00,Aeroflot - Russian International Airlines,Flight,Commercial,Ukraine,Europe,0,0,0,0,0,0,0,Human Factor
1982-11-20 00:00:00,Astro Wings,Landing (descent or approach),Operational,United States of America,North America,2,2,0,0,0,0,2,Technical Failure
1982-11-28 00:00:00,Aerotal Colombia - Aerolineas Territoriales de Colombia,Landing (descent or approach),Commercial,Colombia,South America,0,0,0,0,0,0,0,Technical Failure
1982-11-29 00:00:00,United States Air Force - USAF,Landing (descent or approach),Operational,United States of America,North America,6,6,0,0,0,0,6,Technical Failure
1982-12-04 00:00:00,Global International Airways,Landing (descent or approach),Commercial,Brazil,South America,60,8,0,52,0,0,60,Unknown
1982-12-05 00:00:00,Paul Grossman,Taxiing,Business,United States of America,North America,0,0,0,0,0,0,0,Unknown
1982-12-06 00:00:00,Transair Switzerland,Takeoff (climb),Commercial,France,Europe,4,2,0,2,0,0,4,Other
1982-12-10 00:00:00,Bouraq Indonesia Airlines,Landing (descent or approach),Commercial,Indonesia,Asia,45,3,0,42,0,0,45,Technical Failure
1982-12-13 00:00:00,Argentinian Air Force - Fuerza Aérea Argentina,Landing (descent or approach),Military / Government,Argentina,South America,0,0,0,0,0,0,0,Unknown
1982-12-16 00:00:00,Aeroflot - Russian International Airlines,Flight,Commercial,Ukraine,Europe,27,5,0,22,0,0,27,Technical Failure
1982-12-31 00:00:00,Royal Thai Air Force - Kong Thap Akat Thai,Flight,Military / Government,Thailand,Asia,0,0,0,0,0,0,0,Unknown
1982-12-31 00:00:00,Libyan Government,,Military / Government,Libya,Africa,0,0,0,0,0,0,0,Unknown
1982-12-31 00:00:00,Agricultural Aviation,Flight,Military / Government,South Sudan,Africa,1,1,0,0,0,0,1,Unknown
1983-01-02 00:00:00,Radar Devices,Takeoff (climb),Business,United States of America,North America,4,1,0,3,0,0,4,Human Factor
1983-01-03 00:00:00,Voyageur Airways,Landing (descent or approach),Commercial,Canada,North America,0,0,0,0,0,0,0,Unknown
1983-01-07 00:00:00,Iran Air,Taxiing,Specialised Services,Iran,Asia,2,2,0,0,0,0,2,Human Factor
1983-01-11 00:00:00,Georgia South America,Takeoff (climb),Business,United States of America,North America,4,2,0,2,0,0,4,Human Factor
1983-01-12 00:00:00,Indian Navy - Bharatiya Nau Sena,Taxiing,Military / Government,India,Asia,0,0,0,0,0,0,0,Unknown
1983-01-12 00:00:00,Indian Air Force - Bharatiya Vayu Sena,Takeoff (climb),Military / Government,India,Asia,0,0,0,0,0,0,0,Unknown
1983-01-16 00:00:00,Private Guatemalan,Flight,Humanitarian,United States of America,North America,2,2,0,0,0,0,2,Human Factor
1983-01-21 00:00:00,Raymond A. Waldrop,Landing (descent or approach),Business,United States of America,North America,2,1,0,1,0,0,2,Technical Failure
1983-01-26 00:00:00,Burt Weech,Landing (descent or approach),Operational,United States of America,North America,2,1,0,1,0,0,2,Human Factor
1983-01-27 00:00:00,Cameroon Air Force - Armée de l'Air du Cameroun,,Military / Government,Cameroon,Africa,0,0,0,0,0,0,0,Unknown
1983-01-28 00:00:00,Papua New Guinea Defence Force,,Military / Government,Papua New Guinea,Oceania,0,0,0,0,0,0,0,Unknown
1983-02-01 00:00:00,British Army Air Corps,Landing (descent or approach),Operational,United Kingdom,Europe,2,2,0,0,0,0,2,Human Factor
1983-02-03 00:00:00,Cuban Air Force - Fuerzas Armadas Revolucionaras,Landing (descent or approach),Military / Government,Cuba,Central America,0,0,0,0,0,0,0,Unknown
1983-02-06 00:00:00,Weatherford Services,Takeoff (climb),Business,United States of America,North America,3,2,0,1,0,0,3,Human Factor
1983-02-07 00:00:00,Aeroflot - Russian International Airlines,Flight,Commercial,Russia,Asia,0,0,0,0,0,0,0,Human Factor
1983-02-15 00:00:00,Distrofin,Landing (descent or approach),Business,Switzerland,Europe,3,1,0,2,0,0,3,Technical Failure
1983-02-15 00:00:00,Sierra Pacific Airlines - SPA,Landing (descent or approach),Commercial,United States of America,North America,8,2,0,6,0,0,8,Human Factor
1983-02-15 00:00:00,Ontario Central Airlines,Flight,Commercial,Canada,North America,4,3,0,1,0,0,4,Technical Failure
1983-02-17 00:00:00,Norving,,Commercial,Norway,Europe,0,0,0,0,0,0,0,Unknown
1983-02-23 00:00:00,Aeroflot - Russian International Airlines,Flight,Commercial,Ukraine,Europe,2,2,0,0,0,0,2,Human Factor
1983-02-24 00:00:00,Air Bénin,Flight,Commercial,Benin,Africa,0,0,0,0,0,0,0,Unknown
1983-02-27 00:00:00,CAAC - Civil Aviation Administration of China,Landing (descent or approach),Commercial,China,Asia,96,6,0,90,0,0,96,Unknown
1983-03-09 00:00:00,Aero Coach Aviation International,Flight,Commercial,World,World,3,1,0,2,0,0,3,Technical Failure
1983-03-11 00:00:00,Nihon Kinkyori Airways,Landing (descent or approach),Commercial,Japan,Asia,53,5,0,48,0,0,53,Human Factor
1983-03-11 00:00:00,Asrec Air East,Landing (descent or approach),Commercial,United States of America,North America,2,1,0,1,0,0,2,Technical Failure
1983-03-17 00:00:00,Pars Air,,Commercial,Iran,Asia,0,0,0,0,0,0,0,Unknown
1983-03-17 00:00:00,Ethiopian Air Force - Ye Ityopya Ayer Hayl,Flight,Military / Government,Ethiopia,Africa,0,0,0,0,0,0,0,Terrorism
1983-03-18 00:00:00,Malawi Police Air Wing,Flight,Military / Government,Malawi,Africa,0,0,0,0,0,0,0,Unknown
1983-03-24 00:00:00,Aeroflot - Russian International Airlines,Landing (descent or approach),Commercial,Russia,Asia,0,0,0,0,0,0,0,Technical Failure
1983-03-28 00:00:00,Linhas Aéreas de Moçambique - LAM,Landing (descent or approach),Commercial,Mozambique,Africa,110,6,0,104,0,0,110,Human Factor
1983-04-06 00:00:00,Aviones de Panama,,Commercial,Panama,Central America,0,0,0,0,0,0,0,Unknown
1983-04-12 00:00:00,Aeroflot - Russian International Airlines,Landing (descent or approach),Operational,Belarus,Europe,5,5,0,0,0,0,5,Human Factor
1983-04-14 00:00:00,Walker's International Airlines,Takeoff (climb),Operational,United States of America,North America,1,1,0,0,0,0,1,Technical Failure
1983-04-14 00:00:00,Executive Jet Aviation - USA,Landing (descent or approach),Commercial,Mexico,Central America,4,2,0,2,0,0,4,Human Factor
1983-04-20 00:00:00,Air Ecosse,Landing (descent or approach),Commercial,United Kingdom,Europe,12,2,0,10,0,0,12,Weather
1983-04-25 00:00:00,Soviet Air Force - Voyenno-vozdushnye sily CCCP,Flight,Military / Government,Afghanistan,Asia,0,0,0,0,0,0,0,Terrorism
1983-04-26 00:00:00,Cessna Aircraft Company,Takeoff (climb),Business,United States of America,North America,5,2,0,3,0,0,5,Human Factor
1983-04-26 00:00:00,Aviones Ejecutivos - AVIEL,Flight,Operational,Colombia,South America,1,1,0,0,0,0,1,Technical Failure
1983-04-28 00:00:00,Green Aircraft Service,Landing (descent or approach),Business,United States of America,North America,2,1,0,1,0,0,2,Technical Failure
1983-04-29 00:00:00,Aeroflot - Russian International Airlines,Landing (descent or approach),Commercial,Armenia,Asia,0,0,0,0,0,0,0,Unknown
1983-04-29 00:00:00,Aeroflot - Russian International Airlines,Flight,Military / Government,Latvia,Europe,0,0,0,0,0,0,0,Human Factor
1983-04-29 00:00:00,Airfast Indonesia,Takeoff (climb),Commercial,Indonesia,Asia,1,1,0,0,0,0,1,Technical Failure
1983-05-03 00:00:00,SATENA - Servicio de Aeronavegacion a Territorios Nacionales,Flight,Military / Government,Colombia,South America,22,4,0,18,0,0,22,Technical Failure
1983-05-04 00:00:00,Aeroflot - Russian International Airlines,Flight,Commercial,Lithuania,Europe,0,0,0,0,0,0,0,Unknown
1983-05-08 00:00:00,Supra International,Taxiing,Operational,United States of America,North America,0,0,0,0,0,0,0,Unknown
1983-05-09 00:00:00,Aeroflot - Russian International Airlines,Flight,Commercial,Tajikistan,Asia,0,0,0,0,0,0,0,Technical Failure
1983-05-11 00:00:00,Aeroflot - Russian International Airlines,Flight,Commercial,Russia,Asia,0,0,0,0,0,0,0,Other
1983-05-13 00:00:00,Aeroflot - Russian International Airlines,Flight,Military / Government,Germany,Europe,0,0,0,0,0,0,0,Unknown
1983-05-15 00:00:00,Aeroflot - Russian International Airlines,Flight,Military / Government,Russia,Asia,0,0,0,0,0,0,0,Unknown
1983-05-17 00:00:00,United States Navy - USN,Landing (descent or approach),Military / Government,United States of America,North America,0,0,0,0,0,0,0,Unknown
1983-05-18 00:00:00,Frisia Luftverkehr Norddeich,,Commercial,Germany,Europe,0,0,0,0,0,0,0,Unknown
1983-05-25 00:00:00,Aeroflot - Russian International Airlines,Flight,Military / Government,Russia,Asia,0,0,0,0,0,0,0,Human Factor
1983-06-01 00:00:00,Beech Airways,Landing (descent or approach),Commercial,United States of America,North America,3,1,0,2,0,0,3,Technical Failure
1983-06-06 00:00:00,MAP Perm Motors,Landing (descent or approach),Operational,Russia,Asia,4,4,0,0,0,0,4,Human Factor
1983-06-15 00:00:00,MOM - Ministerstvo Obshego Mashinostroenia,Landing (descent or approach),Operational,Ukraine,Europe,7,5,0,2,0,0,7,Technical Failure
1983-06-17 00:00:00,Aeroflot - Russian International Airlines,Landing (descent or approach),Commercial,Armenia,Asia,67,5,0,62,0,0,67,Weather
1983-06-24 00:00:00,Kaufmann Air Flugzeugvermietung,Takeoff (climb),Commercial,Germany,Europe,0,0,0,0,0,0,0,Technical Failure
1983-06-25 00:00:00,MIAT Mongolian Airlines - Mongolyn Irgeniy Agaaryn Teever,Landing (descent or approach),Commercial,Mongolia,Asia,47,5,0,42,0,0,47,Technical Failure
1983-06-29 00:00:00,Erasmus,Takeoff (climb),Operational,United States of America,North America,2,2,0,0,0,0,2,Human Factor
1983-06-29 00:00:00,Pacific Air Express - USA,Landing (descent or approach),Operational,United States of America,North America,3,3,0,0,0,0,3,Human Factor
1983-06-29 00:00:00,Aeroflot - Russian International Airlines,Landing (descent or approach),Commercial,Kyrgyzstan,Asia,9,3,0,6,0,0,9,Weather
1983-06-29 00:00:00,Aeronica - Aerolineas Nicaraguenses,Landing (descent or approach),Commercial,Nicaragua,Central America,0,0,0,0,0,0,0,Human Factor
1983-07-02 00:00:00,Altair Linee Aeree,Takeoff (climb),Commercial,Italy,Europe,89,7,0,82,0,0,89,Technical Failure
1983-07-02 00:00:00,Usibelli Coal Mine,Landing (descent or approach),Business,United States of America,North America,3,1,0,2,0,0,3,Human Factor
1983-07-04 00:00:00,Zambia Airways,Takeoff (climb),Commercial,Zambia,Africa,46,4,0,42,0,0,46,Technical Failure
1983-07-04 00:00:00,Aeroflot - Russian International Airlines,Flight,Commercial,Georgia,Asia,0,0,0,0,0,0,0,Weather
1983-07-10 00:00:00,Nenana Fuel Company,Landing (descent or approach),Operational,United States of America,North America,2,2,0,0,0,0,2,Human Factor
1983-07-12 00:00:00,Cloudlands Aviation Development,Flight,Commercial,Papua New Guinea,Oceania,0,0,0,0,0,0,0,Unknown
1983-07-15 00:00:00,Orion Air,Landing (descent or approach),Operational,United States of America,North America,2,2,0,0,0,0,2,Human Factor
1983-07-19 00:00:00,Chevron Oil Company,Takeoff (climb),Business,Sudan,Africa,24,3,0,21,0,0,24,Human Factor
1983-07-20 00:00:00,Aeroflot - Russian International Airlines,Flight,Commercial,Ukraine,Europe,0,0,0,0,0,0,0,Human Factor
1983-07-22 00:00:00,Imani %26 Sons,Landing (descent or approach),Business,Nigeria,Africa,3,2,0,1,0,0,3,Unknown
1983-08-04 00:00:00,Pan American World Airways - PAA,Landing (descent or approach),Commercial,Pakistan,Asia,243,16,0,227,0,0,243,Human Factor
1983-08-04 00:00:00,Airlines of Tasmania,Landing (descent or approach),Commercial,Australia,Oceania,7,2,0,5,0,0,7,Human Factor
1983-08-05 00:00:00,Condor Aviation,Landing (descent or approach),Operational,United States of America,North America,3,2,0,1,0,0,3,Technical Failure
1983-08-07 00:00:00,SATENA - Servicio de Aeronavegacion a Territorios Nacionales,Landing (descent or approach),Commercial,Colombia,South America,21,5,0,16,0,0,21,Unknown
1983-08-12 00:00:00,Aeroflot - Russian International Airlines,Flight,Commercial,Ukraine,Europe,0,0,0,0,0,0,0,Human Factor
1983-08-15 00:00:00,MAP Arsenyev,Takeoff (climb),Operational,Russia,Asia,9,4,0,5,0,0,9,Human Factor
1983-08-16 00:00:00,MFS Associates,Takeoff (climb),Business,United States of America,North America,8,1,0,7,0,0,8,Human Factor
1983-08-17 00:00:00,Padosa Productions,Takeoff (climb),Business,Puerto Rico,Central America,11,2,0,9,0,0,11,Human Factor
1983-08-17 00:00:00,Northeast Jet,Takeoff (climb),Operational,United States of America,North America,2,2,0,0,0,0,2,Other
1983-08-20 00:00:00,Alaska North Flying Service,Flight,Commercial,United States of America,North America,5,1,0,4,0,0,5,Human Factor
1983-08-22 00:00:00,Country Club Homes,Takeoff (climb),Commercial,United States of America,North America,4,2,0,2,0,0,4,Human Factor
1983-08-27 00:00:00,Scheduled Skyways,Taxiing,Commercial,United States of America,North America,4,2,0,2,0,0,4,Technical Failure
1983-08-29 00:00:00,Wayland E. Tyner,Takeoff (climb),Business,United States of America,North America,1,1,0,0,0,0,1,Human Factor
1983-09-02 00:00:00,Farrell-Cooper Mining Company,Landing (descent or approach),Business,United States of America,North America,2,1,0,1,0,0,2,Technical Failure
1983-09-04 00:00:00,Transport Aérien Transrégional - TAT,Landing (descent or approach),Commercial,France,Europe,0,0,0,0,0,0,0,Unknown
1983-09-08 00:00:00,Panorama Air Tour,Takeoff (climb),Commercial,United States of America,North America,10,1,0,9,0,0,10,Technical Failure
1983-09-10 00:00:00,Bertram E. Weech,Landing (descent or approach),Business,United States of America,North America,5,1,0,4,0,0,5,Technical Failure
1983-09-10 00:00:00,Mayo Aviation,Landing (descent or approach),Commercial,United States of America,North America,3,1,0,2,0,0,3,Human Factor
1983-09-16 00:00:00,Soviet Air Force - Voyenno-vozdushnye sily CCCP,Landing (descent or approach),Military / Government,Afghanistan,Asia,5,5,0,0,0,0,5,Terrorism
1983-09-19 00:00:00,Private American,Landing (descent or approach),Specialised Services,United States of America,North America,2,2,0,0,0,0,2,Technical Failure
1983-09-20 00:00:00,Larco Concrete Products,Takeoff (climb),Business,Uganda,Africa,0,0,0,0,0,0,0,Unknown
1983-09-23 00:00:00,Dirección Provincial de Aeronáutica de Salta,Landing (descent or approach),Military / Government,Argentina,South America,7,3,0,4,0,0,7,Human Factor
1983-09-25 00:00:00,RN Cargo of Nigeria,Landing (descent or approach),Operational,Ghana,Africa,4,4,0,0,0,0,4,Terrorism
1983-09-27 00:00:00,Angola Air Force - Força Aérea Nacional Angolana,,Military / Government,Angola,Africa,0,0,0,0,0,0,0,Unknown
1983-09-29 00:00:00,Scott M. Brunke,Landing (descent or approach),Business,United States of America,North America,2,2,0,0,0,0,2,Technical Failure
1983-09-29 00:00:00,Bombardier Aerospace,Flight,Operational,Canada,North America,2,2,0,0,0,0,2,Unknown
1983-10-05 00:00:00,ZUA - Zakładu Usług Agrolotniczych - AET Agroaviation Services,Flight,Military / Government,Poland,Europe,0,0,0,0,0,0,0,Unknown
1983-10-05 00:00:00,SAM Colombia - Sociedad Aeronáutica de Medellín,Landing (descent or approach),Commercial,Colombia,South America,0,0,0,0,0,0,0,Unknown
1983-10-09 00:00:00,Yung Shing Airlines,Landing (descent or approach),Commercial,Taiwan,Asia,12,2,0,10,0,0,12,Human Factor
1983-10-12 00:00:00,William Craig,Flight,Humanitarian,United States of America,North America,2,1,0,1,0,0,2,Human Factor
1983-10-19 00:00:00,Aeroflot - Russian International Airlines,Landing (descent or approach),Commercial,Russia,Asia,0,0,0,0,0,0,0,Human Factor
1983-10-28 00:00:00,Transportes Aéreos Bolivar - TAB,Landing (descent or approach),Operational,Bolivia,South America,5,3,0,2,0,0,5,Technical Failure
1983-10-31 00:00:00,FBN Flying Service,Takeoff (climb),Operational,United States of America,North America,2,2,0,0,0,0,2,Technical Failure
1983-11-10 00:00:00,Transportes Aéreos Skorpio,Takeoff (climb),Operational,Bolivia,South America,3,3,0,0,0,0,3,Technical Failure
1983-11-15 00:00:00,North West Airlines,Landing (descent or approach),Operational,Australia,Oceania,2,2,0,0,0,0,2,Human Factor
1983-11-26 00:00:00,The Pacific Institute,Landing (descent or approach),Business,United States of America,North America,1,1,0,0,0,0,1,Human Factor
1983-11-28 00:00:00,Peruvian Air Force - Fuerza Aérea del Perú,Flight,Military / Government,Peru,South America,0,0,0,0,0,0,0,Unknown
1983-12-07 00:00:00,ZB Air,Flight,Commercial,Kenya,Africa,0,0,0,0,0,0,0,Unknown
1983-12-11 00:00:00,West Texas Air Museum,Landing (descent or approach),Operational,United States of America,North America,2,2,0,0,0,0,2,Human Factor
1983-12-11 00:00:00,Guatemalan Air Force - Fuerza Aérea Guatemalteca,Landing (descent or approach),Military / Government,Guatemala,Central America,0,0,0,0,0,0,0,Unknown
1983-12-13 00:00:00,Philair,Takeoff (climb),Commercial,Philippines,Asia,10,3,0,7,0,0,10,Technical Failure
1983-12-18 00:00:00,Malaysian Airlines System - MAS,Landing (descent or approach),Commercial,Malaysia,Asia,247,14,0,233,0,0,247,Human Factor
1983-12-18 00:00:00,Peterborough Parachute Centre,Flight,Humanitarian,United Kingdom,Europe,9,1,0,8,0,0,9,Technical Failure
1983-12-22 00:00:00,AMF Corporation,Landing (descent or approach),Business,United States of America,North America,6,2,0,4,0,0,6,Human Factor
1983-12-23 00:00:00,Korean Air,Takeoff (climb),Operational,United States of America,North America,3,3,0,0,0,0,3,Human Factor
1983-12-23 00:00:00,SouthCentral Air,Takeoff (climb),Commercial,United States of America,North America,9,1,0,8,0,0,9,Human Factor
1983-12-26 00:00:00,Airmore Aviation,Landing (descent or approach),Operational,Denmark,Europe,1,1,0,0,0,0,1,Technical Failure
1984-01-02 00:00:00,Ramos Construction Company,Flight,Business,United States of America,North America,1,1,0,0,0,0,1,Technical Failure
1984-01-12 00:00:00,VSM Corporation,Landing (descent or approach),Business,United States of America,North America,3,1,0,2,0,0,3,Human Factor
1984-01-13 00:00:00,Pilgrim Airlines,Takeoff (climb),Commercial,United States of America,North America,24,3,0,21,0,0,24,Human Factor
1984-01-16 00:00:00,Transports Aériens du Zaïre - TAZ,Landing (descent or approach),Commercial,Guinea,Africa,17,2,0,15,0,0,17,Technical Failure
1984-01-18 00:00:00,United States Army,Landing (descent or approach),Operational,Marshall Islands,Oceania,0,0,0,0,0,0,0,Technical Failure
1984-01-20 00:00:00,Central Air Charter,Flight,Operational,United States of America,North America,1,1,0,0,0,0,1,Human Factor
1984-01-24 00:00:00,Astec Industries,Landing (descent or approach),Business,United States of America,North America,4,1,0,3,0,0,4,Human Factor
1984-02-08 00:00:00,Nevada National Leasing Corporation,Flight,Business,United States of America,North America,3,1,0,2,0,0,3,Technical Failure
1984-02-09 00:00:00,TAAG Angola Airlines - Transportes Aéreos de Angola,Landing (descent or approach),Commercial,Angola,Africa,142,6,0,136,0,0,142,Terrorism
1984-02-11 00:00:00,Aeroflot - Russian International Airlines,Takeoff (climb),Operational,Russia,Asia,2,2,0,0,0,0,2,Other
1984-02-15 00:00:00,Thomas L. Parker,Landing (descent or approach),Business,United States of America,North America,6,1,0,5,0,0,6,Human Factor
1984-02-17 00:00:00,École Départementale de Parachutisme Sportif,Flight,Humanitarian,France,Europe,0,0,0,0,0,0,0,Unknown
1984-02-24 00:00:00,Henles Engineering,Landing (descent or approach),Business,South Africa,Africa,3,1,0,2,0,0,3,Technical Failure
1984-02-25 00:00:00,Private Australian,Takeoff (climb),Military / Government,Australia,Oceania,1,1,0,0,0,0,1,Human Factor
1984-02-25 00:00:00,Donald J. Moore,Landing (descent or approach),Business,United States of America,North America,2,1,0,1,0,0,2,Human Factor
1984-02-28 00:00:00,Royal Thai Air Force - Kong Thap Akat Thai,Takeoff (climb),Military / Government,Thailand,Asia,0,0,0,0,0,0,0,Unknown
1984-03-02 00:00:00,Società Sateco,Takeoff (climb),Business,Italy,Europe,3,1,0,2,0,0,3,Unknown
1984-03-05 00:00:00,Indian Airlines,Takeoff (climb),Operational,India,Asia,3,3,0,0,0,0,3,Human Factor
1984-03-14 00:00:00,Private Bolivian,,Business,Bolivia,South America,0,0,0,0,0,0,0,Unknown
1984-03-15 00:00:00,Aero Cozumel,Takeoff (climb),Commercial,Mexico,Central America,0,0,0,0,0,0,0,Technical Failure
1984-03-21 00:00:00,Salvadorian Air Force - Fuerza Aérea Salvadoreña,Landing (descent or approach),Military / Government,Salvador,Central America,20,3,0,17,0,0,20,Terrorism
1984-03-22 00:00:00,Pacific Western Airlines - PWA,Takeoff (climb),Commercial,Canada,North America,119,5,0,114,0,0,119,Technical Failure
1984-03-26 00:00:00,Sinair,Landing (descent or approach),Commercial,Italy,Europe,6,1,0,5,0,0,6,Human Factor
1984-03-31 00:00:00,Combs FreightAir,Landing (descent or approach),Operational,United States of America,North America,1,1,0,0,0,0,1,Human Factor
1984-03-31 00:00:00,Angola Air Force - Força Aérea Nacional Angolana,,Military / Government,Angola,Africa,0,0,0,0,0,0,0,Unknown
1984-04-02 00:00:00,Egyptian Air Force and Air Defence Command,,Military / Government,Egypt,Africa,0,0,0,0,0,0,0,Unknown
1984-04-05 00:00:00,Scenic Air Tours,Landing (descent or approach),Operational,United States of America,North America,1,1,0,0,0,0,1,Unknown
1984-04-07 00:00:00,King Flying Service,Flight,Business,United States of America,North America,2,1,0,1,0,0,2,Weather
1984-04-15 00:00:00,United States Air Force - USAF,Landing (descent or approach),Specialised Services,Portugal,Europe,6,6,0,0,0,0,6,Technical Failure
1984-04-21 00:00:00,Hawkins %26 Powers Aviation,Takeoff (climb),Operational,United States of America,North America,4,2,0,2,0,0,4,Human Factor
1984-04-28 00:00:00,Intercontinental Air Lease - IAL,Landing (descent or approach),Operational,United States of America,North America,4,3,0,1,0,0,4,Technical Failure
1984-05-06 00:00:00,Transportes Aéreos San Martin,Landing (descent or approach),Operational,Bolivia,South America,3,3,0,0,0,0,3,Technical Failure
1984-05-11 00:00:00,Saint Louis Flight System,Takeoff (climb),Operational,United States of America,North America,1,1,0,0,0,0,1,Human Factor
1984-05-14 00:00:00,The Flying Fireman,Takeoff (climb),Humanitarian,Canada,North America,2,2,0,0,0,0,2,Technical Failure
1984-05-15 00:00:00,Flight Refuelling,Takeoff (climb),Operational,United Kingdom,Europe,3,2,0,1,0,0,3,Human Factor
1984-05-15 00:00:00,Aero Cozumel,,Commercial,Mexico,Central America,0,0,0,0,0,0,0,Unknown
1984-05-21 00:00:00,Aeroflot - Russian International Airlines,Flight,Military / Government,Ukraine,Europe,0,0,0,0,0,0,0,Unknown
1984-05-22 00:00:00,Private Bolivian,Flight,Business,Bolivia,South America,8,1,0,7,0,0,8,Technical Failure
1984-05-24 00:00:00,Sierra Verde Land Development,Flight,Business,United States of America,North America,1,1,0,0,0,0,1,Technical Failure
1984-05-25 00:00:00,Líneas Aéreas del Estado - LADE,Landing (descent or approach),Military / Government,Argentina,South America,15,2,0,13,0,0,15,Unknown
1984-05-28 00:00:00,Labrador Airways,Landing (descent or approach),Commercial,Canada,North America,8,3,0,5,0,0,8,Technical Failure
1984-05-30 00:00:00,Aviones de Panama,,Commercial,Panama,Central America,0,0,0,0,0,0,0,Unknown
1984-06-01 00:00:00,Loganair,Landing (descent or approach),Commercial,United Kingdom,Europe,8,1,0,7,0,0,8,Human Factor
1984-06-03 00:00:00,Royal Air Force - RAF,Flight,Operational,United Kingdom,Europe,13,13,0,0,0,0,13,Other
1984-06-11 00:00:00,Garuda Indonesian Airways,Landing (descent or approach),Operational,Indonesia,Asia,5,5,0,0,0,0,5,Human Factor
1984-06-15 00:00:00,French Air Force - Armée de l'Air,Flight,Humanitarian,France,Europe,0,0,0,0,0,0,0,Unknown
1984-06-16 00:00:00,Aeroflot - Russian International Airlines,Takeoff (climb),Commercial,Ukraine,Europe,0,0,0,0,0,0,0,Other
1984-06-16 00:00:00,Balkan Bulgarian Airlines,Landing (descent or approach),Commercial,Yemen,Asia,18,6,0,12,0,0,18,Human Factor
1984-06-21 00:00:00,Aeroflot - Russian International Airlines,Flight,Military / Government,Russia,Asia,2,2,0,0,0,0,2,Other
1984-06-23 00:00:00,Delmotte Aviation,Flight,Operational,France,Europe,2,2,0,0,0,0,2,Unknown
1984-07-04 00:00:00,Aeroflot - Russian International Airlines,Landing (descent or approach),Commercial,Russia,Asia,0,0,0,0,0,0,0,Human Factor
1984-07-11 00:00:00,Hawkins Corporation,Flight,Operational,United States of America,North America,1,1,0,0,0,0,1,Technical Failure
1984-07-11 00:00:00,Brazilian Air Force - Força Aérea Brasileira,Flight,Military / Government,Brazil,South America,0,0,0,0,0,0,0,Unknown
1984-07-13 00:00:00,Lesotho Airways,Takeoff (climb),Commercial,Lesotho,Africa,0,0,0,0,0,0,0,Technical Failure
1984-07-15 00:00:00,Wolf Aviation - DRC,Landing (descent or approach),Operational,Democratic Republic of Congo,Africa,3,3,0,0,0,0,3,Human Factor
1984-07-17 00:00:00,Pacific Air Express - USA,Takeoff (climb),Operational,United States of America,North America,1,1,0,0,0,0,1,Technical Failure
1984-07-23 00:00:00,Aeroflot - Russian International Airlines,Takeoff (climb),Military / Government,Russia,Asia,2,2,0,0,0,0,2,Weather
1984-07-24 00:00:00,Aeroflot - Russian International Airlines,Landing (descent or approach),Operational,Russia,Asia,5,5,0,0,0,0,5,Unknown
1984-07-26 00:00:00,Northern Thunderbird Air - NT Air,Landing (descent or approach),Commercial,Canada,North America,4,1,0,3,0,0,4,Unknown
1984-07-27 00:00:00,Aeroflot - Russian International Airlines,Landing (descent or approach),Commercial,Ukraine,Europe,2,2,0,0,0,0,2,Human Factor
1984-07-27 00:00:00,Aeroflot - Russian International Airlines,Flight,Commercial,Russia,Asia,0,0,0,0,0,0,0,Technical Failure
1984-07-27 00:00:00,Transportes Colombiana de Aviacion - TAVINA,Landing (descent or approach),Commercial,Colombia,South America,0,0,0,0,0,0,0,Other
1984-07-28 00:00:00,Panorama Flight Service,Takeoff (climb),Commercial,United States of America,North America,5,2,0,3,0,0,5,Human Factor
1984-08-03 00:00:00,Rio-Sul Serviços Aéreos Regionais,Landing (descent or approach),Operational,Brazil,South America,7,7,0,0,0,0,7,Unknown
1984-08-04 00:00:00,Philippine Airlines - PAL,Landing (descent or approach),Commercial,Philippines,Asia,75,5,0,70,0,0,75,Unknown
1984-08-12 00:00:00,Geoterrex,Landing (descent or approach),Commercial,Canada,North America,2,2,0,0,0,0,2,Technical Failure
1984-08-20 00:00:00,Piper Aircraft Corporation,Landing (descent or approach),Specialised Services,United States of America,North America,1,1,0,0,0,0,1,Human Factor
1984-08-24 00:00:00,David Rolschau,Landing (descent or approach),Humanitarian,United States of America,North America,1,1,0,0,0,0,1,Human Factor
1984-08-24 00:00:00,Balkan Bulgarian Airlines,Landing (descent or approach),Operational,Ethiopia,Africa,9,7,0,2,0,0,9,Human Factor
1984-08-28 00:00:00,Zaïre Aero Service,Takeoff (climb),Operational,Democratic Republic of Congo,Africa,0,0,0,0,0,0,0,Unknown
1984-08-30 00:00:00,Air Seychelles,,Commercial,Seychelles,Asia,0,0,0,0,0,0,0,Unknown
1984-08-30 00:00:00,Air Seychelles,,Commercial,Seychelles,Asia,0,0,0,0,0,0,0,Unknown
1984-08-31 00:00:00,Private American,Landing (descent or approach),Humanitarian,United States of America,North America,1,1,0,0,0,0,1,Human Factor
1984-09-05 00:00:00,De Havilland Aircraft of Canada,Landing (descent or approach),Operational,United Kingdom,Europe,3,2,0,1,0,0,3,Human Factor
1984-09-07 00:00:00,Wonderair,Taxiing,Specialised Services,Namibia,Africa,2,2,0,0,0,0,2,Technical Failure
1984-09-09 00:00:00,Georgetown Aircraft,Takeoff (climb),Business,United States of America,North America,2,1,0,1,0,0,2,Human Factor
1984-09-16 00:00:00,Aeroflot - Russian International Airlines,Flight,Specialised Services,Estonia,Europe,10,6,0,4,0,0,10,Technical Failure
1984-09-17 00:00:00,Austrian Air Services - Österreichischer Inlandflugdienst,Landing (descent or approach),Commercial,Austria,Europe,11,3,0,8,0,0,11,Unknown
1984-09-18 00:00:00,LAC Colombia - Lineas Aéreas del Caribe,Landing (descent or approach),Operational,Colombia,South America,4,4,0,0,0,0,4,Human Factor
1984-09-19 00:00:00,Angolan Government,Flight,Military / Government,Angola,Africa,0,0,0,0,0,0,0,Unknown
1984-09-20 00:00:00,John K. Micuda,Takeoff (climb),Business,United States of America,North America,3,2,0,1,0,0,3,Human Factor
1984-09-22 00:00:00,Royal Thai Air Force - Kong Thap Akat Thai,Landing (descent or approach),Military / Government,Thailand,Asia,0,0,0,0,0,0,0,Technical Failure
1984-09-24 00:00:00,Pee Dee Air Express,Landing (descent or approach),Commercial,United States of America,North America,11,2,0,9,0,0,11,Human Factor
1984-09-28 00:00:00,Aerotour - Peru,Flight,Commercial,Peru,South America,0,0,0,0,0,0,0,Unknown
1984-09-29 00:00:00,Private Colombian,Takeoff (climb),Humanitarian,Colombia,South America,5,1,0,4,0,0,5,Unknown
1984-09-30 00:00:00,Angola Air Force - Força Aérea Nacional Angolana,,Military / Government,Angola,Africa,0,0,0,0,0,0,0,Unknown
1984-10-01 00:00:00,Royal Air Force - RAF,Landing (descent or approach),Military / Government,United Kingdom,Europe,11,11,0,0,0,0,11,Technical Failure
1984-10-04 00:00:00,Aeroflot - Russian International Airlines,Flight,Military / Government,Kazakhstan,Asia,6,3,0,3,0,0,6,Weather
1984-10-06 00:00:00,Grondmet Handels,Takeoff (climb),Business,Greece,Europe,10,2,0,8,0,0,10,Unknown
1984-10-06 00:00:00,Aeroflot - Russian International Airlines,Flight,Commercial,Russia,Asia,0,0,0,0,0,0,0,Weather
1984-10-11 00:00:00,Spanish Air Force - Ejército del Aire,Flight,Military / Government,Spain,Europe,9,3,0,6,0,0,9,Technical Failure
1984-10-18 00:00:00,Air Sedona,Landing (descent or approach),Commercial,United States of America,North America,2,1,0,1,0,0,2,Technical Failure
1984-10-20 00:00:00,Metropolitan International Investment %26 Security,Takeoff (climb),Business,United States of America,North America,4,1,0,3,0,0,4,Human Factor
1984-10-22 00:00:00,TAM Bolivia - Transporte Aéreo Militar Boliviano,Landing (descent or approach),Military / Government,Bolivia,South America,0,0,0,0,0,0,0,Unknown
1984-11-01 00:00:00,Wiggins Airways,Takeoff (climb),Commercial,United States of America,North America,2,1,0,1,0,0,2,Human Factor
1984-11-02 00:00:00,United States Air Force - USAF,Landing (descent or approach),Operational,Germany,Europe,4,4,0,0,0,0,4,Unknown
1984-11-03 00:00:00,TTA - Sociedade de Transportes e Trabalhos Aéreos,Landing (descent or approach),Commercial,Mozambique,Africa,8,1,0,7,0,0,8,Unknown
1984-11-10 00:00:00,McPhar International,Flight,Military / Government,Australia,Oceania,1,1,0,0,0,0,1,Technical Failure
1984-11-11 00:00:00,Stellair,Flight,Operational,Morocco,Africa,0,0,0,0,0,0,0,Technical Failure
1984-11-11 00:00:00,Soviet Air Force - Voyenno-vozdushnye sily CCCP,Flight,Military / Government,Afghanistan,Asia,0,0,0,0,0,0,0,Terrorism
1984-11-22 00:00:00,Factury Buying Corporation,Flight,Business,Mexico,Central America,2,2,0,0,0,0,2,Unknown
1984-11-25 00:00:00,Snowy Mountains Hydro-Electric Authority,Takeoff (climb),Humanitarian,Australia,Oceania,13,1,0,12,0,0,13,Technical Failure
1984-12-01 00:00:00,Fairburn Aviation Services,Landing (descent or approach),Commercial,Australia,Oceania,2,1,0,1,0,0,2,Human Factor
1984-12-01 00:00:00,NASA - National Aeronautics %26 Space Administration,Landing (descent or approach),Specialised Services,United States of America,North America,0,0,0,0,0,0,0,Unknown
1984-12-13 00:00:00,Transtar Aviation,Landing (descent or approach),Operational,United States of America,North America,1,1,0,0,0,0,1,Human Factor
1984-12-16 00:00:00,Air Resorts Airlines,Landing (descent or approach),Commercial,United States of America,North America,39,5,0,34,0,0,39,Technical Failure
1984-12-17 00:00:00,Arrowhead Airways,Landing (descent or approach),Commercial,United States of America,North America,3,1,0,2,0,0,3,Technical Failure
1984-12-18 00:00:00,Aeroflot - Russian International Airlines,Takeoff (climb),Commercial,Russia,Asia,0,0,0,0,0,0,0,Human Factor
1984-12-18 00:00:00,Royal Thai Navy - Kong Thap Ruea Thai,Takeoff (climb),Operational,Thailand,Asia,2,2,0,0,0,0,2,Unknown
1984-12-19 00:00:00,Cox Aircraft Company,Flight,Specialised Services,United States of America,North America,3,1,0,2,0,0,3,Technical Failure
1984-12-26 00:00:00,AVCO,Takeoff (climb),Business,United States of America,North America,4,1,0,3,0,0,4,Human Factor
1984-12-29 00:00:00,Ready Air,Flight,Operational,Haiti,Central America,2,2,0,0,0,0,2,Technical Failure
1984-12-29 00:00:00,Aeroflot - Russian International Airlines,Flight,Commercial,Russia,Asia,0,0,0,0,0,0,0,Technical Failure
1984-12-30 00:00:00,Garuda Indonesian Airways,Landing (descent or approach),Commercial,Indonesia,Asia,75,6,0,69,0,0,75,Human Factor
1984-12-31 00:00:00,TAM Paraguay - Transporte Aéreo Militar,,Military / Government,Paraguay,South America,0,0,0,0,0,0,0,Unknown
1985-01-08 00:00:00,Royal Thai Navy - Kong Thap Ruea Thai,Landing (descent or approach),Military / Government,Thailand,Asia,8,2,0,6,0,0,8,Human Factor
1985-01-08 00:00:00,Bakhtar Afghan Airlines,Landing (descent or approach),Commercial,Afghanistan,Asia,20,3,0,17,0,0,20,Unknown
1985-01-10 00:00:00,MAP - Ministerstvo Aviatsionnoi Promyshlennosti - Minaviaprom,Landing (descent or approach),Military / Government,Kazakhstan,Asia,6,4,0,2,0,0,6,Human Factor
1985-01-11 00:00:00,Merpati Nusantara Airlines - MNA,Landing (descent or approach),Commercial,Indonesia,Asia,12,4,0,8,0,0,12,Weather
1985-01-13 00:00:00,Mandala Airlines,Landing (descent or approach),Commercial,Indonesia,Asia,49,4,0,45,0,0,49,Unknown
1985-01-17 00:00:00,Southern Express Airways,Takeoff (climb),Business,United States of America,North America,1,1,0,0,0,0,1,Human Factor
1985-01-17 00:00:00,Royal Thai Air Force - Kong Thap Akat Thai,Landing (descent or approach),Military / Government,Thailand,Asia,0,0,0,0,0,0,0,Unknown
1985-01-24 00:00:00,Aeroflot - Russian International Airlines,Flight,Commercial,Russia,Asia,0,0,0,0,0,0,0,Human Factor
1985-01-28 00:00:00,Aviones de Panama,Flight,Commercial,Panama,Central America,4,1,0,3,0,0,4,Technical Failure
1985-01-29 00:00:00,Galaxy Airlines,Landing (descent or approach),Operational,United States of America,North America,3,3,0,0,0,0,3,Technical Failure
1985-01-31 00:00:00,Hogan Air,Takeoff (climb),Operational,United States of America,North America,4,2,0,2,0,0,4,Human Factor
1985-01-31 00:00:00,United Parcel Service - UPS,Landing (descent or approach),Operational,United States of America,North America,3,2,0,1,0,0,3,Human Factor
1985-01-31 00:00:00,BIF Air,Landing (descent or approach),Operational,Turks and Caicos Islands,Central America,0,0,0,0,0,0,0,Unknown
1985-02-06 00:00:00,Airborne Express,Takeoff (climb),Operational,United States of America,North America,2,2,0,0,0,0,2,Human Factor
1985-02-07 00:00:00,TAG Aviation,Landing (descent or approach),Business,Italy,Europe,12,3,0,9,0,0,12,Human Factor
1985-02-15 00:00:00,Islamic Republic of Iran Air Force,Landing (descent or approach),Military / Government,Iran,Asia,0,0,0,0,0,0,0,Unknown
1985-02-22 00:00:00,Robson S. Walton,Takeoff (climb),Business,United States of America,North America,1,1,0,0,0,0,1,Human Factor
1985-03-02 00:00:00,Manokotak Airways,Takeoff (climb),Operational,United States of America,North America,1,1,0,0,0,0,1,Human Factor
1985-03-05 00:00:00,Soviet Air Force - Voyenno-vozdushnye sily CCCP,Flight,Operational,Ukraine,Europe,5,5,0,0,0,0,5,Technical Failure
1985-03-06 00:00:00,Libyan Arab Airlines,Landing (descent or approach),Commercial,Libya,Africa,0,0,0,0,0,0,0,Human Factor
1985-03-12 00:00:00,SeAir Alaska Airlines,Landing (descent or approach),Commercial,United States of America,North America,4,2,0,2,0,0,4,Human Factor
1985-03-17 00:00:00,Ada Aircraft Museum,Flight,Operational,United States of America,North America,3,3,0,0,0,0,3,Technical Failure
1985-03-21 00:00:00,Airfast Indonesia,Flight,Commercial,Indonesia,Asia,0,0,0,0,0,0,0,Unknown
1985-03-25 00:00:00,Aeroflot - Russian International Airlines,Takeoff (climb),Operational,Russia,Asia,3,3,0,0,0,0,3,Technical Failure
1985-03-25 00:00:00,Eric Schaffer,Landing (descent or approach),Humanitarian,United States of America,North America,1,1,0,0,0,0,1,Human Factor
1985-04-06 00:00:00,Will's Air,Landing (descent or approach),Commercial,United States of America,North America,8,1,0,7,0,0,8,Human Factor
1985-04-13 00:00:00,Oxley Airlines,Takeoff (climb),Commercial,Australia,Oceania,9,1,0,8,0,0,9,Human Factor
1985-04-15 00:00:00,MIAT Mongolian Airlines - Mongolyn Irgeniy Agaaryn Teever,Landing (descent or approach),Commercial,Mongolia,Asia,0,0,0,0,0,0,0,Unknown
1985-04-22 00:00:00,Cega Aviation,Landing (descent or approach),Operational,United Kingdom,Europe,2,2,0,0,0,0,2,Unknown
1985-04-25 00:00:00,Transcontinental Gas Pipe Line Corporation,Flight,Military / Government,United States of America,North America,1,1,0,0,0,0,1,Human Factor
1985-05-01 00:00:00,Globe Air,Takeoff (climb),Specialised Services,United States of America,North America,2,2,0,0,0,0,2,Technical Failure
1985-05-03 00:00:00,Landmark Land Company,Landing (descent or approach),Business,United States of America,North America,2,2,0,0,0,0,2,Human Factor
1985-05-04 00:00:00,Private American,Landing (descent or approach),Humanitarian,United States of America,North America,1,1,0,0,0,0,1,Human Factor
1985-05-04 00:00:00,Perris Valley Skydiving Club,Takeoff (climb),Humanitarian,United States of America,North America,33,2,0,31,0,0,33,Human Factor
1985-05-05 00:00:00,Square Tool %26 Machine Company,Takeoff (climb),Business,United States of America,North America,4,1,0,3,0,0,4,Human Factor
1985-05-10 00:00:00,Private New Zealand,Flight,Military / Government,New Zealand,Oceania,1,1,0,0,0,0,1,Unknown
1985-05-11 00:00:00,Aeroflot - Russian International Airlines,Landing (descent or approach),Operational,Russia,Asia,2,2,0,0,0,0,2,Technical Failure
1985-05-12 00:00:00,William M. Wrigley Company,Landing (descent or approach),Business,United States of America,North America,6,2,0,4,0,0,6,Human Factor
1985-05-12 00:00:00,Bali International Air Service,Flight,Commercial,Indonesia,Asia,0,0,0,0,0,0,0,Unknown
1985-05-13 00:00:00,Superstition Air Service,Landing (descent or approach),Operational,United States of America,North America,1,1,0,0,0,0,1,Technical Failure
1985-05-15 00:00:00,Air Mali,,Commercial,Mali,Africa,0,0,0,0,0,0,0,Unknown
1985-05-17 00:00:00,Cumberland Airlines,Landing (descent or approach),Commercial,United States of America,North America,7,2,0,5,0,0,7,Human Factor
1985-05-17 00:00:00,Polish Geophysical Academy - Polskiego Towarzystwo Geofizyczne,Flight,Specialised Services,Poland,Europe,0,0,0,0,0,0,0,Unknown
1985-05-18 00:00:00,Northland American Air Cargo,Takeoff (climb),Operational,United States of America,North America,1,1,0,0,0,0,1,Human Factor
1985-05-19 00:00:00,Castle Industries of Arkansas,Landing (descent or approach),Operational,United States of America,North America,3,2,0,1,0,0,3,Human Factor
1985-05-21 00:00:00,Aeroflot - Russian International Airlines,Takeoff (climb),Specialised Services,Russia,Asia,22,2,0,20,0,0,22,Other
1985-05-23 00:00:00,Chilcotin Cariboo Aviation,Landing (descent or approach),Commercial,Canada,North America,0,0,0,0,0,0,0,Unknown
1985-05-29 00:00:00,Cessna Aircraft Company,Landing (descent or approach),Specialised Services,United States of America,North America,4,1,0,3,0,0,4,Human Factor
1985-06-05 00:00:00,Aeroflot - Russian International Airlines,Flight,Commercial,Russia,Asia,10,2,0,8,0,0,10,Technical Failure
1985-06-11 00:00:00,Midwest Jet Sales,Landing (descent or approach),Operational,United States of America,North America,3,2,0,1,0,0,3,Human Factor
1985-06-13 00:00:00,Benin Government,Takeoff (climb),Military / Government,Libya,Africa,0,0,0,0,0,0,0,Unknown
1985-06-19 00:00:00,Combs FreightAir,Takeoff (climb),Operational,United States of America,North America,2,2,0,0,0,0,2,Technical Failure
1985-06-20 00:00:00,Bergt Corporation,Landing (descent or approach),Business,United States of America,North America,3,1,0,2,0,0,3,Human Factor
1985-06-20 00:00:00,Aeroflot - Russian International Airlines,Takeoff (climb),Operational,Russia,Asia,3,2,0,1,0,0,3,Human Factor
1985-06-27 00:00:00,Aeroflot - Russian International Airlines,Flight,Military / Government,Russia,Asia,2,2,0,0,0,0,2,Technical Failure
1985-06-30 00:00:00,Reliable Production Service,Takeoff (climb),Operational,United States of America,North America,2,2,0,0,0,0,2,Human Factor
1985-06-30 00:00:00,Northern Peninsular Fisheries,Landing (descent or approach),Business,United States of America,North America,4,2,0,2,0,0,4,Technical Failure
1985-07-02 00:00:00,Sudan Airways,Landing (descent or approach),Commercial,Sudan,Africa,31,5,0,26,0,0,31,Human Factor
1985-07-04 00:00:00,Aeroflot - Russian International Airlines,Takeoff (climb),Operational,Russia,Asia,3,2,0,1,0,0,3,Other
1985-07-07 00:00:00,Northern Pacific Transport,Takeoff (climb),Operational,United States of America,North America,3,3,0,0,0,0,3,Human Factor
1985-07-07 00:00:00,Aeroflot - Russian International Airlines,Flight,Military / Government,Russia,Asia,2,2,0,0,0,0,2,Technical Failure
1985-07-09 00:00:00,Eugene F. Young,Takeoff (climb),Business,United States of America,North America,1,1,0,0,0,0,1,Technical Failure
1985-07-11 00:00:00,Gentex Corporation,Landing (descent or approach),Business,United States of America,North America,3,2,0,1,0,0,3,Human Factor
1985-07-12 00:00:00,Aeroflot - Russian International Airlines,Takeoff (climb),Commercial,Kazakhstan,Asia,0,0,0,0,0,0,0,Unknown
1985-07-12 00:00:00,Soviet Air Force - Voyenno-vozdushnye sily CCCP,Landing (descent or approach),Military / Government,Afghanistan,Asia,6,6,0,0,0,0,6,Terrorism
1985-07-14 00:00:00,PropAir,Takeoff (climb),Commercial,Canada,North America,2,1,0,1,0,0,2,Unknown
1985-07-15 00:00:00,Aeroflot - Russian International Airlines,Flight,Military / Government,Russia,Asia,2,2,0,0,0,0,2,Technical Failure
1985-07-17 00:00:00,NASA - National Aeronautics %26 Space Administration,Takeoff (climb),Operational,United States of America,North America,19,4,0,15,0,0,19,Technical Failure
1985-07-20 00:00:00,Sunrise Aviation,Takeoff (climb),Business,Canada,North America,0,0,0,0,0,0,0,Technical Failure
1985-07-23 00:00:00,Dornier Flugzeugwerke,Landing (descent or approach),Specialised Services,Germany,Europe,2,2,0,0,0,0,2,Human Factor
1985-07-24 00:00:00,United States Army,Landing (descent or approach),Military / Government,Greece,Europe,3,2,0,1,0,0,3,Technical Failure
1985-08-04 00:00:00,Aires Colombia - Aerovias de Integracion Regional,Takeoff (climb),Commercial,Colombia,South America,16,2,0,14,0,0,16,Technical Failure
1985-08-06 00:00:00,Aeroflot - Russian International Airlines,Flight,Commercial,Uzbekistan,Asia,0,0,0,0,0,0,0,Weather
1985-08-10 00:00:00,Oklahoma Jet,Takeoff (climb),Commercial,United States of America,North America,4,1,0,3,0,0,4,Human Factor
1985-08-12 00:00:00,Jet Fleet,Flight,Operational,United States of America,North America,2,2,0,0,0,0,2,Human Factor
1985-08-13 00:00:00,Aviatia Utilitara,Flight,Military / Government,Romania,Europe,0,0,0,0,0,0,0,Unknown
1985-08-15 00:00:00,Viking Aviation,Flight,Commercial,United States of America,North America,3,1,0,2,0,0,3,Technical Failure
1985-08-17 00:00:00,Jim Ricketts,Takeoff (climb),Operational,United States of America,North America,2,2,0,0,0,0,2,Technical Failure
1985-08-19 00:00:00,Compañia Aérea Nacional - CAN,Takeoff (climb),Operational,Bolivia,South America,3,3,0,0,0,0,3,Technical Failure
1985-08-21 00:00:00,California Air Charter - Cal Air Charter,Landing (descent or approach),Operational,United States of America,North America,1,1,0,0,0,0,1,Human Factor
1985-08-24 00:00:00,Homer Allen Anderson,Flight,Business,United States of America,North America,1,1,0,0,0,0,1,Human Factor
1985-08-29 00:00:00,Aeroflot - Russian International Airlines,Flight,Commercial,Russia,Asia,0,0,0,0,0,0,0,Technical Failure
1985-08-30 00:00:00,Gunnell Aviation,Flight,Operational,United States of America,North America,3,3,0,0,0,0,3,Technical Failure
1985-09-01 00:00:00,Aeroflot - Russian International Airlines,Landing (descent or approach),Commercial,Russia,Asia,14,2,0,12,0,0,14,Technical Failure
1985-09-10 00:00:00,Collier Mosquito Control District,Flight,Military / Government,United States of America,North America,2,2,0,0,0,0,2,Technical Failure
1985-09-11 00:00:00,Aeroflot - Russian International Airlines,Flight,Commercial,Russia,Asia,0,0,0,0,0,0,0,Human Factor
1985-09-23 00:00:00,Gull Air - Air Florida Commuter,Landing (descent or approach),Commercial,United States of America,North America,3,1,0,2,0,0,3,Technical Failure
1985-09-23 00:00:00,Durakool,Landing (descent or approach),Business,United States of America,North America,2,2,0,0,0,0,2,Human Factor
1985-09-23 00:00:00,Angola Air Force - Força Aérea Nacional Angolana,Flight,Military / Government,Angola,Africa,0,0,0,0,0,0,0,Unknown
1985-09-30 00:00:00,Kirk E. Molhook,Landing (descent or approach),Humanitarian,United States of America,North America,0,0,0,0,0,0,0,Unknown
1985-10-04 00:00:00,Cronica,Flight,Business,Argentina,South America,0,0,0,0,0,0,0,Unknown
1985-10-09 00:00:00,African Air Charter - Zaire,Landing (descent or approach),Operational,Democratic Republic of Congo,Africa,0,0,0,0,0,0,0,Unknown
1985-10-15 00:00:00,Malmö Aviation,Takeoff (climb),Commercial,Denmark,Europe,0,0,0,0,0,0,0,Technical Failure
1985-10-19 00:00:00,Ray Charles Enterprises,Landing (descent or approach),Business,United States of America,North America,28,2,0,26,0,0,28,Human Factor
1985-10-20 00:00:00,Brazilian Air Force - Força Aérea Brasileira,Landing (descent or approach),Operational,Brazil,South America,3,3,0,0,0,0,3,Technical Failure
1985-10-22 00:00:00,CAAC - Civil Aviation Administration of China,Landing (descent or approach),Commercial,China,Asia,25,4,0,21,0,0,25,Unknown
1985-11-04 00:00:00,Broussair,Flight,Commercial,Democratic Republic of Congo,Africa,0,0,0,0,0,0,0,Unknown
1985-11-07 00:00:00,Hardees Foods,Landing (descent or approach),Business,United States of America,North America,5,2,0,3,0,0,5,Weather
1985-11-08 00:00:00,Essair,Landing (descent or approach),Business,France,Europe,0,0,0,0,0,0,0,Unknown
1985-11-27 00:00:00,Donington Aviation,Takeoff (climb),Commercial,United Kingdom,Europe,12,1,0,11,0,0,12,Unknown
1985-11-30 00:00:00,Mandala Airlines,Landing (descent or approach),Commercial,Indonesia,Asia,45,8,0,37,0,0,45,Technical Failure
1985-12-01 00:00:00,Zilfi Investments Company,Landing (descent or approach),Business,United States of America,North America,3,1,0,2,0,0,3,Human Factor
1985-12-01 00:00:00,J %26 M Partners,Flight,Business,United States of America,North America,6,2,0,4,0,0,6,Technical Failure
1985-12-01 00:00:00,Prestress Supply,Flight,Business,United States of America,North America,1,1,0,0,0,0,1,Technical Failure
1985-12-02 00:00:00,Air France,Landing (descent or approach),Commercial,Brazil,South America,282,17,0,265,0,0,282,Technical Failure
1985-12-04 00:00:00,Zimex Aviation,Landing (descent or approach),Operational,Yemen,Asia,1,1,0,0,0,0,1,Human Factor
1985-12-04 00:00:00,Delta Air,Landing (descent or approach),Commercial,Germany,Europe,0,0,0,0,0,0,0,Unknown
1985-12-12 00:00:00,Plane Masters,Flight,Business,United States of America,North America,2,1,0,1,0,0,2,Technical Failure
1985-12-13 00:00:00,Hertrich Aviation,Landing (descent or approach),Business,United States of America,North America,2,1,0,1,0,0,2,Human Factor
1985-12-13 00:00:00,Aéro-Service,Landing (descent or approach),Commercial,Ghana,Africa,0,0,0,0,0,0,0,Unknown
1985-12-18 00:00:00,Air Provence International,Landing (descent or approach),Commercial,France,Europe,0,0,0,0,0,0,0,Unknown
1985-12-25 00:00:00,AeroEjecutivos,Flight,Commercial,Venezuela,South America,0,0,0,0,0,0,0,Technical Failure
1985-12-29 00:00:00,W. D. Norton,Landing (descent or approach),Business,United States of America,North America,7,1,0,6,0,0,7,Technical Failure
1985-12-31 00:00:00,Benin Government,,Military / Government,Benin,Africa,0,0,0,0,0,0,0,Unknown
1986-01-03 00:00:00,MSN Tselinograd - Mining %26 Chemical Plant,Flight,Business,Kazakhstan,Asia,0,0,0,0,0,0,0,Human Factor
1986-01-10 00:00:00,Goose Bay Air Services,Flight,Commercial,Canada,North America,0,0,0,0,0,0,0,Unknown
1986-01-15 00:00:00,Colonial Oil Industries,Landing (descent or approach),Business,United States of America,North America,1,1,0,0,0,0,1,Human Factor
1986-01-16 00:00:00,ZUA - Zakładu Usług Agrolotniczych - AET Agroaviation Services,Flight,Military / Government,Sudan,Africa,0,0,0,0,0,0,0,Unknown
1986-01-17 00:00:00,Private Philippine,Flight,Operational,Philippines,Asia,10,2,0,8,0,0,10,Technical Failure
1986-01-19 00:00:00,Austin Airways,Landing (descent or approach),Operational,Canada,North America,4,2,0,2,0,0,4,Human Factor
1986-01-27 00:00:00,Aerolineas Argentinas,Landing (descent or approach),Operational,Argentina,South America,5,4,0,1,0,0,5,Human Factor
1986-01-31 00:00:00,Aer Lingus,Landing (descent or approach),Commercial,United Kingdom,Europe,36,3,0,33,0,0,36,Weather
1986-01-31 00:00:00,Hotel Constructions Management,Landing (descent or approach),Operational,United States of America,North America,2,1,0,1,0,0,2,Technical Failure
1986-01-31 00:00:00,Graham Collins Associates,Flight,Operational,Cameroon,Africa,1,1,0,0,0,0,1,Technical Failure
1986-02-06 00:00:00,Aeroflot - Russian International Airlines,Takeoff (climb),Operational,Russia,Asia,6,6,0,0,0,0,6,Human Factor
1986-02-08 00:00:00,Servicios Aéreos Especializados en Transportes Petroleros - SAEP Colombia,Takeoff (climb),Operational,Colombia,South America,5,2,0,3,0,0,5,Technical Failure
1986-02-09 00:00:00,Industrie Leasing,Landing (descent or approach),Commercial,Germany,Europe,4,2,0,2,0,0,4,Weather
1986-02-11 00:00:00,ACE Air Cargo Express,Takeoff (climb),Operational,United States of America,North America,1,1,0,0,0,0,1,Human Factor
1986-02-13 00:00:00,Pacific Air Express - USA,Landing (descent or approach),Operational,United States of America,North America,2,2,0,0,0,0,2,Human Factor
1986-02-18 00:00:00,Japan Air Self-Defense Force - Kōkū Jieitai,Takeoff (climb),Operational,Japan,Asia,7,7,0,0,0,0,7,Weather
1986-02-21 00:00:00,USAir - US Airways,Landing (descent or approach),Commercial,United States of America,North America,23,5,0,18,0,0,23,Human Factor
1986-02-25 00:00:00,XP Express Parcel Systems,Landing (descent or approach),Operational,France,Europe,2,2,0,0,0,0,2,Human Factor
1986-02-26 00:00:00,Blackhawk Airways,Landing (descent or approach),Operational,United States of America,North America,1,1,0,0,0,0,1,Human Factor
1986-02-27 00:00:00,Seneca Sawmill Company,Landing (descent or approach),Business,United States of America,North America,6,2,0,4,0,0,6,Technical Failure
1986-03-07 00:00:00,Chadian Air Force - Force Aérienne Tchadienne,Takeoff (climb),Military / Government,Chad,Africa,0,0,0,0,0,0,0,Unknown
1986-03-13 00:00:00,Flying a Flight Service,Landing (descent or approach),Operational,United States of America,North America,2,2,0,0,0,0,2,Human Factor
1986-04-05 00:00:00,Peter H. Whitem,Landing (descent or approach),Business,United States of America,North America,4,1,0,3,0,0,4,Weather
1986-04-08 00:00:00,Aeroflot - Russian International Airlines,Flight,Commercial,Kyrgyzstan,Asia,0,0,0,0,0,0,0,Human Factor
1986-04-10 00:00:00,Aeroflot - Russian International Airlines,Landing (descent or approach),Specialised Services,World,World,9,5,0,4,0,0,9,Human Factor
1986-04-14 00:00:00,Can-Air Services,Landing (descent or approach),Specialised Services,United States of America,North America,0,0,0,0,0,0,0,Other
1986-04-18 00:00:00,Aeroflot - Russian International Airlines,Landing (descent or approach),Commercial,Russia,Asia,32,5,0,27,0,0,32,Technical Failure
1986-04-24 00:00:00,Malawi Police Air Wing,Landing (descent or approach),Operational,Kenya,Africa,2,2,0,0,0,0,2,Technical Failure
1986-05-03 00:00:00,Aeroflot - Russian International Airlines,Landing (descent or approach),Operational,Russia,Asia,5,5,0,0,0,0,5,Human Factor
1986-05-07 00:00:00,My Wife Yacht Sales,Landing (descent or approach),Business,United States of America,North America,4,2,0,2,0,0,4,Human Factor
1986-05-16 00:00:00,Centennial Airlines,Landing (descent or approach),Commercial,United States of America,North America,9,2,0,7,0,0,9,Weather
1986-05-17 00:00:00,East Coast Airways,Takeoff (climb),Commercial,United States of America,North America,4,2,0,2,0,0,4,Human Factor
1986-05-21 00:00:00,Aeroflot - Russian International Airlines,Landing (descent or approach),Commercial,Russia,Asia,185,10,0,175,0,0,185,Weather
1986-05-25 00:00:00,La Ronge Aviation Services,Landing (descent or approach),Commercial,Canada,North America,0,0,0,0,0,0,0,Unknown
1986-05-31 00:00:00,Jonathan Seagull Holdings,Landing (descent or approach),Operational,United Kingdom,Europe,7,4,0,3,0,0,7,Unknown
1986-06-08 00:00:00,TAAG Angola Airlines - Transportes Aéreos de Angola,Landing (descent or approach),Operational,Angola,Africa,5,5,0,0,0,0,5,Technical Failure
1986-06-11 00:00:00,Airways International Cymru,Landing (descent or approach),Business,United Kingdom,Europe,3,1,0,2,0,0,3,Technical Failure
1986-06-13 00:00:00,Cargair,Flight,Commercial,Canada,North America,0,0,0,0,0,0,0,Unknown
1986-06-14 00:00:00,Air Furness,Landing (descent or approach),Operational,United Kingdom,Europe,1,1,0,0,0,0,1,Human Factor
1986-06-21 00:00:00,Aeroflot - Russian International Airlines,Flight,Commercial,Kazakhstan,Asia,0,0,0,0,0,0,0,Human Factor
1986-06-22 00:00:00,Ethiopian Airlines,Landing (descent or approach),Commercial,Ethiopia,Africa,20,3,0,17,0,0,20,Human Factor
1986-06-28 00:00:00,Aeroflot - Russian International Airlines,Flight,Commercial,Russia,Asia,4,2,0,2,0,0,4,Human Factor
1986-06-29 00:00:00,Private American,Flight,Humanitarian,Mexico,Central America,0,0,0,0,0,0,0,Unknown
1986-06-30 00:00:00,Turkish Air Force - Türk Hava Kuvvetleri,Flight,Specialised Services,Turkey,Asia,4,4,0,0,0,0,4,Unknown
1986-07-04 00:00:00,Royal Australian Air Force - RAAF,Landing (descent or approach),Operational,Australia,Oceania,0,0,0,0,0,0,0,Unknown
1986-07-11 00:00:00,Aeroflot - Russian International Airlines,Flight,Humanitarian,Russia,Asia,3,2,0,1,0,0,3,Technical Failure
1986-07-11 00:00:00,Aeroflot - Russian International Airlines,Flight,Commercial,Russia,Asia,0,0,0,0,0,0,0,Other
1986-07-16 00:00:00,Private Australian,Takeoff (climb),Business,Australia,Oceania,4,2,0,2,0,0,4,Weather
1986-07-17 00:00:00,Norving,Landing (descent or approach),Commercial,Norway,Europe,0,0,0,0,0,0,0,Unknown
1986-07-18 00:00:00,Instituto Nacional de Aviación Civil,Flight,Military / Government,Argentina,South America,0,0,0,0,0,0,0,Unknown
1986-07-25 00:00:00,Air Ivoire,Takeoff (climb),Commercial,Ivory Coast,Africa,29,3,0,26,0,0,29,Technical Failure
1986-07-29 00:00:00,ZUA - Zakładu Usług Agrolotniczych - AET Agroaviation Services,Flight,Military / Government,Poland,Europe,0,0,0,0,0,0,0,Unknown
1986-07-31 00:00:00,Rural Aerial co-op,Flight,Military / Government,New Zealand,Oceania,0,0,0,0,0,0,0,Unknown
1986-08-06 00:00:00,Federal Paper Board Company,Takeoff (climb),Business,United States of America,North America,3,2,0,1,0,0,3,Human Factor
1986-08-06 00:00:00,Kabo Air,Landing (descent or approach),Commercial,Nigeria,Africa,0,0,0,0,0,0,0,Unknown
1986-08-07 00:00:00,Aeroflot - Russian International Airlines,Flight,Commercial,Russia,Asia,0,0,0,0,0,0,0,Technical Failure
1986-08-11 00:00:00,Aeroflot - Russian International Airlines,Landing (descent or approach),Operational,Russia,Asia,2,2,0,0,0,0,2,Human Factor
1986-08-24 00:00:00,Aeroflot - Russian International Airlines,Flight,Commercial,Russia,Asia,0,0,0,0,0,0,0,Human Factor
1986-08-29 00:00:00,Talair,Flight,Commercial,Papua New Guinea,Oceania,3,1,0,2,0,0,3,Unknown
1986-08-31 00:00:00,Wasawings,Landing (descent or approach),Operational,Finland,Europe,1,1,0,0,0,0,1,Human Factor
1986-09-02 00:00:00,Pickle Lake Air Services,Flight,Operational,Canada,North America,2,1,0,1,0,0,2,Technical Failure
1986-09-03 00:00:00,Jet Way Enterprises,Landing (descent or approach),Operational,United States of America,North America,3,3,0,0,0,0,3,Human Factor
1986-09-05 00:00:00,Argentinian Navy - Armada Argentina,Flight,Military / Government,Argentina,South America,0,0,0,0,0,0,0,Unknown
1986-09-09 00:00:00,O.R.D. Inc.,Flight,Business,Bahamas,Central America,0,0,0,0,0,0,0,Unknown
1986-09-29 00:00:00,Federal Aviation Administration - FAA,Landing (descent or approach),Operational,United States of America,North America,4,2,0,2,0,0,4,Human Factor
1986-09-29 00:00:00,Indian Airlines,Takeoff (climb),Commercial,India,Asia,196,11,0,185,0,0,196,Other
1986-09-30 00:00:00,Turks and Caicos Airways - Turks and Caicos National Airline,Flight,Commercial,Haiti,Central America,0,0,0,0,0,0,0,Unknown
1986-10-01 00:00:00,Amiskwi Air,Takeoff (climb),Operational,Canada,North America,1,1,0,0,0,0,1,Human Factor
1986-10-09 00:00:00,Aeroflot - Russian International Airlines,Landing (descent or approach),Commercial,Russia,Asia,9,2,0,7,0,0,9,Human Factor
1986-10-12 00:00:00,Midway Aircraft Brokers,Landing (descent or approach),Operational,United States of America,North America,2,2,0,0,0,0,2,Human Factor
1986-10-15 00:00:00,United States Air Force - USAF,Taxiing,Military / Government,United States of America,North America,0,0,0,0,0,0,0,Human Factor
1986-10-25 00:00:00,Piedmont Airlines,Landing (descent or approach),Commercial,United States of America,North America,119,5,0,114,0,0,119,Human Factor
1986-10-30 00:00:00,Aeroflot - Russian International Airlines,Flight,Commercial,Mongolia,Asia,0,0,0,0,0,0,0,Other
1986-11-02 00:00:00,Jack R. Matison,Flight,Business,United States of America,North America,1,1,0,0,0,0,1,Technical Failure
1986-11-04 00:00:00,William E. Sandman Associates,Landing (descent or approach),Business,United States of America,North America,2,1,0,1,0,0,2,Human Factor
1986-11-08 00:00:00,American Aviation,Landing (descent or approach),Business,United States of America,North America,1,1,0,0,0,0,1,Unknown
1986-11-12 00:00:00,ACE Air Cargo Express,Landing (descent or approach),Operational,United States of America,North America,1,1,0,0,0,0,1,Technical Failure
1986-11-17 00:00:00,Private Colombian,Flight,Humanitarian,Costa Rica,Central America,4,1,0,3,0,0,4,Unknown
1986-11-17 00:00:00,Carga Aérea Dominicana,Landing (descent or approach),Operational,Bahamas,Central America,3,3,0,0,0,0,3,Technical Failure
1986-11-23 00:00:00,Aeroflot - Russian International Airlines,Landing (descent or approach),Commercial,Russia,Asia,0,0,0,0,0,0,0,Human Factor
1986-11-27 00:00:00,Aerosucre Colombia,Takeoff (climb),Operational,Colombia,South America,4,4,0,0,0,0,4,Technical Failure
1986-11-30 00:00:00,Jetstream International Airlines,Parking,Commercial,United States of America,North America,0,0,0,0,0,0,0,Human Factor
1986-11-30 00:00:00,Gary Miller Leasing,Taxiing,Business,United States of America,North America,2,1,0,1,0,0,2,Unknown
1986-12-06 00:00:00,Paul C. Van Alstyne,Landing (descent or approach),Business,United States of America,North America,3,1,0,2,0,0,3,Human Factor
1986-12-07 00:00:00,MAP - Ministerstvo Aviatsionnoi Promyshlennosti - Minaviaprom,Landing (descent or approach),Operational,Russia,Asia,5,5,0,0,0,0,5,Human Factor
1986-12-10 00:00:00,Syncrude Canada,Landing (descent or approach),Business,Canada,North America,4,1,0,3,0,0,4,Human Factor
1986-12-12 00:00:00,Central Air Charter,Flight,Operational,United States of America,North America,1,1,0,0,0,0,1,Human Factor
1986-12-15 00:00:00,Guyana Defence Force,Flight,Military / Government,Guyana,South America,0,0,0,0,0,0,0,Unknown
1986-12-16 00:00:00,Whitby Airways,Landing (descent or approach),Business,Canada,North America,2,2,0,0,0,0,2,Unknown
1986-12-17 00:00:00,Nahanni Air Services,Landing (descent or approach),Operational,Canada,North America,1,1,0,0,0,0,1,Human Factor
1986-12-17 00:00:00,Latin Air Services,Flight,Operational,World,World,3,3,0,0,0,0,3,Unknown
1986-12-23 00:00:00,West Coast Air Cargo,Flight,Operational,World,World,2,2,0,0,0,0,2,Technical Failure
1986-12-23 00:00:00,Aeroflot - Russian International Airlines,Takeoff (climb),Commercial,Russia,Asia,0,0,0,0,0,0,0,Other
1986-12-24 00:00:00,Kansas City Aviation,Landing (descent or approach),Business,United States of America,North America,1,1,0,0,0,0,1,Human Factor
1986-12-31 00:00:00,Aeroflot - Russian International Airlines,Taxiing,Commercial,Russia,Asia,0,0,0,0,0,0,0,Unknown
1987-01-06 00:00:00,Transwede,Takeoff (climb),Commercial,Sweden,Europe,27,6,0,21,0,0,27,Human Factor
1987-01-07 00:00:00,Corporate Air - USA,Landing (descent or approach),Commercial,United States of America,North America,6,1,0,5,0,0,6,Human Factor
1987-01-07 00:00:00,Kinair Cargo,Flight,Operational,Democratic Republic of Congo,Africa,3,3,0,0,0,0,3,Technical Failure
1987-01-10 00:00:00,Nigeria Airways,Landing (descent or approach),Operational,Nigeria,Africa,9,9,0,0,0,0,9,Human Factor
1987-01-13 00:00:00,Mid Pacific Air,Flight,Operational,United States of America,North America,3,3,0,0,0,0,3,Human Factor
1987-01-18 00:00:00,British Midland Airways - BMA,Landing (descent or approach),Operational,United Kingdom,Europe,3,3,0,0,0,0,3,Human Factor
1987-01-23 00:00:00,MIAT Mongolian Airlines - Mongolyn Irgeniy Agaaryn Teever,Landing (descent or approach),Commercial,Mongolia,Asia,0,0,0,0,0,0,0,Unknown
1987-01-25 00:00:00,Aeroflot - Russian International Airlines,Takeoff (climb),Commercial,Russia,Asia,26,4,0,22,0,0,26,Technical Failure
1987-01-27 00:00:00,Brasil Central - Linha Aérea Regional,Landing (descent or approach),Operational,Brazil,South America,2,2,0,0,0,0,2,Unknown
1987-01-28 00:00:00,SouthCentral Air,Landing (descent or approach),Operational,United States of America,North America,1,1,0,0,0,0,1,Human Factor
1987-02-02 00:00:00,Transportes Aéreos San Miguel - TASMI,Flight,Operational,Bolivia,South America,5,3,0,2,0,0,5,Technical Failure
1987-02-05 00:00:00,RFG Regionalflug,Landing (descent or approach),Commercial,Germany,Europe,14,2,0,12,0,0,14,Human Factor
1987-02-07 00:00:00,First Texas Turbine Aircraft,Takeoff (climb),Business,United States of America,North America,1,1,0,0,0,0,1,Human Factor
1987-02-07 00:00:00,Inter Atoll Air,Landing (descent or approach),Commercial,Maldives,Asia,16,2,0,14,0,0,16,Unknown
1987-02-07 00:00:00,Aeroflot - Russian International Airlines,Landing (descent or approach),Operational,Russia,Asia,0,0,0,0,0,0,0,Unknown
1987-02-09 00:00:00,Aviation West,Landing (descent or approach),Operational,United Kingdom,Europe,1,1,0,0,0,0,1,Technical Failure
1987-02-13 00:00:00,United States Air Force - USAF,Landing (descent or approach),Operational,United States of America,North America,7,7,0,0,0,0,7,Technical Failure
1987-02-15 00:00:00,Yung Shing Airlines,,Commercial,Taiwan,Asia,0,0,0,0,0,0,0,Unknown
1987-02-23 00:00:00,Scandinavian Airlines System - SAS,Landing (descent or approach),Commercial,Norway,Europe,107,4,0,103,0,0,107,Human Factor
1987-03-03 00:00:00,Phoenix Air - USA,Flight,Business,United States of America,North America,1,1,0,0,0,0,1,Unknown
1987-03-08 00:00:00,Cooper Skybird Aircharters,Takeoff (climb),Commercial,Kenya,Africa,9,1,0,8,0,0,9,Technical Failure
1987-03-12 00:00:00,Air Parcel Express,Flight,Operational,United States of America,North America,1,1,0,0,0,0,1,Human Factor
1987-03-13 00:00:00,Soviet Air Force - Voyenno-vozdushnye sily CCCP,Landing (descent or approach),Operational,Ethiopia,Africa,9,9,0,0,0,0,9,Human Factor
1987-03-20 00:00:00,Birk Leasing,Landing (descent or approach),Operational,United States of America,North America,2,2,0,0,0,0,2,Human Factor
1987-04-11 00:00:00,Transbrasil,Landing (descent or approach),Operational,Brazil,South America,7,3,0,4,0,0,7,Human Factor
1987-04-12 00:00:00,John A. Schwamm,Flight,Business,United States of America,North America,3,1,0,2,0,0,3,Human Factor
1987-04-12 00:00:00,Provincetown-Boston Airline - PBA,Landing (descent or approach),Commercial,United States of America,North America,9,1,0,8,0,0,9,Technical Failure
1987-04-13 00:00:00,Air Works India,Takeoff (climb),Commercial,India,Asia,33,5,0,28,0,0,33,Human Factor
1987-04-13 00:00:00,Air Works India,Takeoff (climb),Commercial,India,Asia,33,5,0,28,0,0,33,Human Factor
1987-04-15 00:00:00,Taiwan Airlines,,Commercial,Taiwan,Asia,0,0,0,0,0,0,0,Unknown
1987-04-15 00:00:00,Taiwan Airlines,,Commercial,Taiwan,Asia,0,0,0,0,0,0,0,Unknown
1987-04-18 00:00:00,Air-Glaciers,Flight,Humanitarian,Italy,Europe,1,1,0,0,0,0,1,Unknown
1987-04-20 00:00:00,Billcoin Systems,Landing (descent or approach),Business,Denmark,Europe,4,1,0,3,0,0,4,Technical Failure
1987-04-20 00:00:00,PropAir,Landing (descent or approach),Commercial,Canada,North America,5,1,0,4,0,0,5,Weather
1987-04-24 00:00:00,Aeroflot - Russian International Airlines,Landing (descent or approach),Specialised Services,Russia,Asia,9,5,0,4,0,0,9,Other
1987-04-24 00:00:00,Aeroflot - Russian International Airlines,Flight,Commercial,Russia,Asia,0,0,0,0,0,0,0,Human Factor
1987-04-27 00:00:00,Royal Oman Police,Flight,Operational,Oman,Asia,7,2,0,5,0,0,7,Unknown
1987-04-28 00:00:00,Thai Airways International,Landing (descent or approach),Commercial,Thailand,Asia,43,4,0,39,0,0,43,Human Factor
1987-04-29 00:00:00,Inter Island Air,Landing (descent or approach),Operational,United States of America,North America,1,1,0,0,0,0,1,Human Factor
1987-05-04 00:00:00,Private British,Landing (descent or approach),Business,United Kingdom,Europe,4,1,0,3,0,0,4,Human Factor
1987-05-06 00:00:00,Aeroflot - Russian International Airlines,Takeoff (climb),Military / Government,Russia,Asia,2,2,0,0,0,0,2,Human Factor
1987-05-07 00:00:00,TAM Paraguay - Transporte Aéreo Militar,,Military / Government,Paraguay,South America,0,0,0,0,0,0,0,Unknown
1987-05-08 00:00:00,Frigorifico Reyes,Landing (descent or approach),Operational,Bolivia,South America,3,3,0,0,0,0,3,Technical Failure
1987-05-12 00:00:00,Streamline Aviation,Takeoff (climb),Commercial,United Kingdom,Europe,9,2,0,7,0,0,9,Technical Failure
1987-05-13 00:00:00,Northern Pacific Transport,Landing (descent or approach),Operational,United States of America,North America,5,2,0,3,0,0,5,Human Factor
1987-05-15 00:00:00,Aeroflot - Russian International Airlines,Flight,Military / Government,Russia,Asia,0,0,0,0,0,0,0,Human Factor
1987-05-19 00:00:00,Aeroflot - Russian International Airlines,Flight,Military / Government,Russia,Asia,0,0,0,0,0,0,0,Human Factor
1987-05-22 00:00:00,Aeroflot - Russian International Airlines,Flight,Military / Government,Latvia,Europe,0,0,0,0,0,0,0,Technical Failure
1987-05-26 00:00:00,Continental Express,Takeoff (climb),Commercial,United States of America,North America,11,2,0,9,0,0,11,Human Factor
1987-05-27 00:00:00,Kachina Energy,Flight,Business,United States of America,North America,2,1,0,1,0,0,2,Human Factor
1987-05-27 00:00:00,Aeroflot - Russian International Airlines,Flight,Business,Sweden,Europe,1,1,0,0,0,0,1,Unknown
1987-05-31 00:00:00,Aeroflot - Russian International Airlines,Takeoff (climb),Commercial,Russia,Asia,0,0,0,0,0,0,0,Technical Failure
1987-06-04 00:00:00,Diamond Aviation,Landing (descent or approach),Commercial,Canada,North America,0,0,0,0,0,0,0,Human Factor
1987-06-08 00:00:00,James B. Hayton,Takeoff (climb),Business,United States of America,North America,1,1,0,0,0,0,1,Human Factor
1987-06-09 00:00:00,Alaska Airlines,Taxiing,Commercial,United States of America,North America,2,2,0,0,0,0,2,Human Factor
1987-06-09 00:00:00,Aeroflot - Russian International Airlines,Flight,Military / Government,Ukraine,Europe,0,0,0,0,0,0,0,Human Factor
1987-06-10 00:00:00,Sultan of Oman Air Force,,Military / Government,Oman,Asia,0,0,0,0,0,0,0,Unknown
1987-06-13 00:00:00,Athabaska Airways,Landing (descent or approach),Commercial,Canada,North America,9,2,0,7,0,0,9,Human Factor
1987-06-15 00:00:00,Aeroflot - Russian International Airlines,Flight,Commercial,Russia,Asia,0,0,0,0,0,0,0,Weather
1987-06-16 00:00:00,Calm Air International,Landing (descent or approach),Operational,Canada,North America,4,4,0,0,0,0,4,Human Factor
1987-06-16 00:00:00,Brazilian Air Force - Força Aérea Brasileira,Flight,Military / Government,Brazil,South America,9,2,0,7,0,0,9,Technical Failure
1987-06-16 00:00:00,CAMBA Transportes Aéreos - Comercializadora Aérea Mixta Boliviana,Landing (descent or approach),Operational,Bolivia,South America,3,3,0,0,0,0,3,Technical Failure
1987-06-17 00:00:00,Soviet Navy - Voyenno-morskoy flot CCCP,Landing (descent or approach),Operational,Ukraine,Europe,4,4,0,0,0,0,4,Human Factor
1987-06-17 00:00:00,Aeroflot - Russian International Airlines,Landing (descent or approach),Commercial,Tajikistan,Asia,0,0,0,0,0,0,0,Unknown
1987-06-19 00:00:00,Aeroflot - Russian International Airlines,Flight,Military / Government,Ukraine,Europe,0,0,0,0,0,0,0,Human Factor
1987-06-23 00:00:00,Transportes Aéreos Mercantiles Ecuatorianos - TAME,Landing (descent or approach),Commercial,Ecuador,South America,38,4,0,34,0,0,38,Technical Failure
1987-06-23 00:00:00,Barry D. Tidwell,Landing (descent or approach),Business,United States of America,North America,1,1,0,0,0,0,1,Human Factor
1987-06-24 00:00:00,Midwest Energy Development,Taxiing,Business,United States of America,North America,2,1,0,1,0,0,2,Human Factor
1987-06-24 00:00:00,Falkland Islands Government Air Service - FIGAS,Takeoff (climb),Commercial,Falkland Islands,South America,6,1,0,5,0,0,6,Technical Failure
1987-07-01 00:00:00,Aeroflot - Russian International Airlines,Flight,Military / Government,Russia,Asia,2,2,0,0,0,0,2,Human Factor
1987-07-05 00:00:00,Aeroflot - Russian International Airlines,Flight,Operational,Russia,Asia,0,0,0,0,0,0,0,Human Factor
1987-07-10 00:00:00,Arizona Air Power,Flight,Operational,United States of America,North America,2,1,0,1,0,0,2,Technical Failure
1987-07-10 00:00:00,Aviatia Utilitara,Flight,Military / Government,Romania,Europe,0,0,0,0,0,0,0,Unknown
1987-07-13 00:00:00,Miller Flying Service,Takeoff (climb),Operational,United States of America,North America,1,1,0,0,0,0,1,Human Factor
1987-07-15 00:00:00,Casair Aviation,Takeoff (climb),Commercial,United Kingdom,Europe,4,2,0,2,0,0,4,Technical Failure
1987-07-20 00:00:00,Air Safaris %26 Services,Takeoff (climb),Operational,New Zealand,Oceania,1,1,0,0,0,0,1,Human Factor
1987-07-20 00:00:00,Aeroflot - Russian International Airlines,Landing (descent or approach),Commercial,Russia,Asia,0,0,0,0,0,0,0,Human Factor
1987-07-22 00:00:00,Donald A. Henke,Takeoff (climb),Business,United States of America,North America,1,1,0,0,0,0,1,Human Factor
1987-07-25 00:00:00,Rio-Sul Serviços Aéreos Regionais,Landing (descent or approach),Commercial,Brazil,South America,13,3,0,10,0,0,13,Human Factor
1987-07-27 00:00:00,James L. Leverenz,Landing (descent or approach),Operational,United States of America,North America,2,1,0,1,0,0,2,Technical Failure
1987-07-28 00:00:00,La Mesa Leasing,Takeoff (climb),Operational,United States of America,North America,2,2,0,0,0,0,2,Other
1987-07-29 00:00:00,Zimex Aviation,Flight,Humanitarian,Switzerland,Europe,9,1,0,8,0,0,9,Technical Failure
1987-07-31 00:00:00,Aeroflot - Russian International Airlines,Landing (descent or approach),Commercial,Russia,Asia,2,2,0,0,0,0,2,Weather
1987-07-31 00:00:00,Perimeter Aviation,Takeoff (climb),Commercial,Canada,North America,5,1,0,4,0,0,5,Technical Failure
1987-07-31 00:00:00,Agricultural Aviation,Flight,Military / Government,South Sudan,Africa,1,1,0,0,0,0,1,Unknown
1987-08-06 00:00:00,MIAT Mongolian Airlines - Mongolyn Irgeniy Agaaryn Teever,,Commercial,Mongolia,Asia,0,0,0,0,0,0,0,Unknown
1987-08-08 00:00:00,Libyan Air Force - Al Quwwat Al-Jawwiya Al Libiyya,Landing (descent or approach),Military / Government,Libya,Africa,0,0,0,0,0,0,0,Human Factor
1987-08-14 00:00:00,Aeroflot - Russian International Airlines,Landing (descent or approach),Commercial,Russia,Asia,0,0,0,0,0,0,0,Unknown
1987-08-16 00:00:00,OPS Leasing Company,Landing (descent or approach),Business,United States of America,North America,2,1,0,1,0,0,2,Technical Failure
1987-08-17 00:00:00,Aeroflot - Russian International Airlines,Flight,Commercial,Russia,Asia,18,2,0,16,0,0,18,Human Factor
1987-08-21 00:00:00,Air Furness,Flight,Operational,United Kingdom,Europe,1,1,0,0,0,0,1,Human Factor
1987-08-22 00:00:00,Aeroflot - Russian International Airlines,Flight,Commercial,Russia,Asia,14,2,0,12,0,0,14,Technical Failure
1987-08-24 00:00:00,Aeroflot - Russian International Airlines,Takeoff (climb),Commercial,Kazakhstan,Asia,0,0,0,0,0,0,0,Human Factor
1987-08-28 00:00:00,Aeroflot - Russian International Airlines,Flight,Commercial,Ukraine,Europe,0,0,0,0,0,0,0,Other
1987-09-04 00:00:00,Martinaire,Flight,Operational,United States of America,North America,1,1,0,0,0,0,1,Technical Failure
1987-09-07 00:00:00,Aeroflot - Russian International Airlines,Landing (descent or approach),Operational,Russia,Asia,0,0,0,0,0,0,0,Unknown
1987-09-09 00:00:00,ZUA - Zakładu Usług Agrolotniczych - AET Agroaviation Services,Flight,Military / Government,Ethiopia,Africa,0,0,0,0,0,0,0,Unknown
1987-09-11 00:00:00,El Tres Petroleum Corporation,Landing (descent or approach),Business,United States of America,North America,1,1,0,0,0,0,1,Human Factor
1987-09-14 00:00:00,Cal Aero Aircraft Sales,Takeoff (climb),Business,United States of America,North America,2,1,0,1,0,0,2,Human Factor
1987-09-17 00:00:00,J-Lyte,Landing (descent or approach),Humanitarian,United States of America,North America,2,1,0,1,0,0,2,Human Factor
1987-09-18 00:00:00,Borealis Exploration,Flight,Business,Canada,North America,0,0,0,0,0,0,0,Unknown
1987-09-20 00:00:00,South African Air Force,Flight,Military / Government,South Africa,Africa,3,3,0,0,0,0,3,Technical Failure
1987-09-24 00:00:00,Horizon Air,Takeoff (climb),Operational,United States of America,North America,3,3,0,0,0,0,3,Human Factor
1987-09-24 00:00:00,Aeroflot - Russian International Airlines,Takeoff (climb),Operational,Russia,Asia,3,3,0,0,0,0,3,Technical Failure
1987-09-26 00:00:00,Africair,Flight,Commercial,Nigeria,Africa,4,1,0,3,0,0,4,Unknown
1987-09-30 00:00:00,Avantair,Landing (descent or approach),Operational,United States of America,North America,1,1,0,0,0,0,1,Technical Failure
1987-09-30 00:00:00,Air Truck,Landing (descent or approach),Operational,Spain,Europe,2,2,0,0,0,0,2,Human Factor
1987-09-30 00:00:00,MAP - Ministerstvo Aviatsionnoi Promyshlennosti - Minaviaprom,Parking,Military / Government,Russia,Asia,0,0,0,0,0,0,0,Technical Failure
1987-10-03 00:00:00,Aeroflot - Russian International Airlines,Takeoff (climb),Commercial,Russia,Asia,0,0,0,0,0,0,0,Human Factor
1987-10-04 00:00:00,Aeroflot - Russian International Airlines,Flight,Commercial,Uzbekistan,Asia,0,0,0,0,0,0,0,Technical Failure
1987-10-08 00:00:00,Mid-America Air,Landing (descent or approach),Business,United States of America,North America,2,1,0,1,0,0,2,Human Factor
1987-10-11 00:00:00,Drenair,Flight,Operational,Iceland,Europe,6,2,0,4,0,0,6,Technical Failure
1987-10-14 00:00:00,Aeroflot - Russian International Airlines,Takeoff (climb),Commercial,Russia,Asia,0,0,0,0,0,0,0,Human Factor
1987-10-15 00:00:00,Live Air,,Military / Government,Mali,Africa,0,0,0,0,0,0,0,Unknown
1987-10-18 00:00:00,Aeroflot - Russian International Airlines,Flight,Commercial,Russia,Asia,0,0,0,0,0,0,0,Technical Failure
1987-10-20 00:00:00,Tanzanair - Tanzanian Air Services,Flight,Commercial,Tanzania,Africa,1,1,0,0,0,0,1,Technical Failure
1987-10-28 00:00:00,SMB Stage Line,Landing (descent or approach),Operational,United States of America,North America,2,2,0,0,0,0,2,Human Factor
1987-11-09 00:00:00,Aeroflot - Russian International Airlines,Takeoff (climb),Commercial,Russia,Asia,0,0,0,0,0,0,0,Human Factor
1987-11-15 00:00:00,JAT Agricultural Aviation,Flight,Military / Government,Croatia,Europe,0,0,0,0,0,0,0,Unknown
1987-11-16 00:00:00,Chadian Air Force - Force Aérienne Tchadienne,Landing (descent or approach),Military / Government,Chad,Africa,0,0,0,0,0,0,0,Unknown
1987-11-18 00:00:00,Papua New Guinea Defence Force,Takeoff (climb),Military / Government,Papua New Guinea,Oceania,0,0,0,0,0,0,0,Technical Failure
1987-11-18 00:00:00,Argentinian Air Force - Fuerza Aérea Argentina,Landing (descent or approach),Operational,Argentina,South America,2,2,0,0,0,0,2,Unknown
1987-11-19 00:00:00,Connie Kalitta Services,Flight,Operational,United States of America,North America,1,1,0,0,0,0,1,Human Factor
1987-11-19 00:00:00,Air Carelia,Landing (descent or approach),Commercial,Finland,Europe,6,2,0,4,0,0,6,Human Factor
1987-11-20 00:00:00,Panorama Air Tour,Landing (descent or approach),Commercial,United States of America,North America,6,1,0,5,0,0,6,Human Factor
1987-11-21 00:00:00,TAM Paraguay - Transporte Aéreo Militar,,Military / Government,Paraguay,South America,0,0,0,0,0,0,0,Unknown
1987-11-22 00:00:00,Compagnie Aérienne du Languedoc,Landing (descent or approach),Operational,France,Europe,2,2,0,0,0,0,2,Weather
1987-11-27 00:00:00,Marcel Georgi,Landing (descent or approach),Business,Mexico,Central America,2,1,0,1,0,0,2,Unknown
1987-12-01 00:00:00,Israeli Air Force - Heyl Ha'avir,Landing (descent or approach),Operational,Israel,Asia,0,0,0,0,0,0,0,Technical Failure
1987-12-03 00:00:00,Air Continental,Landing (descent or approach),Operational,United States of America,North America,1,1,0,0,0,0,1,Technical Failure
1987-12-07 00:00:00,Nicole Corporation,Landing (descent or approach),Operational,United States of America,North America,2,2,0,0,0,0,2,Technical Failure
1987-12-07 00:00:00,Richard R. Hough,Landing (descent or approach),Business,United States of America,North America,1,1,0,0,0,0,1,Human Factor
1987-12-07 00:00:00,Thai Airways International,Landing (descent or approach),Commercial,Thailand,Asia,0,0,0,0,0,0,0,Human Factor
1987-12-08 00:00:00,Transportes Aéreos San Miguel - TASMI,Takeoff (climb),Commercial,Bolivia,South America,0,0,0,0,0,0,0,Unknown
1987-12-09 00:00:00,Wilbur's Flight Operations,Landing (descent or approach),Commercial,United States of America,North America,5,1,0,4,0,0,5,Human Factor
1987-12-09 00:00:00,Indian Navy - Bharatiya Nau Sena,Flight,Military / Government,India,Asia,3,3,0,0,0,0,3,Technical Failure
1987-12-12 00:00:00,Aeroflot - Russian International Airlines,Takeoff (climb),Operational,Russia,Asia,0,0,0,0,0,0,0,Other
1987-12-14 00:00:00,Northwest Airlink,Landing (descent or approach),Commercial,United States of America,North America,8,2,0,6,0,0,8,Human Factor
1987-12-15 00:00:00,Co-Air,Flight,Commercial,Papua New Guinea,Oceania,0,0,0,0,0,0,0,Unknown
1987-12-15 00:00:00,Aeroflot - Russian International Airlines,Flight,Commercial,Russia,Asia,0,0,0,0,0,0,0,Unknown
1987-12-18 00:00:00,AVAir - Air Virginia,Landing (descent or approach),Commercial,United States of America,North America,8,2,0,6,0,0,8,Human Factor
1987-12-21 00:00:00,Aeronica - Aerolineas Nicaraguenses,Flight,Operational,Costa Rica,Central America,6,3,0,3,0,0,6,Technical Failure
1987-12-28 00:00:00,Eastern Airlines,Landing (descent or approach),Commercial,United States of America,North America,107,4,0,103,0,0,107,Human Factor
1987-12-28 00:00:00,Ethiopian Airlines,Takeoff (climb),Commercial,Ethiopia,Africa,7,4,0,3,0,0,7,Technical Failure
1987-12-28 00:00:00,Aeroflot - Russian International Airlines,Takeoff (climb),Commercial,Russia,Asia,0,0,0,0,0,0,0,Other
1987-12-29 00:00:00,Chemical Financial Corporation,Landing (descent or approach),Business,United States of America,North America,6,1,0,5,0,0,6,Human Factor
1987-12-31 00:00:00,Aero Taxco,,Commercial,Mexico,Central America,0,0,0,0,0,0,0,Unknown
1988-01-08 00:00:00,TAAG Angola Airlines - Transportes Aéreos de Angola,Landing (descent or approach),Commercial,Angola,Africa,0,0,0,0,0,0,0,Unknown
1988-01-10 00:00:00,TOA Domestic Airlines,Takeoff (climb),Commercial,Japan,Asia,52,4,0,48,0,0,52,Human Factor
1988-01-11 00:00:00,British Air Ferries - BAF,Parking,Commercial,United Kingdom,Europe,0,0,0,0,0,0,0,Human Factor
1988-01-11 00:00:00,Fairflight,Taxiing,Operational,United Kingdom,Europe,2,2,0,0,0,0,2,Human Factor
1988-01-12 00:00:00,Air Toronto,Landing (descent or approach),Commercial,Canada,North America,3,2,0,1,0,0,3,Unknown
1988-01-15 00:00:00,Segas International,Takeoff (climb),Operational,Switzerland,Europe,2,2,0,0,0,0,2,Human Factor
1988-01-19 00:00:00,Mountain Air Cargo,Landing (descent or approach),Operational,United States of America,North America,1,1,0,0,0,0,1,Human Factor
1988-01-21 00:00:00,Transportes Aéreos Regionais da Bacia Amazônica - TABA,Landing (descent or approach),Commercial,Brazil,South America,13,2,0,11,0,0,13,Human Factor
1988-01-29 00:00:00,Inter Cargo Services - ICS,Takeoff (climb),Operational,France,Europe,4,3,0,1,0,0,4,Technical Failure
1988-01-29 00:00:00,Aeroflot - Russian International Airlines,Flight,Business,Kazakhstan,Asia,0,0,0,0,0,0,0,Human Factor
1988-02-01 00:00:00,Nevada Flyco,Landing (descent or approach),Business,United States of America,North America,9,2,0,7,0,0,9,Other
1988-02-02 00:00:00,Aspen Airways,Landing (descent or approach),Commercial,United States of America,North America,41,3,0,38,0,0,41,Other
1988-02-08 00:00:00,Royal Thai Air Force - Kong Thap Akat Thai,Landing (descent or approach),Military / Government,Thailand,Asia,0,0,0,0,0,0,0,Unknown
1988-02-08 00:00:00,TAAG Angola Airlines - Transportes Aéreos de Angola,Landing (descent or approach),Operational,Angola,Africa,9,9,0,0,0,0,9,Human Factor
1988-02-11 00:00:00,United States Air Force - USAF,Takeoff (climb),Military / Government,United States of America,North America,0,0,0,0,0,0,0,Unknown
1988-02-17 00:00:00,Vietnam Airlines,Landing (descent or approach),Commercial,Vietnam,Asia,0,0,0,0,0,0,0,Unknown
1988-02-26 00:00:00,Aeroflot - Russian International Airlines,Landing (descent or approach),Commercial,Russia,Asia,0,0,0,0,0,0,0,Unknown
1988-02-26 00:00:00,Aeroflot - Russian International Airlines,Takeoff (climb),Commercial,Ukraine,Europe,0,0,0,0,0,0,0,Technical Failure
1988-02-27 00:00:00,Aeroflot - Russian International Airlines,Takeoff (climb),Commercial,Russia,Asia,0,0,0,0,0,0,0,Technical Failure
1988-03-25 00:00:00,American Eagle,Landing (descent or approach),Operational,United States of America,North America,2,2,0,0,0,0,2,Human Factor
1988-03-26 00:00:00,Fontenay Air Service,Landing (descent or approach),Commercial,France,Europe,8,1,0,7,0,0,8,Unknown
1988-04-08 00:00:00,Lands Edge,Landing (descent or approach),Operational,United States of America,North America,1,1,0,0,0,0,1,Technical Failure
1988-04-12 00:00:00,Aeroflot - Russian International Airlines,Takeoff (climb),Operational,Turkmenistan,Asia,0,0,0,0,0,0,0,Human Factor
1988-04-13 00:00:00,Aeroflot - Russian International Airlines,Flight,Commercial,Kazakhstan,Asia,0,0,0,0,0,0,0,Weather
1988-04-16 00:00:00,Horizon Air,Landing (descent or approach),Commercial,United States of America,North America,40,3,0,37,0,0,40,Technical Failure
1988-04-18 00:00:00,Aeroflot - Russian International Airlines,Flight,Commercial,Russia,Asia,0,0,0,0,0,0,0,Weather
1988-04-27 00:00:00,Helicopters Unlimited,Landing (descent or approach),Operational,United States of America,North America,1,1,0,0,0,0,1,Technical Failure
1988-04-29 00:00:00,Aero Taxi Rockford,Landing (descent or approach),Operational,United States of America,North America,1,1,0,0,0,0,1,Technical Failure
1988-05-05 00:00:00,Federal Border Guard Aviation Command,Landing (descent or approach),Humanitarian,Russia,Asia,0,0,0,0,0,0,0,Weather
1988-05-12 00:00:00,Pacific Coastal Airlines - PCA,Takeoff (climb),Commercial,Canada,North America,7,1,0,6,0,0,7,Weather
1988-05-15 00:00:00,Celanese Mexicana,Landing (descent or approach),Business,Mexico,Central America,0,0,0,0,0,0,0,Unknown
1988-05-16 00:00:00,Avex Air Transport,Flight,Military / Government,South Africa,Africa,0,0,0,0,0,0,0,Unknown
1988-05-17 00:00:00,Mexican Air Force - Fuerza Aérea Mexicana,Flight,Operational,Mexico,Central America,3,3,0,0,0,0,3,Unknown
1988-05-19 00:00:00,ZUA - Zakładu Usług Agrolotniczych - AET Agroaviation Services,Flight,Military / Government,Poland,Europe,0,0,0,0,0,0,0,Unknown
1988-05-20 00:00:00,Safcol Seafoods,Landing (descent or approach),Commercial,Australia,Oceania,3,1,0,2,0,0,3,Human Factor
1988-05-21 00:00:00,American Airlines,Takeoff (climb),Commercial,United States of America,North America,254,14,0,240,0,0,254,Technical Failure
1988-05-23 00:00:00,Lineas Aéreas Costarricenses - LACSA,Takeoff (climb),Commercial,Costa Rica,Central America,26,10,0,16,0,0,26,Human Factor
1988-05-24 00:00:00,Atlantic Southeast Airlines - ASA,Takeoff (climb),Commercial,United States of America,North America,8,2,0,6,0,0,8,Technical Failure
1988-05-31 00:00:00,Aeroflot - Russian International Airlines,Flight,Military / Government,Russia,Asia,0,0,0,0,0,0,0,Human Factor
1988-06-04 00:00:00,Brazilian Air Force - Força Aérea Brasileira,Takeoff (climb),Military / Government,Brazil,South America,6,6,0,0,0,0,6,Unknown
1988-06-07 00:00:00,Keenair Warbirds West,Landing (descent or approach),Operational,United Kingdom,Europe,2,2,0,0,0,0,2,Technical Failure
1988-06-10 00:00:00,Air Today,Landing (descent or approach),Operational,United States of America,North America,1,1,0,0,0,0,1,Technical Failure
1988-06-12 00:00:00,Aeroflot - Russian International Airlines,Flight,Commercial,Ukraine,Europe,15,2,0,13,0,0,15,Technical Failure
1988-06-15 00:00:00,Maraven Oil Company,Landing (descent or approach),Business,Venezuela,South America,0,0,0,0,0,0,0,Other
1988-06-17 00:00:00,Samoa Aviation,Landing (descent or approach),Commercial,Samoa Islands (Western Samoa),Oceania,16,2,0,14,0,0,16,Human Factor
1988-06-17 00:00:00,ATR Industries - Avion de Transport Régional,Takeoff (climb),Specialised Services,France,Europe,3,3,0,0,0,0,3,Unknown
1988-06-19 00:00:00,Indian Airlines,Landing (descent or approach),Commercial,India,Asia,134,6,0,128,0,0,134,Human Factor
1988-06-21 00:00:00,Trans-Provincial Airlines - TPA,Landing (descent or approach),Operational,Canada,North America,3,3,0,0,0,0,3,Unknown
1988-06-24 00:00:00,Aeroflot - Russian International Airlines,Flight,Military / Government,Kazakhstan,Asia,0,0,0,0,0,0,0,Human Factor
1988-06-29 00:00:00,Darryl G. Greenmayer,Takeoff (climb),Business,United States of America,North America,2,2,0,0,0,0,2,Technical Failure
1988-06-29 00:00:00,Aerolineas El Salvador - AESA,Takeoff (climb),Operational,Salvador,Central America,2,2,0,0,0,0,2,Unknown
1988-07-01 00:00:00,Agrohemizacija,Flight,Military / Government,Macedonia,Europe,0,0,0,0,0,0,0,Unknown
1988-07-03 00:00:00,De Havilland Aircraft of Canada,Landing (descent or approach),Operational,Canada,North America,1,1,0,0,0,0,1,Human Factor
1988-07-04 00:00:00,Aeroflot - Russian International Airlines,Takeoff (climb),Commercial,Russia,Asia,0,0,0,0,0,0,0,Weather
1988-07-04 00:00:00,Bouraq Indonesia Airlines,Landing (descent or approach),Commercial,Indonesia,Asia,76,5,0,71,0,0,76,Human Factor
1988-07-08 00:00:00,Aeroflot - Russian International Airlines,Takeoff (climb),Commercial,Russia,Asia,46,5,0,41,0,0,46,Unknown
1988-07-09 00:00:00,Aeroflot - Russian International Airlines,Flight,Military / Government,Russia,Asia,2,2,0,0,0,0,2,Human Factor
1988-07-10 00:00:00,Kenya Airways,Landing (descent or approach),Commercial,Kenya,Africa,43,4,0,39,0,0,43,Human Factor
1988-07-12 00:00:00,United States Navy - USN,Flight,Military / Government,World,World,4,4,0,0,0,0,4,Technical Failure
1988-07-14 00:00:00,Andrew Harris,Landing (descent or approach),Business,Australia,Oceania,2,1,0,1,0,0,2,Human Factor
1988-08-09 00:00:00,Lag Air,Landing (descent or approach),Commercial,Bahamas,Central America,8,1,0,7,0,0,8,Unknown
1988-08-11 00:00:00,Aeroflot - Russian International Airlines,Flight,Military / Government,Ukraine,Europe,0,0,0,0,0,0,0,Human Factor
1988-08-12 00:00:00,Aeroflot - Russian International Airlines,Flight,Commercial,Ukraine,Europe,0,0,0,0,0,0,0,Human Factor
1988-08-15 00:00:00,City Air,Landing (descent or approach),Commercial,South Africa,Africa,8,1,0,7,0,0,8,Technical Failure
1988-08-20 00:00:00,Polynesian Airline of Samoa - Polynesian Airlines,Landing (descent or approach),Commercial,Samoa Islands (Western Samoa),Oceania,0,0,0,0,0,0,0,Unknown
1988-08-27 00:00:00,Trans World Airlines - TWA,Landing (descent or approach),Commercial,United States of America,North America,68,6,0,62,0,0,68,Technical Failure
1988-08-30 00:00:00,Aeroklub Polskiej Rzeczypospolitej Ludowej - APRL,,Commercial,Sudan,Africa,0,0,0,0,0,0,0,Unknown
1988-09-06 00:00:00,TAM Brasil - Taxi Aéreo Marilia - Transportes Aéreos Regionais,Landing (descent or approach),Commercial,Brazil,South America,7,2,0,5,0,0,7,Human Factor
1988-09-09 00:00:00,Frigorifico Reyes,Takeoff (climb),Operational,Bolivia,South America,3,3,0,0,0,0,3,Technical Failure
1988-09-13 00:00:00,Dovair,,Commercial,Vanuatu,Oceania,0,0,0,0,0,0,0,Unknown
1988-09-20 00:00:00,Crest Breeders,Takeoff (climb),Operational,Zimbabwe,Africa,3,3,0,0,0,0,3,Technical Failure
1988-09-21 00:00:00,J. R. Acosta,Takeoff (climb),Specialised Services,Colombia,South America,2,2,0,0,0,0,2,Unknown
1988-09-22 00:00:00,Vayudoot,Landing (descent or approach),Commercial,India,Asia,8,3,0,5,0,0,8,Human Factor
1988-09-23 00:00:00,Vayudoot,Taxiing,Commercial,India,Asia,43,4,0,39,0,0,43,Human Factor
1988-09-24 00:00:00,Aeroflot - Russian International Airlines,Landing (descent or approach),Commercial,Syria,Asia,168,10,0,158,0,0,168,Human Factor
1988-09-24 00:00:00,Aeroflot - Russian International Airlines,Landing (descent or approach),Commercial,Russia,Asia,0,0,0,0,0,0,0,Unknown
1988-09-24 00:00:00,Aeroflot - Russian International Airlines,Takeoff (climb),Commercial,Russia,Asia,5,2,0,3,0,0,5,Technical Failure
1988-09-26 00:00:00,Aerolineas Argentinas,Landing (descent or approach),Commercial,Argentina,South America,62,6,0,56,0,0,62,Human Factor
1988-09-30 00:00:00,Aviatia Utilitara,Flight,Military / Government,Romania,Europe,0,0,0,0,0,0,0,Unknown
1988-10-07 00:00:00,Cargair,Flight,Commercial,Canada,North America,0,0,0,0,0,0,0,Unknown
1988-10-08 00:00:00,Air Burkina,Takeoff (climb),Commercial,Burkina Faso,Africa,0,0,0,0,0,0,0,Unknown
1988-10-11 00:00:00,CSA Czech Airlines - Československé Státní Aerolinie,Landing (descent or approach),Commercial,Czech Republic,Europe,0,0,0,0,0,0,0,Unknown
1988-10-14 00:00:00,Private Australian,Landing (descent or approach),Business,Australia,Oceania,1,1,0,0,0,0,1,Human Factor
1988-10-14 00:00:00,Aeroflot - Russian International Airlines,Landing (descent or approach),Commercial,Russia,Asia,14,2,0,12,0,0,14,Human Factor
1988-10-15 00:00:00,Nigeria Airways,Landing (descent or approach),Commercial,Nigeria,Africa,132,8,0,124,0,0,132,Unknown
1988-10-15 00:00:00,ZUA - Zakładu Usług Agrolotniczych - AET Agroaviation Services,Flight,Military / Government,Sudan,Africa,0,0,0,0,0,0,0,Unknown
1988-10-15 00:00:00,Aeroflot - Russian International Airlines,Takeoff (climb),Commercial,Ukraine,Europe,0,0,0,0,0,0,0,Human Factor
1988-10-16 00:00:00,Texas Air Charter,Flight,Commercial,United States of America,North America,7,1,0,6,0,0,7,Other
1988-10-20 00:00:00,Aeroflot - Russian International Airlines,Flight,Commercial,Russia,Asia,0,0,0,0,0,0,0,Human Factor
1988-10-20 00:00:00,Aeroflot - Russian International Airlines,Flight,Commercial,Russia,Asia,0,0,0,0,0,0,0,Technical Failure
1988-10-26 00:00:00,Bahig F. Bishay,Takeoff (climb),Business,United States of America,North America,1,1,0,0,0,0,1,Human Factor
1988-10-31 00:00:00,Aeroflot - Russian International Airlines,Takeoff (climb),Commercial,Russia,Asia,15,2,0,13,0,0,15,Human Factor
1988-11-10 00:00:00,Sunflower Airlines,Landing (descent or approach),Commercial,Fiji Islands,Oceania,10,2,0,8,0,0,10,Unknown
1988-11-13 00:00:00,S. Lubbezoo,Flight,Operational,Germany,Europe,2,2,0,0,0,0,2,Technical Failure
1988-11-17 00:00:00,ZUA - Zakładu Usług Agrolotniczych - AET Agroaviation Services,Flight,Military / Government,Poland,Europe,0,0,0,0,0,0,0,Unknown
1988-11-18 00:00:00,Magnum Airlines,Takeoff (climb),Commercial,South Africa,Africa,12,2,0,10,0,0,12,Technical Failure
1988-11-19 00:00:00,Aeroflot - Russian International Airlines,Landing (descent or approach),Military / Government,Russia,Asia,10,7,0,3,0,0,10,Human Factor
1988-11-20 00:00:00,Buck Hilkert,Landing (descent or approach),Business,United States of America,North America,5,1,0,4,0,0,5,Human Factor
1988-11-20 00:00:00,MOM - Ministerstvo Obshego Mashinostroenia,Landing (descent or approach),Military / Government,Armenia,Asia,0,0,0,0,0,0,0,Human Factor
1988-11-23 00:00:00,Gibraltar Airways,Landing (descent or approach),Commercial,Morocco,Africa,78,4,0,74,0,0,78,Weather
1988-11-25 00:00:00,Israeli Air Force - Heyl Ha'avir,Landing (descent or approach),Military / Government,Israel,Asia,0,0,0,0,0,0,0,Unknown
1988-11-28 00:00:00,Hagfors Flyg,Takeoff (climb),Commercial,Sweden,Europe,6,2,0,4,0,0,6,Weather
1988-12-03 00:00:00,Air Creebec,Landing (descent or approach),Operational,Canada,North America,3,3,0,0,0,0,3,Human Factor
1988-12-06 00:00:00,United States Air Force - USAF,Takeoff (climb),Operational,United States of America,North America,8,8,0,0,0,0,8,Technical Failure
1988-12-13 00:00:00,Aeroflot - Russian International Airlines,Flight,Commercial,Russia,Asia,0,0,0,0,0,0,0,Other
1988-12-19 00:00:00,Elite Leasing,Landing (descent or approach),Business,United States of America,North America,1,1,0,0,0,0,1,Technical Failure
1988-12-19 00:00:00,Philippine Air Force - Hukbong Himpapawid NG Pilipinas,Landing (descent or approach),Military / Government,Philippines,Asia,16,4,0,12,0,0,16,Weather
1988-12-31 00:00:00,Albert T. Gianchiglia,Landing (descent or approach),Business,United States of America,North America,4,1,0,3,0,0,4,Human Factor
1988-12-31 00:00:00,Air Service Hungary - Repülögépes Szolgalat Allami Vallat,Flight,Military / Government,Hungary,Europe,0,0,0,0,0,0,0,Unknown
1988-12-31 00:00:00,Filair,Landing (descent or approach),Commercial,Democratic Republic of Congo,Africa,0,0,0,0,0,0,0,Technical Failure
1988-12-31 00:00:00,Aerochago Airlines,Landing (descent or approach),Operational,Dominican Republic,Central America,0,0,0,0,0,0,0,Unknown
1989-01-03 00:00:00,A. R. Leasing R. Werjefelt,Landing (descent or approach),Business,Sweden,Europe,1,1,0,0,0,0,1,Technical Failure
1989-01-04 00:00:00,Bouraq Indonesia Airlines,Landing (descent or approach),Commercial,Indonesia,Asia,52,5,0,47,0,0,52,Unknown
1989-01-05 00:00:00,Federal Express - FedEx,Landing (descent or approach),Operational,United States of America,North America,2,1,0,1,0,0,2,Human Factor
1989-01-07 00:00:00,Malcolm Jacobs Aviation,Landing (descent or approach),Business,United States of America,North America,3,1,0,2,0,0,3,Human Factor
1989-01-11 00:00:00,Atlantic Aero,Landing (descent or approach),Operational,United States of America,North America,1,1,0,0,0,0,1,Human Factor
1989-01-13 00:00:00,Aeroflot - Russian International Airlines,Takeoff (climb),Operational,Liberia,Africa,6,6,0,0,0,0,6,Other
1989-01-13 00:00:00,Aeroflot - Russian International Airlines,Landing (descent or approach),Operational,Russia,Asia,6,6,0,0,0,0,6,Technical Failure
1989-01-15 00:00:00,United States Navy - USN,Landing (descent or approach),Operational,United States of America,North America,0,0,0,0,0,0,0,Unknown
1989-01-18 00:00:00,Private Mexican,Takeoff (climb),Operational,United States of America,North America,2,2,0,0,0,0,2,Other
1989-01-20 00:00:00,Aspen Airways,Flight,Commercial,United States of America,North America,26,3,0,23,0,0,26,Technical Failure
1989-01-21 00:00:00,Muk Air,Landing (descent or approach),Commercial,Sweden,Europe,17,2,0,15,0,0,17,Technical Failure
1989-01-23 00:00:00,Soviet Air Force - Voyenno-vozdushnye sily CCCP,Landing (descent or approach),Military / Government,Afghanistan,Asia,6,6,0,0,0,0,6,Terrorism
1989-01-27 00:00:00,Wallner %26 Neubert,Landing (descent or approach),Business,Austria,Europe,5,1,0,4,0,0,5,Technical Failure
1989-01-30 00:00:00,Air Entreprise,Landing (descent or approach),Operational,Portugal,Europe,2,2,0,0,0,0,2,Unknown
1989-01-31 00:00:00,Ricardt Investment,Landing (descent or approach),Business,United States of America,North America,2,1,0,1,0,0,2,Technical Failure
1989-02-05 00:00:00,Proteus Petroleum,Flight,Operational,United Kingdom,Europe,1,1,0,0,0,0,1,Technical Failure
1989-02-07 00:00:00,Aeroflot - Russian International Airlines,Taxiing,Commercial,Russia,Asia,0,0,0,0,0,0,0,Unknown
1989-02-08 00:00:00,Aeroflot - Russian International Airlines,Takeoff (climb),Commercial,Russia,Asia,14,2,0,12,0,0,14,Unknown
1989-02-09 00:00:00,Linhas Aéreas de Moçambique - LAM,Landing (descent or approach),Commercial,Mozambique,Africa,108,6,0,102,0,0,108,Other
1989-02-14 00:00:00,Southern Cross Aviation,Flight,Operational,World,World,1,1,0,0,0,0,1,Technical Failure
1989-02-15 00:00:00,Reliant Airlines,Landing (descent or approach),Operational,United States of America,North America,2,2,0,0,0,0,2,Human Factor
1989-02-17 00:00:00,Serv-Jet,Landing (descent or approach),Operational,Brazil,South America,2,2,0,0,0,0,2,Human Factor
1989-02-21 00:00:00,Ethiopian Air Force - Ye Ityopya Ayer Hayl,,Military / Government,Ethiopia,Africa,0,0,0,0,0,0,0,Unknown
1989-02-27 00:00:00,Nynex Corporation,Landing (descent or approach),Operational,United States of America,North America,2,2,0,0,0,0,2,Human Factor
1989-02-27 00:00:00,Aeroflot - Russian International Airlines,Taxiing,Commercial,Kazakhstan,Asia,0,0,0,0,0,0,0,Weather
1989-03-01 00:00:00,Borinquen Air,Landing (descent or approach),Operational,Puerto Rico,Central America,2,2,0,0,0,0,2,Technical Failure
1989-03-03 00:00:00,C. M. Oldenburg,Landing (descent or approach),Business,United States of America,North America,2,1,0,1,0,0,2,Human Factor
1989-03-16 00:00:00,Aeroflot - Russian International Airlines,Flight,Commercial,Russia,Asia,0,0,0,0,0,0,0,Technical Failure
1989-03-19 00:00:00,Soundsair,Landing (descent or approach),Commercial,New Zealand,Oceania,6,1,0,5,0,0,6,Human Factor
1989-03-21 00:00:00,Soviet Air Force - Voyenno-vozdushnye sily CCCP,Flight,Military / Government,Angola,Africa,0,0,0,0,0,0,0,Terrorism
1989-03-24 00:00:00,Aeroflot - Russian International Airlines,Landing (descent or approach),Commercial,Russia,Asia,0,0,0,0,0,0,0,Unknown
1989-03-27 00:00:00,Aeroflot - Russian International Airlines,Landing (descent or approach),Commercial,Ukraine,Europe,0,0,0,0,0,0,0,Unknown
1989-03-27 00:00:00,Royal Saudi Air Force,Takeoff (climb),Military / Government,Saudi Arabia,Asia,0,0,0,0,0,0,0,Unknown
1989-04-01 00:00:00,Philippine Air Force - Hukbong Himpapawid NG Pilipinas,Landing (descent or approach),Military / Government,Philippines,Asia,0,0,0,0,0,0,0,Unknown
1989-04-03 00:00:00,Faucett,Landing (descent or approach),Commercial,Peru,South America,139,6,0,133,0,0,139,Unknown
1989-04-08 00:00:00,Aeroflot - Russian International Airlines,Flight,Commercial,Russia,Asia,0,0,0,0,0,0,0,Technical Failure
1989-04-08 00:00:00,Transafrik,Landing (descent or approach),Operational,Angola,Africa,4,4,0,0,0,0,4,Terrorism
1989-04-13 00:00:00,United States Navy - USN,Flight,Operational,United States of America,North America,2,2,0,0,0,0,2,Human Factor
1989-04-17 00:00:00,Aeroflot - Russian International Airlines,Landing (descent or approach),Commercial,Russia,Asia,0,0,0,0,0,0,0,Unknown
1989-04-20 00:00:00,East German Air Force - Luftstreitkräfte der Nationalen Volksarmee,Landing (descent or approach),Military / Government,Germany,Europe,2,2,0,0,0,0,2,Human Factor
1989-04-22 00:00:00,Aeroflot - Russian International Airlines,Landing (descent or approach),Operational,Russia,Asia,3,3,0,0,0,0,3,Human Factor
1989-04-26 00:00:00,Planemasters,Landing (descent or approach),Operational,United States of America,North America,1,1,0,0,0,0,1,Human Factor
1989-04-29 00:00:00,Raymond E. Wooldridge,Landing (descent or approach),Business,Bahamas,Central America,2,1,0,1,0,0,2,Unknown
1989-05-03 00:00:00,Private Icelandic,Landing (descent or approach),Business,Norway,Europe,2,2,0,0,0,0,2,Technical Failure
1989-05-06 00:00:00,Manila Aero Transport System - MATS,Takeoff (climb),Operational,Philippines,Asia,18,2,0,16,0,0,18,Technical Failure
1989-05-06 00:00:00,Aeroflot - Russian International Airlines,Flight,Military / Government,Russia,Asia,0,0,0,0,0,0,0,Unknown
1989-05-08 00:00:00,Aeroflot - Russian International Airlines,Flight,Business,Russia,Asia,3,2,0,1,0,0,3,Human Factor
1989-05-12 00:00:00,Aeropol,Flight,Commercial,Poland,Europe,0,0,0,0,0,0,0,Unknown
1989-05-15 00:00:00,Aero Condor - Servicio de Transporte Aéreo Turistico - STAT,Takeoff (climb),Commercial,Peru,South America,0,0,0,0,0,0,0,Unknown
1989-05-17 00:00:00,Somali Airlines,Takeoff (climb),Commercial,Kenya,Africa,70,13,0,57,0,0,70,Unknown
1989-05-18 00:00:00,Mexican Air Force - Fuerza Aérea Mexicana,Takeoff (climb),Military / Government,Mexico,Central America,30,2,0,28,0,0,30,Unknown
1989-05-21 00:00:00,Central Mountain Air,Landing (descent or approach),Operational,Canada,North America,2,2,0,0,0,0,2,Technical Failure
1989-05-22 00:00:00,Cockatoo Island Airways,Flight,Commercial,Australia,Oceania,3,1,0,2,0,0,3,Human Factor
1989-05-22 00:00:00,Aeroflot - Russian International Airlines,Flight,Commercial,Russia,Asia,0,0,0,0,0,0,0,Weather
1989-05-27 00:00:00,RCMP - GRC Air Services,Takeoff (climb),Military / Government,Canada,North America,5,1,0,4,0,0,5,Unknown
1989-05-31 00:00:00,Guardian Health Services,Landing (descent or approach),Humanitarian,United States of America,North America,4,1,0,3,0,0,4,Other
1989-06-01 00:00:00,Awaa Aviation,Landing (descent or approach),Business,United States of America,North America,3,1,0,2,0,0,3,Human Factor
1989-06-06 00:00:00,Aeromarket Express,Landing (descent or approach),Operational,Spain,Europe,2,2,0,0,0,0,2,Technical Failure
1989-06-06 00:00:00,Aeroflot - Russian International Airlines,Flight,Commercial,Russia,Asia,0,0,0,0,0,0,0,Technical Failure
1989-06-06 00:00:00,Libyan Arab Airlines,Takeoff (climb),Commercial,Libya,Africa,39,3,0,36,0,0,39,Technical Failure
1989-06-08 00:00:00,Private American,Flight,Operational,Canada,North America,2,2,0,0,0,0,2,Technical Failure
1989-06-13 00:00:00,Aeroflot - Russian International Airlines,Flight,Military / Government,Russia,Asia,0,0,0,0,0,0,0,Human Factor
1989-06-14 00:00:00,Private French,Takeoff (climb),Humanitarian,France,Europe,10,1,0,9,0,0,10,Human Factor
1989-06-15 00:00:00,Aeroflot - Russian International Airlines,Landing (descent or approach),Commercial,Kazakhstan,Asia,0,0,0,0,0,0,0,Unknown
1989-06-17 00:00:00,William E. Hamilton,Takeoff (climb),Business,United States of America,North America,4,1,0,3,0,0,4,Technical Failure
1989-06-25 00:00:00,Aeroflot - Russian International Airlines,Landing (descent or approach),Commercial,Kazakhstan,Asia,0,0,0,0,0,0,0,Unknown
1989-06-26 00:00:00,California Air Tours,Takeoff (climb),Operational,United States of America,North America,2,2,0,0,0,0,2,Human Factor
1989-06-26 00:00:00,Aeroflot - Russian International Airlines,Flight,Commercial,Uzbekistan,Asia,0,0,0,0,0,0,0,Human Factor
1989-07-03 00:00:00,Colombian Air Force - Fuerza Aérea Colombiana,Landing (descent or approach),Military / Government,Colombia,South America,0,0,0,0,0,0,0,Unknown
1989-07-05 00:00:00,Reef World Airways,Takeoff (climb),Commercial,Australia,Oceania,7,1,0,6,0,0,7,Human Factor
1989-07-06 00:00:00,Aeroflot - Russian International Airlines,Takeoff (climb),Military / Government,Russia,Asia,9,5,0,4,0,0,9,Technical Failure
1989-07-07 00:00:00,Aeroflot - Russian International Airlines,Landing (descent or approach),Commercial,Russia,Asia,0,0,0,0,0,0,0,Unknown
1989-07-11 00:00:00,Kenya Airways,Landing (descent or approach),Commercial,Ethiopia,Africa,76,10,0,66,0,0,76,Technical Failure
1989-07-12 00:00:00,Aeroflot - Russian International Airlines,Flight,Commercial,Russia,Asia,0,0,0,0,0,0,0,Technical Failure
1989-07-13 00:00:00,Uyak Air Services,Landing (descent or approach),Commercial,United States of America,North America,6,1,0,5,0,0,6,Human Factor
1989-07-18 00:00:00,Talair,,Commercial,Papua New Guinea,Oceania,0,0,0,0,0,0,0,Unknown
1989-07-18 00:00:00,Aeroflot - Russian International Airlines,Flight,Commercial,Russia,Asia,0,0,0,0,0,0,0,Human Factor
1989-07-22 00:00:00,Zimex Aviation,Flight,Operational,Mozambique,Africa,0,0,0,0,0,0,0,Unknown
1989-07-25 00:00:00,Institut Géographique National,Takeoff (climb),Specialised Services,United Kingdom,Europe,10,10,0,0,0,0,10,Technical Failure
1989-07-25 00:00:00,Precissi Flying Services,Flight,Military / Government,United States of America,North America,1,1,0,0,0,0,1,Human Factor
1989-07-26 00:00:00,Commuter Air Philippines,Landing (descent or approach),Operational,Philippines,Asia,2,2,0,0,0,0,2,Technical Failure
1989-07-28 00:00:00,Aeroflot - Russian International Airlines,Flight,Commercial,Russia,Asia,0,0,0,0,0,0,0,Technical Failure
1989-07-28 00:00:00,Soviet Air Force - Voyenno-vozdushnye sily CCCP,Landing (descent or approach),Military / Government,Russia,Asia,6,6,0,0,0,0,6,Human Factor
1989-07-29 00:00:00,Aeroflot - Russian International Airlines,Landing (descent or approach),Commercial,Tajikistan,Asia,0,0,0,0,0,0,0,Unknown
1989-07-30 00:00:00,Aeroflot - Russian International Airlines,Flight,Commercial,Russia,Asia,0,0,0,0,0,0,0,Technical Failure
1989-07-31 00:00:00,Ariana Afghan Airlines,Landing (descent or approach),Commercial,Afghanistan,Asia,20,3,0,17,0,0,20,Unknown
1989-08-01 00:00:00,Air Algérie,Landing (descent or approach),Operational,Algeria,Africa,4,4,0,0,0,0,4,Unknown
1989-08-01 00:00:00,Aeroflot - Russian International Airlines,Flight,Commercial,Russia,Asia,10,2,0,8,0,0,10,Technical Failure
1989-08-04 00:00:00,International Turbine Service,Landing (descent or approach),Operational,United States of America,North America,3,3,0,0,0,0,3,Technical Failure
1989-08-08 00:00:00,Private British,Flight,Business,United Kingdom,Europe,1,1,0,0,0,0,1,Technical Failure
1989-08-10 00:00:00,Apisa Air Cargo,Landing (descent or approach),Operational,Peru,South America,4,4,0,0,0,0,4,Human Factor
1989-08-11 00:00:00,40 Mile Air,Flight,Commercial,United States of America,North America,2,1,0,1,0,0,2,Human Factor
1989-08-12 00:00:00,Aeroflot - Russian International Airlines,Flight,Commercial,Russia,Asia,0,0,0,0,0,0,0,Technical Failure
1989-08-13 00:00:00,Skytravel,Landing (descent or approach),Business,United States of America,North America,8,2,0,6,0,0,8,Technical Failure
1989-08-14 00:00:00,Aeroflot - Russian International Airlines,Landing (descent or approach),Commercial,Russia,Asia,29,3,0,26,0,0,29,Unknown
1989-08-16 00:00:00,Líneas Aéreas del Estado - LADE,Takeoff (climb),Commercial,Argentina,South America,65,6,0,59,0,0,65,Human Factor
1989-08-18 00:00:00,Private Australian,Landing (descent or approach),Business,Australia,Oceania,2,1,0,1,0,0,2,Technical Failure
1989-08-25 00:00:00,Torosair,Takeoff (climb),Commercial,Turkey,Asia,165,8,0,157,0,0,165,Unknown
1989-08-27 00:00:00,Aeroflot - Russian International Airlines,Flight,Commercial,Russia,Asia,0,0,0,0,0,0,0,Human Factor
1989-08-28 00:00:00,Aeroflot - Russian International Airlines,Takeoff (climb),Commercial,Russia,Asia,17,2,0,15,0,0,17,Technical Failure
1989-09-01 00:00:00,Aeroflot - Russian International Airlines,Flight,Commercial,Russia,Asia,0,0,0,0,0,0,0,Technical Failure
1989-09-02 00:00:00,Aeroflot - Russian International Airlines,Landing (descent or approach),Commercial,Kyrgyzstan,Asia,43,3,0,40,0,0,43,Technical Failure
1989-09-04 00:00:00,Transportes Aéreos Mercantiles Ecuatorianos - TAME,Landing (descent or approach),Commercial,Ecuador,South America,99,7,0,92,0,0,99,Technical Failure
1989-09-07 00:00:00,Okada Air,Landing (descent or approach),Commercial,Nigeria,Africa,92,4,0,88,0,0,92,Human Factor
1989-09-10 00:00:00,Aeroflot - Russian International Airlines,Landing (descent or approach),Operational,Russia,Asia,0,0,0,0,0,0,0,Unknown
1989-09-13 00:00:00,Aero Vodochody,Landing (descent or approach),Commercial,Czech Republic,Europe,0,0,0,0,0,0,0,Unknown
1989-09-16 00:00:00,Aviex Jet,Landing (descent or approach),Operational,United States of America,North America,3,1,0,2,0,0,3,Technical Failure
1989-09-22 00:00:00,Air Corse,Parking,Commercial,France,Europe,40,3,0,37,0,0,40,Unknown
1989-09-23 00:00:00,Argentinian Navy - Armada Argentina,Landing (descent or approach),Military / Government,Argentina,South America,23,5,0,18,0,0,23,Technical Failure
1989-10-02 00:00:00,Harry W. O’Conner,Landing (descent or approach),Business,United States of America,North America,1,1,0,0,0,0,1,Human Factor
1989-10-02 00:00:00,Nigeria Airways,Landing (descent or approach),Commercial,Nigeria,Africa,135,6,0,129,0,0,135,Unknown
1989-10-02 00:00:00,Aeroflot - Russian International Airlines,Flight,Commercial,Russia,Asia,0,0,0,0,0,0,0,Technical Failure
1989-10-04 00:00:00,Aeroflot - Russian International Airlines,Landing (descent or approach),Commercial,Kazakhstan,Asia,52,4,0,48,0,0,52,Human Factor
1989-10-10 00:00:00,Lake Powell Air Service,Flight,Commercial,United States of America,North America,3,1,0,2,0,0,3,Technical Failure
1989-10-14 00:00:00,Aeroflot - Russian International Airlines,Landing (descent or approach),Commercial,Russia,Asia,0,0,0,0,0,0,0,Other
1989-10-16 00:00:00,Aeroflot - Russian International Airlines,Flight,Commercial,Russia,Asia,0,0,0,0,0,0,0,Technical Failure
1989-10-24 00:00:00,Private German,,Business,Germany,Europe,0,0,0,0,0,0,0,Unknown
1989-10-26 00:00:00,Air Inuit,Landing (descent or approach),Commercial,Canada,North America,13,2,0,11,0,0,13,Weather
1989-10-26 00:00:00,Mexican Air Force - Fuerza Aérea Mexicana,Landing (descent or approach),Military / Government,Mexico,Central America,7,2,0,5,0,0,7,Unknown
1989-10-27 00:00:00,Private Australian,Flight,Business,Australia,Oceania,7,1,0,6,0,0,7,Human Factor
1989-10-27 00:00:00,Aeroflot - Russian International Airlines,Takeoff (climb),Commercial,Russia,Asia,0,0,0,0,0,0,0,Human Factor
1989-11-07 00:00:00,Aeroflot - Russian International Airlines,Takeoff (climb),Commercial,Kazakhstan,Asia,0,0,0,0,0,0,0,Other
1989-11-08 00:00:00,French Air Force - Armée de l'Air,Flight,Military / Government,Egypt,Africa,0,0,0,0,0,0,0,Unknown
1989-11-14 00:00:00,Aviatia Utilitara,Takeoff (climb),Operational,Romania,Europe,0,0,0,0,0,0,0,Unknown
1989-11-15 00:00:00,Victoria Air - Philippines,Flight,Operational,Philippines,Asia,5,2,0,3,0,0,5,Unknown
1989-11-22 00:00:00,Air Tchad,Landing (descent or approach),Commercial,Chad,Africa,0,0,0,0,0,0,0,Technical Failure
1989-11-25 00:00:00,Korean Air,Takeoff (climb),Commercial,South Korea,Asia,48,6,0,42,0,0,48,Weather
1989-11-25 00:00:00,Maya Airways,Flight,Commercial,Belize,Central America,0,0,0,0,0,0,0,Unknown
1989-11-27 00:00:00,Paramount Leasing Corporation,Landing (descent or approach),Business,United States of America,North America,3,1,0,2,0,0,3,Technical Failure
1989-11-27 00:00:00,ZUA - Zakładu Usług Agrolotniczych - AET Agroaviation Services,Flight,Military / Government,Poland,Europe,0,0,0,0,0,0,0,Unknown
1989-11-28 00:00:00,Mid Eastern Airways,Landing (descent or approach),Commercial,United States of America,North America,2,1,0,1,0,0,2,Human Factor
1989-11-30 00:00:00,Correos de Mexico,Flight,Operational,Mexico,Central America,2,2,0,0,0,0,2,Technical Failure
1989-12-02 00:00:00,Gomes %26 Warra Aircraft Corporation,Flight,Operational,Bahamas,Central America,0,0,0,0,0,0,0,Unknown
1989-12-22 00:00:00,Aeroflot - Russian International Airlines,Flight,Commercial,Russia,Asia,0,0,0,0,0,0,0,Technical Failure
1989-12-27 00:00:00,Eagle Aviation - Malta,Landing (descent or approach),Operational,Switzerland,Europe,2,2,0,0,0,0,2,Human Factor
1989-12-30 00:00:00,America West Airlines,Landing (descent or approach),Commercial,United States of America,North America,130,5,0,125,0,0,130,Technical Failure
1989-12-30 00:00:00,Air Ivoire,Landing (descent or approach),Commercial,Ivory Coast,Africa,70,6,0,64,0,0,70,Unknown
1989-12-30 00:00:00,Milford Sound Scenic Flights,Flight,Commercial,New Zealand,Oceania,5,1,0,4,0,0,5,Human Factor
1989-12-31 00:00:00,Aeroflot - Russian International Airlines,,Commercial,Russia,Asia,0,0,0,0,0,0,0,Unknown
1990-01-03 00:00:00,Vanair,Flight,Commercial,Vanuatu,Oceania,0,0,0,0,0,0,0,Technical Failure
1990-01-05 00:00:00,Aerolineas Argentinas,Landing (descent or approach),Commercial,Argentina,South America,90,5,0,85,0,0,90,Human Factor
1990-01-05 00:00:00,Angola Air Charter,Landing (descent or approach),Operational,Angola,Africa,7,4,0,3,0,0,7,Terrorism
1990-01-09 00:00:00,Sudanese Air Force - Al Quwwat al-Jawwiya As-Sudaniya,Flight,Military / Government,South Sudan,Africa,0,0,0,0,0,0,0,Terrorism
1990-01-11 00:00:00,United States Air Force - USAF,Parking,Military / Government,United States of America,North America,2,2,0,0,0,0,2,Other
1990-01-15 00:00:00,SkyWest Airlines - USA,Landing (descent or approach),Commercial,United States of America,North America,16,2,0,14,0,0,16,Human Factor
1990-01-16 00:00:00,Freight Runners Express,Landing (descent or approach),Operational,United States of America,North America,1,1,0,0,0,0,1,Human Factor
1990-01-16 00:00:00,Aeroflot - Russian International Airlines,Landing (descent or approach),Commercial,Russia,Asia,13,2,0,11,0,0,13,Technical Failure
1990-01-17 00:00:00,Geodatos,Flight,Operational,United States of America,North America,3,1,0,2,0,0,3,Technical Failure
1990-01-21 00:00:00,Private Dominican,Landing (descent or approach),Humanitarian,Guatemala,Central America,0,0,0,0,0,0,0,Unknown
1990-01-26 00:00:00,MIAT Mongolian Airlines - Mongolyn Irgeniy Agaaryn Teever,Landing (descent or approach),Commercial,Mongolia,Asia,30,5,0,25,0,0,30,Unknown
1990-01-26 00:00:00,Western Arctic Air,Flight,Commercial,Canada,North America,0,0,0,0,0,0,0,Unknown
1990-01-29 00:00:00,KASET - Bureau of Royal Rainmaking and Agricultural Aviation,Flight,Military / Government,Thailand,Asia,1,1,0,0,0,0,1,Unknown
1990-01-31 00:00:00,Morris Communication Corporation,Landing (descent or approach),Business,United States of America,North America,1,1,0,0,0,0,1,Human Factor
1990-02-03 00:00:00,City of Detroit,Landing (descent or approach),Military / Government,United States of America,North America,6,2,0,4,0,0,6,Unknown
1990-02-17 00:00:00,Aviaco - Aviacion y Comercio,Landing (descent or approach),Commercial,Spain,Europe,89,7,0,82,0,0,89,Human Factor
1990-02-17 00:00:00,Japan Air Self-Defense Force - Kōkū Jieitai,Flight,Military / Government,Japan,Asia,0,0,0,0,0,0,0,Unknown
1990-02-19 00:00:00,Aeroflot - Russian International Airlines,Flight,Military / Government,Antarctica,Antarctica,4,4,0,0,0,0,4,Technical Failure
1990-02-20 00:00:00,Aeroflot - Russian International Airlines,Flight,Commercial,Lithuania,Europe,0,0,0,0,0,0,0,Unknown
1990-02-21 00:00:00,Corporate Air - USA,Flight,Operational,United States of America,North America,1,1,0,0,0,0,1,Technical Failure
1990-02-21 00:00:00,Beegles Aircraft Services,Takeoff (climb),Specialised Services,United States of America,North America,2,1,0,1,0,0,2,Human Factor
1990-02-22 00:00:00,Lear Jet Corporation,Landing (descent or approach),Operational,China,Asia,7,2,0,5,0,0,7,Human Factor
1990-02-24 00:00:00,FTG-Air Service Flugcharter,Flight,Operational,Germany,Europe,2,2,0,0,0,0,2,Technical Failure
1990-02-24 00:00:00,Aeroflot - Russian International Airlines,Landing (descent or approach),Commercial,Russia,Asia,0,0,0,0,0,0,0,Unknown
1990-02-28 00:00:00,Venezuelan National Guard - Guardia Nacional Bolivariana de Venezuela,Takeoff (climb),Military / Government,Venezuela,South America,4,2,0,2,0,0,4,Unknown
1990-03-01 00:00:00,Katale Aero Transport,Landing (descent or approach),Operational,Democratic Republic of Congo,Africa,9,6,0,3,0,0,9,Human Factor
1990-03-06 00:00:00,Argentinian Navy - Armada Argentina,,Military / Government,Argentina,South America,0,0,0,0,0,0,0,Unknown
1990-03-09 00:00:00,Bel Air,Landing (descent or approach),Commercial,Uganda,Africa,0,0,0,0,0,0,0,Unknown
1990-03-14 00:00:00,Air Service Hungary - Repülögépes Szolgalat Allami Vallat,Flight,Military / Government,Hungary,Europe,2,2,0,0,0,0,2,Technical Failure
1990-03-15 00:00:00,Top Flight Air Service,Flight,Operational,United States of America,North America,1,1,0,0,0,0,1,Technical Failure
1990-03-16 00:00:00,Alexander A. Greco,Landing (descent or approach),Business,United States of America,North America,3,1,0,2,0,0,3,Technical Failure
1990-03-16 00:00:00,Aeroflot - Russian International Airlines,Landing (descent or approach),Operational,Russia,Asia,2,2,0,0,0,0,2,Human Factor
1990-03-22 00:00:00,Air China,Landing (descent or approach),Commercial,China,Asia,107,5,0,102,0,0,107,Human Factor
1990-03-24 00:00:00,Aeroflot - Russian International Airlines,Flight,Commercial,Russia,Asia,0,0,0,0,0,0,0,Technical Failure
1990-03-24 00:00:00,Aeroflot - Russian International Airlines,Flight,Commercial,Russia,Asia,2,2,0,0,0,0,2,Technical Failure
1990-03-27 00:00:00,Dolph Briscoe Jr.,Landing (descent or approach),Business,United States of America,North America,2,2,0,0,0,0,2,Human Factor
1990-04-01 00:00:00,Concord Airlines,Takeoff (climb),Commercial,Nigeria,Africa,52,7,0,45,0,0,52,Human Factor
1990-04-01 00:00:00,Safe Air,Landing (descent or approach),Operational,New Zealand,Oceania,2,2,0,0,0,0,2,Technical Failure
1990-04-02 00:00:00,Flight International,Takeoff (climb),Operational,United States of America,North America,2,2,0,0,0,0,2,Technical Failure
1990-04-03 00:00:00,Merpati Nusantara Airlines - MNA,Takeoff (climb),Commercial,Indonesia,Asia,17,3,0,14,0,0,17,Technical Failure
1990-04-04 00:00:00,Isleña Airlines - Isleña de Inversiones,Landing (descent or approach),Commercial,Honduras,Central America,20,2,0,18,0,0,20,Human Factor
1990-04-05 00:00:00,Sydney Skydivers Parachuting School,Takeoff (climb),Operational,Australia,Oceania,1,1,0,0,0,0,1,Human Factor
1990-04-13 00:00:00,Windrock Aviation,Landing (descent or approach),Commercial,United States of America,North America,7,1,0,6,0,0,7,Human Factor
1990-04-16 00:00:00,Aeronica - Aerolineas Nicaraguenses,,Commercial,Nicaragua,Central America,0,0,0,0,0,0,0,Unknown
1990-04-22 00:00:00,Lao Aviation,Takeoff (climb),Commercial,Laos,Asia,35,5,0,30,0,0,35,Human Factor
1990-04-22 00:00:00,Private Australian,Landing (descent or approach),Business,Australia,Oceania,8,2,0,6,0,0,8,Human Factor
1990-04-26 00:00:00,ZUA - Zakładu Usług Agrolotniczych - AET Agroaviation Services,Flight,Military / Government,Iran,Asia,0,0,0,0,0,0,0,Unknown
1990-04-30 00:00:00,Aero Union,Landing (descent or approach),Operational,United States of America,North America,2,2,0,0,0,0,2,Technical Failure
1990-05-02 00:00:00,Helicol Colombia - Helicopteros Nacionales de Colombia,Landing (descent or approach),Commercial,Colombia,South America,6,2,0,4,0,0,6,Human Factor
1990-05-07 00:00:00,Air India,Landing (descent or approach),Commercial,India,Asia,215,20,0,195,0,0,215,Technical Failure
1990-05-14 00:00:00,ZUA - Zakładu Usług Agrolotniczych - AET Agroaviation Services,Flight,Military / Government,Iran,Asia,0,0,0,0,0,0,0,Unknown
1990-05-15 00:00:00,DOSAAF,Landing (descent or approach),Other,Latvia,Europe,0,0,0,0,0,0,0,Unknown
1990-05-28 00:00:00,Embry-Riddle Aeronautical University,Landing (descent or approach),Operational,United States of America,North America,2,2,0,0,0,0,2,Technical Failure
1990-05-29 00:00:00,Aerokon Aviation,Takeoff (climb),Operational,Canada,North America,2,1,0,1,0,0,2,Human Factor
1990-05-31 00:00:00,Scottish Department of Agriculture and Fisheries,Flight,Military / Government,United Kingdom,Europe,3,2,0,1,0,0,3,Technical Failure
1990-06-02 00:00:00,Aeroflot - Russian International Airlines,Landing (descent or approach),Commercial,Kazakhstan,Asia,33,4,0,29,0,0,33,Human Factor
1990-06-02 00:00:00,MarkAir,Landing (descent or approach),Operational,United States of America,North America,4,4,0,0,0,0,4,Human Factor
1990-06-06 00:00:00,Federal Express - FedEx,Landing (descent or approach),Operational,United States of America,North America,1,1,0,0,0,0,1,Technical Failure
1990-06-12 00:00:00,Aeroflot - Russian International Airlines,Landing (descent or approach),Operational,Afghanistan,Asia,10,10,0,0,0,0,10,Terrorism
1990-06-15 00:00:00,Aerochago Airlines,Landing (descent or approach),Operational,Dominican Republic,Central America,3,3,0,0,0,0,3,Technical Failure
1990-06-18 00:00:00,Ecuadorian Air Force - Fuerza Aérea Ecuatoriana,Landing (descent or approach),Operational,Ecuador,South America,2,2,0,0,0,0,2,Technical Failure
1990-06-23 00:00:00,North Star Air Cargo,Landing (descent or approach),Operational,United States of America,North America,2,2,0,0,0,0,2,Human Factor
1990-06-30 00:00:00,Wright Air Service,Flight,Commercial,United States of America,North America,9,1,0,8,0,0,9,Technical Failure
1990-06-30 00:00:00,Zimex Aviation,Takeoff (climb),Humanitarian,Angola,Africa,22,2,0,20,0,0,22,Technical Failure
1990-07-01 00:00:00,Aeroflot - Russian International Airlines,Landing (descent or approach),Commercial,Russia,Asia,109,10,0,99,0,0,109,Human Factor
1990-07-13 00:00:00,Aeroflot - Russian International Airlines,Parking,Specialised Services,Belarus,Europe,0,0,0,0,0,0,0,Unknown
1990-07-13 00:00:00,Aeroflot - Russian International Airlines,Parking,Specialised Services,Belarus,Europe,0,0,0,0,0,0,0,Unknown
1990-07-14 00:00:00,TPI International Airways,Landing (descent or approach),Operational,Netherlands,Central America,3,3,0,0,0,0,3,Technical Failure
1990-07-14 00:00:00,Trans Arabian Air Transport - TAAT,Landing (descent or approach),Operational,Sudan,Africa,5,5,0,0,0,0,5,Technical Failure
1990-07-17 00:00:00,Ecuadorian Air Force - Fuerza Aérea Ecuatoriana,Landing (descent or approach),Operational,Canada,North America,2,2,0,0,0,0,2,Technical Failure
1990-07-17 00:00:00,Royal Australian Army,Flight,Operational,Australia,Oceania,1,1,0,0,0,0,1,Unknown
1990-07-21 00:00:00,Air Ivoire,Landing (descent or approach),Commercial,Ivory Coast,Africa,12,2,0,10,0,0,12,Human Factor
1990-07-22 00:00:00,USAir - US Airways,Takeoff (climb),Commercial,United States of America,North America,27,5,0,22,0,0,27,Technical Failure
1990-07-24 00:00:00,Victoria Air - Philippines,Landing (descent or approach),Operational,Philippines,Asia,3,3,0,0,0,0,3,Technical Failure
1990-07-25 00:00:00,Ethiopian Airlines,Takeoff (climb),Operational,Ethiopia,Africa,4,4,0,0,0,0,4,Other
1990-07-26 00:00:00,Aero Manu,Landing (descent or approach),Commercial,Peru,South America,10,2,0,8,0,0,10,Unknown
1990-07-26 00:00:00,Aeroflot - Russian International Airlines,Landing (descent or approach),Military / Government,Russia,Asia,5,3,0,2,0,0,5,Weather
1990-07-27 00:00:00,Aeroklub Polskiej Rzeczypospolitej Ludowej - APRL,Flight,Commercial,Poland,Europe,0,0,0,0,0,0,0,Unknown
1990-07-31 00:00:00,Service de Formation Aéronautique %26 de Contrôle Technique - SFACT,Takeoff (climb),Operational,France,Europe,2,2,0,0,0,0,2,Human Factor
1990-07-31 00:00:00,EAA Air Museum,Landing (descent or approach),Operational,United States of America,North America,5,1,0,4,0,0,5,Technical Failure
1990-08-01 00:00:00,Aeroflot - Russian International Airlines,Takeoff (climb),Military / Government,Russia,Asia,3,3,0,0,0,0,3,Human Factor
1990-08-05 00:00:00,Gordon Brumm,Takeoff (climb),Operational,United States of America,North America,1,1,0,0,0,0,1,Human Factor
1990-08-05 00:00:00,International Airboats,Landing (descent or approach),Operational,Iceland,Europe,2,1,0,1,0,0,2,Technical Failure
1990-08-12 00:00:00,Società Aerea Piemontese - SAEP,Flight,Business,Italy,Europe,0,0,0,0,0,0,0,Unknown
1990-08-12 00:00:00,Southern Air Transport,Landing (descent or approach),Operational,South Sudan,Africa,5,4,0,1,0,0,5,Technical Failure
1990-08-14 00:00:00,Formosa Airlines,Landing (descent or approach),Operational,Taiwan,Asia,2,2,0,0,0,0,2,Human Factor
1990-08-18 00:00:00,Aeroflot - Russian International Airlines,Landing (descent or approach),Commercial,Tajikistan,Asia,0,0,0,0,0,0,0,Human Factor
1990-08-23 00:00:00,Soviet Navy - Voyenno-morskoy flot CCCP,Takeoff (climb),Military / Government,Ukraine,Europe,0,0,0,0,0,0,0,Human Factor
1990-09-06 00:00:00,Gabonese Air Force - Forces Aériennes Gabonaises,Landing (descent or approach),Military / Government,Gabon,Africa,0,0,0,0,0,0,0,Unknown
1990-09-09 00:00:00,Aeroflot - Russian International Airlines,Landing (descent or approach),Commercial,Kazakhstan,Asia,22,4,0,18,0,0,22,Human Factor
1990-09-09 00:00:00,Aeroflot - Russian International Airlines,Parking,Commercial,Kazakhstan,Asia,0,0,0,0,0,0,0,Human Factor
1990-09-16 00:00:00,Confederate Air Force,Taxiing,Business,United States of America,North America,4,4,0,0,0,0,4,Technical Failure
1990-09-20 00:00:00,Aero Manu,Flight,Commercial,Peru,South America,7,2,0,5,0,0,7,Technical Failure
1990-09-22 00:00:00,Westport Air Travel,Flight,Business,United States of America,North America,6,1,0,5,0,0,6,Technical Failure
1990-09-25 00:00:00,United States Navy - USN,Landing (descent or approach),Operational,United States of America,North America,4,4,0,0,0,0,4,Unknown
1990-09-29 00:00:00,Howard M. Mullins,Takeoff (climb),Humanitarian,United States of America,North America,11,1,0,10,0,0,11,Human Factor
1990-10-08 00:00:00,Rwandese Air Force - Force Aérienne Rwandaise,Flight,Military / Government,Rwanda,Africa,0,0,0,0,0,0,0,Terrorism
1990-10-11 00:00:00,Celanese Mexicana,Landing (descent or approach),Business,Mexico,Central America,13,2,0,11,0,0,13,Other
1990-10-12 00:00:00,Gary Zagari %26 Associates,Landing (descent or approach),Operational,United States of America,North America,1,1,0,0,0,0,1,Human Factor
1990-10-12 00:00:00,Aeroflot - Russian International Airlines,Landing (descent or approach),Commercial,Ukraine,Europe,15,2,0,13,0,0,15,Human Factor
1990-10-17 00:00:00,Alan Merrell Jr.,Takeoff (climb),Business,United States of America,North America,4,1,0,3,0,0,4,Human Factor
1990-10-20 00:00:00,Aeroflot - Russian International Airlines,Takeoff (climb),Commercial,Georgia,Asia,171,7,0,164,0,0,171,Human Factor
1990-11-02 00:00:00,Aeroflot - Russian International Airlines,Landing (descent or approach),Humanitarian,Russia,Asia,0,0,0,0,0,0,0,Unknown
1990-11-04 00:00:00,Aero Bellavista,Flight,Commercial,Peru,South America,12,1,0,11,0,0,12,Unknown
1990-11-08 00:00:00,Comair,Landing (descent or approach),Operational,United States of America,North America,3,2,0,1,0,0,3,Human Factor
1990-11-17 00:00:00,Aeroflot - Russian International Airlines,Flight,Operational,Czech Republic,Europe,6,6,0,0,0,0,6,Technical Failure
1990-11-20 00:00:00,Egyptian Air Force and Air Defence Command,Flight,Military / Government,Egypt,Africa,0,0,0,0,0,0,0,Unknown
1990-11-21 00:00:00,Aeroflot - Russian International Airlines,Landing (descent or approach),Commercial,Russia,Asia,189,10,0,179,0,0,189,Human Factor
1990-11-21 00:00:00,Argentinian Air Force - Fuerza Aérea Argentina,Flight,Specialised Services,Argentina,South America,1,1,0,0,0,0,1,Unknown
1990-11-21 00:00:00,Libyan Arab Airlines,Landing (descent or approach),Humanitarian,Libya,Africa,5,2,0,3,0,0,5,Human Factor
1990-11-21 00:00:00,Transportes Aéreos Nacionales de la Selva - TANS,Flight,Military / Government,Peru,South America,0,0,0,0,0,0,0,Unknown
1990-11-21 00:00:00,Libyan Arab Airlines,Landing (descent or approach),Humanitarian,Libya,Africa,5,2,0,3,0,0,5,Human Factor
1990-11-29 00:00:00,Steven T. Bramwell,Flight,Business,United States of America,North America,5,1,0,4,0,0,5,Technical Failure
1990-11-29 00:00:00,Gabonese Air Force - Forces Aériennes Gabonaises,,Military / Government,Gabon,Africa,0,0,0,0,0,0,0,Unknown
1990-11-30 00:00:00,Aeroflot - Russian International Airlines,Landing (descent or approach),Commercial,Russia,Asia,35,4,0,31,0,0,35,Human Factor
1990-12-12 00:00:00,MAP - Ministerstvo Aviatsionnoi Promyshlennosti - Minaviaprom,Flight,Operational,Ukraine,Europe,17,5,0,12,0,0,17,Human Factor
1990-12-14 00:00:00,Aeroflot - Russian International Airlines,Landing (descent or approach),Commercial,Russia,Asia,43,4,0,39,0,0,43,Human Factor
1990-12-15 00:00:00,Frigorifico Santa Rita,Landing (descent or approach),Operational,Bolivia,South America,3,3,0,0,0,0,3,Unknown
1990-12-26 00:00:00,Air Mobile Ministries,Landing (descent or approach),Business,Bahamas,Central America,5,1,0,4,0,0,5,Unknown
1991-01-04 00:00:00,Aeromarket Express,Takeoff (climb),Operational,Spain,Europe,2,2,0,0,0,0,2,Unknown
1991-01-04 00:00:00,United States Army,Flight,Military / Government,Saudi Arabia,Asia,0,0,0,0,0,0,0,Unknown
1991-01-07 00:00:00,Private Australian,Flight,Commercial,Australia,Oceania,7,1,0,6,0,0,7,Human Factor
1991-01-10 00:00:00,Romavia,Landing (descent or approach),Specialised Services,Romania,Europe,13,5,0,8,0,0,13,Human Factor
1991-01-11 00:00:00,United Executive Jet,Landing (descent or approach),Operational,United States of America,North America,4,2,0,2,0,0,4,Human Factor
1991-01-11 00:00:00,Ridgeaire,Takeoff (climb),Specialised Services,United States of America,North America,1,1,0,0,0,0,1,Human Factor
1991-01-12 00:00:00,Vietnam Airlines,Landing (descent or approach),Commercial,Vietnam,Asia,79,7,0,72,0,0,79,Human Factor
1991-01-16 00:00:00,Muk Air,Landing (descent or approach),Operational,Denmark,Europe,2,2,0,0,0,0,2,Technical Failure
1991-01-17 00:00:00,United States Army,Landing (descent or approach),Operational,United States of America,North America,2,2,0,0,0,0,2,Human Factor
1991-01-30 00:00:00,CC Air,Landing (descent or approach),Commercial,United States of America,North America,19,2,0,17,0,0,19,Human Factor
1991-01-31 00:00:00,Aero Huaylas,Takeoff (climb),Commercial,Peru,South America,5,1,0,4,0,0,5,Other
1991-02-05 00:00:00,Air Guinée,Landing (descent or approach),Commercial,Liberia,Africa,72,7,0,65,0,0,72,Unknown
1991-02-06 00:00:00,KASET - Bureau of Royal Rainmaking and Agricultural Aviation,Flight,Military / Government,Thailand,Asia,2,2,0,0,0,0,2,Unknown
1991-02-07 00:00:00,Tanzania Peoples Defence Forces,Landing (descent or approach),Operational,Tanzania,Africa,2,2,0,0,0,0,2,Technical Failure
1991-02-10 00:00:00,Air Colombia,Takeoff (climb),Commercial,Colombia,South America,85,5,0,80,0,0,85,Technical Failure
1991-02-14 00:00:00,Aero Manu,Flight,Commercial,Peru,South America,15,2,0,13,0,0,15,Technical Failure
1991-02-17 00:00:00,Aeroflot - Russian International Airlines,Takeoff (climb),Commercial,Russia,Asia,17,2,0,15,0,0,17,Other
1991-02-23 00:00:00,Aerolineas Marcos,Landing (descent or approach),Operational,United States of America,North America,2,2,0,0,0,0,2,Technical Failure
1991-02-25 00:00:00,Transporte Aéreo Militar de Uruguay - TAMU,Landing (descent or approach),Military / Government,Uruguay,South America,0,0,0,0,0,0,0,Technical Failure
1991-03-12 00:00:00,Air Transport International,Takeoff (climb),Operational,United States of America,North America,5,3,0,2,0,0,5,Human Factor
1991-03-15 00:00:00,Líder Taxi Aéreo,Landing (descent or approach),Humanitarian,Brazil,South America,4,2,0,2,0,0,4,Human Factor
1991-03-20 00:00:00,Korean Air,Landing (descent or approach),Operational,South Korea,Asia,3,3,0,0,0,0,3,Human Factor
1991-03-24 00:00:00,Servicios Aéreos de Los Angeles,Takeoff (climb),Commercial,Mexico,Central America,8,2,0,6,0,0,8,Technical Failure
1991-03-25 00:00:00,Sudan Airways,Takeoff (climb),Commercial,Sudan,Africa,27,5,0,22,0,0,27,Unknown
1991-03-31 00:00:00,Intercontinental Colombia - Intercontinental de Aviación,Flight,Operational,Colombia,South America,2,2,0,0,0,0,2,Technical Failure
1991-04-07 00:00:00,Igor Paskhover,Flight,Business,United States of America,North America,2,1,0,1,0,0,2,Human Factor
1991-05-01 00:00:00,PGA Tour Investments,Landing (descent or approach),Commercial,United States of America,North America,9,2,0,7,0,0,9,Human Factor
1991-05-03 00:00:00,Ryan International Airlines,Takeoff (climb),Operational,United States of America,North America,3,3,0,0,0,0,3,Technical Failure
1991-05-04 00:00:00,S. C. Johnson %26 Son,Flight,Business,United States of America,North America,2,1,0,1,0,0,2,Technical Failure
1991-05-08 00:00:00,Harbour Air Seaplanes,Flight,Commercial,Canada,North America,11,1,0,10,0,0,11,Unknown
1991-05-13 00:00:00,Pakistani Government,Flight,Military / Government,Pakistan,Asia,0,0,0,0,0,0,0,Unknown
1991-05-14 00:00:00,Transportes Aéreos Eldorado,Landing (descent or approach),Commercial,Bolivia,South America,5,2,0,3,0,0,5,Technical Failure
1991-05-25 00:00:00,Chris E. Nicholson,Flight,Operational,United States of America,North America,1,1,0,0,0,0,1,Technical Failure
1991-05-30 00:00:00,Bolivian Air Force - Fuerza Aérea Boliviana,Takeoff (climb),Military / Government,Bolivia,South America,8,2,0,6,0,0,8,Unknown
1991-06-01 00:00:00,JAT Agricultural Aviation,Flight,Military / Government,Croatia,Europe,0,0,0,0,0,0,0,Unknown
1991-06-02 00:00:00,Fayard Enterprises,Takeoff (climb),Humanitarian,United States of America,North America,12,1,0,11,0,0,12,Unknown
1991-06-04 00:00:00,Línea Aérea Taxpa,Flight,Commercial,Chile,South America,4,2,0,2,0,0,4,Technical Failure
1991-06-05 00:00:00,Italian Air Force - Aeronautica Militare Italiana,,Military / Government,Italy,Europe,0,0,0,0,0,0,0,Unknown
1991-06-05 00:00:00,Sempati Air,Flight,Operational,Indonesia,Asia,2,2,0,0,0,0,2,Human Factor
1991-06-07 00:00:00,Victoria Air - USA,Landing (descent or approach),Commercial,Dominican Republic,Central America,35,3,0,32,0,0,35,Technical Failure
1991-06-08 00:00:00,Arrows Aviation Company,Landing (descent or approach),Business,United Kingdom,Europe,5,2,0,3,0,0,5,Weather
1991-06-09 00:00:00,Royal Nepal Airlines,Landing (descent or approach),Commercial,Nepal,Asia,17,3,0,14,0,0,17,Human Factor
1991-06-13 00:00:00,Korean Air,Landing (descent or approach),Commercial,South Korea,Asia,127,7,0,120,0,0,127,Human Factor
1991-06-18 00:00:00,Pacific Flying Fish,Flight,Operational,World,World,3,2,0,1,0,0,3,Technical Failure
1991-06-19 00:00:00,Baikal Airlines,Flight,Commercial,Russia,Asia,4,2,0,2,0,0,4,Technical Failure
1991-06-20 00:00:00,United Nations Development Programme,Landing (descent or approach),Humanitarian,Nepal,Asia,2,2,0,0,0,0,2,Weather
1991-06-21 00:00:00,Hydrowell,Takeoff (climb),Business,Venezuela,South America,5,2,0,3,0,0,5,Technical Failure
1991-06-27 00:00:00,Conrad Ramaker,Takeoff (climb),Business,United States of America,North America,5,1,0,4,0,0,5,Human Factor
1991-07-01 00:00:00,New Creations,Landing (descent or approach),Commercial,United States of America,North America,2,2,0,0,0,0,2,Human Factor
1991-07-02 00:00:00,Kalitta Charters - Kalitta Services,Landing (descent or approach),Operational,United States of America,North America,2,2,0,0,0,0,2,Other
1991-07-10 00:00:00,Transportes Aéreos Unidos de la Selva Amazonica - TAUSA,Takeoff (climb),Operational,Peru,South America,2,1,0,1,0,0,2,Technical Failure
1991-07-16 00:00:00,NewCal Aviation,Landing (descent or approach),Operational,Canada,North America,1,1,0,0,0,0,1,Unknown
1991-07-17 00:00:00,Jack Marshall Foods,Takeoff (climb),Business,United States of America,North America,3,1,0,2,0,0,3,Technical Failure
1991-07-17 00:00:00,Janes Aviation,Takeoff (climb),Operational,United Kingdom,Europe,2,2,0,0,0,0,2,Technical Failure
1991-07-25 00:00:00,Air Algérie,Landing (descent or approach),Commercial,Algeria,Africa,0,0,0,0,0,0,0,Unknown
1991-08-04 00:00:00,Palm Beach Aviation,Flight,Commercial,World,World,4,1,0,3,0,0,4,Technical Failure
1991-08-14 00:00:00,Commuter Air Philippines,Takeoff (climb),Commercial,Philippines,Asia,0,0,0,0,0,0,0,Unknown
1991-08-20 00:00:00,Northern Airmotive,Takeoff (climb),Operational,United States of America,North America,1,1,0,0,0,0,1,Technical Failure
1991-08-21 00:00:00,Aeroflot - Russian International Airlines,Takeoff (climb),Commercial,Russia,Asia,14,2,0,12,0,0,14,Unknown
1991-08-27 00:00:00,Aeroflot - Russian International Airlines,Flight,Commercial,Kazakhstan,Asia,6,2,0,4,0,0,6,Human Factor
1991-09-01 00:00:00,Norman Baron,Landing (descent or approach),Business,United States of America,North America,3,1,0,2,0,0,3,Human Factor
1991-09-02 00:00:00,Southern Air Transport,Taxiing,Humanitarian,South Sudan,Africa,5,5,0,0,0,0,5,Terrorism
1991-09-11 00:00:00,Harvey L. Montague,Landing (descent or approach),Business,United States of America,North America,3,1,0,2,0,0,3,Human Factor
1991-09-13 00:00:00,United Breweries,Landing (descent or approach),Business,India,Asia,17,3,0,14,0,0,17,Human Factor
1991-09-14 00:00:00,Cubana de Aviación,Landing (descent or approach),Commercial,Mexico,Central America,112,12,0,100,0,0,112,Human Factor
1991-09-16 00:00:00,Kabo Air,Landing (descent or approach),Commercial,Nigeria,Africa,66,6,0,60,0,0,66,Human Factor
1991-09-21 00:00:00,Air Service Hungary - Repülögépes Szolgalat Allami Vallat,Flight,Business,Indonesia,Asia,7,2,0,5,0,0,7,Technical Failure
1991-09-25 00:00:00,Grup-Air,Landing (descent or approach),Commercial,Germany,Europe,10,3,0,7,0,0,10,Human Factor
1991-09-27 00:00:00,Aeroflot - Russian International Airlines,Takeoff (climb),Commercial,Russia,Asia,0,0,0,0,0,0,0,Human Factor
1991-09-28 00:00:00,North Flying,Takeoff (climb),Humanitarian,Denmark,Europe,7,1,0,6,0,0,7,Unknown
1991-09-29 00:00:00,Aerosucre Colombia,Takeoff (climb),Operational,Colombia,South America,3,3,0,0,0,0,3,Technical Failure
1991-09-30 00:00:00,Orca Air,Flight,Commercial,Canada,North America,0,0,0,0,0,0,0,Unknown
1991-10-03 00:00:00,Aeroflot - Russian International Airlines,Landing (descent or approach),Operational,Angola,Africa,6,6,0,0,0,0,6,Other
1991-10-08 00:00:00,BAC Express Airlines,Flight,Operational,Greenland,Europe,3,3,0,0,0,0,3,Weather
1991-10-23 00:00:00,Aeroflot - Russian International Airlines,Landing (descent or approach),Commercial,Russia,Asia,13,2,0,11,0,0,13,Human Factor
1991-10-27 00:00:00,Transporte Aéreo Ejecutivo - TAE,Flight,Commercial,Ecuador,South America,7,1,0,6,0,0,7,Terrorism
1991-11-03 00:00:00,Aeromarket Express,Takeoff (climb),Operational,Spain,Europe,3,3,0,0,0,0,3,Unknown
1991-11-08 00:00:00,Sigi Air Cargo,Landing (descent or approach),Operational,Sudan,Africa,6,6,0,0,0,0,6,Unknown
1991-11-09 00:00:00,Croatian Air Force - Hrvatske Zračne Snage,Flight,Military / Government,Croatia,Europe,0,0,0,0,0,0,0,Unknown
1991-11-15 00:00:00,Socata,Landing (descent or approach),Specialised Services,France,Europe,2,2,0,0,0,0,2,Unknown
1991-11-17 00:00:00,SAHSA - Servicios Aéreos de Honduras SA,Landing (descent or approach),Commercial,Costa Rica,Central America,42,6,0,36,0,0,42,Human Factor
1991-11-20 00:00:00,Brazilian Air Force - Força Aérea Brasileira,Flight,Operational,Brazil,South America,0,0,0,0,0,0,0,Unknown
1991-11-22 00:00:00,Kras Air - Krasnoyarsk Avia - Krasnoyarskie Avialinii,Flight,Commercial,Russia,Asia,13,2,0,11,0,0,13,Technical Failure
1991-11-23 00:00:00,Gorhams,Takeoff (climb),Business,United States of America,North America,3,1,0,2,0,0,3,Technical Failure
1991-11-27 00:00:00,Aliserio,Landing (descent or approach),Operational,Italy,Europe,2,2,0,0,0,0,2,Human Factor
1991-11-28 00:00:00,Rhoades International,Takeoff (climb),Operational,United States of America,North America,2,2,0,0,0,0,2,Human Factor
1991-11-29 00:00:00,Jerry Miller,Flight,Business,United States of America,North America,2,1,0,1,0,0,2,Technical Failure
1991-11-29 00:00:00,Air Creebec,Takeoff (climb),Commercial,Canada,North America,35,3,0,32,0,0,35,Technical Failure
1991-12-02 00:00:00,Yakutavia,Flight,Commercial,Russia,Asia,0,0,0,0,0,0,0,Unknown
1991-12-04 00:00:00,Viking Express,Takeoff (climb),Operational,United States of America,North America,1,1,0,0,0,0,1,Human Factor
1991-12-07 00:00:00,Libyan Arab Airlines,Takeoff (climb),Commercial,Libya,Africa,199,10,0,189,0,0,199,Unknown
1991-12-08 00:00:00,Yakutavia,Flight,Commercial,Russia,Asia,0,0,0,0,0,0,0,Unknown
1991-12-15 00:00:00,Fiji Air Services,Landing (descent or approach),Operational,Fiji Islands,Oceania,2,2,0,0,0,0,2,Human Factor
1991-12-17 00:00:00,Alitalia - Linee Aeree Italiane,Landing (descent or approach),Commercial,Poland,Europe,96,6,0,90,0,0,96,Human Factor
1991-12-18 00:00:00,Transair USA,Landing (descent or approach),Commercial,Romania,Europe,10,2,0,8,0,0,10,Human Factor
1991-12-23 00:00:00,Flight Management,Landing (descent or approach),Operational,United States of America,North America,3,3,0,0,0,0,3,Human Factor
1991-12-27 00:00:00,Scandinavian Airlines System - SAS,Takeoff (climb),Commercial,Sweden,Europe,129,6,0,123,0,0,129,Weather
1991-12-30 00:00:00,Aeroflot - Russian International Airlines,Takeoff (climb),Commercial,Russia,Asia,25,4,0,21,0,0,25,Human Factor
1991-12-31 00:00:00,Aeroflot - Russian International Airlines,Landing (descent or approach),Commercial,Russia,Asia,0,0,0,0,0,0,0,Unknown
1991-12-31 00:00:00,GLM Aviation,,Operational,Democratic Republic of Congo,Africa,0,0,0,0,0,0,0,Technical Failure
1992-01-03 00:00:00,Aeroflot - Russian International Airlines,Landing (descent or approach),Military / Government,Tajikistan,Asia,13,2,0,11,0,0,13,Human Factor
1992-01-05 00:00:00,Island Air Services - Tanzania,Landing (descent or approach),Operational,Tanzania,Africa,1,1,0,0,0,0,1,Human Factor
1992-01-11 00:00:00,United States Army,Landing (descent or approach),Military / Government,Brazil,South America,0,0,0,0,0,0,0,Unknown
1992-01-14 00:00:00,Private American,Flight,Humanitarian,Mexico,Central America,0,0,0,0,0,0,0,Unknown
1992-01-18 00:00:00,USAir - US Airways,Landing (descent or approach),Commercial,United States of America,North America,41,5,0,36,0,0,41,Weather
1992-01-20 00:00:00,Air Satellite,Takeoff (climb),Operational,Canada,North America,2,2,0,0,0,0,2,Unknown
1992-01-21 00:00:00,Royal Thai Air Force - Kong Thap Akat Thai,Landing (descent or approach),Military / Government,Thailand,Asia,0,0,0,0,0,0,0,Unknown
1992-01-24 00:00:00,Aeroflot - Russian International Airlines,Landing (descent or approach),Commercial,Georgia,Asia,0,0,0,0,0,0,0,Other
1992-01-31 00:00:00,Aero Taxi - Panama,Landing (descent or approach),Commercial,Colombia,South America,13,2,0,11,0,0,13,Terrorism
1992-02-03 00:00:00,West Indies Air Transport,Taxiing,Other,Puerto Rico,Central America,1,1,0,0,0,0,1,Technical Failure
1992-02-06 00:00:00,Spanish Air Force - Ejército del Aire,Takeoff (climb),Military / Government,Spain,Europe,0,0,0,0,0,0,0,Unknown
1992-02-06 00:00:00,Ministic Air,Landing (descent or approach),Operational,Canada,North America,1,1,0,0,0,0,1,Unknown
1992-02-07 00:00:00,Pakistan International Airlines - PIA,Landing (descent or approach),Commercial,Pakistan,Asia,0,0,0,0,0,0,0,Unknown
1992-02-09 00:00:00,Aeroflot - Russian International Airlines,Landing (descent or approach),Commercial,Kazakhstan,Asia,51,5,0,46,0,0,51,Technical Failure
1992-02-11 00:00:00,Tunis Air,Parking,Specialised Services,Tunisia,Africa,0,0,0,0,0,0,0,Human Factor
1992-02-13 00:00:00,Western Aviators,Flight,Humanitarian,United States of America,North America,5,1,0,4,0,0,5,Technical Failure
1992-02-14 00:00:00,Polynesian Airways,Landing (descent or approach),Operational,United States of America,North America,1,1,0,0,0,0,1,Weather
1992-02-15 00:00:00,MK Airlines,Landing (descent or approach),Operational,Nigeria,Africa,5,5,0,0,0,0,5,Unknown
1992-02-15 00:00:00,Air Kenya,Landing (descent or approach),Commercial,Kenya,Africa,0,0,0,0,0,0,0,Unknown
1992-02-18 00:00:00,Transporte Aéreos Universal,Landing (descent or approach),Operational,Bolivia,South America,6,3,0,3,0,0,6,Technical Failure
1992-02-20 00:00:00,TAAG Angola Airlines - Transportes Aéreos de Angola,Taxiing,Operational,Angola,Africa,4,4,0,0,0,0,4,Technical Failure
1992-02-22 00:00:00,Trans Amazon,Landing (descent or approach),Commercial,Peru,South America,45,4,0,41,0,0,45,Human Factor
1992-02-25 00:00:00,Chilean Air Force - Fuerza Aérea de Chile,Landing (descent or approach),Military / Government,Antarctica,Antarctica,11,2,0,9,0,0,11,Unknown
1992-02-26 00:00:00,PMAS Regional Airline,Landing (descent or approach),Commercial,Nigeria,Africa,12,2,0,10,0,0,12,Human Factor
1992-02-26 00:00:00,Kathleen Keller,Landing (descent or approach),Business,Germany,Europe,1,1,0,0,0,0,1,Human Factor
1992-02-27 00:00:00,German Air Force - Deutsche Luftwaffe,Landing (descent or approach),Military / Government,Germany,Europe,0,0,0,0,0,0,0,Unknown
1992-03-01 00:00:00,David D. Maytag Jr.,Flight,Business,United States of America,North America,2,1,0,1,0,0,2,Human Factor
1992-03-03 00:00:00,Everts Air Cargo,Landing (descent or approach),Operational,United States of America,North America,3,3,0,0,0,0,3,Human Factor
1992-03-06 00:00:00,Airborne Express,Landing (descent or approach),Operational,United States of America,North America,3,3,0,0,0,0,3,Human Factor
1992-03-13 00:00:00,Slov-Air,Landing (descent or approach),Commercial,Slovakia,Europe,9,5,0,4,0,0,9,Human Factor
1992-03-13 00:00:00,Aerocaribe - Aerovias Caribe,Landing (descent or approach),Commercial,Mexico,Central America,14,4,0,10,0,0,14,Technical Failure
1992-03-19 00:00:00,ZUA - Zakładu Usług Agrolotniczych - AET Agroaviation Services,Flight,Military / Government,Italy,Europe,0,0,0,0,0,0,0,Unknown
1992-03-26 00:00:00,Intercontinental Colombia - Intercontinental de Aviación,Landing (descent or approach),Commercial,Colombia,South America,92,4,0,88,0,0,92,Human Factor
1992-03-26 00:00:00,Chapelle Darblay,Landing (descent or approach),Business,France,Europe,0,0,0,0,0,0,0,Unknown
1992-03-28 00:00:00,Export Air Cargo,Landing (descent or approach),Operational,Peru,South America,6,3,0,3,0,0,6,Technical Failure
1992-03-30 00:00:00,Aviaco - Aviacion y Comercio,Landing (descent or approach),Commercial,Spain,Europe,99,5,0,94,0,0,99,Human Factor
1992-03-30 00:00:00,Russian Air Force - Voyenno-vozdushnye sily Rossii,Flight,Operational,India,Asia,7,7,0,0,0,0,7,Technical Failure
1992-03-31 00:00:00,Trans-Air Services,Landing (descent or approach),Operational,France,Europe,5,3,0,2,0,0,5,Technical Failure
1992-03-31 00:00:00,Japan Maritime Self-Defense Force - Kaijō Jieitai,Landing (descent or approach),Military / Government,Japan,Asia,0,0,0,0,0,0,0,Technical Failure
1992-04-14 00:00:00,Tatarstan Airlines,Flight,Military / Government,Russia,Asia,2,2,0,0,0,0,2,Technical Failure
1992-04-14 00:00:00,TyumenAviaTrans,Flight,Commercial,Russia,Asia,0,0,0,0,0,0,0,Unknown
1992-04-14 00:00:00,TyumenAviaTrans,Flight,Commercial,Russia,Asia,0,0,0,0,0,0,0,Unknown
1992-04-29 00:00:00,GAS Air Cargo - General %26 Aviation Services,Landing (descent or approach),Operational,Nigeria,Africa,3,3,0,0,0,0,3,Human Factor
1992-05-01 00:00:00,Private British,Flight,Business,World,World,2,1,0,1,0,0,2,Technical Failure
1992-05-02 00:00:00,Cross Country Construction,Landing (descent or approach),Business,United States of America,North America,2,1,0,1,0,0,2,Human Factor
1992-05-06 00:00:00,Kras Air - Krasnoyarsk Avia - Krasnoyarskie Avialinii,Flight,Commercial,Russia,Asia,0,0,0,0,0,0,0,Unknown
1992-05-09 00:00:00,Ararat Avia,Landing (descent or approach),Commercial,Armenia,Asia,33,3,0,30,0,0,33,Terrorism
1992-05-13 00:00:00,Turkmenistan Airlines,Landing (descent or approach),Commercial,Turkmenistan,Asia,38,4,0,34,0,0,38,Human Factor
1992-05-29 00:00:00,United States Air Force - USAF,Landing (descent or approach),Operational,United States of America,North America,14,3,0,11,0,0,14,Human Factor
1992-06-05 00:00:00,Balkan Bulgarian Airlines,Landing (descent or approach),Commercial,Bulgaria,Europe,134,7,0,127,0,0,134,Human Factor
1992-06-10 00:00:00,Aeropulse - Airtransport School,Landing (descent or approach),Operational,Mozambique,Africa,5,4,0,1,0,0,5,Human Factor
1992-06-13 00:00:00,Aerojet,Flight,Operational,Bahamas,Central America,2,1,0,1,0,0,2,Technical Failure
1992-06-21 00:00:00,Aeroflot - Russian International Airlines,Flight,Commercial,Kazakhstan,Asia,0,0,0,0,0,0,0,Unknown
1992-06-22 00:00:00,TAS Airways,Takeoff (climb),Commercial,Italy,Europe,18,3,0,15,0,0,18,Human Factor
1992-06-25 00:00:00,Zero One Tango,Takeoff (climb),Business,United States of America,North America,2,1,0,1,0,0,2,Technical Failure
1992-07-01 00:00:00,Aerolineas JLJ,Flight,Operational,Peru,South America,2,2,0,0,0,0,2,Technical Failure
1992-07-04 00:00:00,Golden Sierra Aviation,Takeoff (climb),Commercial,United States of America,North America,4,1,0,3,0,0,4,Human Factor
1992-07-08 00:00:00,Aeroflot - Russian International Airlines,Flight,Commercial,Russia,Asia,0,0,0,0,0,0,0,Unknown
1992-07-11 00:00:00,PacificAir - Pacific Airways,Takeoff (climb),Commercial,Philippines,Asia,4,1,0,3,0,0,4,Technical Failure
1992-07-14 00:00:00,TANTK - Taganrog ANTK,Landing (descent or approach),Humanitarian,Russia,Asia,4,4,0,0,0,0,4,Other
1992-07-14 00:00:00,Magadan Cargo Airlines,Flight,Operational,Russia,Asia,7,6,0,1,0,0,7,Technical Failure
1992-07-15 00:00:00,Hellenic Air Force - Elleniki Polemiki Aeroporia,Landing (descent or approach),Humanitarian,Greece,Europe,2,2,0,0,0,0,2,Unknown
1992-07-20 00:00:00,MarkAir Express,Flight,Operational,United States of America,North America,1,1,0,0,0,0,1,Human Factor
1992-07-22 00:00:00,Woods Air Service - Woods Air Fuel,Flight,Commercial,United States of America,North America,2,1,0,1,0,0,2,Technical Failure
1992-07-26 00:00:00,Sudanese Air Force - Al Quwwat al-Jawwiya As-Sudaniya,Landing (descent or approach),Military / Government,South Sudan,Africa,0,0,0,0,0,0,0,Unknown
1992-07-30 00:00:00,Trans World Airlines - TWA,Takeoff (climb),Commercial,United States of America,North America,292,12,0,280,0,0,292,Technical Failure
1992-07-31 00:00:00,United States Marine Corps,Takeoff (climb),Military / Government,United States of America,North America,0,0,0,0,0,0,0,Unknown
1992-08-06 00:00:00,Jabil Circuit Company,Landing (descent or approach),Business,United States of America,North America,1,1,0,0,0,0,1,Human Factor
1992-08-10 00:00:00,Air Travel Services,Takeoff (climb),Business,United States of America,North America,1,1,0,0,0,0,1,Human Factor
1992-08-20 00:00:00,Yugavia,Flight,Military / Government,Russia,Asia,1,1,0,0,0,0,1,Technical Failure
1992-08-20 00:00:00,Finnish Government,Landing (descent or approach),Military / Government,Finland,Europe,2,2,0,0,0,0,2,Technical Failure
1992-08-21 00:00:00,Air Saguenay,Flight,Commercial,Canada,North America,7,1,0,6,0,0,7,Human Factor
1992-08-22 00:00:00,Stage Aviation,Landing (descent or approach),Business,United States of America,North America,3,2,0,1,0,0,3,Human Factor
1992-08-22 00:00:00,J. Guzman,Flight,Business,Bolivia,South America,0,0,0,0,0,0,0,Unknown
1992-08-23 00:00:00,Kabo Air,Landing (descent or approach),Commercial,Nigeria,Africa,57,4,0,53,0,0,57,Human Factor
1992-08-26 00:00:00,Isleña Airlines - Isleña de Inversiones,Landing (descent or approach),Commercial,Honduras,Central America,5,1,0,4,0,0,5,Human Factor
1992-08-28 00:00:00,Russian Navy - Voyenno-morskoy Flot Rossii,Takeoff (climb),Specialised Services,World,World,0,0,0,0,0,0,0,Unknown
1992-08-28 00:00:00,Bouraq Indonesia Airlines,Takeoff (climb),Commercial,Indonesia,Asia,77,6,0,71,0,0,77,Technical Failure
1992-08-29 00:00:00,Aeroflot - Russian International Airlines,Landing (descent or approach),Commercial,Ukraine,Europe,58,7,0,51,0,0,58,Human Factor
1992-08-29 00:00:00,Hold-Trade Air,Landing (descent or approach),Commercial,Nigeria,Africa,73,7,0,66,0,0,73,Human Factor
1992-09-04 00:00:00,Marina Aeroservice,Landing (descent or approach),Operational,Spain,Europe,1,1,0,0,0,0,1,Technical Failure
1992-09-05 00:00:00,Air Ukraine,Landing (descent or approach),Commercial,Ukraine,Europe,147,6,0,141,0,0,147,Technical Failure
1992-09-14 00:00:00,Yakutavia,Landing (descent or approach),Commercial,Russia,Asia,28,4,0,24,0,0,28,Technical Failure
1992-09-18 00:00:00,Fairchild Aircraft Corporation,Landing (descent or approach),Specialised Services,United States of America,North America,2,2,0,0,0,0,2,Human Factor
1992-09-18 00:00:00,Dalavia - Dal'nevostochny Avialinii,Landing (descent or approach),Operational,Russia,Asia,2,2,0,0,0,0,2,Technical Failure
1992-09-19 00:00:00,Ecuadorian Air Force - Fuerza Aérea Ecuatoriana,Landing (descent or approach),Military / Government,Ecuador,South America,2,1,0,1,0,0,2,Human Factor
1992-09-21 00:00:00,Air Sweden,Takeoff (climb),Commercial,Sweden,Europe,7,2,0,5,0,0,7,Technical Failure
1992-09-21 00:00:00,Aeroflot - Russian International Airlines,Flight,Commercial,Russia,Asia,0,0,0,0,0,0,0,Unknown
1992-09-26 00:00:00,Nepal Airways,Takeoff (climb),Commercial,Nepal,Asia,14,2,0,12,0,0,14,Other
1992-10-01 00:00:00,Eagle Aviation - Kenya,Takeoff (climb),Commercial,Kenya,Africa,2,2,0,0,0,0,2,Technical Failure
1992-10-13 00:00:00,Belarusian Civil Aviation Administration,Takeoff (climb),Commercial,Russia,Asia,67,5,0,62,0,0,67,Other
1992-10-14 00:00:00,Aeroflot - Russian International Airlines,Flight,Military / Government,Kazakhstan,Asia,3,3,0,0,0,0,3,Unknown
1992-10-15 00:00:00,LAC Colombia - Lineas Aéreas del Caribe,Landing (descent or approach),Operational,Colombia,South America,3,3,0,0,0,0,3,Unknown
1992-10-25 00:00:00,Eagle Aviation - Kenya,Landing (descent or approach),Commercial,Somalia,Africa,10,2,0,8,0,0,10,Other
1992-10-27 00:00:00,Sky Tours - Mozambique,Flight,Commercial,Malawi,Africa,0,0,0,0,0,0,0,Technical Failure
1992-10-29 00:00:00,Osmo Inc.,Landing (descent or approach),Business,Colombia,South America,3,1,0,2,0,0,3,Unknown
1992-10-30 00:00:00,French Navy,Landing (descent or approach),Military / Government,France,Europe,0,0,0,0,0,0,0,Unknown
1992-11-02 00:00:00,Transportes Aéreos San Jorge,Takeoff (climb),Specialised Services,Bolivia,South America,3,3,0,0,0,0,3,Technical Failure
1992-11-03 00:00:00,Ketchikan Air Service,Takeoff (climb),Operational,Antarctica,Antarctica,0,0,0,0,0,0,0,Unknown
1992-11-06 00:00:00,Aerochago Airlines,Takeoff (climb),Operational,United States of America,North America,5,3,0,2,0,0,5,Other
1992-11-07 00:00:00,Halford R. Price,Landing (descent or approach),Business,United States of America,North America,8,2,0,6,0,0,8,Human Factor
1992-11-11 00:00:00,Aviatia Utilitara,Flight,Military / Government,Romania,Europe,0,0,0,0,0,0,0,Unknown
1992-11-12 00:00:00,Aerodinos,Takeoff (climb),Commercial,Bolivia,South America,16,2,0,14,0,0,16,Unknown
1992-11-13 00:00:00,Provincial Airlines,Landing (descent or approach),Commercial,Canada,North America,2,2,0,0,0,0,2,Unknown
1992-11-20 00:00:00,Aerolineas Argentinas,Takeoff (climb),Commercial,Argentina,South America,113,6,0,107,0,0,113,Technical Failure
1992-11-20 00:00:00,Muhl Air,Takeoff (climb),Business,United States of America,North America,4,2,0,2,0,0,4,Human Factor
1992-11-21 00:00:00,Yugavia,Landing (descent or approach),Commercial,Russia,Asia,20,3,0,17,0,0,20,Human Factor
1992-11-22 00:00:00,Farroll Equipment Company,Landing (descent or approach),Business,United States of America,North America,3,1,0,2,0,0,3,Technical Failure
1992-11-25 00:00:00,DAS Air Cargo - Dairo Air Services,Landing (descent or approach),Operational,Nigeria,Africa,4,4,0,0,0,0,4,Human Factor
1992-11-26 00:00:00,Tucson Air,Landing (descent or approach),Operational,United States of America,North America,1,1,0,0,0,0,1,Human Factor
1992-11-26 00:00:00,AeroBrasil Cargo,Landing (descent or approach),Operational,Brazil,South America,4,4,0,0,0,0,4,Human Factor
1992-11-27 00:00:00,Aerospace Finance Leasing,Landing (descent or approach),Business,United Kingdom,Europe,7,2,0,5,0,0,7,Weather
1992-12-01 00:00:00,TAM Brasil - Taxi Aéreo Marilia - Transportes Aéreos Regionais,Landing (descent or approach),Operational,Brazil,South America,4,2,0,2,0,0,4,Human Factor
1992-12-01 00:00:00,Tradewinds Airlines,Landing (descent or approach),Operational,Puerto Rico,Central America,4,4,0,0,0,0,4,Weather
1992-12-05 00:00:00,Aeroflot - Russian International Airlines,Landing (descent or approach),Commercial,Armenia,Asia,154,8,0,146,0,0,154,Human Factor
1992-12-05 00:00:00,MIAT Mongolian Airlines - Mongolyn Irgeniy Agaaryn Teever,Takeoff (climb),Commercial,Mongolia,Asia,0,0,0,0,0,0,0,Unknown
1992-12-08 00:00:00,Trigana Air Service,Takeoff (climb),Operational,Indonesia,Asia,2,2,0,0,0,0,2,Human Factor
1992-12-10 00:00:00,Socata,Landing (descent or approach),Operational,United Kingdom,Europe,6,2,0,4,0,0,6,Human Factor
1992-12-13 00:00:00,Dwyer Air,Landing (descent or approach),Commercial,United States of America,North America,7,1,0,6,0,0,7,Human Factor
1992-12-15 00:00:00,Provo Air Charter,Landing (descent or approach),Commercial,Turks and Caicos Islands,Central America,4,1,0,3,0,0,4,Unknown
1992-12-15 00:00:00,Hong Kong Government,Flight,Operational,China,Asia,2,2,0,0,0,0,2,Technical Failure
1992-12-18 00:00:00,Manchester Group,Takeoff (climb),Business,United States of America,North America,4,2,0,2,0,0,4,Human Factor
1992-12-18 00:00:00,Philippine Air Force - Hukbong Himpapawid NG Pilipinas,Flight,Military / Government,Philippines,Asia,4,2,0,2,0,0,4,Unknown
1992-12-27 00:00:00,Atlantique Air Assistance,Takeoff (climb),Humanitarian,France,Europe,2,1,0,1,0,0,2,Technical Failure
1992-12-31 00:00:00,Líneas Aéreas del Estado - LADE,Takeoff (climb),Military / Government,Argentina,South America,0,0,0,0,0,0,0,Weather
1993-01-02 00:00:00,Express Airlines,Landing (descent or approach),Commercial,United States of America,North America,31,3,0,28,0,0,31,Human Factor
1993-01-02 00:00:00,Chartercraft Leasing %26 Sales,Landing (descent or approach),Operational,Bahamas,Central America,1,1,0,0,0,0,1,Unknown
1993-01-05 00:00:00,Bering Air,Landing (descent or approach),Operational,United States of America,North America,1,1,0,0,0,0,1,Human Factor
1993-01-09 00:00:00,Indian Airlines,Landing (descent or approach),Commercial,India,Asia,165,13,0,152,0,0,165,Human Factor
1993-01-15 00:00:00,Air Afrique,Landing (descent or approach),Operational,Ivory Coast,Africa,6,6,0,0,0,0,6,Human Factor
1993-01-16 00:00:00,Kazakhstan Airlines - Air Kazakhstan - Kazair,Landing (descent or approach),Commercial,Kazakhstan,Asia,23,4,0,19,0,0,23,Technical Failure
1993-01-17 00:00:00,Indonesia Air Transport,Landing (descent or approach),Operational,Indonesia,Asia,2,2,0,0,0,0,2,Human Factor
1993-01-21 00:00:00,DOSAAF,Takeoff (climb),Humanitarian,Russia,Asia,11,1,0,10,0,0,11,Human Factor
1993-01-23 00:00:00,Island Airways - PNG,Landing (descent or approach),Commercial,Papua New Guinea,Oceania,4,1,0,3,0,0,4,Weather
1993-01-29 00:00:00,363 Kingair,Landing (descent or approach),Business,United States of America,North America,8,2,0,6,0,0,8,Human Factor
1993-01-30 00:00:00,Yakutavia,Flight,Commercial,Russia,Asia,4,2,0,2,0,0,4,Human Factor
1993-01-31 00:00:00,Líneas Aéreas del Estado - LADE,Landing (descent or approach),Commercial,Brazil,South America,168,12,0,156,0,0,168,Human Factor
1993-02-03 00:00:00,Yakutavia,Takeoff (climb),Commercial,Russia,Asia,27,4,0,23,0,0,27,Unknown
1993-02-07 00:00:00,M. Wolff,Takeoff (climb),Business,United Kingdom,Europe,2,1,0,1,0,0,2,Human Factor
1993-02-08 00:00:00,ATSA-Aero Transporte - Asesoramientos Tecnicos,Flight,Commercial,Peru,South America,0,0,0,0,0,0,0,Unknown
1993-02-09 00:00:00,United Nations Organization,Takeoff (climb),Humanitarian,Kenya,Africa,4,4,0,0,0,0,4,Unknown
1993-02-10 00:00:00,James B. Heth,Landing (descent or approach),Business,United States of America,North America,1,1,0,0,0,0,1,Technical Failure
1993-02-10 00:00:00,Afghan Republican Air Force - Afghan Hanai Qurah,Landing (descent or approach),Military / Government,Uzbekistan,Asia,119,8,0,111,0,0,119,Technical Failure
1993-02-17 00:00:00,White Industries,Landing (descent or approach),Business,France,Europe,9,2,0,7,0,0,9,Unknown
1993-02-18 00:00:00,Cianbro Corporation,Landing (descent or approach),Business,United States of America,North America,4,1,0,3,0,0,4,Human Factor
1993-02-18 00:00:00,Aerocaribe - Aerovias Caribe,Landing (descent or approach),Commercial,Mexico,Central America,43,3,0,40,0,0,43,Technical Failure
1993-02-18 00:00:00,Aerochago Airlines,Takeoff (climb),Operational,Dominican Republic,Central America,3,3,0,0,0,0,3,Human Factor
1993-02-20 00:00:00,Ryan Air,Takeoff (climb),Commercial,United States of America,North America,2,1,0,1,0,0,2,Human Factor
1993-02-23 00:00:00,MTC Leasing Inc.,Landing (descent or approach),Business,United States of America,North America,2,1,0,1,0,0,2,Technical Failure
1993-03-06 00:00:00,Kenn Borek Air,Takeoff (climb),Operational,Canada,North America,2,2,0,0,0,0,2,Other
1993-03-07 00:00:00,Hast,Takeoff (climb),Operational,United States of America,North America,2,2,0,0,0,0,2,Human Factor
1993-03-08 00:00:00,Compañia Aérea Nacional - CAN,Takeoff (climb),Operational,Bolivia,South America,4,3,0,1,0,0,4,Technical Failure
1993-03-13 00:00:00,Sete Taxi Aéreo,Landing (descent or approach),Commercial,Brazil,South America,7,2,0,5,0,0,7,Human Factor
1993-03-23 00:00:00,Air West Express,Flight,Commercial,Ethiopia,Africa,35,6,0,29,0,0,35,Technical Failure
1993-03-25 00:00:00,Phoenix 2000 Air Taxi,Landing (descent or approach),Operational,Hungary,Europe,2,2,0,0,0,0,2,Unknown
1993-03-30 00:00:00,TANTK - Taganrog ANTK,Landing (descent or approach),Commercial,Russia,Asia,38,4,0,34,0,0,38,Human Factor
1993-04-06 00:00:00,TACA International Airlines - Transportes Aéreos Centro Americanos,Landing (descent or approach),Commercial,Guatemala,Central America,236,9,0,227,0,0,236,Human Factor
1993-04-06 00:00:00,Latavio Latvian Airlines,Landing (descent or approach),Commercial,Armenia,Asia,32,4,0,28,0,0,32,Human Factor
1993-04-07 00:00:00,ZUA - Zakładu Usług Agrolotniczych - AET Agroaviation Services,Flight,Military / Government,Poland,Europe,0,0,0,0,0,0,0,Unknown
1993-04-09 00:00:00,ZUA - Zakładu Usług Agrolotniczych - AET Agroaviation Services,Flight,Military / Government,Turkey,Asia,0,0,0,0,0,0,0,Unknown
1993-04-14 00:00:00,American Airlines,Landing (descent or approach),Commercial,United States of America,North America,202,13,0,189,0,0,202,Human Factor
1993-04-14 00:00:00,Jetcraft Air Cargo,Landing (descent or approach),Operational,Australia,Oceania,1,1,0,0,0,0,1,Technical Failure
1993-04-18 00:00:00,Japan Air System,Landing (descent or approach),Commercial,Japan,Asia,76,4,0,72,0,0,76,Human Factor
1993-04-19 00:00:00,United Express,Takeoff (climb),Operational,United States of America,North America,3,3,0,0,0,0,3,Human Factor
1993-04-20 00:00:00,Phoenix Air - USA,Takeoff (climb),Humanitarian,United States of America,North America,42,2,0,40,0,0,42,Technical Failure
1993-04-29 00:00:00,Continental Express,Flight,Commercial,United States of America,North America,30,3,0,27,0,0,30,Human Factor
1993-05-02 00:00:00,Brian Esler,Flight,Business,United States of America,North America,3,1,0,2,0,0,3,Human Factor
1993-05-05 00:00:00,Baikal Airlines,Landing (descent or approach),Commercial,Russia,Asia,0,0,0,0,0,0,0,Weather
1993-05-06 00:00:00,MarkAir Express,Flight,Operational,United States of America,North America,1,1,0,0,0,0,1,Human Factor
1993-05-06 00:00:00,Atlantic Air BVI,Takeoff (climb),Commercial,British Virgin Islands,Central America,30,3,0,27,0,0,30,Human Factor
1993-05-06 00:00:00,SERCA Colombia - Servicio Especializado de Carga Aérea,Landing (descent or approach),Operational,Guyana,South America,4,4,0,0,0,0,4,Unknown
1993-05-14 00:00:00,Transportes Aéreos Nacionales de la Selva - TANS,Landing (descent or approach),Commercial,Peru,South America,0,0,0,0,0,0,0,Unknown
1993-05-20 00:00:00,AeroVolga,Takeoff (climb),Commercial,Russia,Asia,0,0,0,0,0,0,0,Weather
1993-05-26 00:00:00,Aerocharter Midlands,Landing (descent or approach),Operational,United Kingdom,Europe,2,2,0,0,0,0,2,Human Factor
1993-05-29 00:00:00,Augusta Airways,Takeoff (climb),Commercial,Australia,Oceania,4,1,0,3,0,0,4,Human Factor
1993-06-03 00:00:00,North Coast Aviation - PNG,Flight,Commercial,Papua New Guinea,Oceania,0,0,0,0,0,0,0,Technical Failure
1993-06-10 00:00:00,Five Star Aviation,Takeoff (climb),Business,United States of America,North America,1,1,0,0,0,0,1,Technical Failure
1993-06-12 00:00:00,Thoroughbred Technology,Landing (descent or approach),Business,United Kingdom,Europe,3,1,0,2,0,0,3,Human Factor
1993-06-14 00:00:00,Formosa Airlines,Landing (descent or approach),Commercial,Taiwan,Asia,22,2,0,20,0,0,22,Human Factor
1993-06-20 00:00:00,Frigorifico Reyes,Takeoff (climb),Operational,Bolivia,South America,3,3,0,0,0,0,3,Technical Failure
1993-06-21 00:00:00,Garuda Indonesian Airways,Landing (descent or approach),Commercial,Indonesia,Asia,79,7,0,72,0,0,79,Human Factor
1993-06-23 00:00:00,Shabair,Landing (descent or approach),Commercial,Democratic Republic of Congo,Africa,4,1,0,3,0,0,4,Weather
1993-07-10 00:00:00,Schaked Corporation,Flight,Business,Turks and Caicos Islands,Central America,2,1,0,1,0,0,2,Technical Failure
1993-07-12 00:00:00,Colombian Air Force - Fuerza Aérea Colombiana,Flight,Military / Government,Colombia,South America,7,3,0,4,0,0,7,Technical Failure
1993-07-16 00:00:00,Ronald W. Garner,Landing (descent or approach),Business,United States of America,North America,3,1,0,2,0,0,3,Human Factor
1993-07-18 00:00:00,SAHSA - Servicios Aéreos de Honduras SA,Landing (descent or approach),Commercial,Nicaragua,Central America,94,6,0,88,0,0,94,Human Factor
1993-07-19 00:00:00,Servivensa - Servicios Avensa - Servicios Aerovias Venezolanas,Landing (descent or approach),Commercial,Venezuela,South America,65,5,0,60,0,0,65,Human Factor
1993-07-26 00:00:00,TMA of Lebanon - Trans Mediterranean Airways,Taxiing,Operational,Netherlands,Europe,3,3,0,0,0,0,3,Technical Failure
1993-07-27 00:00:00,Renoun Aviation,Landing (descent or approach),Operational,United States of America,North America,3,3,0,0,0,0,3,Human Factor
1993-08-02 00:00:00,MarkAir Express,Landing (descent or approach),Operational,United States of America,North America,1,1,0,0,0,0,1,Human Factor
1993-08-07 00:00:00,Aviakor,Flight,Commercial,Sudan,Africa,23,9,0,14,0,0,23,Other
1993-08-09 00:00:00,Servicios y Transportes Aéreos Petroleros - STAP,Landing (descent or approach),Commercial,Bolivia,South America,7,2,0,5,0,0,7,Technical Failure
1993-08-13 00:00:00,Marc Aviation,Flight,Business,United States of America,North America,7,1,0,6,0,0,7,Technical Failure
1993-08-18 00:00:00,Kalitta Air,Landing (descent or approach),Operational,Cuba,Central America,3,3,0,0,0,0,3,Human Factor
1993-08-19 00:00:00,Ketchum Air Service,Takeoff (climb),Commercial,United States of America,North America,6,1,0,5,0,0,6,Technical Failure
1993-08-20 00:00:00,Komi Avia,Takeoff (climb),Operational,Russia,Asia,6,6,0,0,0,0,6,Other
1993-08-25 00:00:00,Air Sunshine,Flight,Commercial,United States of America,North America,5,1,0,4,0,0,5,Technical Failure
1993-08-26 00:00:00,BAC Inc.,Landing (descent or approach),Business,United States of America,North America,2,2,0,0,0,0,2,Human Factor
1993-08-26 00:00:00,TAM Brasil - Taxi Aéreo Marilia - Transportes Aéreos Regionais,Takeoff (climb),Humanitarian,Brazil,South America,8,2,0,6,0,0,8,Terrorism
1993-08-28 00:00:00,Hungarian Aeronautical Association - Magyar Repülő Szövetség,Takeoff (climb),Humanitarian,United Kingdom,Europe,19,2,0,17,0,0,19,Technical Failure
1993-08-29 00:00:00,Hokie Airco,Landing (descent or approach),Business,United States of America,North America,3,1,0,2,0,0,3,Human Factor
1993-08-29 00:00:00,Magnitogorsk Avia,Landing (descent or approach),Operational,Ukraine,Europe,5,5,0,0,0,0,5,Human Factor
1993-08-31 00:00:00,Aerosol - Aerovias Sol de Colombia,Flight,Operational,Colombia,South America,2,2,0,0,0,0,2,Unknown
1993-08-31 00:00:00,J. G. Abdi,Takeoff (climb),Operational,Kenya,Africa,1,1,0,0,0,0,1,Technical Failure
1993-09-02 00:00:00,Transportes Aéreos Ejecutivos - TAESA,Landing (descent or approach),Commercial,Mexico,Central America,6,2,0,4,0,0,6,Human Factor
1993-09-03 00:00:00,Aero Condor - Servicio de Transporte Aéreo Turistico - STAT,Landing (descent or approach),Commercial,Argentina,South America,4,2,0,2,0,0,4,Technical Failure
1993-09-05 00:00:00,DEKA Research %26 Development Company,Landing (descent or approach),Business,United States of America,North America,4,1,0,3,0,0,4,Human Factor
1993-09-05 00:00:00,Dominicana de Aviación,Landing (descent or approach),Commercial,Dominican Republic,Central America,105,7,0,98,0,0,105,Technical Failure
1993-09-07 00:00:00,GB Express,Flight,Commercial,United Kingdom,Europe,4,1,0,3,0,0,4,Technical Failure
1993-09-07 00:00:00,Airfast Indonesia,Landing (descent or approach),Commercial,Indonesia,Asia,6,2,0,4,0,0,6,Human Factor
1993-09-12 00:00:00,KAL Aero Marine,Takeoff (climb),Commercial,Bahamas,Central America,8,1,0,7,0,0,8,Unknown
1993-09-13 00:00:00,Frigorifico Santa Rita,Takeoff (climb),Operational,Bolivia,South America,3,3,0,0,0,0,3,Technical Failure
1993-09-14 00:00:00,Servicios Aéreos Santa Ana - SASA,Flight,Operational,Peru,South America,3,3,0,0,0,0,3,Technical Failure
1993-09-15 00:00:00,Dalavia - Dal'nevostochny Avialinii,Flight,Commercial,Russia,Asia,0,0,0,0,0,0,0,Unknown
1993-09-19 00:00:00,Airlec,Takeoff (climb),Commercial,France,Europe,19,2,0,17,0,0,19,Human Factor
1993-09-25 00:00:00,Rostvertol,Landing (descent or approach),Operational,Russia,Asia,4,4,0,0,0,0,4,Technical Failure
1993-09-26 00:00:00,Lineas Aéreas de Ucayali - LAUSA,Landing (descent or approach),Commercial,Peru,South America,6,2,0,4,0,0,6,Technical Failure
1993-09-26 00:00:00,Aeroflot - Russian International Airlines,,Commercial,Russia,Asia,0,0,0,0,0,0,0,Unknown
1993-10-05 00:00:00,Jama Guled Abdi,Landing (descent or approach),Business,Kenya,Africa,0,0,0,0,0,0,0,Unknown
1993-10-06 00:00:00,Myanma Airways,Landing (descent or approach),Commercial,Myanmar,Asia,45,4,0,41,0,0,45,Human Factor
1993-10-08 00:00:00,Brooks Fuel,Landing (descent or approach),Operational,United States of America,North America,3,2,0,1,0,0,3,Other
1993-10-13 00:00:00,Flight Contract Services,Flight,Operational,United States of America,North America,2,2,0,0,0,0,2,Technical Failure
1993-10-19 00:00:00,Swiftair,Landing (descent or approach),Operational,Spain,Europe,2,2,0,0,0,0,2,Human Factor
1993-10-25 00:00:00,Far Eastern Air Transport - FAT,Landing (descent or approach),Commercial,Taiwan,Asia,160,8,0,152,0,0,160,Technical Failure
1993-10-25 00:00:00,Sahakol Air,Landing (descent or approach),Specialised Services,Thailand,Asia,2,2,0,0,0,0,2,Technical Failure
1993-10-31 00:00:00,TANTK - Taganrog ANTK,Landing (descent or approach),Commercial,Russia,Asia,20,4,0,16,0,0,20,Human Factor
1993-11-03 00:00:00,CAMBA Transportes Aéreos - Comercializadora Aérea Mixta Boliviana,Landing (descent or approach),Operational,Bolivia,South America,3,3,0,0,0,0,3,Technical Failure
1993-11-04 00:00:00,China Airlines,Landing (descent or approach),Commercial,China,Asia,296,22,0,274,0,0,296,Human Factor
1993-11-07 00:00:00,Professional Aviation Services,Takeoff (climb),Humanitarian,Kenya,Africa,4,3,0,1,0,0,4,Human Factor
1993-11-08 00:00:00,Nepal Airways,Landing (descent or approach),Commercial,Nepal,Asia,19,3,0,16,0,0,19,Human Factor
1993-11-10 00:00:00,Ketchikan Air Service,Takeoff (climb),Operational,United States of America,North America,3,1,0,2,0,0,3,Unknown
1993-11-11 00:00:00,Turkmenistan Airlines,Flight,Commercial,Turkmenistan,Asia,4,2,0,2,0,0,4,Technical Failure
1993-11-12 00:00:00,Allen J. Hicks,Landing (descent or approach),Business,Canada,North America,1,1,0,0,0,0,1,Unknown
1993-11-13 00:00:00,Aéreo Transporte La Montaña,Flight,Operational,Venezuela,South America,2,2,0,0,0,0,2,Technical Failure
1993-11-15 00:00:00,Indian Airlines,Flight,Commercial,India,Asia,262,12,0,250,0,0,262,Technical Failure
1993-11-19 00:00:00,COPA Panama - Compania Panamena de Aviacion,Landing (descent or approach),Commercial,Panama,Central America,92,6,0,86,0,0,92,Human Factor
1993-11-23 00:00:00,32 Romeo Golf,Takeoff (climb),Business,Mexico,Central America,4,1,0,3,0,0,4,Human Factor
1993-11-23 00:00:00,Transportes Aéreos Marañón,Flight,Commercial,Peru,South America,0,0,0,0,0,0,0,Unknown
1993-11-26 00:00:00,VIASA - Venezolana Internacional de Aviacion SA,Landing (descent or approach),Commercial,Argentina,South America,123,17,0,106,0,0,123,Other
1993-11-26 00:00:00,Allcair Air Transport,Landing (descent or approach),Operational,Antarctica,Antarctica,8,6,0,2,0,0,8,Human Factor
1993-12-01 00:00:00,Government of Quebec,Landing (descent or approach),Military / Government,Canada,North America,13,2,0,11,0,0,13,Human Factor
1993-12-02 00:00:00,CAE Aviation,Landing (descent or approach),Commercial,Liberia,Africa,13,2,0,11,0,0,13,Unknown
1993-12-03 00:00:00,Rudge Air,Takeoff (climb),Commercial,Australia,Oceania,10,2,0,8,0,0,10,Technical Failure
1993-12-06 00:00:00,Transportes Aéreos Meridionais,Landing (descent or approach),Commercial,Brazil,South America,4,2,0,2,0,0,4,Technical Failure
1993-12-06 00:00:00,Provincial Airlines,Landing (descent or approach),Operational,Canada,North America,2,2,0,0,0,0,2,Technical Failure
1993-12-07 00:00:00,Daniel G. Maloney,Takeoff (climb),Business,United States of America,North America,5,1,0,4,0,0,5,Human Factor
1993-12-09 00:00:00,Gambia Airways,Takeoff (climb),Commercial,Senegal,Africa,38,4,0,34,0,0,38,Human Factor
1993-12-10 00:00:00,Airlink Papua New Guinea,Landing (descent or approach),Operational,Papua New Guinea,Oceania,1,1,0,0,0,0,1,Unknown
1993-12-12 00:00:00,Air Tanzania,Landing (descent or approach),Operational,Tanzania,Africa,2,2,0,0,0,0,2,Human Factor
1993-12-13 00:00:00,Civil Aviation Authority of Malaysia,Landing (descent or approach),Military / Government,Malaysia,Asia,6,2,0,4,0,0,6,Unknown
1993-12-13 00:00:00,Kadvi Company,Landing (descent or approach),Operational,Armenia,Asia,8,5,0,3,0,0,8,Human Factor
1993-12-14 00:00:00,Kras Air - Krasnoyarsk Avia - Krasnoyarskie Avialinii,Takeoff (climb),Commercial,Russia,Asia,16,1,0,15,0,0,16,Technical Failure
1993-12-15 00:00:00,John F. Burton,Landing (descent or approach),Business,United States of America,North America,1,1,0,0,0,0,1,Technical Failure
1993-12-19 00:00:00,Air Lithuania,Flight,Commercial,Poland,Europe,0,0,0,0,0,0,0,Unknown
1993-12-22 00:00:00,Aeroflot - Russian International Airlines,Flight,Commercial,Russia,Asia,10,2,0,8,0,0,10,Technical Failure
1993-12-24 00:00:00,Rimbunan Hijau,Takeoff (climb),Operational,Papua New Guinea,Oceania,3,1,0,2,0,0,3,Technical Failure
1993-12-25 00:00:00,Vnukovo Airlines - Vnukovskie Avialinii,Landing (descent or approach),Commercial,Russia,Asia,172,7,0,165,0,0,172,Human Factor
1993-12-28 00:00:00,Philippine Air Force - Hukbong Himpapawid NG Pilipinas,Flight,Military / Government,Philippines,Asia,6,2,0,4,0,0,6,Unknown
1993-12-31 00:00:00,Mozambique Air Force - Força Aérea de Moçambique,Landing (descent or approach),Military / Government,Mozambique,Africa,0,0,0,0,0,0,0,Human Factor
1993-12-31 00:00:00,Aerogaviota,Landing (descent or approach),Specialised Services,Cuba,Central America,0,0,0,0,0,0,0,Unknown
1994-01-06 00:00:00,Dirgantara Air Service,Flight,Commercial,Indonesia,Asia,10,1,0,9,0,0,10,Technical Failure
1994-01-08 00:00:00,Travair,Landing (descent or approach),Commercial,Romania,Europe,10,2,0,8,0,0,10,Human Factor
1994-01-13 00:00:00,Charles Kuykendall,Flight,Operational,France,Europe,1,1,0,0,0,0,1,Technical Failure
1994-01-15 00:00:00,The Catalina Company,Flight,Business,World,World,8,1,0,7,0,0,8,Technical Failure
1994-01-18 00:00:00,Conquest Charter Corporation,Landing (descent or approach),Business,United States of America,North America,1,1,0,0,0,0,1,Other
1994-01-21 00:00:00,Trans Service Airlift - TSA,Landing (descent or approach),Operational,Democratic Republic of Congo,Africa,0,0,0,0,0,0,0,Technical Failure
1994-01-23 00:00:00,Lineas Aéreas Entre Rios - LAER,Landing (descent or approach),Operational,Argentina,South America,2,2,0,0,0,0,2,Human Factor
1994-01-30 00:00:00,Líneas Aéreas Suramericanas,Landing (descent or approach),Operational,Colombia,South America,3,3,0,0,0,0,3,Other
1994-02-01 00:00:00,KolymaAvia,Takeoff (climb),Commercial,Russia,Asia,53,5,0,48,0,0,53,Other
1994-02-05 00:00:00,North-West Parachute Center,Landing (descent or approach),Humanitarian,United Kingdom,Europe,1,1,0,0,0,0,1,Human Factor
1994-02-08 00:00:00,AeroVolga,Landing (descent or approach),Operational,Russia,Asia,11,6,0,5,0,0,11,Human Factor
1994-02-15 00:00:00,Aerosol - Aerovias Sol de Colombia,Landing (descent or approach),Other,Colombia,South America,0,0,0,0,0,0,0,Technical Failure
1994-02-16 00:00:00,H %26 G Import %26 Export Corporation,Landing (descent or approach),Operational,United States of America,North America,1,1,0,0,0,0,1,Human Factor
1994-02-21 00:00:00,Eastern Air Charter,Landing (descent or approach),Commercial,United States of America,North America,5,2,0,3,0,0,5,Human Factor
1994-03-08 00:00:00,Aeroflot - Russian International Airlines,Parking,Commercial,India,Asia,0,0,0,0,0,0,0,Human Factor
1994-03-09 00:00:00,Zanair,Takeoff (climb),Operational,Tanzania,Africa,1,1,0,0,0,0,1,Unknown
1994-03-11 00:00:00,Aéro-Service,Landing (descent or approach),Commercial,Congo,Africa,6,2,0,4,0,0,6,Human Factor
1994-03-15 00:00:00,Caribintair,Takeoff (climb),Commercial,Haiti,Central America,9,1,0,8,0,0,9,Unknown
1994-03-15 00:00:00,SEC Colombia - Servicio Especializado de Carga Aérea,Landing (descent or approach),Operational,Colombia,South America,9,3,0,6,0,0,9,Technical Failure
1994-03-16 00:00:00,Mavewa - Sociedade Comercial e Industrial,Flight,Operational,Angola,Africa,1,1,0,0,0,0,1,Technical Failure
1994-03-19 00:00:00,SATENA - Servicio de Aeronavegacion a Territorios Nacionales,Flight,Commercial,Colombia,South America,29,4,0,25,0,0,29,Technical Failure
1994-03-20 00:00:00,Crystal Air %26 Aviation,Landing (descent or approach),Operational,United States of America,North America,2,2,0,0,0,0,2,Human Factor
1994-03-21 00:00:00,Aviaco - Aviacion y Comercio,Landing (descent or approach),Commercial,Spain,Europe,116,6,0,110,0,0,116,Human Factor
1994-03-23 00:00:00,United States Air Force - USAF,Parking,Military / Government,United States of America,North America,0,0,0,0,0,0,0,Human Factor
1994-03-25 00:00:00,South Florida Truck Sales,Landing (descent or approach),Commercial,Bahamas,Central America,2,1,0,1,0,0,2,Unknown
1994-03-27 00:00:00,Multi Servicios Lujal,Landing (descent or approach),Operational,Venezuela,South America,2,2,0,0,0,0,2,Technical Failure
1994-04-04 00:00:00,ICIPA,Landing (descent or approach),Business,Spain,Europe,10,2,0,8,0,0,10,Technical Failure
1994-04-07 00:00:00,Angola Air Charter,Landing (descent or approach),Operational,Angola,Africa,5,5,0,0,0,0,5,Technical Failure
1994-04-15 00:00:00,Royal Malaysian Air Force - Tentera Udara Diraja Malaysia,Landing (descent or approach),Operational,Malaysia,Asia,3,3,0,0,0,0,3,Human Factor
1994-04-23 00:00:00,Air Manitoba,Takeoff (climb),Operational,Kenya,Africa,2,2,0,0,0,0,2,Technical Failure
1994-04-24 00:00:00,South Pacific Airmotive - SPA,Takeoff (climb),Commercial,Australia,Oceania,25,4,0,21,0,0,25,Technical Failure
1994-04-27 00:00:00,Transafrik,Landing (descent or approach),Operational,Angola,Africa,3,3,0,0,0,0,3,Human Factor
1994-05-06 00:00:00,South African Air Force,Takeoff (climb),Military / Government,South Africa,Africa,2,2,0,0,0,0,2,Technical Failure
1994-05-07 00:00:00,Martin L. Adren,Flight,Business,World,World,4,1,0,3,0,0,4,Technical Failure
1994-05-07 00:00:00,Rico Taxi Aéreo - Rondonia Importaçao e Comercio,Landing (descent or approach),Commercial,Brazil,South America,16,2,0,14,0,0,16,Human Factor
1994-05-07 00:00:00,Aeroflot - Russian International Airlines,Landing (descent or approach),Commercial,Russia,Asia,62,6,0,56,0,0,62,Technical Failure
1994-05-08 00:00:00,ATA - Aerocondor Transportes Aéreos,Landing (descent or approach),Commercial,Portugal,Europe,4,2,0,2,0,0,4,Technical Failure
1994-05-12 00:00:00,KoryakAvia,Landing (descent or approach),Commercial,Russia,Asia,12,2,0,10,0,0,12,Weather
1994-05-21 00:00:00,Inversiones Agropecuarias del Casanare - IAC,Landing (descent or approach),Commercial,Colombia,South America,9,3,0,6,0,0,9,Technical Failure
1994-05-30 00:00:00,DB Aviation,Landing (descent or approach),Operational,United States of America,North America,2,2,0,0,0,0,2,Human Factor
1994-06-14 00:00:00,Aeroflot - Russian International Airlines,Taxiing,Commercial,Russia,Asia,14,3,0,11,0,0,14,Human Factor
1994-06-18 00:00:00,G. G. Trucking,Takeoff (climb),Commercial,Canada,North America,6,1,0,5,0,0,6,Other
1994-06-21 00:00:00,Tatarstan Airlines,Flight,Humanitarian,Russia,Asia,1,1,0,0,0,0,1,Human Factor
1994-06-25 00:00:00,Aeroflot - Russian International Airlines,Takeoff (climb),Commercial,Russia,Asia,8,2,0,6,0,0,8,Technical Failure
1994-06-26 00:00:00,E. Siebzehnrübl,Landing (descent or approach),Operational,Germany,Europe,1,1,0,0,0,0,1,Human Factor
1994-06-26 00:00:00,Buffalo Airways,Landing (descent or approach),Operational,Canada,North America,2,2,0,0,0,0,2,Technical Failure
1994-06-29 00:00:00,Air Provence International,Landing (descent or approach),Commercial,France,Europe,27,3,0,24,0,0,27,Technical Failure
1994-07-06 00:00:00,Pakistan International Airlines - PIA,Landing (descent or approach),Commercial,Pakistan,Asia,42,4,0,38,0,0,42,Technical Failure
1994-07-06 00:00:00,Air Zanzibar,Landing (descent or approach),Operational,Tanzania,Africa,1,1,0,0,0,0,1,Other
1994-07-09 00:00:00,Freefall Express,Takeoff (climb),Operational,United States of America,North America,2,1,0,1,0,0,2,Human Factor
1994-07-09 00:00:00,ACM Prag - Prague Aeroclub,Landing (descent or approach),Commercial,Austria,Europe,0,0,0,0,0,0,0,Unknown
1994-07-12 00:00:00,Transporte Aéreo Taxi - TATSA,Takeoff (climb),Commercial,Peru,South America,11,1,0,10,0,0,11,Unknown
1994-07-12 00:00:00,Clifford Botway,Takeoff (climb),Business,United States of America,North America,5,2,0,3,0,0,5,Human Factor
1994-07-13 00:00:00,Budget Marketing,Takeoff (climb),Business,United States of America,North America,5,1,0,4,0,0,5,Technical Failure
1994-07-13 00:00:00,South African Air Force,Flight,Military / Government,Western Sahara,Africa,19,3,0,16,0,0,19,Technical Failure
1994-07-15 00:00:00,West Air Aviation,Landing (descent or approach),Other,Namibia,Africa,0,0,0,0,0,0,0,Unknown
1994-07-17 00:00:00,Bykovo Avia,Takeoff (climb),Commercial,Ukraine,Europe,32,4,0,28,0,0,32,Human Factor
1994-07-20 00:00:00,China Yunnan Airlines,Landing (descent or approach),Commercial,China,Asia,148,8,0,140,0,0,148,Human Factor
1994-08-01 00:00:00,Turkish Air Force - Türk Hava Kuvvetleri,Takeoff (climb),Military / Government,Turkey,Asia,3,3,0,0,0,0,3,Technical Failure
1994-08-01 00:00:00,Morozov i K,Landing (descent or approach),Commercial,Russia,Asia,17,2,0,15,0,0,17,Human Factor
1994-08-08 00:00:00,Tawakal Airlines,Takeoff (climb),Operational,Kenya,Africa,3,1,0,2,0,0,3,Human Factor
1994-08-10 00:00:00,Korean Air,Landing (descent or approach),Commercial,South Korea,Asia,160,8,0,152,0,0,160,Human Factor
1994-08-18 00:00:00,ADC Airlines - Aviation Development Company,Landing (descent or approach),Commercial,Liberia,Africa,85,11,0,74,0,0,85,Human Factor
1994-08-18 00:00:00,TyumenAviaTrans,Flight,Commercial,Russia,Asia,0,0,0,0,0,0,0,Technical Failure
1994-08-28 00:00:00,Conair Aviation,Flight,Humanitarian,Canada,North America,1,1,0,0,0,0,1,Human Factor
1994-09-14 00:00:00,FCF-Bowers,Landing (descent or approach),Business,United States of America,North America,4,1,0,3,0,0,4,Technical Failure
1994-09-15 00:00:00,Kayman Sankar Aviation,Landing (descent or approach),Operational,Guyana,South America,1,1,0,0,0,0,1,Unknown
1994-09-20 00:00:00,Romanian Air Force - Fortele Aeriene Române,Takeoff (climb),Military / Government,Romania,Europe,11,6,0,5,0,0,11,Human Factor
1994-09-29 00:00:00,MAP Kaluga Motors,Landing (descent or approach),Operational,Russia,Asia,24,6,0,18,0,0,24,Technical Failure
1994-10-08 00:00:00,Selva Colombia - Servicios Aéreos del Vaupés,Landing (descent or approach),Operational,Colombia,South America,5,5,0,0,0,0,5,Human Factor
1994-10-09 00:00:00,TAMPA Cargo,Landing (descent or approach),Operational,Brazil,South America,5,5,0,0,0,0,5,Technical Failure
1994-10-15 00:00:00,Essam al-Ridi,Landing (descent or approach),Specialised Services,Sudan,Africa,2,2,0,0,0,0,2,Technical Failure
1994-10-23 00:00:00,Federal Border Guard Aviation Command,Takeoff (climb),Military / Government,Russia,Asia,34,5,0,29,0,0,34,Technical Failure
1994-11-01 00:00:00,Keys Family LLC,Landing (descent or approach),Business,United States of America,North America,4,1,0,3,0,0,4,Human Factor
1994-11-04 00:00:00,Federal Office of Civil Aviation,Takeoff (climb),Operational,Switzerland,Europe,2,2,0,0,0,0,2,Human Factor
1994-11-06 00:00:00,Kosmos %26 Transport,Flight,Operational,Russia,Asia,9,5,0,4,0,0,9,Human Factor
1994-11-09 00:00:00,Líder Taxi Aéreo,Landing (descent or approach),Commercial,Brazil,South America,5,2,0,3,0,0,5,Human Factor
1994-11-12 00:00:00,Endiama,Landing (descent or approach),Business,Angola,Africa,10,2,0,8,0,0,10,Human Factor
1994-11-21 00:00:00,Top Air,Landing (descent or approach),Operational,France,Europe,3,3,0,0,0,0,3,Human Factor
1994-11-23 00:00:00,Air Satellite,Landing (descent or approach),Operational,Canada,North America,1,1,0,0,0,0,1,Human Factor
1994-11-24 00:00:00,TAM Paraguay - Transporte Aéreo Militar,Takeoff (climb),Military / Government,Paraguay,South America,3,3,0,0,0,0,3,Unknown
1994-11-26 00:00:00,Continental Airlines,Taxiing,Commercial,United States of America,North America,2,2,0,0,0,0,2,Human Factor
1994-11-30 00:00:00,Merpati Nusantara Airlines - MNA,Landing (descent or approach),Commercial,Indonesia,Asia,85,6,0,79,0,0,85,Human Factor
1994-12-02 00:00:00,Southern Cross Aviation,Flight,Operational,World,World,1,1,0,0,0,0,1,Technical Failure
1994-12-05 00:00:00,Dornier Flugzeugwerke,Landing (descent or approach),Operational,Greenland,Europe,2,1,0,1,0,0,2,Technical Failure
1994-12-06 00:00:00,Von Haaf Air,Takeoff (climb),Operational,Angola,Africa,6,6,0,0,0,0,6,Unknown
1994-12-08 00:00:00,Air Gabon,Landing (descent or approach),Commercial,Gabon,Africa,21,4,0,17,0,0,21,Unknown
1994-12-21 00:00:00,Servicios Aéreos Facchini,Takeoff (climb),Operational,Argentina,South America,2,2,0,0,0,0,2,Human Factor
1994-12-22 00:00:00,Lloyd Aéreo Boliviano - LAB Airlines,Takeoff (climb),Commercial,Bolivia,South America,40,4,0,36,0,0,40,Technical Failure
1994-12-31 00:00:00,TAM Bolivia - Transporte Aéreo Militar Boliviano,Takeoff (climb),Operational,Bolivia,South America,4,4,0,0,0,0,4,Unknown
1994-12-31 00:00:00,Belair,Landing (descent or approach),Operational,Bosnia and Herzegovina,Europe,6,6,0,0,0,0,6,Human Factor
1995-01-02 00:00:00,Air Zaïre,Landing (descent or approach),Commercial,Democratic Republic of Congo,Africa,0,0,0,0,0,0,0,Human Factor
1995-01-03 00:00:00,Islands Nationair,Takeoff (climb),Operational,Papua New Guinea,Oceania,2,2,0,0,0,0,2,Unknown
1995-01-09 00:00:00,Gladys Enterprises,Landing (descent or approach),Business,United States of America,North America,3,1,0,2,0,0,3,Human Factor
1995-01-15 00:00:00,Kazakh Government,Taxiing,Military / Government,Kazakhstan,Asia,0,0,0,0,0,0,0,Unknown
1995-01-16 00:00:00,Sempati Air,Landing (descent or approach),Commercial,Indonesia,Asia,58,6,0,52,0,0,58,Human Factor
1995-01-18 00:00:00,Martinaire,Takeoff (climb),Operational,United States of America,North America,1,1,0,0,0,0,1,Human Factor
1995-01-21 00:00:00,Kazakhstan Airlines - Air Kazakhstan - Kazair,Takeoff (climb),Commercial,Pakistan,Asia,117,12,0,105,0,0,117,Human Factor
1995-01-23 00:00:00,Air Ukraine,Landing (descent or approach),Operational,Russia,Asia,3,2,0,1,0,0,3,Technical Failure
1995-01-24 00:00:00,Harolds Flying Service,Takeoff (climb),Business,United States of America,North America,2,2,0,0,0,0,2,Technical Failure
1995-01-25 00:00:00,Volga Airlines - Aviakompania Volga,Landing (descent or approach),Commercial,Russia,Asia,10,4,0,6,0,0,10,Human Factor
1995-01-25 00:00:00,Northway Aviation,Landing (descent or approach),Commercial,Canada,North America,2,1,0,1,0,0,2,Human Factor
1995-01-26 00:00:00,Guinée Air Service,Takeoff (climb),Commercial,Guinea,Africa,24,3,0,21,0,0,24,Human Factor
1995-01-31 00:00:00,Angola Air Charter,Landing (descent or approach),Operational,Angola,Africa,3,3,0,0,0,0,3,Human Factor
1995-02-01 00:00:00,Chukotavia,Landing (descent or approach),Commercial,Russia,Asia,10,2,0,8,0,0,10,Human Factor
1995-02-02 00:00:00,VASP - Viação Aérea de São Paulo,Landing (descent or approach),Commercial,Brazil,South America,128,7,0,121,0,0,128,Technical Failure
1995-02-02 00:00:00,Berjaya Air,Taxiing,Commercial,Malaysia,Asia,19,2,0,17,0,0,19,Human Factor
1995-02-06 00:00:00,Arkhangelsk Airlines,Landing (descent or approach),Commercial,Russia,Asia,38,4,0,34,0,0,38,Human Factor
1995-02-09 00:00:00,Aviapaslauga,Flight,Commercial,Poland,Europe,0,0,0,0,0,0,0,Unknown
1995-02-09 00:00:00,Jetspread,Takeoff (climb),Military / Government,New Zealand,Oceania,1,1,0,0,0,0,1,Unknown
1995-02-10 00:00:00,Antonov Design Bureau,Flight,Specialised Services,Ukraine,Europe,0,0,0,0,0,0,0,Human Factor
1995-02-14 00:00:00,Tiger Aviation,Landing (descent or approach),Business,United States of America,North America,4,1,0,3,0,0,4,Human Factor
1995-02-15 00:00:00,ROSTO,Flight,Commercial,Russia,Asia,0,0,0,0,0,0,0,Human Factor
1995-02-21 00:00:00,Bearskin Airlines - Bearskin Lake Air Services,Landing (descent or approach),Commercial,Canada,North America,11,2,0,9,0,0,11,Human Factor
1995-02-27 00:00:00,Tanzanair - Tanzanian Air Services,Takeoff (climb),Commercial,Tanzania,Africa,6,1,0,5,0,0,6,Unknown
1995-03-01 00:00:00,Lignum,Landing (descent or approach),Business,Canada,North America,4,2,0,2,0,0,4,Human Factor
1995-03-04 00:00:00,Policía Nacional del Peru,Landing (descent or approach),Military / Government,Brazil,South America,8,3,0,5,0,0,8,Other
1995-03-10 00:00:00,Ketchikan Air Service,Flight,Commercial,United States of America,North America,3,1,0,2,0,0,3,Human Factor
1995-03-12 00:00:00,Trans Fair,Landing (descent or approach),Operational,Canada,North America,3,3,0,0,0,0,3,Other
1995-03-13 00:00:00,Private German,Flight,Business,Germany,Europe,5,1,0,4,0,0,5,Human Factor
1995-03-13 00:00:00,Blue Airlines,Landing (descent or approach),Operational,Democratic Republic of Congo,Africa,0,0,0,0,0,0,0,Human Factor
1995-03-14 00:00:00,Penza Air Enterprise - Penzenskoe Aviapredpriatie,Landing (descent or approach),Operational,Azerbaijan,Asia,15,7,0,8,0,0,15,Human Factor
1995-03-16 00:00:00,Leafair,Takeoff (climb),Military / Government,Australia,Oceania,1,1,0,0,0,0,1,Human Factor
1995-03-16 00:00:00,Great Barrier Airlines,Flight,Operational,World,World,3,3,0,0,0,0,3,Human Factor
1995-03-18 00:00:00,Gulf %26 Caribbean Cargo,Landing (descent or approach),Commercial,Haiti,Central America,31,2,0,29,0,0,31,Technical Failure
1995-03-20 00:00:00,Transmile Air Services,Takeoff (climb),Operational,Malaysia,Asia,2,2,0,0,0,0,2,Unknown
1995-03-20 00:00:00,Yute Air Alaska,Flight,Commercial,United States of America,North America,2,1,0,1,0,0,2,Human Factor
1995-03-23 00:00:00,Caribe Air Cargo,Landing (descent or approach),Operational,Bahamas,Central America,2,1,0,1,0,0,2,Human Factor
1995-03-23 00:00:00,Aviation Boréal,Takeoff (climb),Operational,Canada,North America,2,2,0,0,0,0,2,Other
1995-03-25 00:00:00,United States Navy - USN,Landing (descent or approach),Military / Government,Oman,Asia,11,11,0,0,0,0,11,Technical Failure
1995-03-27 00:00:00,Amuraviatrans,Landing (descent or approach),Operational,Democratic Republic of Congo,Africa,10,6,0,4,0,0,10,Human Factor
1995-04-04 00:00:00,Central Region Airlines - Avialinii Tsentralnykh Rayonov,Takeoff (climb),Operational,Russia,Asia,9,6,0,3,0,0,9,Human Factor
1995-04-06 00:00:00,French Air Force - Armée de l'Air,Takeoff (climb),Military / Government,France,Europe,6,6,0,0,0,0,6,Unknown
1995-04-07 00:00:00,Jetcraft Corporation,Landing (descent or approach),Business,Dominican Republic,Central America,6,2,0,4,0,0,6,Human Factor
1995-04-08 00:00:00,SEC Colombia - Servicio Especializado de Carga Aérea,Takeoff (climb),Operational,Colombia,South America,4,4,0,0,0,0,4,Human Factor
1995-04-11 00:00:00,Transportes Aéreos Meridionais,Landing (descent or approach),Operational,Brazil,South America,5,5,0,0,0,0,5,Human Factor
1995-04-12 00:00:00,Islands Nationair,Landing (descent or approach),Commercial,Papua New Guinea,Oceania,2,1,0,1,0,0,2,Technical Failure
1995-04-13 00:00:00,Cheboksary Aviation Enterprise - Cheboksarskoe Aviapredpriatie,Takeoff (climb),Military / Government,Russia,Asia,2,2,0,0,0,0,2,Weather
1995-04-15 00:00:00,Imperial Air,Landing (descent or approach),Commercial,Peru,South America,73,5,0,68,0,0,73,Technical Failure
1995-04-17 00:00:00,Brooks Fuel,Landing (descent or approach),Operational,United States of America,North America,3,2,0,1,0,0,3,Human Factor
1995-04-19 00:00:00,ZUA - Zakładu Usług Agrolotniczych - AET Agroaviation Services,Flight,Military / Government,Iran,Asia,0,0,0,0,0,0,0,Unknown
1995-04-24 00:00:00,TACA International Airlines - Transportes Aéreos Centro Americanos,Landing (descent or approach),Operational,Salvador,Central America,2,2,0,0,0,0,2,Human Factor
1995-04-24 00:00:00,Royal Canadian Air Force - RCAF,Landing (descent or approach),Operational,Canada,North America,4,4,0,0,0,0,4,Human Factor
1995-04-25 00:00:00,MarkAir Express,Flight,Operational,United States of America,North America,1,1,0,0,0,0,1,Human Factor
1995-04-26 00:00:00,Ring Can Corporation,Landing (descent or approach),Business,Bahamas,Central America,5,2,0,3,0,0,5,Human Factor
1995-04-28 00:00:00,Millon Air,Landing (descent or approach),Operational,Guatemala,Central America,3,3,0,0,0,0,3,Human Factor
1995-05-08 00:00:00,Farmers Air,Takeoff (climb),Military / Government,New Zealand,Oceania,1,1,0,0,0,0,1,Human Factor
1995-05-08 00:00:00,Trigana Air Service,Landing (descent or approach),Commercial,Indonesia,Asia,28,4,0,24,0,0,28,Technical Failure
1995-05-13 00:00:00,ROSTO,Landing (descent or approach),Humanitarian,Russia,Asia,2,2,0,0,0,0,2,Unknown
1995-05-15 00:00:00,Brazilian Air Force - Força Aérea Brasileira,Landing (descent or approach),Operational,Brazil,South America,0,0,0,0,0,0,0,Unknown
1995-05-16 00:00:00,Sky Tours - Kenya,Takeoff (climb),Operational,Tanzania,Africa,1,1,0,0,0,0,1,Human Factor
1995-05-16 00:00:00,Royal Air Force - RAF,Flight,Operational,United Kingdom,Europe,7,7,0,0,0,0,7,Technical Failure
1995-05-19 00:00:00,Swiftair,Landing (descent or approach),Operational,Spain,Europe,4,2,0,2,0,0,4,Human Factor
1995-05-31 00:00:00,Air Niugini,Landing (descent or approach),Commercial,Papua New Guinea,Oceania,39,4,0,35,0,0,39,Human Factor
1995-06-05 00:00:00,Selkirk Air,Takeoff (climb),Commercial,Canada,North America,7,1,0,6,0,0,7,Technical Failure
1995-06-07 00:00:00,Pink Aviation Services,Takeoff (climb),Humanitarian,Austria,Europe,24,1,0,23,0,0,24,Other
1995-06-08 00:00:00,ValuJet,Takeoff (climb),Commercial,United States of America,North America,62,5,0,57,0,0,62,Technical Failure
1995-06-12 00:00:00,Servicios Turisticos,Landing (descent or approach),Commercial,Mexico,Central America,4,2,0,2,0,0,4,Technical Failure
1995-06-12 00:00:00,Tawakal Airlines,,Commercial,Kenya,Africa,0,0,0,0,0,0,0,Unknown
1995-06-14 00:00:00,Volga Airlines - Aviakompania Volga,Flight,Commercial,Russia,Asia,0,0,0,0,0,0,0,Unknown
1995-06-15 00:00:00,Formosa Airlines,Landing (descent or approach),Commercial,Taiwan,Asia,19,2,0,17,0,0,19,Human Factor
1995-06-16 00:00:00,Líneas Aéreas del Estado - LADE,Landing (descent or approach),Humanitarian,Haiti,Central America,35,4,0,31,0,0,35,Technical Failure
1995-06-17 00:00:00,Uzbekistan Airways - Uzbekistan Havo Jullary,Takeoff (climb),Military / Government,Uzbekistan,Asia,2,2,0,0,0,0,2,Technical Failure
1995-06-18 00:00:00,Formosa Airlines,Taxiing,Commercial,Taiwan,Asia,19,2,0,17,0,0,19,Human Factor
1995-06-23 00:00:00,Air Florida Express,Landing (descent or approach),Operational,United States of America,North America,1,1,0,0,0,0,1,Technical Failure
1995-06-30 00:00:00,EM Travel %26 Sales,Landing (descent or approach),Business,Bahamas,Central America,4,1,0,3,0,0,4,Technical Failure
1995-07-01 00:00:00,East West Airlines - India,Landing (descent or approach),Operational,India,Asia,3,3,0,0,0,0,3,Technical Failure
1995-07-08 00:00:00,Air Inter Gabon,Landing (descent or approach),Commercial,Gabon,Africa,8,1,0,7,0,0,8,Unknown
1995-07-12 00:00:00,Yibitaş Air,Landing (descent or approach),Commercial,Turkey,Asia,6,2,0,4,0,0,6,Human Factor
1995-07-16 00:00:00,SIBIA Aviakompania,Flight,Military / Government,Russia,Asia,2,2,0,0,0,0,2,Technical Failure
1995-07-26 00:00:00,ADC Airlines - Aviation Development Company,Landing (descent or approach),Commercial,Liberia,Africa,91,9,0,82,0,0,91,Human Factor
1995-07-29 00:00:00,Provincial Air Transport,Landing (descent or approach),Commercial,Papua New Guinea,Oceania,12,1,0,11,0,0,12,Human Factor
1995-07-30 00:00:00,Turdus Airways,Landing (descent or approach),Humanitarian,Belgium,Europe,3,1,0,2,0,0,3,Human Factor
1995-08-09 00:00:00,Symbol,Takeoff (climb),Operational,Spain,Europe,2,2,0,0,0,0,2,Unknown
1995-08-10 00:00:00,UraiAvia,Takeoff (climb),Military / Government,Russia,Asia,25,2,0,23,0,0,25,Other
1995-08-16 00:00:00,Caribbean Food %26 Produce,Flight,Business,World,World,1,1,0,0,0,0,1,Technical Failure
1995-08-17 00:00:00,Air Afrique,Landing (descent or approach),Operational,Chad,Africa,6,6,0,0,0,0,6,Technical Failure
1995-08-17 00:00:00,Barak Aviation Services,Takeoff (climb),Commercial,Israel,Asia,11,1,0,10,0,0,11,Other
1995-08-20 00:00:00,Haïti Express Airways,Landing (descent or approach),Commercial,Haiti,Central America,14,2,0,12,0,0,14,Technical Failure
1995-08-23 00:00:00,Jack Lichty,Landing (descent or approach),Business,United States of America,North America,1,1,0,0,0,0,1,Human Factor
1995-08-28 00:00:00,Medicorp,Landing (descent or approach),Operational,Argentina,South America,2,2,0,0,0,0,2,Human Factor
1995-09-18 00:00:00,Great Western Hotels,Landing (descent or approach),Operational,United States of America,North America,1,1,0,0,0,0,1,Human Factor
1995-09-21 00:00:00,Corporate Flight Management,Takeoff (climb),Operational,United States of America,North America,2,1,0,1,0,0,2,Human Factor
1995-09-26 00:00:00,Executive Jet Aviation - Switzerland,Landing (descent or approach),Humanitarian,Algeria,Africa,4,2,0,2,0,0,4,Human Factor
1995-10-18 00:00:00,Air Maldives,Landing (descent or approach),Commercial,Maldives,Asia,8,3,0,5,0,0,8,Human Factor
1995-10-22 00:00:00,Bowman Aviation,Flight,Business,Canada,North America,5,1,0,4,0,0,5,Human Factor
1995-10-22 00:00:00,Ethiopian Airlines,Landing (descent or approach),Commercial,Ethiopia,Africa,20,3,0,17,0,0,20,Other
1995-10-29 00:00:00,Austrian Cessna Aviation,Landing (descent or approach),Business,Austria,Europe,6,1,0,5,0,0,6,Human Factor
1995-11-01 00:00:00,Kazakhstan Airlines - Air Kazakhstan - Kazair,Landing (descent or approach),Operational,Kazakhstan,Asia,4,4,0,0,0,0,4,Human Factor
1995-11-04 00:00:00,Americana Colombia,Landing (descent or approach),Humanitarian,Mexico,Central America,0,0,0,0,0,0,0,Human Factor
1995-11-11 00:00:00,Royal Thai Police,Flight,Military / Government,Thailand,Asia,0,0,0,0,0,0,0,Unknown
1995-11-16 00:00:00,Transportes Aéreos Ejecutivos - TAESA,Landing (descent or approach),Commercial,Mexico,Central America,9,2,0,7,0,0,9,Technical Failure
1995-11-18 00:00:00,Comeravia - Comercial de Aviacion,Flight,Commercial,Venezuela,South America,0,0,0,0,0,0,0,Unknown
1995-11-22 00:00:00,Island Air Gold Coast,Takeoff (climb),Commercial,Australia,Oceania,5,1,0,4,0,0,5,Human Factor
1995-11-22 00:00:00,Korsar Airlines - Korsar Avia,Landing (descent or approach),Humanitarian,Angola,Africa,9,6,0,3,0,0,9,Human Factor
1995-11-25 00:00:00,Eagle Air Services - Canada,Takeoff (climb),Humanitarian,Canada,North America,4,1,0,3,0,0,4,Human Factor
1995-11-28 00:00:00,Yenisei Aviation Enterprise,Takeoff (climb),Commercial,Russia,Asia,9,2,0,7,0,0,9,Unknown
1995-11-29 00:00:00,Internacional Aéreas,Landing (descent or approach),Commercial,Poland,Europe,4,1,0,3,0,0,4,Weather
1995-11-30 00:00:00,Skydive Assets,Landing (descent or approach),Operational,United States of America,North America,3,2,0,1,0,0,3,Human Factor
1995-12-02 00:00:00,Indian Airlines,Landing (descent or approach),Commercial,India,Asia,108,6,0,102,0,0,108,Human Factor
1995-12-05 00:00:00,Kotlasavia,Takeoff (climb),Commercial,Russia,Asia,15,2,0,13,0,0,15,Other
1995-12-06 00:00:00,Federal Border Guard Aviation Command,Landing (descent or approach),Operational,Russia,Asia,18,7,0,11,0,0,18,Technical Failure
1995-12-06 00:00:00,Laoag International Airline,Landing (descent or approach),Commercial,Philippines,Asia,0,0,0,0,0,0,0,Unknown
1995-12-08 00:00:00,Private Austrian,Landing (descent or approach),Business,Germany,Europe,6,1,0,5,0,0,6,Human Factor
1995-12-15 00:00:00,Air Transport - USA,Landing (descent or approach),Operational,United States of America,North America,1,1,0,0,0,0,1,Human Factor
1995-12-17 00:00:00,Athabaska Airways,Takeoff (climb),Humanitarian,Canada,North America,1,1,0,0,0,0,1,Human Factor
1995-12-18 00:00:00,Western Airways Inc.,Takeoff (climb),Humanitarian,United States of America,North America,2,1,0,1,0,0,2,Human Factor
1995-12-18 00:00:00,Bering Air,Takeoff (climb),Operational,United States of America,North America,1,1,0,0,0,0,1,Other
1995-12-20 00:00:00,Tower Air,Takeoff (climb),Commercial,United States of America,North America,468,17,0,451,0,0,468,Human Factor
1995-12-21 00:00:00,Kuban Airlines - Kuban'skie Avialinii,Landing (descent or approach),Commercial,Russia,Asia,44,5,0,39,0,0,44,Human Factor
1995-12-27 00:00:00,Komi Avia,Takeoff (climb),Commercial,Russia,Asia,14,2,0,12,0,0,14,Human Factor
1995-12-27 00:00:00,Sakha Avia - Sakha Airlines,Landing (descent or approach),Commercial,Russia,Asia,0,0,0,0,0,0,0,Unknown
1995-12-29 00:00:00,Saransk Flight Unit,Landing (descent or approach),Operational,Russia,Asia,5,5,0,0,0,0,5,Human Factor
1995-12-30 00:00:00,TAROM - Transporturile Aeriene Române,Landing (descent or approach),Commercial,Turkey,Asia,81,6,0,75,0,0,81,Weather
1995-12-31 00:00:00,Air Swift Aviation,Landing (descent or approach),Commercial,Papua New Guinea,Oceania,0,0,0,0,0,0,0,Unknown
1996-01-04 00:00:00,Salair,Landing (descent or approach),Operational,United States of America,North America,2,2,0,0,0,0,2,Technical Failure
1996-01-04 00:00:00,West Star Aviation,Landing (descent or approach),Commercial,United States of America,North America,5,2,0,3,0,0,5,Other
1996-01-06 00:00:00,Imperial Air,Landing (descent or approach),Commercial,Peru,South America,44,5,0,39,0,0,44,Human Factor
1996-01-19 00:00:00,Benskin Brothers,Landing (descent or approach),Business,United States of America,North America,3,1,0,2,0,0,3,Human Factor
1996-01-19 00:00:00,Bankair,Landing (descent or approach),Specialised Services,United States of America,North America,2,2,0,0,0,0,2,Technical Failure
1996-01-24 00:00:00,MASCO,Landing (descent or approach),Business,United States of America,North America,8,2,0,6,0,0,8,Technical Failure
1996-01-25 00:00:00,Transportes Aéreos Neuquén,Landing (descent or approach),Commercial,Argentina,South America,6,2,0,4,0,0,6,Human Factor
1996-01-27 00:00:00,Grand Aire Express - Executive Aire Express,Flight,Operational,United States of America,North America,1,1,0,0,0,0,1,Technical Failure
1996-01-28 00:00:00,Affretair,Landing (descent or approach),Operational,Zimbabwe,Africa,5,5,0,0,0,0,5,Technical Failure
1996-02-02 00:00:00,Sabre Aviation,Landing (descent or approach),Operational,United States of America,North America,1,1,0,0,0,0,1,Human Factor
1996-02-04 00:00:00,Táxi Aéreo Weston,Landing (descent or approach),Operational,Brazil,South America,3,3,0,0,0,0,3,Human Factor
1996-02-04 00:00:00,Ukraine Air Alliance,Landing (descent or approach),Operational,Angola,Africa,5,4,0,1,0,0,5,Unknown
1996-02-07 00:00:00,GippsAero,Flight,Specialised Services,Australia,Oceania,1,1,0,0,0,0,1,Technical Failure
1996-02-09 00:00:00,Nagasaki Airways,Flight,Operational,Japan,Asia,2,2,0,0,0,0,2,Human Factor
1996-02-12 00:00:00,George R. Harrington,Landing (descent or approach),Business,United States of America,North America,2,1,0,1,0,0,2,Human Factor
1996-02-12 00:00:00,Falcon Airlines,Takeoff (climb),Commercial,Australia,Oceania,9,2,0,7,0,0,9,Technical Failure
1996-02-19 00:00:00,Continental Airlines,Landing (descent or approach),Commercial,United States of America,North America,87,5,0,82,0,0,87,Human Factor
1996-02-24 00:00:00,South African Air Force,Flight,Operational,South Africa,Africa,11,2,0,9,0,0,11,Technical Failure
1996-02-24 00:00:00,Sakha Avia - Sakha Airlines,Landing (descent or approach),Operational,Russia,Asia,10,7,0,3,0,0,10,Human Factor
1996-02-25 00:00:00,Kampuchea Airlines,Landing (descent or approach),Commercial,Cambodia,Asia,42,6,0,36,0,0,42,Technical Failure
1996-02-27 00:00:00,Private South African,Flight,Business,South Africa,Africa,0,0,0,0,0,0,0,Unknown
1996-03-11 00:00:00,Farnas Aviation Services,Takeoff (climb),Operational,Sudan,Africa,16,6,0,10,0,0,16,Unknown
1996-03-17 00:00:00,Wagner Foundation,Landing (descent or approach),Operational,Iceland,Europe,1,1,0,0,0,0,1,Human Factor
1996-03-24 00:00:00,British World Airlines - BWA,Landing (descent or approach),Operational,United Kingdom,Europe,2,2,0,0,0,0,2,Human Factor
1996-03-30 00:00:00,LANC Colombia - Lineas Aéreas Norte de Colombia,Landing (descent or approach),Commercial,Colombia,South America,20,2,0,18,0,0,20,Technical Failure
1996-04-02 00:00:00,PacificAir - Pacific Airways,Taxiing,Commercial,Philippines,Asia,2,2,0,0,0,0,2,Human Factor
1996-04-04 00:00:00,Alas del Sur,Landing (descent or approach),Operational,Argentina,South America,2,2,0,0,0,0,2,Other
1996-04-07 00:00:00,Island Air Gold Coast,Landing (descent or approach),Commercial,Australia,Oceania,10,1,0,9,0,0,10,Technical Failure
1996-04-07 00:00:00,Ronald C. Bingham,Landing (descent or approach),Business,United States of America,North America,2,1,0,1,0,0,2,Technical Failure
1996-04-07 00:00:00,Dolphin Express Airlines,Takeoff (climb),Commercial,British Virgin Islands,Central America,11,2,0,9,0,0,11,Unknown
1996-04-12 00:00:00,Hjalmar Guzman Gonzales,Landing (descent or approach),Business,Bolivia,South America,8,2,0,6,0,0,8,Unknown
1996-04-17 00:00:00,Yute Air Alaska,Takeoff (climb),Operational,United States of America,North America,1,1,0,0,0,0,1,Human Factor
1996-04-20 00:00:00,Warrington Development Corporation,Landing (descent or approach),Business,Bahamas,Central America,4,1,0,3,0,0,4,Human Factor
1996-04-20 00:00:00,Cherskoye Aviation Enterprise,Flight,Commercial,Russia,Asia,0,0,0,0,0,0,0,Unknown
1996-04-23 00:00:00,VoronezhAvia,Takeoff (climb),Military / Government,Russia,Asia,2,2,0,0,0,0,2,Human Factor
1996-04-24 00:00:00,Bangko Sentral NG Pilipinas,Takeoff (climb),Operational,Philippines,Asia,8,2,0,6,0,0,8,Unknown
1996-04-25 00:00:00,Royal Nepal Airlines,Landing (descent or approach),Commercial,Nepal,Asia,31,4,0,27,0,0,31,Human Factor
1996-05-01 00:00:00,Fly Linhas Aéreas,Takeoff (climb),Commercial,Ecuador,South America,90,11,0,79,0,0,90,Other
1996-05-02 00:00:00,Sky Charter-Cargo,Landing (descent or approach),Operational,United States of America,North America,1,1,0,0,0,0,1,Technical Failure
1996-05-03 00:00:00,PenAir - Peninsula Airways - Alaska Airlines Commuter,Landing (descent or approach),Commercial,United States of America,North America,13,2,0,11,0,0,13,Human Factor
1996-05-05 00:00:00,Aviation Boréal,Landing (descent or approach),Operational,Canada,North America,3,2,0,1,0,0,3,Other
1996-05-11 00:00:00,Peruvian Air Force - Fuerza Aérea del Perú,,Military / Government,Peru,South America,0,0,0,0,0,0,0,Unknown
1996-05-14 00:00:00,Líneas Aéreas Allegro,Landing (descent or approach),Commercial,Mexico,Central America,47,4,0,43,0,0,47,Human Factor
1996-05-16 00:00:00,Argentinian Air Force - Fuerza Aérea Argentina,Landing (descent or approach),Military / Government,Argentina,South America,0,0,0,0,0,0,0,Unknown
1996-05-18 00:00:00,Archana Airways,Landing (descent or approach),Commercial,India,Asia,19,3,0,16,0,0,19,Human Factor
1996-05-20 00:00:00,Bush Field Aircraft Company,Landing (descent or approach),Military / Government,United States of America,North America,1,1,0,0,0,0,1,Human Factor
1996-05-24 00:00:00,Robert W. Childs,Takeoff (climb),Business,United States of America,North America,7,1,0,6,0,0,7,Human Factor
1996-05-29 00:00:00,Trans Guyana Airways,Landing (descent or approach),Commercial,Guyana,South America,0,0,0,0,0,0,0,Human Factor
1996-05-30 00:00:00,G Aviation,Landing (descent or approach),Business,United Kingdom,Europe,3,1,0,2,0,0,3,Unknown
1996-05-31 00:00:00,Italian Air Force - Aeronautica Militare Italiana,Landing (descent or approach),Military / Government,Italy,Europe,4,4,0,0,0,0,4,Unknown
1996-06-16 00:00:00,Wildcountry Airways,Flight,Commercial,Canada,North America,7,1,0,6,0,0,7,Technical Failure
1996-06-16 00:00:00,Pink Aviation Services,Landing (descent or approach),Humanitarian,Netherlands,Europe,2,2,0,0,0,0,2,Technical Failure
1996-06-17 00:00:00,Samarkand Flight Enterprise,Flight,Other,Tajikistan,Asia,0,0,0,0,0,0,0,Unknown
1996-06-20 00:00:00,Keewatin Air,Landing (descent or approach),Operational,Canada,North America,2,2,0,0,0,0,2,Weather
1996-06-20 00:00:00,Loren Davis Ministries,Takeoff (climb),Operational,United States of America,North America,3,3,0,0,0,0,3,Human Factor
1996-06-20 00:00:00,Robin F. Diver,Takeoff (climb),Business,United States of America,North America,1,1,0,0,0,0,1,Technical Failure
1996-06-24 00:00:00,Air Philippines,Landing (descent or approach),Commercial,Philippines,Asia,34,4,0,30,0,0,34,Unknown
1996-06-27 00:00:00,Fleet Air,Landing (descent or approach),Commercial,Tanzania,Africa,0,0,0,0,0,0,0,Technical Failure
1996-06-28 00:00:00,Samorodok,Landing (descent or approach),Commercial,Russia,Asia,11,4,0,7,0,0,11,Human Factor
1996-06-30 00:00:00,Advantage Aviation,Takeoff (climb),Commercial,United States of America,North America,4,1,0,3,0,0,4,Human Factor
1996-06-30 00:00:00,DAS Air Cargo - Dairo Air Services,Landing (descent or approach),Operational,Mali,Africa,4,4,0,0,0,0,4,Weather
1996-07-02 00:00:00,Transportes Aéreos de Santander,Landing (descent or approach),Commercial,Colombia,South America,9,2,0,7,0,0,9,Unknown
1996-07-06 00:00:00,Rusty Myers Flying Service,Flight,Commercial,Canada,North America,5,1,0,4,0,0,5,Human Factor
1996-07-11 00:00:00,Bouraq Indonesia Airlines,Takeoff (climb),Commercial,Indonesia,Asia,48,5,0,43,0,0,48,Technical Failure
1996-07-12 00:00:00,Delta Mike Inc.,Takeoff (climb),Business,United States of America,North America,6,1,0,5,0,0,6,Human Factor
1996-07-14 00:00:00,NATO Airborne Early Warning Force,Takeoff (climb),Military / Government,Greece,Europe,16,5,0,11,0,0,16,Unknown
1996-07-17 00:00:00,Operation Blessing,Takeoff (climb),Humanitarian,Democratic Republic of Congo,Africa,2,2,0,0,0,0,2,Unknown
1996-07-18 00:00:00,Trans-Provincial Airlines - TPA,Takeoff (climb),Operational,United Kingdom,Europe,8,2,0,6,0,0,8,Human Factor
1996-07-20 00:00:00,Med Arizona,Takeoff (climb),Humanitarian,United States of America,North America,1,1,0,0,0,0,1,Technical Failure
1996-07-23 00:00:00,Arkia Israeli Airlines,Landing (descent or approach),Commercial,Israel,Asia,8,3,0,5,0,0,8,Human Factor
1996-07-25 00:00:00,Weasua Air Transport,Landing (descent or approach),Commercial,Liberia,Africa,11,4,0,7,0,0,11,Weather
1996-07-27 00:00:00,Aircraft Leasing Services - ALS,Landing (descent or approach),Humanitarian,South Sudan,Africa,4,1,0,3,0,0,4,Human Factor
1996-07-30 00:00:00,Polish Navy - Lotnictwa Marynarki Wojenna,Flight,Military / Government,Poland,Europe,11,2,0,9,0,0,11,Technical Failure
1996-08-02 00:00:00,Greatland Air Cargo,Landing (descent or approach),Operational,United States of America,North America,2,2,0,0,0,0,2,Technical Failure
1996-08-02 00:00:00,Air Algérie,Takeoff (climb),Commercial,Algeria,Africa,106,6,0,100,0,0,106,Technical Failure
1996-08-02 00:00:00,Skyways - Kenya,Landing (descent or approach),Humanitarian,Sudan,Africa,2,2,0,0,0,0,2,Other
1996-08-03 00:00:00,Superior Aviation,Landing (descent or approach),Operational,United States of America,North America,1,1,0,0,0,0,1,Human Factor
1996-08-05 00:00:00,Virgin Air,Takeoff (climb),Commercial,Saint-Barthélemy,Central America,8,1,0,7,0,0,8,Technical Failure
1996-08-07 00:00:00,Transair Cargo,Landing (descent or approach),Operational,Angola,Africa,0,0,0,0,0,0,0,Unknown
1996-08-09 00:00:00,Transportes Aéreos Petroleros - TAPSA,Flight,Operational,Argentina,South America,2,2,0,0,0,0,2,Human Factor
1996-08-13 00:00:00,MAC Aviation,Landing (descent or approach),Commercial,United Kingdom,Europe,3,2,0,1,0,0,3,Human Factor
1996-08-14 00:00:00,Basco Flying Service,Takeoff (climb),Commercial,United States of America,North America,3,1,0,2,0,0,3,Human Factor
1996-08-15 00:00:00,Aerolineas Nacionales - ANSA Panama,Flight,Commercial,Panama,Central America,0,0,0,0,0,0,0,Unknown
1996-08-17 00:00:00,Azovtransavia,Flight,Commercial,Ukraine,Europe,0,0,0,0,0,0,0,Unknown
1996-08-21 00:00:00,Egyptair,Landing (descent or approach),Commercial,Turkey,Asia,131,11,0,120,0,0,131,Weather
1996-08-30 00:00:00,Kiowa Service,Flight,Commercial,United States of America,North America,3,1,0,2,0,0,3,Human Factor
1996-09-05 00:00:00,Federal Express - FedEx,Landing (descent or approach),Operational,United States of America,North America,5,3,0,2,0,0,5,Other
1996-09-16 00:00:00,North Star Air Cargo,Landing (descent or approach),Operational,United States of America,North America,1,1,0,0,0,0,1,Technical Failure
1996-09-23 00:00:00,Vanua Air Charter,Landing (descent or approach),Commercial,Fiji Islands,Oceania,5,2,0,3,0,0,5,Human Factor
1996-09-24 00:00:00,Branch River Air Service,Takeoff (climb),Commercial,United States of America,North America,4,1,0,3,0,0,4,Human Factor
1996-09-27 00:00:00,Chaillotine Air Service,Taxiing,Commercial,Spain,Europe,4,2,0,2,0,0,4,Human Factor
1996-09-28 00:00:00,Air Hi Ho,Landing (descent or approach),Commercial,United States of America,North America,4,1,0,3,0,0,4,Technical Failure
1996-09-30 00:00:00,Trigana Air Service,Landing (descent or approach),Commercial,Indonesia,Asia,5,2,0,3,0,0,5,Weather
1996-10-08 00:00:00,Olympia - Frank,Flight,Military / Government,Czech Republic,Europe,4,2,0,2,0,0,4,Human Factor
1996-10-09 00:00:00,Trans Oriente Colombia - Transportes Aéreos Regular Secundario Oriental,Takeoff (climb),Operational,Colombia,South America,3,2,0,1,0,0,3,Human Factor
1996-10-11 00:00:00,Servicios y Transportes Aéreos Petroleros - STAP,Landing (descent or approach),Commercial,Brazil,South America,15,2,0,13,0,0,15,Unknown
1996-10-15 00:00:00,Air Services - Guyana,Landing (descent or approach),Commercial,Guyana,South America,0,0,0,0,0,0,0,Other
1996-10-19 00:00:00,Glenn Allen Kranig,Takeoff (climb),Business,United States of America,North America,1,1,0,0,0,0,1,Human Factor
1996-10-23 00:00:00,PropAir,Landing (descent or approach),Commercial,Canada,North America,13,2,0,11,0,0,13,Other
1996-10-31 00:00:00,Flamenco Airways,Takeoff (climb),Operational,Puerto Rico,Central America,3,3,0,0,0,0,3,Technical Failure
1996-11-01 00:00:00,Perimeter Aviation,Landing (descent or approach),Commercial,Canada,North America,7,2,0,5,0,0,7,Human Factor
1996-11-01 00:00:00,Aviaobshchemash,Landing (descent or approach),Operational,Russia,Asia,15,6,0,9,0,0,15,Other
1996-11-06 00:00:00,Sakha Avia - Sakha Airlines,Landing (descent or approach),Commercial,Russia,Asia,29,5,0,24,0,0,29,Human Factor
1996-11-07 00:00:00,John Manera,Landing (descent or approach),Business,United States of America,North America,3,2,0,1,0,0,3,Human Factor
1996-11-12 00:00:00,Argentinian Navy - Armada Argentina,Landing (descent or approach),Operational,Argentina,South America,2,2,0,0,0,0,2,Unknown
1996-11-16 00:00:00,Fayard Enterprises,Takeoff (climb),Humanitarian,United States of America,North America,11,1,0,10,0,0,11,Human Factor
1996-11-16 00:00:00,Vietnam Airlines,Taxiing,Commercial,Vietnam,Asia,0,0,0,0,0,0,0,Technical Failure
1996-11-18 00:00:00,RAAF Museum,Landing (descent or approach),Operational,Australia,Oceania,0,0,0,0,0,0,0,Technical Failure
1996-11-22 00:00:00,Yeniseiski Meridian,Landing (descent or approach),Commercial,Russia,Asia,27,5,0,22,0,0,27,Human Factor
1996-11-28 00:00:00,A. Soriano Aviation,Landing (descent or approach),Commercial,Philippines,Asia,3,1,0,2,0,0,3,Other
1996-12-02 00:00:00,Kostroma Air - Kostromskoye Aviapredpriatie,Landing (descent or approach),Commercial,Russia,Asia,15,2,0,13,0,0,15,Human Factor
1996-12-06 00:00:00,Contact Air,Landing (descent or approach),Commercial,Canada,North America,14,2,0,12,0,0,14,Human Factor
1996-12-09 00:00:00,French Air Force - Armée de l'Air,Landing (descent or approach),Operational,France,Europe,3,3,0,0,0,0,3,Technical Failure
1996-12-10 00:00:00,Vostsibaero - East Siberia Air,Takeoff (climb),Operational,Russia,Asia,12,9,0,3,0,0,12,Technical Failure
1996-12-13 00:00:00,Merpati Nusantara Airlines - MNA,Landing (descent or approach),Commercial,Indonesia,Asia,6,3,0,3,0,0,6,Unknown
1996-12-17 00:00:00,MK Airlines,Landing (descent or approach),Operational,Nigeria,Africa,4,4,0,0,0,0,4,Human Factor
1996-12-23 00:00:00,Federal Border Guard Aviation Command,Landing (descent or approach),Military / Government,Russia,Asia,24,6,0,18,0,0,24,Human Factor
1996-12-28 00:00:00,Mutual Security,Landing (descent or approach),Business,United States of America,North America,10,1,0,9,0,0,10,Weather
1997-01-02 00:00:00,Executive Wings,Takeoff (climb),Specialised Services,United States of America,North America,2,2,0,0,0,0,2,Technical Failure
1997-01-03 00:00:00,Nakina Outpost Camps %26 Airservice,Takeoff (climb),Operational,Canada,North America,1,1,0,0,0,0,1,Technical Failure
1997-01-03 00:00:00,Titan Airways,Landing (descent or approach),Operational,United Kingdom,Europe,3,2,0,1,0,0,3,Unknown
1997-01-05 00:00:00,Skylink Charter,Landing (descent or approach),Commercial,United States of America,North America,21,2,0,19,0,0,21,Human Factor
1997-01-11 00:00:00,Ibertrans Aérea,Landing (descent or approach),Commercial,Tunisia,Africa,21,2,0,19,0,0,21,Unknown
1997-01-16 00:00:00,Air Cargo Express,Landing (descent or approach),Operational,United States of America,North America,2,2,0,0,0,0,2,Human Factor
1997-01-16 00:00:00,First International Airlines,Landing (descent or approach),Operational,Democratic Republic of Congo,Africa,5,5,0,0,0,0,5,Technical Failure
1997-01-17 00:00:00,TAM Brasil - Taxi Aéreo Marilia - Transportes Aéreos Regionais,Landing (descent or approach),Operational,Brazil,South America,2,2,0,0,0,0,2,Human Factor
1997-01-22 00:00:00,Air One - USA,Takeoff (climb),Commercial,United States of America,North America,3,2,0,1,0,0,3,Human Factor
1997-01-23 00:00:00,Fayard Enterprises,Landing (descent or approach),Operational,United States of America,North America,1,1,0,0,0,0,1,Human Factor
1997-01-24 00:00:00,Linea Aérea Mexicana de Carga,Landing (descent or approach),Operational,Mexico,Central America,2,2,0,0,0,0,2,Unknown
1997-01-25 00:00:00,Voronezh Aircraft Production Association - VASO Airlines,Takeoff (climb),Operational,Russia,Asia,25,9,0,16,0,0,25,Human Factor
1997-01-25 00:00:00,KolymaAvia,Landing (descent or approach),Commercial,Russia,Asia,17,5,0,12,0,0,17,Human Factor
1997-01-28 00:00:00,PropAir,Takeoff (climb),Commercial,Canada,North America,11,2,0,9,0,0,11,Human Factor
1997-01-29 00:00:00,Cheremshanka Airlines,Landing (descent or approach),Commercial,Russia,Asia,27,4,0,23,0,0,27,Human Factor
1997-02-01 00:00:00,Brooks Fuel,Landing (descent or approach),Operational,Canada,North America,4,4,0,0,0,0,4,Human Factor
1997-02-04 00:00:00,Aero Cuahonte,Landing (descent or approach),Commercial,Mexico,Central America,12,2,0,10,0,0,12,Unknown
1997-02-17 00:00:00,Private American,Landing (descent or approach),Humanitarian,Mexico,Central America,0,0,0,0,0,0,0,Human Factor
1997-02-19 00:00:00,SemeiAvia,Landing (descent or approach),Commercial,Kazakhstan,Asia,18,4,0,14,0,0,18,Human Factor
1997-02-22 00:00:00,Polynesian Airways,Takeoff (climb),Operational,United States of America,North America,2,2,0,0,0,0,2,Unknown
1997-02-25 00:00:00,South Otago Aerial Topdressing Co-op Ltd,Flight,Military / Government,New Zealand,Oceania,1,1,0,0,0,0,1,Weather
1997-02-27 00:00:00,Colvin Aviation,Landing (descent or approach),Operational,United States of America,North America,2,2,0,0,0,0,2,Human Factor
1997-03-01 00:00:00,Rennies Express Air Services,Takeoff (climb),Operational,South Africa,Africa,1,1,0,0,0,0,1,Technical Failure
1997-03-03 00:00:00,Isleña Airlines - Isleña de Inversiones,Takeoff (climb),Commercial,Honduras,Central America,21,2,0,19,0,0,21,Human Factor
1997-03-03 00:00:00,Pantanal Linhas Aéreas Sul-Matogrossenses,Landing (descent or approach),Commercial,Brazil,South America,16,3,0,13,0,0,16,Human Factor
1997-03-07 00:00:00,Dodita Air Cargo,Takeoff (climb),Operational,United States of America,North America,2,2,0,0,0,0,2,Technical Failure
1997-03-07 00:00:00,Representaciones de Cristaleria y Peltre de Zamor,Flight,Business,Mexico,Central America,2,1,0,1,0,0,2,Technical Failure
1997-03-07 00:00:00,Travelair - Costa Rica,Flight,Commercial,Costa Rica,Central America,7,1,0,6,0,0,7,Technical Failure
1997-03-10 00:00:00,Gulf Air,Takeoff (climb),Commercial,United Arab Emirates,Asia,115,8,0,107,0,0,115,Technical Failure
1997-03-12 00:00:00,Diamond Jet,Landing (descent or approach),Business,United States of America,North America,2,2,0,0,0,0,2,Other
1997-03-25 00:00:00,PAB Aviation,Landing (descent or approach),Commercial,United States of America,North America,4,2,0,2,0,0,4,Human Factor
1997-03-28 00:00:00,Trans Andes,Landing (descent or approach),Commercial,Peru,South America,7,1,0,6,0,0,7,Human Factor
1997-04-01 00:00:00,Compagnie Africaine d'Aviation,Takeoff (climb),Commercial,Democratic Republic of Congo,Africa,14,4,0,10,0,0,14,Human Factor
1997-04-08 00:00:00,Channel Express - Air Services,Taxiing,Operational,United Kingdom,Europe,2,2,0,0,0,0,2,Unknown
1997-04-10 00:00:00,Pilot Services International,Flight,Operational,United States of America,North America,2,2,0,0,0,0,2,Technical Failure
1997-04-12 00:00:00,Corporate Air - USA,Flight,Operational,World,World,1,1,0,0,0,0,1,Technical Failure
1997-04-12 00:00:00,Ghana Airways,Landing (descent or approach),Commercial,Ivory Coast,Africa,104,7,0,97,0,0,104,Human Factor
1997-04-13 00:00:00,Avia Y. Petrova Aviakompania,Landing (descent or approach),Operational,Russia,Asia,12,5,0,7,0,0,12,Other
1997-04-19 00:00:00,Fayard Enterprises,Landing (descent or approach),Humanitarian,United States of America,North America,1,1,0,0,0,0,1,Technical Failure
1997-04-22 00:00:00,Frans Pind,Landing (descent or approach),Business,Iceland,Europe,1,1,0,0,0,0,1,Technical Failure
1997-04-24 00:00:00,Hawkair Aviation Services,Landing (descent or approach),Operational,Canada,North America,3,3,0,0,0,0,3,Technical Failure
1997-05-02 00:00:00,Olympic Aviation,Landing (descent or approach),Commercial,Greece,Europe,20,2,0,18,0,0,20,Unknown
1997-05-10 00:00:00,South African Police,Takeoff (climb),Military / Government,South Africa,Africa,7,2,0,5,0,0,7,Other
1997-05-14 00:00:00,Regional Lineas Aéreas,Landing (descent or approach),Commercial,Portugal,Europe,37,3,0,34,0,0,37,Human Factor
1997-05-16 00:00:00,First Air Jet Charter,Takeoff (climb),Operational,United States of America,North America,2,2,0,0,0,0,2,Human Factor
1997-05-22 00:00:00,Dodita Air Cargo,Flight,Operational,Puerto Rico,Central America,3,2,0,1,0,0,3,Technical Failure
1997-05-28 00:00:00,Sociedad de Aviaçao Ligeira - SAL,Landing (descent or approach),Commercial,Angola,Africa,6,2,0,4,0,0,6,Technical Failure
1997-05-29 00:00:00,Athabaska Airways,Takeoff (climb),Operational,Canada,North America,1,1,0,0,0,0,1,Human Factor
1997-06-01 00:00:00,Casper Air Service,Takeoff (climb),Operational,United States of America,North America,1,1,0,0,0,0,1,Human Factor
1997-06-05 00:00:00,Yeiskaero,Takeoff (climb),Military / Government,Russia,Asia,2,2,0,0,0,0,2,Technical Failure
1997-06-07 00:00:00,TAROM - Transporturile Aeriene Române,Landing (descent or approach),Commercial,Sweden,Europe,26,6,0,20,0,0,26,Human Factor
1997-06-07 00:00:00,Continental Airlines,Taxiing,Commercial,United States of America,North America,2,2,0,0,0,0,2,Unknown
1997-06-13 00:00:00,North American Airlines,Landing (descent or approach),Operational,Canada,North America,2,2,0,0,0,0,2,Human Factor
1997-06-16 00:00:00,Yessentuki Air Sport Club,Flight,Humanitarian,Russia,Asia,0,0,0,0,0,0,0,Unknown
1997-06-24 00:00:00,Lipetsk Aviation Enterprise,Flight,Military / Government,Russia,Asia,1,1,0,0,0,0,1,Human Factor
1997-06-25 00:00:00,Walter Warner,Takeoff (climb),Operational,United States of America,North America,1,1,0,0,0,0,1,Technical Failure
1997-06-25 00:00:00,Aerosucre Colombia,Takeoff (climb),Operational,Colombia,South America,6,3,0,3,0,0,6,Other
1997-06-28 00:00:00,Hondu Carib Cargo,Takeoff (climb),Operational,United States of America,North America,3,3,0,0,0,0,3,Technical Failure
1997-06-28 00:00:00,Bashkirian Airlines - Bashkirskie Avialinii,Flight,Military / Government,Russia,Asia,2,2,0,0,0,0,2,Human Factor
1997-06-30 00:00:00,Silver Express Company,Takeoff (climb),Operational,Puerto Rico,Central America,3,2,0,1,0,0,3,Technical Failure
1997-06-30 00:00:00,International Aviation,Landing (descent or approach),Commercial,United States of America,North America,4,2,0,2,0,0,4,Technical Failure
1997-07-03 00:00:00,Riana Táxi Aéreo,Takeoff (climb),Commercial,Brazil,South America,5,2,0,3,0,0,5,Unknown
1997-07-08 00:00:00,Aeronimbus,Landing (descent or approach),Operational,Argentina,South America,4,1,0,3,0,0,4,Technical Failure
1997-07-10 00:00:00,Airways International,Landing (descent or approach),Commercial,Bahamas,Central America,9,1,0,8,0,0,9,Technical Failure
1997-07-13 00:00:00,P. Elsner,Takeoff (climb),Humanitarian,Germany,Europe,0,0,0,0,0,0,0,Unknown
1997-07-15 00:00:00,Orion Aircraft Leasing,Landing (descent or approach),Operational,United States of America,North America,2,2,0,0,0,0,2,Human Factor
1997-07-24 00:00:00,M. R. Aircraft Sales %26 Rental,Flight,Business,World,World,5,2,0,3,0,0,5,Technical Failure
1997-07-31 00:00:00,Federal Express - FedEx,Landing (descent or approach),Operational,United States of America,North America,5,3,0,2,0,0,5,Human Factor
1997-08-01 00:00:00,Airborne Fire Attack,Takeoff (climb),Humanitarian,United States of America,North America,2,2,0,0,0,0,2,Weather
1997-08-03 00:00:00,Air Afrique,Takeoff (climb),Commercial,Cameroon,Africa,114,8,0,106,0,0,114,Technical Failure
1997-08-07 00:00:00,Aero Bieke,Landing (descent or approach),Business,Puerto Rico,Central America,4,1,0,3,0,0,4,Human Factor
1997-08-12 00:00:00,Olympic Airways,Landing (descent or approach),Commercial,Greece,Europe,35,9,0,26,0,0,35,Human Factor
1997-08-13 00:00:00,Ameriflight,Landing (descent or approach),Operational,United States of America,North America,1,1,0,0,0,0,1,Human Factor
1997-08-14 00:00:00,PT Benua Indah,Landing (descent or approach),Business,Indonesia,Asia,7,1,0,6,0,0,7,Unknown
1997-08-17 00:00:00,Inductotherm Group,Flight,Business,United States of America,North America,8,1,0,7,0,0,8,Human Factor
1997-08-19 00:00:00,Superior Aviation,Landing (descent or approach),Operational,United States of America,North America,1,1,0,0,0,0,1,Human Factor
1997-08-19 00:00:00,Angola Air Charter,Landing (descent or approach),Operational,Angola,Africa,4,4,0,0,0,0,4,Unknown
1997-08-22 00:00:00,SAETA - Sociedad Anonima Ecuatoriana de Transportes Aéreos,Landing (descent or approach),Commercial,Ecuador,South America,56,9,0,47,0,0,56,Human Factor
1997-08-28 00:00:00,Private French,Flight,Business,France,Europe,1,1,0,0,0,0,1,Technical Failure
1997-08-30 00:00:00,South Canterbury Aerial Co-op,Flight,Military / Government,New Zealand,Oceania,1,1,0,0,0,0,1,Weather
1997-09-02 00:00:00,North American Plastics,Landing (descent or approach),Operational,United States of America,North America,2,2,0,0,0,0,2,Human Factor
1997-09-02 00:00:00,United States Air Force - USAF,Landing (descent or approach),Operational,United States of America,North America,11,11,0,0,0,0,11,Human Factor
1997-09-05 00:00:00,Aviation Sans Frontières - ASF,Landing (descent or approach),Humanitarian,Democratic Republic of Congo,Africa,0,0,0,0,0,0,0,Unknown
1997-09-06 00:00:00,Saudi Arabian Airlines - SAUDIA,Takeoff (climb),Commercial,Saudi Arabia,Asia,85,6,0,79,0,0,85,Technical Failure
1997-09-12 00:00:00,Manan Air Services,Landing (descent or approach),Operational,Canada,North America,1,1,0,0,0,0,1,Human Factor
1997-09-12 00:00:00,Nigerian Air Force,Takeoff (climb),Military / Government,Nigeria,Africa,10,2,0,8,0,0,10,Other
1997-09-14 00:00:00,Intercontinental Colombia - Intercontinental de Aviación,Landing (descent or approach),Commercial,Colombia,South America,44,5,0,39,0,0,44,Technical Failure
1997-09-23 00:00:00,United States Navy - USN,Landing (descent or approach),Military / Government,Greece,Europe,26,4,0,22,0,0,26,Human Factor
1997-09-23 00:00:00,BoniAir,,Commercial,Macedonia,Europe,0,0,0,0,0,0,0,Unknown
1997-09-26 00:00:00,Vostok Aviakompania - East Air,Landing (descent or approach),Commercial,Russia,Asia,7,2,0,5,0,0,7,Technical Failure
1997-10-01 00:00:00,Ryan International Airlines,Taxiing,Operational,United States of America,North America,3,3,0,0,0,0,3,Human Factor
1997-10-02 00:00:00,May Air Express,Takeoff (climb),Operational,United States of America,North America,2,1,0,1,0,0,2,Human Factor
1997-10-06 00:00:00,May Air Express,Flight,Operational,United States of America,North America,1,1,0,0,0,0,1,Human Factor
1997-10-10 00:00:00,Private French,Landing (descent or approach),Business,France,Europe,5,1,0,4,0,0,5,Human Factor
1997-10-13 00:00:00,Bouraq Indonesia Airlines,Landing (descent or approach),Commercial,Indonesia,Asia,10,5,0,5,0,0,10,Unknown
1997-10-15 00:00:00,AeroMéxico,Landing (descent or approach),Commercial,Mexico,Central America,72,5,0,67,0,0,72,Unknown
1997-10-18 00:00:00,Transportes Aéreos Meridionais,Flight,Operational,Brazil,South America,2,2,0,0,0,0,2,Technical Failure
1997-10-28 00:00:00,Aerogal - Aerolineas Galapagos,Landing (descent or approach),Operational,Ecuador,South America,7,2,0,5,0,0,7,Human Factor
1997-11-01 00:00:00,Congo Airlines,Landing (descent or approach),Commercial,Democratic Republic of Congo,Africa,0,0,0,0,0,0,0,Technical Failure
1997-11-02 00:00:00,Air Flight,Landing (descent or approach),Commercial,United States of America,North America,7,1,0,6,0,0,7,Technical Failure
1997-11-02 00:00:00,Perimeter Aviation,Landing (descent or approach),Commercial,Canada,North America,11,2,0,9,0,0,11,Technical Failure
1997-11-06 00:00:00,Necon Air,Landing (descent or approach),Commercial,Nepal,Asia,48,4,0,44,0,0,48,Technical Failure
1997-11-07 00:00:00,McNeely Charter Service,Landing (descent or approach),Operational,United States of America,North America,2,2,0,0,0,0,2,Technical Failure
1997-11-08 00:00:00,Aviaobshchemash,Landing (descent or approach),Operational,Russia,Asia,9,8,0,1,0,0,9,Human Factor
1997-11-09 00:00:00,Royal Australian Army,Flight,Operational,Papua New Guinea,Oceania,4,4,0,0,0,0,4,Human Factor
1997-11-09 00:00:00,Air Saint Barthelemy,Flight,Commercial,Bahamas,Central America,0,0,0,0,0,0,0,Unknown
1997-11-13 00:00:00,Skyward Aviation - USA,Landing (descent or approach),Commercial,United States of America,North America,5,2,0,3,0,0,5,Human Factor
1997-11-16 00:00:00,Air Niugini,Landing (descent or approach),Commercial,Papua New Guinea,Oceania,49,4,0,45,0,0,49,Technical Failure
1997-11-18 00:00:00,Cougar Air Cargo International,Landing (descent or approach),Operational,Tanzania,Africa,4,4,0,0,0,0,4,Human Factor
1997-11-19 00:00:00,Rollins Air,Landing (descent or approach),Commercial,Honduras,Central America,11,2,0,9,0,0,11,Other
1997-11-24 00:00:00,Rollins Air,Landing (descent or approach),Commercial,Honduras,Central America,12,2,0,10,0,0,12,Other
1997-11-25 00:00:00,Corporate Air - USA,Landing (descent or approach),Operational,United States of America,North America,2,2,0,0,0,0,2,Human Factor
1997-11-27 00:00:00,Vanair,Landing (descent or approach),Commercial,Vanuatu,Oceania,3,1,0,2,0,0,3,Human Factor
1997-11-29 00:00:00,Dwyer Aircraft,Landing (descent or approach),Operational,United States of America,North America,1,1,0,0,0,0,1,Human Factor
1997-12-04 00:00:00,Bearskin Airlines - Bearskin Lake Air Services,Landing (descent or approach),Commercial,Canada,North America,10,2,0,8,0,0,10,Human Factor
1997-12-07 00:00:00,Air UK,Landing (descent or approach),Commercial,United Kingdom,Europe,54,4,0,50,0,0,54,Human Factor
1997-12-07 00:00:00,Voyageur Airways,Landing (descent or approach),Humanitarian,Canada,North America,4,2,0,2,0,0,4,Human Factor
1997-12-11 00:00:00,Russian Air Force - Voyenno-vozdushnye sily Rossii,Landing (descent or approach),Military / Government,Russia,Asia,9,7,0,2,0,0,9,Human Factor
1997-12-16 00:00:00,Air Canada,Landing (descent or approach),Commercial,Canada,North America,42,3,0,39,0,0,42,Human Factor
1997-12-17 00:00:00,Ramaer Cargo,Takeoff (climb),Operational,South Africa,Africa,4,3,0,1,0,0,4,Other
1997-12-20 00:00:00,Aerolineas California del Pacifico,Takeoff (climb),Commercial,Mexico,Central America,5,2,0,3,0,0,5,Unknown
1997-12-22 00:00:00,Biman Bangladesh Airlines,Landing (descent or approach),Commercial,Bangladesh,Asia,89,4,0,85,0,0,89,Human Factor
1997-12-23 00:00:00,Libyan Arab Airlines,Landing (descent or approach),Specialised Services,Libya,Africa,5,5,0,0,0,0,5,Technical Failure
1997-12-28 00:00:00,Golden Eagle Aviation - USA,Takeoff (climb),Commercial,United States of America,North America,7,2,0,5,0,0,7,Human Factor
1997-12-31 00:00:00,Transportes Aéreos Virgen del Carmen,Flight,Operational,Bolivia,South America,0,0,0,0,0,0,0,Technical Failure
1997-12-31 00:00:00,Air Force of Zimbabwe,,Military / Government,Zimbabwe,Africa,0,0,0,0,0,0,0,Unknown
1997-12-31 00:00:00,Sudanese Air Force - Al Quwwat al-Jawwiya As-Sudaniya,Flight,Military / Government,South Sudan,Africa,0,0,0,0,0,0,0,Human Factor
1997-12-31 00:00:00,Aerosur,Takeoff (climb),Commercial,Bolivia,South America,20,2,0,18,0,0,20,Unknown
1997-12-31 00:00:00,Philippine Air Force - Hukbong Himpapawid NG Pilipinas,Flight,Operational,Philippines,Asia,0,0,0,0,0,0,0,Unknown
1998-01-02 00:00:00,Woods Air Service - Woods Air Fuel,Takeoff (climb),Operational,United States of America,North America,3,3,0,0,0,0,3,Human Factor
1998-01-05 00:00:00,Iran Air,Landing (descent or approach),Commercial,Iran,Asia,113,9,0,104,0,0,113,Unknown
1998-01-06 00:00:00,US Motorsports,Landing (descent or approach),Business,United States of America,North America,3,2,0,1,0,0,3,Human Factor
1998-01-08 00:00:00,Malaysian Airlines System - MAS,Landing (descent or approach),Commercial,Malaysia,Asia,8,2,0,6,0,0,8,Unknown
1998-01-09 00:00:00,William Byars,Takeoff (climb),Operational,Philippines,Asia,2,2,0,0,0,0,2,Unknown
1998-01-11 00:00:00,Turkish Airlines - THY Türk Hava Yollari,Landing (descent or approach),Commercial,Turkey,Asia,74,6,0,68,0,0,74,Human Factor
1998-01-15 00:00:00,Airco Aircraft Charters,Takeoff (climb),Commercial,Canada,North America,9,2,0,7,0,0,9,Human Factor
1998-01-20 00:00:00,Alberta Citylink,Landing (descent or approach),Commercial,Canada,North America,15,2,0,13,0,0,15,Human Factor
1998-01-20 00:00:00,ItalAir,Landing (descent or approach),Commercial,Italy,Europe,25,3,0,22,0,0,25,Weather
1998-01-20 00:00:00,Air Nunavut,Takeoff (climb),Commercial,Canada,North America,4,2,0,2,0,0,4,Technical Failure
1998-01-22 00:00:00,Global Air Services,Landing (descent or approach),Business,United States of America,North America,1,1,0,0,0,0,1,Other
1998-01-30 00:00:00,PenAir - Peninsula Airways - Alaska Airlines Commuter,Landing (descent or approach),Operational,United States of America,North America,1,1,0,0,0,0,1,Weather
1998-01-31 00:00:00,Sicotra Aviation,Flight,Commercial,Democratic Republic of Congo,Africa,0,0,0,0,0,0,0,Unknown
1998-02-03 00:00:00,Missionary Flights International,Landing (descent or approach),Humanitarian,Bahamas,Central America,27,3,0,24,0,0,27,Technical Failure
1998-02-06 00:00:00,Pegasus Aviation - Bermuda,Landing (descent or approach),Business,France,Europe,5,3,0,2,0,0,5,Human Factor
1998-02-09 00:00:00,British Regional Airlines,Landing (descent or approach),Commercial,United Kingdom,Europe,30,4,0,26,0,0,30,Human Factor
1998-02-09 00:00:00,American Airlines,Landing (descent or approach),Commercial,United States of America,North America,121,6,0,115,0,0,121,Human Factor
1998-02-09 00:00:00,Brazilian Air Force - Força Aérea Brasileira,Landing (descent or approach),Military / Government,Brazil,South America,25,7,0,18,0,0,25,Unknown
1998-02-11 00:00:00,Continental Express,Takeoff (climb),Operational,United States of America,North America,4,4,0,0,0,0,4,Human Factor
1998-02-11 00:00:00,JU-Air,Landing (descent or approach),Commercial,Switzerland,Europe,20,3,0,17,0,0,20,Weather
1998-02-19 00:00:00,Skyways - Kenya,Landing (descent or approach),Commercial,Somalia,Africa,23,3,0,20,0,0,23,Technical Failure
1998-02-23 00:00:00,Chanchangi Airlines,Taxiing,Operational,Nigeria,Africa,24,3,0,21,0,0,24,Human Factor
1998-03-03 00:00:00,Airlink Papua New Guinea,Landing (descent or approach),Commercial,Papua New Guinea,Oceania,13,3,0,10,0,0,13,Other
1998-03-04 00:00:00,Sierra West Airlines,Landing (descent or approach),Operational,United States of America,North America,2,2,0,0,0,0,2,Human Factor
1998-03-07 00:00:00,Aerolíneas Sosa,Landing (descent or approach),Commercial,Honduras,Central America,17,2,0,15,0,0,17,Technical Failure
1998-03-12 00:00:00,Santa Cruz Imperial,Takeoff (climb),Operational,Somalia,Africa,4,4,0,0,0,0,4,Unknown
1998-03-13 00:00:00,Ray M. Dolby,Landing (descent or approach),Business,United States of America,North America,4,1,0,3,0,0,4,Human Factor
1998-03-19 00:00:00,R. L. Riemenschneider Enterprises,Takeoff (climb),Business,United States of America,North America,4,1,0,3,0,0,4,Human Factor
1998-03-20 00:00:00,Banco Republica de Uruguay,Takeoff (climb),Business,Uruguay,South America,6,2,0,4,0,0,6,Other
1998-03-22 00:00:00,Philippine Airlines - PAL,Landing (descent or approach),Commercial,Philippines,Asia,130,6,0,124,0,0,130,Human Factor
1998-03-22 00:00:00,Arapahoe Aviation,Takeoff (climb),Business,United States of America,North America,3,1,0,2,0,0,3,Human Factor
1998-03-30 00:00:00,Emerald Airways,Takeoff (climb),Commercial,United Kingdom,Europe,44,4,0,40,0,0,44,Technical Failure
1998-04-03 00:00:00,Dove One,Landing (descent or approach),Commercial,United States of America,North America,9,1,0,8,0,0,9,Human Factor
1998-04-08 00:00:00,Phillips Air Service,Takeoff (climb),Operational,United States of America,North America,1,1,0,0,0,0,1,Technical Failure
1998-04-11 00:00:00,Lipetsk Aviation Enterprise,Takeoff (climb),Military / Government,Russia,Asia,2,2,0,0,0,0,2,Human Factor
1998-04-12 00:00:00,Orient Eagle Airways,Landing (descent or approach),Commercial,Kazakhstan,Asia,88,8,0,80,0,0,88,Human Factor
1998-04-23 00:00:00,SAFT Gabon - Société Anonyme de Fret et de Transport,Landing (descent or approach),Commercial,Gabon,Africa,16,3,0,13,0,0,16,Human Factor
1998-04-24 00:00:00,Trans Asian Airlines,Parking,Commercial,Turkey,Asia,73,9,0,64,0,0,73,Technical Failure
1998-05-04 00:00:00,Speed Air,Takeoff (climb),Commercial,South Africa,Africa,0,0,0,0,0,0,0,Technical Failure
1998-05-07 00:00:00,Gama Air,Landing (descent or approach),Operational,South Africa,Africa,4,4,0,0,0,0,4,Technical Failure
1998-05-11 00:00:00,Quinn Industries,Landing (descent or approach),Business,Bahamas,Central America,3,1,0,2,0,0,3,Technical Failure
1998-05-11 00:00:00,Tyumen Airlines - Tyumenskie Avialinii,Landing (descent or approach),Operational,Angola,Africa,7,7,0,0,0,0,7,Weather
1998-05-14 00:00:00,Avionair,Landing (descent or approach),Commercial,Canada,North America,4,2,0,2,0,0,4,Technical Failure
1998-05-15 00:00:00,Merpati Nusantara Airlines - MNA,Takeoff (climb),Commercial,Indonesia,Asia,64,4,0,60,0,0,64,Technical Failure
1998-05-16 00:00:00,Manunggal Air,Landing (descent or approach),Commercial,Singapore,Asia,80,7,0,73,0,0,80,Human Factor
1998-05-18 00:00:00,V. Kelner Airways,Landing (descent or approach),Commercial,Canada,North America,10,1,0,9,0,0,10,Human Factor
1998-05-23 00:00:00,Panther Aviation,Landing (descent or approach),Humanitarian,United States of America,North America,6,2,0,4,0,0,6,Human Factor
1998-05-24 00:00:00,Majestic Air Cargo,Landing (descent or approach),Operational,United States of America,North America,3,2,0,1,0,0,3,Human Factor
1998-05-25 00:00:00,World Geoscience Corporation,Flight,Business,Zimbabwe,Africa,0,0,0,0,0,0,0,Technical Failure
1998-05-28 00:00:00,Silverhawk Security Specialists,Takeoff (climb),Business,United States of America,North America,3,1,0,2,0,0,3,Technical Failure
1998-06-01 00:00:00,Trans Florida Airlines,Landing (descent or approach),Operational,Puerto Rico,Central America,3,3,0,0,0,0,3,Human Factor
1998-06-03 00:00:00,Air Tango,Landing (descent or approach),Operational,Argentina,South America,2,2,0,0,0,0,2,Human Factor
1998-06-05 00:00:00,Two Engines and a Prayer,Landing (descent or approach),Business,United States of America,North America,5,1,0,4,0,0,5,Human Factor
1998-06-27 00:00:00,Air Parabat,Landing (descent or approach),Commercial,Bangladesh,Asia,7,5,0,2,0,0,7,Technical Failure
1998-07-10 00:00:00,Sete Taxi Aéreo,Takeoff (climb),Commercial,Brazil,South America,5,2,0,3,0,0,5,Technical Failure
1998-07-16 00:00:00,G-BSPF Crusader Group,Landing (descent or approach),Operational,United Kingdom,Europe,1,1,0,0,0,0,1,Human Factor
1998-07-19 00:00:00,Sudan Airways,Landing (descent or approach),Commercial,Sudan,Africa,100,9,0,91,0,0,100,Technical Failure
1998-07-23 00:00:00,Norilsk Avia,Takeoff (climb),Operational,Russia,Asia,9,7,0,2,0,0,9,Human Factor
1998-07-24 00:00:00,Skyward Aviation - Canada,Takeoff (climb),Operational,United States of America,North America,2,2,0,0,0,0,2,Human Factor
1998-07-26 00:00:00,Legion Express,Landing (descent or approach),Operational,Iceland,Europe,2,2,0,0,0,0,2,Technical Failure
1998-08-05 00:00:00,Korean Air,Landing (descent or approach),Commercial,South Korea,Asia,395,16,0,379,0,0,395,Technical Failure
1998-08-06 00:00:00,Wasaya Airways,Landing (descent or approach),Operational,Canada,North America,4,2,0,2,0,0,4,Human Factor
1998-08-06 00:00:00,Rhodes Aviation,Takeoff (climb),Commercial,United States of America,North America,6,2,0,4,0,0,6,Human Factor
1998-08-14 00:00:00,Polyarnye Avialinii,Flight,Commercial,Russia,Asia,0,0,0,0,0,0,0,Unknown
1998-08-14 00:00:00,Kyrgyzstan Airlines - Kyrgyzstan Aba Zholdoru,Landing (descent or approach),Commercial,Kyrgyzstan,Asia,0,0,0,0,0,0,0,Unknown
1998-08-19 00:00:00,Motor Sich Aviakompania,Taxiing,Operational,Indonesia,Asia,0,0,0,0,0,0,0,Unknown
1998-08-19 00:00:00,Chilean Air Force - Fuerza Aérea de Chile,Takeoff (climb),Operational,Chile,South America,3,3,0,0,0,0,3,Human Factor
1998-08-19 00:00:00,Aeroklub Togliatti,Flight,Humanitarian,Russia,Asia,2,2,0,0,0,0,2,Human Factor
1998-08-22 00:00:00,Transportes Aéreos Nacionales de la Selva - TANS,Takeoff (climb),Commercial,Peru,South America,4,2,0,2,0,0,4,Unknown
1998-08-24 00:00:00,Sociedad Aérea del Caqueta - Sadelca Colombia,Takeoff (climb),Operational,Colombia,South America,6,3,0,3,0,0,6,Other
1998-08-24 00:00:00,Yeniseiski Meridian,Landing (descent or approach),Commercial,Russia,Asia,20,5,0,15,0,0,20,Human Factor
1998-08-28 00:00:00,Reliant Airlines,Takeoff (climb),Operational,United States of America,North America,2,2,0,0,0,0,2,Technical Failure
1998-08-31 00:00:00,DHL Worldwide Express - DHL Airways,Landing (descent or approach),Operational,United States of America,North America,5,5,0,0,0,0,5,Technical Failure
1998-09-02 00:00:00,Fresh Water Adventures,Flight,Commercial,United States of America,North America,3,2,0,1,0,0,3,Human Factor
1998-09-07 00:00:00,Krystal Corporation,Takeoff (climb),Business,United States of America,North America,1,1,0,0,0,0,1,Technical Failure
1998-09-10 00:00:00,Pakistan Air Force - Pakistan Fiza'ya,Parking,Military / Government,Pakistan,Asia,0,0,0,0,0,0,0,Technical Failure
1998-09-10 00:00:00,Pakistan Air Force - Pakistan Fiza'ya,Parking,Military / Government,Pakistan,Asia,0,0,0,0,0,0,0,Technical Failure
1998-09-14 00:00:00,Avia Trend,Takeoff (climb),Operational,Kenya,Africa,4,4,0,0,0,0,4,Other
1998-09-16 00:00:00,Continental Airlines,Landing (descent or approach),Commercial,Mexico,Central America,108,6,0,102,0,0,108,Weather
1998-09-16 00:00:00,Mexican Air Force - Fuerza Aérea Mexicana,Flight,Military / Government,Mexico,Central America,3,3,0,0,0,0,3,Human Factor
1998-09-18 00:00:00,Brazilian Air Force - Força Aérea Brasileira,Flight,Military / Government,Brazil,South America,5,2,0,3,0,0,5,Unknown
1998-09-24 00:00:00,Trans Florida Airlines,Landing (descent or approach),Operational,Puerto Rico,Central America,3,2,0,1,0,0,3,Technical Failure
1998-09-25 00:00:00,Southern Mechanical Plumbing,Landing (descent or approach),Business,United States of America,North America,1,1,0,0,0,0,1,Unknown
1998-09-26 00:00:00,Gamston Aviation,Landing (descent or approach),Commercial,United Kingdom,Europe,3,2,0,1,0,0,3,Human Factor
1998-10-05 00:00:00,Linhas Aéreas de Moçambique - LAM,Takeoff (climb),Commercial,Mozambique,Africa,66,16,0,50,0,0,66,Technical Failure
1998-10-08 00:00:00,Castle Aviation,Landing (descent or approach),Operational,United States of America,North America,1,1,0,0,0,0,1,Technical Failure
1998-10-09 00:00:00,Precision Air Services - Precisionair,Landing (descent or approach),Commercial,Tanzania,Africa,4,1,0,3,0,0,4,Other
1998-10-12 00:00:00,Bashkirian Airlines - Bashkirskie Avialinii,Flight,Commercial,Russia,Asia,16,3,0,13,0,0,16,Human Factor
1998-10-17 00:00:00,Pink Aviation Services,Takeoff (climb),Humanitarian,Austria,Europe,21,2,0,19,0,0,21,Human Factor
1998-10-17 00:00:00,Alpine Air,Landing (descent or approach),Operational,United States of America,North America,2,2,0,0,0,0,2,Human Factor
1998-10-17 00:00:00,Bemidji Airlines,Landing (descent or approach),Operational,United States of America,North America,1,1,0,0,0,0,1,Human Factor
1998-10-18 00:00:00,Critical Air Medicine,Takeoff (climb),Humanitarian,United States of America,North America,5,1,0,4,0,0,5,Weather
1998-10-19 00:00:00,Belize Defence Force Air Wing,Flight,Military / Government,Belize,Central America,0,0,0,0,0,0,0,Unknown
1998-10-21 00:00:00,Ararat Avia,Takeoff (climb),Commercial,Armenia,Asia,37,4,0,33,0,0,37,Human Factor
1998-10-21 00:00:00,Coral Sea Airlines,Landing (descent or approach),Commercial,Australia,Oceania,5,1,0,4,0,0,5,Technical Failure
1998-10-21 00:00:00,Boma Helicopters,Takeoff (climb),Operational,South Africa,Africa,2,1,0,1,0,0,2,Other
1998-10-27 00:00:00,Gates Learjet Aircraft Corporation,Landing (descent or approach),Specialised Services,United States of America,North America,3,2,0,1,0,0,3,Human Factor
1998-11-01 00:00:00,Airtran Airways,Landing (descent or approach),Commercial,United States of America,North America,105,5,0,100,0,0,105,Human Factor
1998-11-11 00:00:00,Aeroflot - Russian International Airlines,Parking,Commercial,United States of America,North America,12,12,0,0,0,0,12,Human Factor
1998-11-14 00:00:00,IAT Cargo Airlines - International Air Tours,Landing (descent or approach),Operational,Belgium,Europe,5,5,0,0,0,0,5,Technical Failure
1998-11-17 00:00:00,Sequel Group,Takeoff (climb),Business,United States of America,North America,2,2,0,0,0,0,2,Human Factor
1998-11-20 00:00:00,Mexican Navy - Armada de México,Takeoff (climb),Military / Government,Mexico,Central America,7,2,0,5,0,0,7,Human Factor
1998-11-23 00:00:00,Kaikén Linéas Aéreas,Landing (descent or approach),Commercial,Argentina,South America,7,2,0,5,0,0,7,Technical Failure
1998-11-27 00:00:00,Banair,Landing (descent or approach),Business,United States of America,North America,3,2,0,1,0,0,3,Technical Failure
1998-11-27 00:00:00,Pan African Airlines,Landing (descent or approach),Commercial,Nigeria,Africa,3,1,0,2,0,0,3,Technical Failure
1998-11-29 00:00:00,BPI Aerospace,Flight,Business,Haiti,Central America,1,1,0,0,0,0,1,Technical Failure
1998-12-03 00:00:00,First Air,Takeoff (climb),Commercial,Canada,North America,7,4,0,3,0,0,7,Other
1998-12-03 00:00:00,Cape Smythe Air Service,Landing (descent or approach),Operational,United States of America,North America,1,1,0,0,0,0,1,Human Factor
1998-12-12 00:00:00,Private Ghanaian,Flight,Business,Ghana,Africa,5,2,0,3,0,0,5,Unknown
1998-12-17 00:00:00,Yute Air Alaska,Takeoff (climb),Commercial,United States of America,North America,2,1,0,1,0,0,2,Human Factor
1998-12-20 00:00:00,Nikolayevski Aviation Enterprise,Takeoff (climb),Commercial,Russia,Asia,11,2,0,9,0,0,11,Human Factor
1998-12-28 00:00:00,Rio-Sul Serviços Aéreos Regionais,Landing (descent or approach),Commercial,Brazil,South America,40,4,0,36,0,0,40,Human Factor
1998-12-31 00:00:00,Aeroklub Zrenjanin,Flight,Other,Serbia,Europe,0,0,0,0,0,0,0,Unknown
1998-12-31 00:00:00,Mexican Air Force - Fuerza Aérea Mexicana,Flight,Humanitarian,Mexico,Central America,0,0,0,0,0,0,0,Unknown
1998-12-31 00:00:00,Aeroklub Zrenjanin,Flight,Other,Serbia,Europe,0,0,0,0,0,0,0,Unknown
1998-12-31 00:00:00,Aeroflot - Russian International Airlines,Landing (descent or approach),Commercial,Russia,Asia,0,0,0,0,0,0,0,Unknown
1999-01-04 00:00:00,RégionnAir,Landing (descent or approach),Commercial,Canada,North America,12,2,0,10,0,0,12,Human Factor
1999-01-09 00:00:00,Private Spanish,Takeoff (climb),Business,Spain,Europe,2,1,0,1,0,0,2,Technical Failure
1999-01-11 00:00:00,Mag Marketing,Landing (descent or approach),Specialised Services,Germany,Europe,2,2,0,0,0,0,2,Human Factor
1999-01-13 00:00:00,Besit Servizi Aerei,Landing (descent or approach),Operational,Italy,Europe,2,2,0,0,0,0,2,Unknown
1999-01-20 00:00:00,Private Sao Tome %26 Principe,Landing (descent or approach),Operational,Angola,Africa,7,7,0,0,0,0,7,Unknown
1999-01-28 00:00:00,Alitalia - Linee Aeree Italiane,Landing (descent or approach),Commercial,Italy,Europe,84,6,0,78,0,0,84,Weather
1999-01-31 00:00:00,Air Algérie,Landing (descent or approach),Commercial,Algeria,Africa,99,7,0,92,0,0,99,Unknown
1999-02-02 00:00:00,Nortema Aerotáxi,Parking,Operational,Brazil,South America,2,1,0,1,0,0,2,Technical Failure
1999-02-04 00:00:00,Air Angol,Landing (descent or approach),Commercial,Angola,Africa,36,6,0,30,0,0,36,Human Factor
1999-02-07 00:00:00,Avistar,Takeoff (climb),Operational,Slovakia,Europe,7,3,0,4,0,0,7,Technical Failure
1999-02-08 00:00:00,Italian Air Force - Aeronautica Militare Italiana,Parking,Military / Government,Russia,Asia,0,0,0,0,0,0,0,Human Factor
1999-02-11 00:00:00,ACE Air Cargo,Landing (descent or approach),Operational,United States of America,North America,1,1,0,0,0,0,1,Human Factor
1999-02-14 00:00:00,748 Air Services,Landing (descent or approach),Operational,South Sudan,Africa,2,2,0,0,0,0,2,Technical Failure
1999-02-23 00:00:00,Aero Lloyd,Landing (descent or approach),Commercial,Chile,South America,4,1,0,3,0,0,4,Technical Failure
1999-02-27 00:00:00,Crown Charter Services,Landing (descent or approach),Operational,Canada,North America,2,1,0,1,0,0,2,Human Factor
1999-03-01 00:00:00,Channel Express - Air Services,Landing (descent or approach),Operational,Ireland,Europe,3,3,0,0,0,0,3,Human Factor
1999-03-04 00:00:00,Air France,Landing (descent or approach),Commercial,France,Europe,97,6,0,91,0,0,97,Weather
1999-03-06 00:00:00,Air France Cargo,Landing (descent or approach),Operational,India,Asia,5,5,0,0,0,0,5,Technical Failure
1999-03-15 00:00:00,Korean Air,Landing (descent or approach),Commercial,South Korea,Asia,156,6,0,150,0,0,156,Human Factor
1999-03-16 00:00:00,Pantanal Linhas Aéreas Sul-Matogrossenses,Landing (descent or approach),Commercial,Brazil,South America,14,4,0,10,0,0,14,Technical Failure
1999-03-18 00:00:00,Thomas M. Fisher,Takeoff (climb),Business,United States of America,North America,2,1,0,1,0,0,2,Technical Failure
1999-03-24 00:00:00,United Arab Emirates - Abu Dhabi Amiri Flight,Landing (descent or approach),Commercial,Greece,Europe,271,19,0,252,0,0,271,Human Factor
1999-04-05 00:00:00,Carib-Air Cargo,Landing (descent or approach),Commercial,United States of America,North America,10,1,0,9,0,0,10,Technical Failure
1999-04-14 00:00:00,Tokyo International Trading America,Flight,Operational,United States of America,North America,1,1,0,0,0,0,1,Technical Failure
1999-04-14 00:00:00,Jet Sul Taxi Aéreo,Flight,Operational,Brazil,South America,2,2,0,0,0,0,2,Human Factor
1999-04-17 00:00:00,Vecellio Group,Landing (descent or approach),Business,United States of America,North America,8,2,0,6,0,0,8,Human Factor
1999-04-20 00:00:00,Execstar Aviation,Landing (descent or approach),Operational,United States of America,North America,1,1,0,0,0,0,1,Technical Failure
1999-04-22 00:00:00,Hélicópteros del Caribe - Hélica,Flight,Operational,France,Europe,3,2,0,1,0,0,3,Human Factor
1999-05-01 00:00:00,Points North Air,Takeoff (climb),Commercial,Canada,North America,6,1,0,5,0,0,6,Human Factor
1999-05-01 00:00:00,Kenya Air Force,Takeoff (climb),Military / Government,Kenya,Africa,5,5,0,0,0,0,5,Unknown
1999-05-07 00:00:00,Neville A. Lewis,Landing (descent or approach),Business,United States of America,North America,2,2,0,0,0,0,2,Technical Failure
1999-05-10 00:00:00,Mexican Air Force - Fuerza Aérea Mexicana,Landing (descent or approach),Operational,Mexico,Central America,6,6,0,0,0,0,6,Human Factor
1999-05-12 00:00:00,Avia Volga Atlantik,Takeoff (climb),Operational,Angola,Africa,5,2,0,3,0,0,5,Terrorism
1999-05-16 00:00:00,ZUA - Zakładu Usług Agrolotniczych - AET Agroaviation Services,Flight,Military / Government,Iran,Asia,0,0,0,0,0,0,0,Unknown
1999-05-19 00:00:00,Centrafricain Airlines,Landing (descent or approach),Commercial,Central African Republic,Africa,33,3,0,30,0,0,33,Unknown
1999-05-21 00:00:00,Robert J. Scott,Landing (descent or approach),Operational,United States of America,North America,1,1,0,0,0,0,1,Human Factor
1999-05-21 00:00:00,Private Danish,Takeoff (climb),Operational,Denmark,Europe,2,2,0,0,0,0,2,Human Factor
1999-05-29 00:00:00,Alpha Beta Aviation,Takeoff (climb),Business,United States of America,North America,6,1,0,5,0,0,6,Technical Failure
1999-06-09 00:00:00,China Southern Airlines,Landing (descent or approach),Commercial,China,Asia,90,9,0,81,0,0,90,Human Factor
1999-06-11 00:00:00,Royal Air Force - RAF,Takeoff (climb),Military / Government,Albania,Europe,15,6,0,9,0,0,15,Human Factor
1999-06-14 00:00:00,Thunder Airlines,Takeoff (climb),Commercial,Canada,North America,5,2,0,3,0,0,5,Human Factor
1999-06-19 00:00:00,Xinjiang General Aviation,Flight,Military / Government,China,Asia,0,0,0,0,0,0,0,Human Factor
1999-06-22 00:00:00,D. Owen,Landing (descent or approach),Business,United Kingdom,Europe,1,1,0,0,0,0,1,Human Factor
1999-06-30 00:00:00,British Army Air Corps,Landing (descent or approach),Operational,United Kingdom,Europe,2,2,0,0,0,0,2,Unknown
1999-07-26 00:00:00,Precision Air Services - Precisionair,Landing (descent or approach),Operational,Tanzania,Africa,2,2,0,0,0,0,2,Human Factor
1999-07-26 00:00:00,Elf Air,Takeoff (climb),Operational,Russia,Asia,7,7,0,0,0,0,7,Human Factor
1999-07-28 00:00:00,KAL Aviation,Landing (descent or approach),Operational,Greece,Europe,2,2,0,0,0,0,2,Technical Failure
1999-08-02 00:00:00,National Argentinian Police,Landing (descent or approach),Military / Government,Argentina,South America,3,3,0,0,0,0,3,Unknown
1999-08-06 00:00:00,Merpati Nusantara Airlines - MNA,Landing (descent or approach),Operational,Indonesia,Asia,2,2,0,0,0,0,2,Unknown
1999-08-07 00:00:00,Nepalese Army,Takeoff (climb),Military / Government,Nepal,Asia,2,2,0,0,0,0,2,Other
1999-08-13 00:00:00,Greystoke Engineering,Takeoff (climb),Operational,United States of America,North America,1,1,0,0,0,0,1,Technical Failure
1999-08-14 00:00:00,Trans Arabian Air Transport - TAAT,Landing (descent or approach),Operational,South Sudan,Africa,5,5,0,0,0,0,5,Human Factor
1999-08-16 00:00:00,Hop-a-Jet,Landing (descent or approach),Operational,United States of America,North America,3,3,0,0,0,0,3,Human Factor
1999-08-16 00:00:00,Merlin Express,Landing (descent or approach),Operational,United States of America,North America,2,2,0,0,0,0,2,Human Factor
1999-08-17 00:00:00,DP Air,Landing (descent or approach),Commercial,United States of America,North America,8,2,0,6,0,0,8,Technical Failure
1999-08-24 00:00:00,Uni Air,Landing (descent or approach),Commercial,Taiwan,Asia,96,6,0,90,0,0,96,Other
1999-08-28 00:00:00,Mack Ponder,Takeoff (climb),Business,United States of America,North America,4,1,0,3,0,0,4,Human Factor
1999-08-29 00:00:00,Sowind Air,Flight,Commercial,Canada,North America,11,1,0,10,0,0,11,Technical Failure
1999-08-30 00:00:00,Mabuhay Airways,Landing (descent or approach),Operational,Philippines,Asia,9,2,0,7,0,0,9,Technical Failure
1999-09-06 00:00:00,Hangar 5 Airservices,Landing (descent or approach),Operational,United Kingdom,Europe,2,2,0,0,0,0,2,Human Factor
1999-09-07 00:00:00,Skyline Air,Landing (descent or approach),Commercial,Nigeria,Africa,19,4,0,15,0,0,19,Human Factor
1999-09-09 00:00:00,Webs Planes,Landing (descent or approach),Business,Bahamas,Central America,7,1,0,6,0,0,7,Technical Failure
1999-09-09 00:00:00,Trans World Airlines - TWA,Landing (descent or approach),Commercial,United States of America,North America,46,5,0,41,0,0,46,Human Factor
1999-09-09 00:00:00,Alsair,Landing (descent or approach),Commercial,France,Europe,3,2,0,1,0,0,3,Human Factor
1999-09-23 00:00:00,River Transportation,Landing (descent or approach),Business,United States of America,North America,1,1,0,0,0,0,1,Human Factor
1999-09-26 00:00:00,Dolphin Aviation,Landing (descent or approach),Business,United States of America,North America,5,2,0,3,0,0,5,Human Factor
1999-09-28 00:00:00,Private New Zealand,Takeoff (climb),Military / Government,New Zealand,Oceania,1,1,0,0,0,0,1,Unknown
1999-09-29 00:00:00,Air Sofia,Landing (descent or approach),Operational,Indonesia,Asia,7,7,0,0,0,0,7,Human Factor
1999-10-01 00:00:00,Kenmore Air,Flight,Specialised Services,United States of America,North America,5,1,0,4,0,0,5,Human Factor
1999-10-02 00:00:00,North Star Air,Flight,Commercial,Canada,North America,2,1,0,1,0,0,2,Technical Failure
1999-10-02 00:00:00,AP International Corporation,Takeoff (climb),Business,United States of America,North America,8,1,0,7,0,0,8,Human Factor
1999-10-08 00:00:00,Scandinavian Airlines System - SAS,Taxiing,Other,Sweden,Europe,2,2,0,0,0,0,2,Human Factor
1999-10-15 00:00:00,Wasaya Airways,Flight,Operational,Canada,North America,1,1,0,0,0,0,1,Human Factor
1999-10-15 00:00:00,AeroItalia,Landing (descent or approach),Commercial,Italy,Europe,8,3,0,5,0,0,8,Human Factor
1999-10-15 00:00:00,R. Warren Davies,Landing (descent or approach),Business,United Kingdom,Europe,0,0,0,0,0,0,0,Human Factor
1999-10-16 00:00:00,Continental Cargo Airlines,Landing (descent or approach),Operational,Democratic Republic of Congo,Africa,8,6,0,2,0,0,8,Human Factor
1999-10-17 00:00:00,Federal Express - FedEx,Landing (descent or approach),Operational,Philippines,Asia,2,2,0,0,0,0,2,Human Factor
1999-10-21 00:00:00,Celso Tinoco Taxi Aéreo,Landing (descent or approach),Operational,Brazil,South America,2,2,0,0,0,0,2,Human Factor
1999-11-01 00:00:00,Twin Cities Air Service,Landing (descent or approach),Commercial,United States of America,North America,3,1,0,2,0,0,3,Human Factor
1999-11-12 00:00:00,Dix Aviation,Landing (descent or approach),Commercial,Poland,Europe,6,2,0,4,0,0,6,Human Factor
1999-11-12 00:00:00,Private Angolan,Landing (descent or approach),Operational,Angola,Africa,6,6,0,0,0,0,6,Technical Failure
1999-11-18 00:00:00,Compagnie Africaine d'Aviation,Takeoff (climb),Operational,Democratic Republic of Congo,Africa,3,3,0,0,0,0,3,Human Factor
1999-11-19 00:00:00,Jiangnan Universal Aviation,Landing (descent or approach),Commercial,China,Asia,7,2,0,5,0,0,7,Technical Failure
1999-11-20 00:00:00,Sociedad de Aviaçao Ligeira - SAL,Landing (descent or approach),Commercial,Angola,Africa,5,1,0,4,0,0,5,Unknown
1999-11-27 00:00:00,SmithAir - USA,Landing (descent or approach),Operational,United States of America,North America,2,2,0,0,0,0,2,Technical Failure
1999-11-29 00:00:00,Enimex,Flight,Operational,Poland,Europe,3,2,0,1,0,0,3,Human Factor
1999-12-01 00:00:00,Schuybroek Aviation,Landing (descent or approach),Operational,France,Europe,1,1,0,0,0,0,1,Human Factor
1999-12-08 00:00:00,TAF Linhas Aéreas - Taxi Aéreo Fortaleza,Takeoff (climb),Operational,Brazil,South America,2,2,0,0,0,0,2,Technical Failure
1999-12-13 00:00:00,Twin Wings,Takeoff (climb),Commercial,Tanzania,Africa,6,1,0,5,0,0,6,Other
1999-12-15 00:00:00,Kenn Borek Air,Landing (descent or approach),Commercial,Canada,North America,7,2,0,5,0,0,7,Other
1999-12-16 00:00:00,Robert J. Denison,Takeoff (climb),Business,United States of America,North America,1,1,0,0,0,0,1,Human Factor
1999-12-23 00:00:00,M %26 N Aviation,Flight,Commercial,Puerto Rico,Central America,2,1,0,1,0,0,2,Human Factor
1999-12-24 00:00:00,Grant Aviation,Takeoff (climb),Commercial,United States of America,North America,6,1,0,5,0,0,6,Human Factor
1999-12-26 00:00:00,Bradley Aviation,Taxiing,Business,United States of America,North America,6,2,0,4,0,0,6,Technical Failure
1999-12-28 00:00:00,Seair Seaplanes - Seair Services,Takeoff (climb),Commercial,Canada,North America,6,1,0,5,0,0,6,Human Factor
1999-12-28 00:00:00,Transafrik,Landing (descent or approach),Operational,Angola,Africa,4,4,0,0,0,0,4,Human Factor
1999-12-31 00:00:00,Bohlke International Airways,Landing (descent or approach),Commercial,Saint-Barthélemy,Central America,9,2,0,7,0,0,9,Technical Failure
2000-01-10 00:00:00,Methow Aviation,Takeoff (climb),Operational,United States of America,North America,1,1,0,0,0,0,1,Unknown
2000-01-16 00:00:00,Alster Flug Center,Landing (descent or approach),Operational,Germany,Europe,1,1,0,0,0,0,1,Human Factor
2000-01-26 00:00:00,Malibu Boats West,Takeoff (climb),Operational,United States of America,North America,2,1,0,1,0,0,2,Human Factor
2000-01-27 00:00:00,Matrix Aviation,Landing (descent or approach),Business,United States of America,North America,6,2,0,4,0,0,6,Human Factor
2000-01-31 00:00:00,Government of the State of Amazonas,Landing (descent or approach),Military / Government,Brazil,South America,19,2,0,17,0,0,19,Human Factor
2000-02-02 00:00:00,Florida Air Cargo,Flight,Operational,Bahamas,Central America,2,1,0,1,0,0,2,Technical Failure
2000-02-03 00:00:00,Trans Arabian Air Transport - TAAT,Landing (descent or approach),Operational,Tanzania,Africa,5,5,0,0,0,0,5,Human Factor
2000-02-03 00:00:00,Mexican Air Force - Fuerza Aérea Mexicana,Takeoff (climb),Specialised Services,Mexico,Central America,2,2,0,0,0,0,2,Technical Failure
2000-02-07 00:00:00,Terry Air,Flight,Operational,Canada,North America,1,1,0,0,0,0,1,Human Factor
2000-02-08 00:00:00,Sabin Air,Takeoff (climb),Commercial,Mozambique,Africa,18,2,0,16,0,0,18,Unknown
2000-02-09 00:00:00,Cape Smythe Air Service,Landing (descent or approach),Commercial,United States of America,North America,9,1,0,8,0,0,9,Human Factor
2000-02-12 00:00:00,Transafrik,Landing (descent or approach),Operational,Angola,Africa,7,7,0,0,0,0,7,Human Factor
2000-02-12 00:00:00,Air Afrique,Taxiing,Commercial,Senegal,Africa,182,11,0,171,0,0,182,Technical Failure
2000-02-16 00:00:00,Air Nippon,Landing (descent or approach),Commercial,Japan,Asia,41,4,0,37,0,0,41,Human Factor
2000-02-21 00:00:00,Cape Smythe Air Service,Landing (descent or approach),Commercial,United States of America,North America,1,1,0,0,0,0,1,Human Factor
2000-02-23 00:00:00,Indian Air Force - Bharatiya Vayu Sena,Landing (descent or approach),Military / Government,India,Asia,0,0,0,0,0,0,0,Unknown
2000-02-27 00:00:00,Athabaska Airways,Landing (descent or approach),Commercial,Canada,North America,7,1,0,6,0,0,7,Human Factor
2000-03-01 00:00:00,Private South African,Flight,Business,Botswana,Africa,5,1,0,4,0,0,5,Technical Failure
2000-03-05 00:00:00,Southwest Airlines,Landing (descent or approach),Commercial,United States of America,North America,142,5,0,137,0,0,142,Human Factor
2000-03-17 00:00:00,Skypower Express Airways,Landing (descent or approach),Commercial,Nigeria,Africa,6,3,0,3,0,0,6,Technical Failure
2000-03-19 00:00:00,Air Urga,Landing (descent or approach),Humanitarian,Democratic Republic of Congo,Africa,10,5,0,5,0,0,10,Weather
2000-03-21 00:00:00,American Eagle,Landing (descent or approach),Commercial,United States of America,North America,36,3,0,33,0,0,36,Human Factor
2000-03-23 00:00:00,Cimber Air,Takeoff (climb),Operational,Denmark,Europe,1,1,0,0,0,0,1,Technical Failure
2000-04-06 00:00:00,Saransk Aviation Enterprise,Landing (descent or approach),Operational,Russia,Asia,4,2,0,2,0,0,4,Weather
2000-04-15 00:00:00,Superior Aviation,Takeoff (climb),Operational,United States of America,North America,1,1,0,0,0,0,1,Human Factor
2000-04-22 00:00:00,Turkish Airlines - THY Türk Hava Yollari,Landing (descent or approach),Commercial,Turkey,Asia,46,4,0,42,0,0,46,Weather
2000-04-29 00:00:00,Brutlag Aviation,Landing (descent or approach),Business,United States of America,North America,3,1,0,2,0,0,3,Human Factor
2000-04-30 00:00:00,DAS Air Cargo - Dairo Air Services,Landing (descent or approach),Operational,Uganda,Africa,7,7,0,0,0,0,7,Human Factor
2000-05-07 00:00:00,Private German,Landing (descent or approach),Business,Germany,Europe,1,1,0,0,0,0,1,Unknown
2000-05-09 00:00:00,United States Navy - USN,Takeoff (climb),Military / Government,United States of America,North America,3,3,0,0,0,0,3,Other
2000-05-10 00:00:00,Mapiex Aero,Landing (descent or approach),Commercial,Panama,Central America,8,2,0,6,0,0,8,Unknown
2000-05-14 00:00:00,John M. Stone,Landing (descent or approach),Business,United States of America,North America,1,1,0,0,0,0,1,Human Factor
2000-05-15 00:00:00,Greatland Resource,Landing (descent or approach),Business,World,World,5,2,0,3,0,0,5,Other
2000-05-23 00:00:00,Calico Ventures,Flight,Business,World,World,1,1,0,0,0,0,1,Human Factor
2000-05-30 00:00:00,Government of the State of Goiás,Landing (descent or approach),Military / Government,Brazil,South America,9,2,0,7,0,0,9,Human Factor
2000-06-07 00:00:00,Aviatrans-K Airlines,Landing (descent or approach),Operational,Sudan,Africa,8,4,0,4,0,0,8,Other
2000-06-11 00:00:00,Air Andalusia,Landing (descent or approach),Commercial,Spain,Europe,0,0,0,0,0,0,0,Human Factor
2000-06-12 00:00:00,Scan African Aviation,Flight,Commercial,Tanzania,Africa,8,1,0,7,0,0,8,Human Factor
2000-06-13 00:00:00,Grand Aire Express - Executive Aire Express,Landing (descent or approach),Operational,Canada,North America,2,2,0,0,0,0,2,Human Factor
2000-06-13 00:00:00,EFS Flug Service,Landing (descent or approach),Business,Germany,Europe,3,1,0,2,0,0,3,Human Factor
2000-06-14 00:00:00,Continental Airlines,Parking,Commercial,United States of America,North America,7,1,0,6,0,0,7,Human Factor
2000-06-20 00:00:00,Russian Air Force - Voyenno-vozdushnye sily Rossii,Landing (descent or approach),Military / Government,Russia,Asia,228,7,0,221,0,0,228,Technical Failure
2000-06-24 00:00:00,Alligator Airways,Takeoff (climb),Commercial,Australia,Oceania,6,1,0,5,0,0,6,Human Factor
2000-06-26 00:00:00,Yemenia Yemen Airways,Landing (descent or approach),Operational,Sudan,Africa,5,5,0,0,0,0,5,Human Factor
2000-06-29 00:00:00,Air Spray,Landing (descent or approach),Humanitarian,Canada,North America,1,1,0,0,0,0,1,Human Factor
2000-07-04 00:00:00,Malév Hungarian Airlines - Magyar Légiközlekedési Vallalat,Landing (descent or approach),Commercial,Greece,Europe,94,8,0,86,0,0,94,Human Factor
2000-07-07 00:00:00,Convergence Aviation,Flight,Specialised Services,United Kingdom,Europe,3,1,0,2,0,0,3,Human Factor
2000-07-12 00:00:00,Hapag-Lloyd,Landing (descent or approach),Commercial,Austria,Europe,151,8,0,143,0,0,151,Human Factor
2000-07-12 00:00:00,Air Bateleur,Takeoff (climb),Commercial,Kenya,Africa,0,0,0,0,0,0,0,Technical Failure
2000-07-18 00:00:00,Iran Aseman Airlines,Landing (descent or approach),Commercial,Iran,Asia,88,4,0,84,0,0,88,Human Factor
2000-07-20 00:00:00,Skyline Aviation,Landing (descent or approach),Specialised Services,Netherlands,Europe,2,2,0,0,0,0,2,Technical Failure
2000-07-27 00:00:00,Airwave Transport,Landing (descent or approach),Operational,Canada,North America,2,2,0,0,0,0,2,Human Factor
2000-08-02 00:00:00,HEDA KG,Landing (descent or approach),Specialised Services,Germany,Europe,3,1,0,2,0,0,3,Unknown
2000-08-02 00:00:00,Avialesookhrana,Flight,Specialised Services,Russia,Asia,5,3,0,2,0,0,5,Human Factor
2000-08-02 00:00:00,Jackson Air Service,Takeoff (climb),Commercial,Canada,North America,3,1,0,2,0,0,3,Technical Failure
2000-08-08 00:00:00,Airtran Airways,Landing (descent or approach),Commercial,United States of America,North America,63,5,0,58,0,0,63,Technical Failure
2000-08-12 00:00:00,Great Texas Food,Landing (descent or approach),Business,Bahamas,Central America,3,1,0,2,0,0,3,Technical Failure
2000-08-14 00:00:00,Air Force of Serbia and Montenegro,Landing (descent or approach),Military / Government,Serbia,Europe,0,0,0,0,0,0,0,Unknown
2000-08-15 00:00:00,Inter Trans Air,Landing (descent or approach),Humanitarian,Democratic Republic of Congo,Africa,7,7,0,0,0,0,7,Unknown
2000-08-24 00:00:00,West Coast Airways,Takeoff (climb),Operational,Sierra Leone,Africa,2,2,0,0,0,0,2,Human Factor
2000-08-29 00:00:00,Rougier,Landing (descent or approach),Business,Cameroon,Africa,6,1,0,5,0,0,6,Human Factor
2000-09-07 00:00:00,IEG Venture Management,Takeoff (climb),Business,United States of America,North America,2,1,0,1,0,0,2,Human Factor
2000-09-19 00:00:00,KoryakAvia,Takeoff (climb),Commercial,Russia,Asia,11,2,0,9,0,0,11,Other
2000-09-19 00:00:00,KoryakAvia,Takeoff (climb),Commercial,Russia,Asia,11,2,0,9,0,0,11,Other
2000-09-20 00:00:00,Entertainment Engineering,Landing (descent or approach),Business,United States of America,North America,1,1,0,0,0,0,1,Human Factor
2000-09-21 00:00:00,Togolese Government,Landing (descent or approach),Military / Government,Niger,Africa,10,8,0,2,0,0,10,Technical Failure
2000-09-22 00:00:00,Seair Seaplanes - Seair Services,Flight,Specialised Services,Canada,North America,2,1,0,1,0,0,2,Human Factor
2000-09-22 00:00:00,USAir - US Airways,Parking,Specialised Services,United States of America,North America,3,3,0,0,0,0,3,Technical Failure
2000-09-23 00:00:00,Telford Aviation,Landing (descent or approach),Operational,United States of America,North America,1,1,0,0,0,0,1,Human Factor
2000-09-23 00:00:00,ABAS,Flight,Military / Government,Czech Republic,Europe,2,2,0,0,0,0,2,Unknown
2000-09-26 00:00:00,Saber Cargo Airlines,Landing (descent or approach),Operational,United States of America,North America,2,2,0,0,0,0,2,Technical Failure
2000-09-27 00:00:00,Hydro-Québec - Service Transport Aérien,Landing (descent or approach),Commercial,Canada,North America,21,3,0,18,0,0,21,Human Factor
2000-09-29 00:00:00,Benchmark Aviation,Landing (descent or approach),Operational,Fiji Islands,Oceania,1,1,0,0,0,0,1,Unknown
2000-10-03 00:00:00,Russian Air Force - Voyenno-vozdushnye sily Rossii,Landing (descent or approach),Military / Government,Russia,Asia,0,0,0,0,0,0,0,Unknown
2000-10-06 00:00:00,AeroMéxico,Landing (descent or approach),Commercial,Mexico,Central America,90,5,0,85,0,0,90,Human Factor
2000-10-06 00:00:00,Centrafricain Airlines,Landing (descent or approach),Operational,Angola,Africa,10,6,0,4,0,0,10,Human Factor
2000-10-12 00:00:00,Air Capital Enterprises,Takeoff (climb),Business,United States of America,North America,5,1,0,4,0,0,5,Human Factor
2000-10-16 00:00:00,Aérospatiale Industries - SNIAS,Takeoff (climb),Business,France,Europe,8,2,0,6,0,0,8,Technical Failure
2000-10-19 00:00:00,AeroSmith Aviation,Takeoff (climb),Operational,United States of America,North America,1,1,0,0,0,0,1,Human Factor
2000-10-30 00:00:00,Private German,Landing (descent or approach),Business,Germany,Europe,1,1,0,0,0,0,1,Unknown
2000-11-01 00:00:00,OK Aviation,Landing (descent or approach),Operational,São Tomé and Principe,Africa,1,1,0,0,0,0,1,Human Factor
2000-11-01 00:00:00,West Coast Air,Takeoff (climb),Commercial,Canada,North America,17,2,0,15,0,0,17,Technical Failure
2000-11-05 00:00:00,Cameroon Airlines,Landing (descent or approach),Commercial,France,Europe,203,16,0,187,0,0,203,Human Factor
2000-11-05 00:00:00,Cheboksary Aviation Enterprise - Cheboksarskoe Aviapredpriatie,Takeoff (climb),Commercial,Russia,Asia,0,0,0,0,0,0,0,Human Factor
2000-11-09 00:00:00,Salvadorian Air Force - Fuerza Aérea Salvadoreña,Landing (descent or approach),Military / Government,Salvador,Central America,0,0,0,0,0,0,0,Technical Failure
2000-11-13 00:00:00,Ghana Airways,Landing (descent or approach),Commercial,Guinea,Africa,50,8,0,42,0,0,50,Technical Failure
2000-11-18 00:00:00,Dirgantara Air Service,Takeoff (climb),Commercial,Indonesia,Asia,18,1,0,17,0,0,18,Other
2000-11-24 00:00:00,Jim Mitchell Aviation,Takeoff (climb),Specialised Services,United States of America,North America,2,1,0,1,0,0,2,Technical Failure
2000-11-28 00:00:00,Aero Condor - Servicio de Transporte Aéreo Turistico - STAT,Landing (descent or approach),Operational,Peru,South America,2,2,0,0,0,0,2,Technical Failure
2000-11-29 00:00:00,Airtran Airways,Landing (descent or approach),Commercial,United States of America,North America,97,5,0,92,0,0,97,Human Factor
2000-12-05 00:00:00,SATENA - Servicio de Aeronavegacion a Territorios Nacionales,Landing (descent or approach),Military / Government,Colombia,South America,12,3,0,9,0,0,12,Technical Failure
2000-12-15 00:00:00,Private New Zealand,Takeoff (climb),Military / Government,New Zealand,Oceania,1,1,0,0,0,0,1,Unknown
2000-12-16 00:00:00,Lesotho Defence Force,Landing (descent or approach),Military / Government,Lesotho,Africa,13,3,0,10,0,0,13,Human Factor
2000-12-19 00:00:00,Augusto César Lemos Belo,Landing (descent or approach),Business,Brazil,South America,3,1,0,2,0,0,3,Human Factor
2000-12-20 00:00:00,TS Aviation,Takeoff (climb),Commercial,Costa Rica,Central America,7,1,0,6,0,0,7,Technical Failure
2000-12-20 00:00:00,Million Air Charter,Landing (descent or approach),Commercial,United States of America,North America,4,2,0,2,0,0,4,Human Factor
2000-12-29 00:00:00,United Express,Landing (descent or approach),Commercial,United States of America,North America,18,3,0,15,0,0,18,Human Factor
2001-01-04 00:00:00,Air Response North,Takeoff (climb),Humanitarian,United States of America,North America,3,2,0,1,0,0,3,Human Factor
2001-01-05 00:00:00,Air Gemini,Landing (descent or approach),Operational,Angola,Africa,10,4,0,6,0,0,10,Human Factor
2001-01-09 00:00:00,Lloyd Aéreo Boliviano - LAB Airlines,Taxiing,Commercial,Argentina,South America,146,8,0,138,0,0,146,Technical Failure
2001-01-09 00:00:00,Honduran Air Force - Fuerza Aérea Hondureña,Landing (descent or approach),Military / Government,Honduras,Central America,2,2,0,0,0,0,2,Human Factor
2001-01-14 00:00:00,Ark-Air Flight,Landing (descent or approach),Operational,United States of America,North America,2,2,0,0,0,0,2,Other
2001-01-23 00:00:00,Air Eagle,Landing (descent or approach),Commercial,Nigeria,Africa,18,4,0,14,0,0,18,Human Factor
2001-01-27 00:00:00,Antonov Design Bureau,Takeoff (climb),Specialised Services,Russia,Asia,33,11,0,22,0,0,33,Technical Failure
2001-01-30 00:00:00,Cape Air,Landing (descent or approach),Operational,United States of America,North America,2,2,0,0,0,0,2,Human Factor
2001-01-31 00:00:00,Everts Air Cargo,Landing (descent or approach),Operational,United States of America,North America,3,3,0,0,0,0,3,Human Factor
2001-02-04 00:00:00,Aer Arann,Landing (descent or approach),Commercial,United Kingdom,Europe,28,3,0,25,0,0,28,Human Factor
2001-02-07 00:00:00,Iberia - Lineas Aéreas de Espana,Landing (descent or approach),Commercial,Spain,Europe,143,7,0,136,0,0,143,Weather
2001-02-10 00:00:00,Heringer Taxi Aéreo,Landing (descent or approach),Commercial,Brazil,South America,5,3,0,2,0,0,5,Technical Failure
2001-02-11 00:00:00,Indonesian Air Force - TNI-AU Tentara Nasional Indonesia - Angkatan Udara,Takeoff (climb),Military / Government,Indonesia,Asia,14,3,0,11,0,0,14,Unknown
2001-02-19 00:00:00,Angola Air Force - Força Aérea Nacional Angolana,Takeoff (climb),Military / Government,Angola,Africa,0,0,0,0,0,0,0,Unknown
2001-02-20 00:00:00,Aéropro,Landing (descent or approach),Operational,Canada,North America,1,1,0,0,0,0,1,Human Factor
2001-02-22 00:00:00,Sete Taxi Aéreo,Takeoff (climb),Operational,Brazil,South America,2,2,0,0,0,0,2,Technical Failure
2001-02-26 00:00:00,Marlin Air,Landing (descent or approach),Humanitarian,United States of America,North America,4,2,0,2,0,0,4,Human Factor
2001-03-07 00:00:00,Skymaster Airlines,Landing (descent or approach),Operational,Brazil,South America,3,3,0,0,0,0,3,Human Factor
2001-03-11 00:00:00,Express One International,Landing (descent or approach),Operational,Micronesia,Oceania,3,3,0,0,0,0,3,Human Factor
2001-03-14 00:00:00,Saxon Wings,Landing (descent or approach),Operational,South Africa,Africa,4,4,0,0,0,0,4,Human Factor
2001-03-15 00:00:00,Jim Hankins Air Service,Landing (descent or approach),Operational,United States of America,North America,2,2,0,0,0,0,2,Technical Failure
2001-03-22 00:00:00,Tulip Air,Takeoff (climb),Commercial,France,Europe,10,2,0,8,0,0,10,Human Factor
2001-03-23 00:00:00,Luxor Air,Landing (descent or approach),Commercial,Liberia,Africa,182,7,0,175,0,0,182,Human Factor
2001-03-31 00:00:00,Bishop Aviation,Takeoff (climb),Humanitarian,United States of America,North America,22,1,0,21,0,0,22,Human Factor
2001-04-04 00:00:00,Roblex Aviation,Takeoff (climb),Operational,Puerto Rico,Central America,2,2,0,0,0,0,2,Human Factor
2001-04-04 00:00:00,Royal Aviation,Landing (descent or approach),Operational,Canada,North America,2,2,0,0,0,0,2,Human Factor
2001-04-05 00:00:00,Servicio Autónomo de Transporte Aéreo - SATA,Flight,Commercial,Venezuela,South America,8,2,0,6,0,0,8,Technical Failure
2001-04-07 00:00:00,Alberta Central Airways,Landing (descent or approach),Commercial,Canada,North America,5,2,0,3,0,0,5,Human Factor
2001-04-10 00:00:00,Air West - Equatorial Guinea,Takeoff (climb),Operational,Mauritania,Africa,6,6,0,0,0,0,6,Technical Failure
2001-04-14 00:00:00,North Net,Takeoff (climb),Commercial,Democratic Republic of Congo,Africa,9,1,0,8,0,0,9,Technical Failure
2001-04-18 00:00:00,Dart Airlines,Takeoff (climb),Operational,Belgium,Europe,8,8,0,0,0,0,8,Technical Failure
2001-04-23 00:00:00,ROSTO,Takeoff (climb),Humanitarian,Russia,Asia,13,2,0,11,0,0,13,Human Factor
2001-04-25 00:00:00,Adygeya-Avia,Flight,Military / Government,Russia,Asia,2,2,0,0,0,0,2,Human Factor
2001-04-26 00:00:00,Federal Express - FedEx,Takeoff (climb),Operational,United States of America,North America,1,1,0,0,0,0,1,Human Factor
2001-04-27 00:00:00,Virazh,Takeoff (climb),Military / Government,Russia,Asia,2,2,0,0,0,0,2,Human Factor
2001-05-05 00:00:00,Northeast Equipment Leasing Corporation,Landing (descent or approach),Business,United States of America,North America,9,1,0,8,0,0,9,Human Factor
2001-05-10 00:00:00,Angola Air Charter,Landing (descent or approach),Operational,Angola,Africa,11,5,0,6,0,0,11,Human Factor
2001-05-15 00:00:00,Chrome Air,Landing (descent or approach),Commercial,Nigeria,Africa,4,2,0,2,0,0,4,Human Factor
2001-05-18 00:00:00,Executive Fliteways,Landing (descent or approach),Operational,United States of America,North America,2,2,0,0,0,0,2,Technical Failure
2001-05-22 00:00:00,First Air,Landing (descent or approach),Commercial,Canada,North America,104,6,0,98,0,0,104,Human Factor
2001-05-23 00:00:00,American Airlines,Landing (descent or approach),Commercial,United States of America,North America,92,4,0,88,0,0,92,Technical Failure
2001-05-27 00:00:00,Lake Mead Air,Landing (descent or approach),Operational,United States of America,North America,1,1,0,0,0,0,1,Human Factor
2001-06-03 00:00:00,Southern Aircraft Consultancy,Flight,Business,United Kingdom,Europe,5,1,0,4,0,0,5,Technical Failure
2001-06-06 00:00:00,Taxi Aéreo Weiss,Landing (descent or approach),Operational,Brazil,South America,3,2,0,1,0,0,3,Human Factor
2001-06-07 00:00:00,NASA - National Aeronautics %26 Space Administration,Landing (descent or approach),Operational,United States of America,North America,3,2,0,1,0,0,3,Human Factor
2001-06-07 00:00:00,Aerope 3S Aviation,Landing (descent or approach),Operational,Spain,Europe,2,2,0,0,0,0,2,Human Factor
2001-06-12 00:00:00,Avcon Industries,Landing (descent or approach),Specialised Services,United States of America,North America,2,2,0,0,0,0,2,Human Factor
2001-06-14 00:00:00,Wideroe - Wideroe's Flyveselskap,Landing (descent or approach),Commercial,Norway,Europe,27,3,0,24,0,0,27,Human Factor
2001-06-14 00:00:00,FL25 Aviation,Landing (descent or approach),Operational,United States of America,North America,2,2,0,0,0,0,2,Technical Failure
2001-06-18 00:00:00,Israir,Landing (descent or approach),Commercial,Israel,Asia,42,3,0,39,0,0,42,Technical Failure
2001-06-25 00:00:00,Airtex Aviation,Landing (descent or approach),Commercial,Australia,Oceania,9,1,0,8,0,0,9,Technical Failure
2001-06-26 00:00:00,Parachutisme 74,Landing (descent or approach),Humanitarian,France,Europe,1,1,0,0,0,0,1,Technical Failure
2001-07-06 00:00:00,Maxfly Aviation,Flight,Operational,United States of America,North America,2,2,0,0,0,0,2,Technical Failure
2001-07-06 00:00:00,Air Transat,Flight,Commercial,France,Europe,211,14,0,197,0,0,211,Weather
2001-07-08 00:00:00,Access Air,Flight,Commercial,Russia,Asia,4,1,0,3,0,0,4,Technical Failure
2001-07-08 00:00:00,Cape Air,Takeoff (climb),Operational,United States of America,North America,1,1,0,0,0,0,1,Human Factor
2001-07-10 00:00:00,Línea Aérea Amaszonas,Flight,Commercial,Bolivia,South America,13,2,0,11,0,0,13,Technical Failure
2001-07-12 00:00:00,Belgavia-PANKh,Flight,Military / Government,Russia,Asia,3,3,0,0,0,0,3,Human Factor
2001-07-15 00:00:00,David I. Laskin,Landing (descent or approach),Business,United States of America,North America,1,1,0,0,0,0,1,Human Factor
2001-07-20 00:00:00,Great Barrier Airlines,Landing (descent or approach),Operational,New Zealand,Oceania,1,1,0,0,0,0,1,Weather
2001-07-24 00:00:00,Transtel,Takeoff (climb),Operational,Chad,Africa,3,2,0,1,0,0,3,Weather
2001-07-27 00:00:00,Xinjiang General Aviation,Flight,Military / Government,China,Asia,2,2,0,0,0,0,2,Unknown
2001-08-01 00:00:00,Yemenia Yemen Airways,Landing (descent or approach),Commercial,Eritrea,Africa,140,8,0,132,0,0,140,Unknown
2001-08-01 00:00:00,Air Rainbow Mid-Coast,Landing (descent or approach),Commercial,Canada,North America,4,1,0,3,0,0,4,Technical Failure
2001-08-09 00:00:00,Roeder-Johnson Corporation,Landing (descent or approach),Business,United States of America,North America,1,1,0,0,0,0,1,Technical Failure
2001-08-09 00:00:00,Warren Manufacturing,Landing (descent or approach),Business,United States of America,North America,6,1,0,5,0,0,6,Human Factor
2001-08-14 00:00:00,Air Nunavut,Landing (descent or approach),Commercial,Canada,North America,10,2,0,8,0,0,10,Unknown
2001-08-23 00:00:00,Saudi Arabian Airlines - SAUDIA,Taxiing,Commercial,Malaysia,Asia,6,6,0,0,0,0,6,Human Factor
2001-08-28 00:00:00,Grand Aire Express - Executive Aire Express,Landing (descent or approach),Operational,United States of America,North America,2,2,0,0,0,0,2,Human Factor
2001-08-28 00:00:00,Eagle Aviation - Nigeria,Landing (descent or approach),Commercial,Gabon,Africa,0,0,0,0,0,0,0,Technical Failure
2001-08-29 00:00:00,Greatland Air Cargo,Landing (descent or approach),Operational,United States of America,North America,2,2,0,0,0,0,2,Human Factor
2001-08-30 00:00:00,Air Euro Trans,Takeoff (climb),Commercial,France,Europe,6,1,0,5,0,0,6,Technical Failure
2001-08-31 00:00:00,Air Wemindji,Flight,Operational,Canada,North America,1,1,0,0,0,0,1,Technical Failure
2001-09-06 00:00:00,AeroLitoral,Landing (descent or approach),Commercial,Mexico,Central America,32,3,0,29,0,0,32,Technical Failure
2001-09-07 00:00:00,Equaflight Service,Landing (descent or approach),Operational,Democratic Republic of Congo,Africa,3,3,0,0,0,0,3,Technical Failure
2001-09-08 00:00:00,Private New Zealand,Takeoff (climb),Military / Government,New Zealand,Oceania,1,1,0,0,0,0,1,Human Factor
2001-09-12 00:00:00,Tamalik Air,Takeoff (climb),Commercial,Canada,North America,4,1,0,3,0,0,4,Unknown
2001-09-14 00:00:00,SkyLink Express - Canada,Takeoff (climb),Operational,Canada,North America,2,2,0,0,0,0,2,Unknown
2001-09-16 00:00:00,VARIG - Viação Aérea Rio Grandense,Landing (descent or approach),Commercial,Brazil,South America,67,5,0,62,0,0,67,Human Factor
2001-09-20 00:00:00,Max Aviation - Canada,Landing (descent or approach),Operational,Canada,North America,2,2,0,0,0,0,2,Human Factor
2001-09-21 00:00:00,Aeroflot - Russian International Airlines,Landing (descent or approach),Commercial,United Arab Emirates,Asia,322,15,0,307,0,0,322,Human Factor
2001-09-22 00:00:00,Fundação Nacional do Índio - FUNAI,Flight,Specialised Services,Brazil,South America,5,1,0,4,0,0,5,Technical Failure
2001-09-23 00:00:00,Petropavlosvk-Khamchatsky Air Enterprise,Landing (descent or approach),Commercial,Russia,Asia,21,3,0,18,0,0,21,Human Factor
2001-09-25 00:00:00,Northern Air Cargo,Landing (descent or approach),Operational,United States of America,North America,3,3,0,0,0,0,3,Human Factor
2001-10-06 00:00:00,Alrosa Aviakompania,Flight,Operational,Russia,Asia,3,2,0,1,0,0,3,Weather
2001-10-09 00:00:00,J %26 D Aircraft Sales,Landing (descent or approach),Business,United States of America,North America,1,1,0,0,0,0,1,Human Factor
2001-10-13 00:00:00,Mach 1 Aircraft,Landing (descent or approach),Operational,United States of America,North America,2,2,0,0,0,0,2,Human Factor
2001-10-16 00:00:00,ACE Air Cargo,Landing (descent or approach),Operational,United States of America,North America,2,2,0,0,0,0,2,Human Factor
2001-10-16 00:00:00,Pacific Air Express - Solomon Islands,Landing (descent or approach),Operational,Solomon Islands,Oceania,6,6,0,0,0,0,6,Human Factor
2001-10-17 00:00:00,Pakistan International Airlines - PIA,Landing (descent or approach),Commercial,United Arab Emirates,Asia,205,12,0,193,0,0,205,Technical Failure
2001-10-21 00:00:00,Kyrgyzstan Airlines - Kyrgyzstan Aba Zholdoru,Takeoff (climb),Commercial,Kyrgyzstan,Asia,36,4,0,32,0,0,36,Unknown
2001-10-25 00:00:00,Williams Patent Crusher %26 Pulverizer Company,Landing (descent or approach),Business,United States of America,North America,1,1,0,0,0,0,1,Human Factor
2001-10-26 00:00:00,American Jet International,Landing (descent or approach),Humanitarian,Mexico,Central America,6,2,0,4,0,0,6,Technical Failure
2001-11-21 00:00:00,Commuter Air Philippines,Landing (descent or approach),Commercial,Philippines,Asia,3,2,0,1,0,0,3,Technical Failure
2001-11-25 00:00:00,Jorge Wady Cecilio,Landing (descent or approach),Business,Brazil,South America,6,1,0,5,0,0,6,Human Factor
2001-11-27 00:00:00,Aero Ferinco,Flight,Operational,Mexico,Central America,4,4,0,0,0,0,4,Technical Failure
2001-11-27 00:00:00,Aerocassa,Landing (descent or approach),Operational,Argentina,South America,3,2,0,1,0,0,3,Technical Failure
2001-11-30 00:00:00,European Executive Express,Landing (descent or approach),Commercial,Norway,Europe,13,2,0,11,0,0,13,Human Factor
2001-12-02 00:00:00,OLT Ostfriesische Lufttransport,Landing (descent or approach),Operational,Germany,Europe,3,3,0,0,0,0,3,Human Factor
2001-12-06 00:00:00,Trans-Air-Link,Flight,Operational,United States of America,North America,2,2,0,0,0,0,2,Technical Failure
2001-12-06 00:00:00,Croatian Air Force - Hrvatske Zračne Snage,Landing (descent or approach),Operational,Croatia,Europe,3,3,0,0,0,0,3,Technical Failure
2001-12-09 00:00:00,Air Del,Landing (descent or approach),Operational,United States of America,North America,2,2,0,0,0,0,2,Human Factor
2001-12-11 00:00:00,Air Nave,Landing (descent or approach),Operational,Angola,Africa,6,6,0,0,0,0,6,Unknown
2001-12-20 00:00:00,Indonesian Air Force - TNI-AU Tentara Nasional Indonesia - Angkatan Udara,Landing (descent or approach),Military / Government,Indonesia,Asia,95,12,0,83,0,0,95,Unknown
2001-12-23 00:00:00,Private South African,Landing (descent or approach),Business,South Africa,Africa,4,1,0,3,0,0,4,Technical Failure
2002-01-14 00:00:00,Lion Air,Takeoff (climb),Commercial,Indonesia,Asia,103,7,0,96,0,0,103,Human Factor
2002-01-16 00:00:00,Garuda Indonesian Airways,Landing (descent or approach),Commercial,Indonesia,Asia,60,6,0,54,0,0,60,Weather
2002-01-17 00:00:00,Royal Bahamas Defence Force,Landing (descent or approach),Military / Government,Bahamas,Central America,5,2,0,3,0,0,5,Technical Failure
2002-01-18 00:00:00,Fly BVI,Flight,Commercial,British Virgin Islands,Central America,4,1,0,3,0,0,4,Technical Failure
2002-01-18 00:00:00,Trigana Air Service,Landing (descent or approach),Operational,Indonesia,Asia,2,2,0,0,0,0,2,Weather
2002-01-22 00:00:00,TAM Bolivia - Transporte Aéreo Militar Boliviano,Landing (descent or approach),Military / Government,Bolivia,South America,44,4,0,40,0,0,44,Technical Failure
2002-01-29 00:00:00,Raul Arias Betancourt,Landing (descent or approach),Business,Venezuela,South America,17,2,0,15,0,0,17,Technical Failure
2002-01-29 00:00:00,Swiss Air Force,Takeoff (climb),Military / Government,Switzerland,Europe,1,1,0,0,0,0,1,Unknown
2002-01-30 00:00:00,Manatt's,Landing (descent or approach),Business,United States of America,North America,7,1,0,6,0,0,7,Human Factor
2002-02-02 00:00:00,Transaven - Transporte Aéreo Venezuela,Flight,Commercial,Venezuela,South America,14,2,0,12,0,0,14,Technical Failure
2002-02-03 00:00:00,Thiene Aero Club,Landing (descent or approach),Humanitarian,Italy,Europe,4,1,0,3,0,0,4,Technical Failure
2002-02-04 00:00:00,Robert D. Calhoon,Landing (descent or approach),Business,United States of America,North America,1,1,0,0,0,0,1,Human Factor
2002-02-08 00:00:00,United States Army,Flight,Operational,United States of America,North America,4,4,0,0,0,0,4,Unknown
2002-02-10 00:00:00,Flight Options,Landing (descent or approach),Operational,United States of America,North America,2,2,0,0,0,0,2,Human Factor
2002-02-11 00:00:00,United States Marine Corps,Takeoff (climb),Operational,United States of America,North America,8,8,0,0,0,0,8,Technical Failure
2002-02-12 00:00:00,Aircenter,Flight,Business,United States of America,North America,1,1,0,0,0,0,1,Human Factor
2002-02-12 00:00:00,J %26 D Aviation,Parking,Commercial,South Africa,Africa,4,2,0,2,0,0,4,Human Factor
2002-02-13 00:00:00,United States Air Force - USAF,Flight,Military / Government,Afghanistan,Asia,8,8,0,0,0,0,8,Unknown
2002-02-14 00:00:00,Lao Aviation,Takeoff (climb),Commercial,Laos,Asia,15,2,0,13,0,0,15,Weather
2002-02-14 00:00:00,BB Five Inc.,Landing (descent or approach),Operational,United States of America,North America,2,2,0,0,0,0,2,Human Factor
2002-02-16 00:00:00,Trans Porter International Airlines,Flight,Business,United States of America,North America,1,1,0,0,0,0,1,Human Factor
2002-02-17 00:00:00,Skymaster Freight Services,Takeoff (climb),Operational,Democratic Republic of Congo,Africa,23,3,0,20,0,0,23,Technical Failure
2002-02-24 00:00:00,Islamic Revolutionary Guard Corps,Landing (descent or approach),Military / Government,Iran,Asia,230,8,0,222,0,0,230,Technical Failure
2002-02-27 00:00:00,El Magal Aviation,Landing (descent or approach),Commercial,Sudan,Africa,16,4,0,12,0,0,16,Human Factor
2002-02-28 00:00:00,Arrow Air,Taxiing,Operational,Singapore,Asia,3,3,0,0,0,0,3,Human Factor
2002-03-04 00:00:00,Provincial Airlines,Landing (descent or approach),Operational,Canada,North America,2,2,0,0,0,0,2,Technical Failure
2002-03-04 00:00:00,Russian Air Force - Voyenno-vozdushnye sily Rossii,Landing (descent or approach),Military / Government,Russia,Asia,0,0,0,0,0,0,0,Weather
2002-03-08 00:00:00,Indian Airlines,Taxiing,Specialised Services,India,Asia,5,5,0,0,0,0,5,Human Factor
2002-03-09 00:00:00,Bee Bee Aviation,Landing (descent or approach),Business,Australia,Oceania,4,1,0,3,0,0,4,Human Factor
2002-03-13 00:00:00,Regent Air,Landing (descent or approach),Commercial,United States of America,North America,6,1,0,5,0,0,6,Technical Failure
2002-03-18 00:00:00,Varig Log,Landing (descent or approach),Operational,Brazil,South America,3,3,0,0,0,0,3,Human Factor
2002-03-25 00:00:00,Corporate Flight Management,Landing (descent or approach),Commercial,United States of America,North America,6,2,0,4,0,0,6,Human Factor
2002-03-28 00:00:00,Smithsonian National Air %26 Space Museum,Landing (descent or approach),Specialised Services,United States of America,North America,4,4,0,0,0,0,4,Human Factor
2002-04-02 00:00:00,Renan,Landing (descent or approach),Operational,Angola,Africa,15,4,0,11,0,0,15,Human Factor
2002-04-03 00:00:00,Bulair,Flight,Military / Government,Bulgaria,Europe,3,2,0,1,0,0,3,Technical Failure
2002-04-03 00:00:00,Southstream Aviation,Landing (descent or approach),Commercial,Bahamas,Central America,2,1,0,1,0,0,2,Technical Failure
2002-04-12 00:00:00,Alibrixia Nord,Takeoff (climb),Business,Italy,Europe,0,0,0,0,0,0,0,Unknown
2002-04-13 00:00:00,Nomad Fleet Vamdrup,Takeoff (climb),Humanitarian,United Kingdom,Europe,15,2,0,13,0,0,15,Human Factor
2002-04-16 00:00:00,Airquarius Air Charter,Landing (descent or approach),Commercial,South Africa,Africa,47,5,0,42,0,0,47,Technical Failure
2002-04-17 00:00:00,United Airlines of Kenya,Takeoff (climb),Commercial,Kenya,Africa,19,2,0,17,0,0,19,Human Factor
2002-04-18 00:00:00,Bulair,Flight,Military / Government,Bulgaria,Europe,2,2,0,0,0,0,2,Human Factor
2002-04-21 00:00:00,Enimex,Landing (descent or approach),Operational,Indonesia,Asia,4,4,0,0,0,0,4,Human Factor
2002-04-24 00:00:00,Aeronautica SA,Landing (descent or approach),Commercial,Argentina,South America,3,2,0,1,0,0,3,Human Factor
2002-04-26 00:00:00,Hewa Bora Airways,Landing (descent or approach),Operational,Democratic Republic of Congo,Africa,3,3,0,0,0,0,3,Unknown
2002-04-30 00:00:00,Martin Junge,Takeoff (climb),Business,United States of America,North America,1,1,0,0,0,0,1,Human Factor
2002-04-30 00:00:00,Aerovista,Landing (descent or approach),Operational,Sudan,Africa,4,4,0,0,0,0,4,Other
2002-05-02 00:00:00,NetJets,Landing (descent or approach),Commercial,United States of America,North America,6,2,0,4,0,0,6,Human Factor
2002-05-13 00:00:00,European Aeronautics Defense %26 Space Company - EADS,Landing (descent or approach),Specialised Services,France,Europe,2,1,0,1,0,0,2,Human Factor
2002-05-20 00:00:00,Airlease,Takeoff (climb),Commercial,United States of America,North America,6,2,0,4,0,0,6,Human Factor
2002-05-21 00:00:00,Aero JBR,Takeoff (climb),Specialised Services,United States of America,North America,3,3,0,0,0,0,3,Technical Failure
2002-06-01 00:00:00,D-FEAR GmbH,Takeoff (climb),Humanitarian,Germany,Europe,9,1,0,8,0,0,9,Unknown
2002-06-04 00:00:00,Sibaviatrans,Takeoff (climb),Commercial,Russia,Asia,12,3,0,9,0,0,12,Human Factor
2002-06-09 00:00:00,Indian Airlines,Landing (descent or approach),Operational,India,Asia,2,2,0,0,0,0,2,Unknown
2002-06-11 00:00:00,Sudan Airways,Landing (descent or approach),Operational,Sudan,Africa,2,2,0,0,0,0,2,Technical Failure
2002-06-12 00:00:00,Private German,Landing (descent or approach),Business,Germany,Europe,1,1,0,0,0,0,1,Technical Failure
2002-06-14 00:00:00,Copenhagen Airtaxi,Takeoff (climb),Commercial,Denmark,Europe,8,1,0,7,0,0,8,Human Factor
2002-06-14 00:00:00,Intercontinental Colombia - Intercontinental de Aviación,Landing (descent or approach),Commercial,Colombia,South America,71,6,0,65,0,0,71,Human Factor
2002-06-26 00:00:00,All Nippon Airways,Landing (descent or approach),Operational,Japan,Asia,3,3,0,0,0,0,3,Human Factor
2002-06-26 00:00:00,Eagle Point Inc.,Takeoff (climb),Business,United States of America,North America,3,1,0,2,0,0,3,Human Factor
2002-06-27 00:00:00,Kostroma Air - Kostromskoye Aviapredpriatie,Takeoff (climb),Military / Government,Russia,Asia,2,2,0,0,0,0,2,Other
2002-06-30 00:00:00,Air Saguenay,Takeoff (climb),Commercial,Canada,North America,3,1,0,2,0,0,3,Human Factor
2002-07-02 00:00:00,TAF Linhas Aéreas - Taxi Aéreo Fortaleza,Takeoff (climb),Specialised Services,Brazil,South America,3,1,0,2,0,0,3,Technical Failure
2002-07-10 00:00:00,Crossair,Landing (descent or approach),Commercial,Germany,Europe,20,4,0,16,0,0,20,Human Factor
2002-07-13 00:00:00,Sakha Avia - Sakha Airlines,Landing (descent or approach),Operational,Russia,Asia,4,4,0,0,0,0,4,Human Factor
2002-07-25 00:00:00,Kenya Air Force,Flight,Operational,Kenya,Africa,7,7,0,0,0,0,7,Technical Failure
2002-07-26 00:00:00,Federal Express - FedEx,Landing (descent or approach),Operational,United States of America,North America,3,3,0,0,0,0,3,Human Factor
2002-07-26 00:00:00,Africa One,Takeoff (climb),Operational,Democratic Republic of Congo,Africa,21,6,0,15,0,0,21,Other
2002-08-02 00:00:00,Aviation Sans Frontières - ASF,Landing (descent or approach),Humanitarian,Democratic Republic of Congo,Africa,7,2,0,5,0,0,7,Unknown
2002-08-08 00:00:00,Hewa Bora Airways,Landing (descent or approach),Commercial,Democratic Republic of Congo,Africa,200,12,0,188,0,0,200,Technical Failure
2002-08-13 00:00:00,Rico Linhas Aéreas - Rondonia Importaçao e Comercio,Taxiing,Commercial,Brazil,South America,25,3,0,22,0,0,25,Human Factor
2002-08-13 00:00:00,Corporate Flight International,Landing (descent or approach),Commercial,United States of America,North America,7,2,0,5,0,0,7,Human Factor
2002-08-13 00:00:00,Tanzanair - Tanzanian Air Services,Landing (descent or approach),Commercial,Tanzania,Africa,10,1,0,9,0,0,10,Human Factor
2002-08-13 00:00:00,Private Russian,Flight,Business,Russia,Asia,15,2,0,13,0,0,15,Technical Failure
2002-08-20 00:00:00,Texas Avstar,Takeoff (climb),Business,Canada,North America,2,1,0,1,0,0,2,Human Factor
2002-08-26 00:00:00,Dauriya,Takeoff (climb),Commercial,Russia,Asia,0,0,0,0,0,0,0,Unknown
2002-08-28 00:00:00,America West Airlines,Landing (descent or approach),Commercial,United States of America,North America,159,5,0,154,0,0,159,Human Factor
2002-08-28 00:00:00,Buffalo Airways,Landing (descent or approach),Operational,Canada,North America,2,2,0,0,0,0,2,Human Factor
2002-08-30 00:00:00,TAM Brasil - Taxi Aéreo Marilia - Transportes Aéreos Regionais,Landing (descent or approach),Commercial,Brazil,South America,38,5,0,33,0,0,38,Technical Failure
2002-08-30 00:00:00,TAM Brasil - Taxi Aéreo Marilia - Transportes Aéreos Regionais,Flight,Commercial,Brazil,South America,29,5,0,24,0,0,29,Technical Failure
2002-09-03 00:00:00,Trigana Air Service,Landing (descent or approach),Operational,Indonesia,Asia,3,3,0,0,0,0,3,Weather
2002-09-05 00:00:00,Asian Spirit,Landing (descent or approach),Commercial,Philippines,Asia,49,4,0,45,0,0,49,Technical Failure
2002-09-09 00:00:00,Malift Air,Takeoff (climb),Commercial,Democratic Republic of Congo,Africa,0,0,0,0,0,0,0,Unknown
2002-09-15 00:00:00,Phoenix Aviation - Kyrgyzstan,Landing (descent or approach),Commercial,Angola,Africa,0,0,0,0,0,0,0,Unknown
2002-09-29 00:00:00,Skylink Charter,Takeoff (climb),Commercial,United States of America,North America,21,2,0,19,0,0,21,Human Factor
2002-09-30 00:00:00,Bodaibo Air Enterprise - Bodaibinskoe Aviapredpriatie,Flight,Commercial,Russia,Asia,5,3,0,2,0,0,5,Human Factor
2002-10-07 00:00:00,Exec-Jet,Landing (descent or approach),Business,United States of America,North America,4,2,0,2,0,0,4,Human Factor
2002-10-15 00:00:00,Northwest Airlink,Taxiing,Commercial,United States of America,North America,2,2,0,0,0,0,2,Human Factor
2002-10-23 00:00:00,Tretyakovo Air Transport Company,Landing (descent or approach),Operational,Kyrgyzstan,Asia,9,9,0,0,0,0,9,Human Factor
2002-10-28 00:00:00,Grant Aviation,Takeoff (climb),Operational,United States of America,North America,1,1,0,0,0,0,1,Human Factor
2002-10-31 00:00:00,AeroMéxico,Landing (descent or approach),Commercial,Mexico,Central America,90,4,0,86,0,0,90,Human Factor
2002-11-02 00:00:00,Euroceltic Airways,Landing (descent or approach),Commercial,Ireland,Europe,40,4,0,36,0,0,40,Human Factor
2002-11-06 00:00:00,Sverdlovsk Air Enterprise,Takeoff (climb),Commercial,Russia,Asia,15,2,0,13,0,0,15,Human Factor
2002-11-07 00:00:00,Dale Lawrence Triffett,Landing (descent or approach),Business,Australia,Oceania,5,1,0,4,0,0,5,Technical Failure
2002-11-07 00:00:00,Silk Way Airlines,Landing (descent or approach),Operational,Chad,Africa,6,6,0,0,0,0,6,Human Factor
2002-11-09 00:00:00,TyumenAviaTrans,Landing (descent or approach),Commercial,Turkey,Asia,27,8,0,19,0,0,27,Human Factor
2002-11-12 00:00:00,Canada Jet Charters,Landing (descent or approach),Humanitarian,Canada,North America,4,2,0,2,0,0,4,Human Factor
2002-12-01 00:00:00,American Virginia,Landing (descent or approach),Business,Brazil,South America,7,2,0,5,0,0,7,Human Factor
2002-12-03 00:00:00,Phoenix Air Group,Takeoff (climb),Military / Government,United States of America,North America,4,2,0,2,0,0,4,Other
2002-12-06 00:00:00,Aerotaxi,Landing (descent or approach),Commercial,Cuba,Central America,10,2,0,8,0,0,10,Human Factor
2002-12-07 00:00:00,Changan Airlines,Parking,Specialised Services,China,Asia,2,2,0,0,0,0,2,Human Factor
2002-12-13 00:00:00,Arrow Air,Landing (descent or approach),Operational,Singapore,Asia,4,3,0,1,0,0,4,Human Factor
2002-12-16 00:00:00,National Aircraft Leasing,Landing (descent or approach),Business,United States of America,North America,3,2,0,1,0,0,3,Human Factor
2002-12-17 00:00:00,Philippine Air Force - Hukbong Himpapawid NG Pilipinas,Landing (descent or approach),Military / Government,Philippines,Asia,14,1,0,13,0,0,14,Unknown
2002-12-24 00:00:00,North Flying,Takeoff (climb),Operational,United Kingdom,Europe,2,2,0,0,0,0,2,Human Factor
2002-12-27 00:00:00,Dauriya,Landing (descent or approach),Operational,Russia,Asia,6,5,0,1,0,0,6,Human Factor
2002-12-28 00:00:00,Grasshopper Aviation,Landing (descent or approach),Operational,United States of America,North America,2,1,0,1,0,0,2,Human Factor
2002-12-31 00:00:00,Blackbrook Aviation,Landing (descent or approach),Commercial,United Kingdom,Europe,2,1,0,1,0,0,2,Human Factor
2002-12-31 00:00:00,Inter Tropic Airlines,Landing (descent or approach),Commercial,Sierra Leone,Africa,16,2,0,14,0,0,16,Other
2002-12-31 00:00:00,Private Angolan,,Operational,Angola,Africa,0,0,0,0,0,0,0,Unknown
2003-01-08 00:00:00,Caribbean Aviation,Landing (descent or approach),Commercial,Dominican Republic,Central America,4,2,0,2,0,0,4,Technical Failure
2003-01-14 00:00:00,Siam Air Sports,Takeoff (climb),Humanitarian,Thailand,Asia,7,1,0,6,0,0,7,Technical Failure
2003-01-17 00:00:00,Air Nostrum,Landing (descent or approach),Commercial,Spain,Europe,19,5,0,14,0,0,19,Human Factor
2003-01-17 00:00:00,Transportes Aéreos Mercantiles Ecuatorianos - TAME,Takeoff (climb),Commercial,Ecuador,South America,77,5,0,72,0,0,77,Technical Failure
2003-01-17 00:00:00,Servicio Aéreo Vargas España - SAVE,Landing (descent or approach),Commercial,Bolivia,South America,21,2,0,19,0,0,21,Technical Failure
2003-01-18 00:00:00,American Eagle,Taxiing,Specialised Services,United States of America,North America,3,3,0,0,0,0,3,Human Factor
2003-01-19 00:00:00,Northwest Airlines,Taxiing,Commercial,United States of America,North America,2,2,0,0,0,0,2,Human Factor
2003-01-20 00:00:00,Dairy Air,Takeoff (climb),Commercial,United States of America,North America,3,1,0,2,0,0,3,Human Factor
2003-01-23 00:00:00,Redding Aero Enterprises,Landing (descent or approach),Commercial,United States of America,North America,1,1,0,0,0,0,1,Technical Failure
2003-01-24 00:00:00,Federal Express - FedEx,Landing (descent or approach),Operational,United States of America,North America,2,2,0,0,0,0,2,Human Factor
2003-01-26 00:00:00,VASP - Viação Aérea de São Paulo,Landing (descent or approach),Commercial,Brazil,South America,95,6,0,89,0,0,95,Human Factor
2003-02-14 00:00:00,Belgian Air Force - Force Aérienne Belge - Belgische Luchtmacht,Landing (descent or approach),Operational,Belgium,Europe,2,2,0,0,0,0,2,Unknown
2003-02-16 00:00:00,Kansas Air Center,Flight,Operational,United States of America,North America,1,1,0,0,0,0,1,Human Factor
2003-02-19 00:00:00,Star Air Aviation,Taxiing,Operational,Pakistan,Asia,2,2,0,0,0,0,2,Human Factor
2003-02-20 00:00:00,Bel Air Transport,Landing (descent or approach),Operational,United States of America,North America,1,1,0,0,0,0,1,Technical Failure
2003-02-27 00:00:00,Airwork - New Zealand,Parking,Operational,New Zealand,Oceania,2,2,0,0,0,0,2,Human Factor
2003-03-02 00:00:00,Bering Air,Landing (descent or approach),Operational,United States of America,North America,1,1,0,0,0,0,1,Human Factor
2003-03-06 00:00:00,Minerva Airlines,Taxiing,Commercial,Italy,Europe,45,3,0,42,0,0,45,Technical Failure
2003-03-06 00:00:00,Air Whitsunday Seaplanes,Landing (descent or approach),Operational,Australia,Oceania,1,1,0,0,0,0,1,Human Factor
2003-03-08 00:00:00,Federal Express - FedEx,Landing (descent or approach),Operational,United States of America,North America,2,2,0,0,0,0,2,Technical Failure
2003-03-12 00:00:00,Federal Aviation,Flight,Operational,Argentina,South America,2,2,0,0,0,0,2,Technical Failure
2003-03-12 00:00:00,United States Navy - USN,Landing (descent or approach),Military / Government,United States of America,North America,0,0,0,0,0,0,0,Unknown
2003-03-15 00:00:00,Klaipedos Avialinijos,Takeoff (climb),Business,Switzerland,Europe,3,1,0,2,0,0,3,Technical Failure
2003-03-19 00:00:00,Mountain Flight Service,Landing (descent or approach),Humanitarian,United States of America,North America,3,1,0,2,0,0,3,Human Factor
2003-03-20 00:00:00,Procuraduría General de la República,Landing (descent or approach),Military / Government,Mexico,Central America,5,2,0,3,0,0,5,Unknown
2003-03-22 00:00:00,TransAsia Airways,Landing (descent or approach),Commercial,Taiwan,Asia,175,6,0,169,0,0,175,Human Factor
2003-03-23 00:00:00,Libra Administração e Participações,Landing (descent or approach),Business,Brazil,South America,3,2,0,1,0,0,3,Human Factor
2003-03-26 00:00:00,Royal Air Maroc - RAM,Landing (descent or approach),Commercial,Morocco,Africa,60,7,0,53,0,0,60,Human Factor
2003-03-29 00:00:00,Perelle Aviation Services,Landing (descent or approach),Operational,United Kingdom,Europe,3,2,0,1,0,0,3,Human Factor
2003-03-31 00:00:00,Specialty Microwave Corporation,Landing (descent or approach),Business,United States of America,North America,1,1,0,0,0,0,1,Human Factor
2003-03-31 00:00:00,748 Air Services,Landing (descent or approach),Operational,South Sudan,Africa,0,0,0,0,0,0,0,Technical Failure
2003-04-07 00:00:00,Ibiza Flights,Landing (descent or approach),Business,Switzerland,Europe,3,1,0,2,0,0,3,Human Factor
2003-04-08 00:00:00,Grand Aire Express - Executive Aire Express,Landing (descent or approach),Operational,United States of America,North America,2,2,0,0,0,0,2,Human Factor
2003-04-09 00:00:00,SkyWay Enterprises,Landing (descent or approach),Operational,United States of America,North America,2,2,0,0,0,0,2,Human Factor
2003-04-09 00:00:00,Uzbekistan Airways - Uzbekistan Havo Jullary,Takeoff (climb),Commercial,Uzbekistan,Asia,0,0,0,0,0,0,0,Technical Failure
2003-04-10 00:00:00,ZUA - Zakładu Usług Agrolotniczych - AET Agroaviation Services,Flight,Military / Government,Iran,Asia,2,2,0,0,0,0,2,Human Factor
2003-04-11 00:00:00,Zapolyarye Aviakompania,Landing (descent or approach),Operational,Russia,Asia,13,6,0,7,0,0,13,Human Factor
2003-04-14 00:00:00,South Carolina Department of Natural Resources,Takeoff (climb),Military / Government,United States of America,North America,2,2,0,0,0,0,2,Human Factor
2003-04-15 00:00:00,Superior Aviation,Landing (descent or approach),Operational,United States of America,North America,2,2,0,0,0,0,2,Technical Failure
2003-04-23 00:00:00,Transwest Air,Landing (descent or approach),Commercial,Canada,North America,6,2,0,4,0,0,6,Human Factor
2003-04-25 00:00:00,Private Congolese,Landing (descent or approach),Operational,Democratic Republic of Congo,Africa,10,4,0,6,0,0,10,Human Factor
2003-04-27 00:00:00,Trans IntAir,Takeoff (climb),Commercial,Democratic Republic of Congo,Africa,0,0,0,0,0,0,0,Technical Failure
2003-04-28 00:00:00,Air Regional,Landing (descent or approach),Commercial,Indonesia,Asia,4,3,0,1,0,0,4,Unknown
2003-04-28 00:00:00,Dniproavia,Landing (descent or approach),Commercial,Ukraine,Europe,17,4,0,13,0,0,17,Unknown
2003-04-29 00:00:00,Avirex,Landing (descent or approach),Commercial,Democratic Republic of Congo,Africa,15,2,0,13,0,0,15,Human Factor
2003-04-30 00:00:00,Policía Nacional de Colombia,Landing (descent or approach),Military / Government,Colombia,South America,0,0,0,0,0,0,0,Human Factor
2003-05-03 00:00:00,Private German,Flight,Business,Greece,Europe,0,0,0,0,0,0,0,Technical Failure
2003-05-11 00:00:00,Intertransavia Cargo,Landing (descent or approach),Operational,Eritrea,Africa,7,5,0,2,0,0,7,Technical Failure
2003-05-15 00:00:00,DK%26L Company,Takeoff (climb),Operational,United States of America,North America,1,1,0,0,0,0,1,Technical Failure
2003-05-15 00:00:00,Royal Flying Doctor Service - RFDS,Landing (descent or approach),Humanitarian,Australia,Oceania,4,1,0,3,0,0,4,Human Factor
2003-05-16 00:00:00,Polyarnye Avialinii,Flight,Commercial,Russia,Asia,13,2,0,11,0,0,13,Weather
2003-05-18 00:00:00,Oso Rio,Landing (descent or approach),Operational,United States of America,North America,1,1,0,0,0,0,1,Technical Failure
2003-05-26 00:00:00,Rits Aviation,Flight,Business,United States of America,North America,1,1,0,0,0,0,1,Technical Failure
2003-05-27 00:00:00,Showa Air,Landing (descent or approach),Operational,Democratic Republic of Congo,Africa,4,4,0,0,0,0,4,Weather
2003-05-28 00:00:00,Joseph L. Ciabattoni,Takeoff (climb),Business,United States of America,North America,4,1,0,3,0,0,4,Weather
2003-05-30 00:00:00,Harris Aircraft Services,Landing (descent or approach),Operational,United States of America,North America,1,1,0,0,0,0,1,Human Factor
2003-06-05 00:00:00,Ontario Ministry of Natural Resources,Landing (descent or approach),Humanitarian,Canada,North America,1,1,0,0,0,0,1,Human Factor
2003-06-06 00:00:00,John F. Sumrall,Landing (descent or approach),Business,United States of America,North America,1,1,0,0,0,0,1,Human Factor
2003-06-14 00:00:00,Cubana de Aviación,Landing (descent or approach),Commercial,Cuba,Central America,52,4,0,48,0,0,52,Technical Failure
2003-06-14 00:00:00,Sri Lanka Air Force,Landing (descent or approach),Military / Government,Sri Lanka,Asia,55,5,0,50,0,0,55,Unknown
2003-06-16 00:00:00,Mid Airlines,Landing (descent or approach),Commercial,South Sudan,Africa,45,3,0,42,0,0,45,Other
2003-06-17 00:00:00,Execstar Aviation,Landing (descent or approach),Commercial,Bahamas,Central America,3,1,0,2,0,0,3,Other
2003-06-24 00:00:00,VoronezhAvia,Takeoff (climb),Specialised Services,Russia,Asia,11,9,0,2,0,0,11,Human Factor
2003-06-30 00:00:00,Aeroklub KVS,Flight,Humanitarian,Russia,Asia,0,0,0,0,0,0,0,Technical Failure
2003-07-11 00:00:00,Air Memphis,Takeoff (climb),Operational,Bangladesh,Asia,5,5,0,0,0,0,5,Technical Failure
2003-07-22 00:00:00,Tango Corporation,Flight,Business,United States of America,North America,2,1,0,1,0,0,2,Other
2003-07-31 00:00:00,Colombian Navy - Armada de Colombia,Landing (descent or approach),Military / Government,Colombia,South America,3,2,0,1,0,0,3,Unknown
2003-08-02 00:00:00,PLF Aviation,Flight,Business,United States of America,North America,2,1,0,1,0,0,2,Technical Failure
2003-08-02 00:00:00,Air Albatros,Flight,Commercial,Germany,Europe,11,2,0,9,0,0,11,Technical Failure
2003-08-02 00:00:00,Buffalo Airways,Landing (descent or approach),Operational,Canada,North America,2,2,0,0,0,0,2,Human Factor
2003-08-13 00:00:00,Lexus Aviation,Landing (descent or approach),Commercial,South Sudan,Africa,5,2,0,3,0,0,5,Human Factor
2003-08-14 00:00:00,Air America Flight Services,Landing (descent or approach),Humanitarian,Mexico,Central America,5,2,0,3,0,0,5,Human Factor
2003-08-16 00:00:00,United States Air Force - USAF,Landing (descent or approach),Operational,United States of America,North America,2,2,0,0,0,0,2,Human Factor
2003-08-16 00:00:00,SOREM - Società Ricerche Esperienze Meteorologiche,Flight,Humanitarian,Italy,Europe,2,2,0,0,0,0,2,Human Factor
2003-08-19 00:00:00,Transworld Safaris,Takeoff (climb),Commercial,South Sudan,Africa,6,1,0,5,0,0,6,Human Factor
2003-08-26 00:00:00,Svedijos Prekes,Landing (descent or approach),Operational,Sweden,Europe,2,1,0,1,0,0,2,Human Factor
2003-08-28 00:00:00,Tom Bishop,Flight,Business,United States of America,North America,1,1,0,0,0,0,1,Technical Failure
2003-09-04 00:00:00,Venegas Construction Corporation,Flight,Business,Puerto Rico,Central America,6,1,0,5,0,0,6,Technical Failure
2003-09-06 00:00:00,National Argentinian Police,Takeoff (climb),Military / Government,Argentina,South America,0,0,0,0,0,0,0,Unknown
2003-09-13 00:00:00,Private Mexican,Takeoff (climb),Business,Mexico,Central America,7,1,0,6,0,0,7,Unknown
2003-09-14 00:00:00,ACS Ltd,Takeoff (climb),Commercial,South Sudan,Africa,5,2,0,3,0,0,5,Unknown
2003-09-17 00:00:00,European Executive Express,Landing (descent or approach),Operational,Sweden,Europe,2,2,0,0,0,0,2,Human Factor
2003-09-17 00:00:00,Eastern Airways,Landing (descent or approach),Commercial,United Kingdom,Europe,7,3,0,4,0,0,7,Human Factor
2003-09-20 00:00:00,Super Air,Flight,Operational,New Zealand,Oceania,2,1,0,1,0,0,2,Human Factor
2003-09-21 00:00:00,Hawk Aviation,Landing (descent or approach),Business,United States of America,North America,1,1,0,0,0,0,1,Human Factor
2003-09-24 00:00:00,Sarit Airlines,Landing (descent or approach),Operational,South Sudan,Africa,5,5,0,0,0,0,5,Technical Failure
2003-10-08 00:00:00,War Eagle Aviation,Landing (descent or approach),Business,United States of America,North America,2,1,0,1,0,0,2,Human Factor
2003-10-09 00:00:00,Alrosa Aviakompania,Flight,Operational,Russia,Asia,2,2,0,0,0,0,2,Technical Failure
2003-10-13 00:00:00,Aéreo Transporte La Montaña,Flight,Operational,Venezuela,South America,1,1,0,0,0,0,1,Technical Failure
2003-10-17 00:00:00,Skydive San Marcos,Landing (descent or approach),Humanitarian,United States of America,North America,1,1,0,0,0,0,1,Human Factor
2003-10-20 00:00:00,TAVAJ Linhas Aéreas,Landing (descent or approach),Commercial,Brazil,South America,23,3,0,20,0,0,23,Human Factor
2003-10-24 00:00:00,Private American,Landing (descent or approach),Business,United Kingdom,Europe,4,1,0,3,0,0,4,Human Factor
2003-10-28 00:00:00,Cirrus Aviation,Landing (descent or approach),Operational,Switzerland,Europe,2,2,0,0,0,0,2,Human Factor
2003-10-30 00:00:00,Tepavia Trans,Landing (descent or approach),Operational,Democratic Republic of Congo,Africa,4,4,0,0,0,0,4,Human Factor
2003-11-02 00:00:00,Hezemans Air,Landing (descent or approach),Operational,Netherlands,Central America,1,1,0,0,0,0,1,Technical Failure
2003-11-03 00:00:00,Sarit Airlines,Landing (descent or approach),Operational,Sudan,Africa,5,5,0,0,0,0,5,Human Factor
2003-11-05 00:00:00,Blagoveshchensk AK,Flight,Commercial,Russia,Asia,0,0,0,0,0,0,0,Technical Failure
2003-11-12 00:00:00,Multi-Aero,Takeoff (climb),Commercial,United States of America,North America,4,2,0,2,0,0,4,Other
2003-11-18 00:00:00,Haalo,Landing (descent or approach),Operational,United States of America,North America,4,4,0,0,0,0,4,Human Factor
2003-11-18 00:00:00,Key Lime Air,Landing (descent or approach),Operational,United States of America,North America,1,1,0,0,0,0,1,Technical Failure
2003-11-21 00:00:00,Intertransit,Landing (descent or approach),Operational,Angola,Africa,2,2,0,0,0,0,2,Technical Failure
2003-11-29 00:00:00,Andrew Airways,Landing (descent or approach),Commercial,United States of America,North America,3,1,0,2,0,0,3,Human Factor
2003-11-29 00:00:00,Hydro Air Cargo,Landing (descent or approach),Operational,Nigeria,Africa,9,9,0,0,0,0,9,Human Factor
2003-12-03 00:00:00,Key Lime Air,Taxiing,Operational,United States of America,North America,1,1,0,0,0,0,1,Human Factor
2003-12-04 00:00:00,Kato Airline,Landing (descent or approach),Commercial,Norway,Europe,4,2,0,2,0,0,4,Weather
2003-12-07 00:00:00,East African Safari Air,Landing (descent or approach),Commercial,Kenya,Africa,27,4,0,23,0,0,27,Technical Failure
2003-12-13 00:00:00,Aero Continente,Landing (descent or approach),Commercial,Peru,South America,100,6,0,94,0,0,100,Human Factor
2003-12-16 00:00:00,Freight Runners Express,Landing (descent or approach),Operational,United States of America,North America,1,1,0,0,0,0,1,Human Factor
2003-12-18 00:00:00,Federal Express - FedEx,Landing (descent or approach),Operational,United States of America,North America,7,2,0,5,0,0,7,Human Factor
2003-12-19 00:00:00,Air Gabon,Landing (descent or approach),Commercial,Gabon,Africa,131,6,0,125,0,0,131,Human Factor
2004-01-01 00:00:00,Thunder Airlines,Takeoff (climb),Humanitarian,Canada,North America,2,2,0,0,0,0,2,Human Factor
2004-01-02 00:00:00,Larry's Flying Service,Landing (descent or approach),Operational,United States of America,North America,1,1,0,0,0,0,1,Human Factor
2004-01-05 00:00:00,Regional Air,Takeoff (climb),Commercial,Papua New Guinea,Oceania,3,2,0,1,0,0,3,Human Factor
2004-01-19 00:00:00,Air Regional,Landing (descent or approach),Operational,Indonesia,Asia,1,1,0,0,0,0,1,Weather
2004-01-21 00:00:00,Jet Express,Landing (descent or approach),Business,United States of America,North America,5,2,0,3,0,0,5,Technical Failure
2004-01-27 00:00:00,Renan,Takeoff (climb),Commercial,Angola,Africa,18,4,0,14,0,0,18,Technical Failure
2004-01-31 00:00:00,Victor Echo,Takeoff (climb),Operational,Spain,Europe,2,2,0,0,0,0,2,Technical Failure
2004-02-04 00:00:00,Expo Aviation,Landing (descent or approach),Operational,Sri Lanka,Asia,7,7,0,0,0,0,7,Human Factor
2004-02-08 00:00:00,Cape York Air,Flight,Operational,Australia,Oceania,2,1,0,1,0,0,2,Human Factor
2004-02-13 00:00:00,Charter Air,Takeoff (climb),Commercial,Austria,Europe,7,2,0,5,0,0,7,Human Factor
2004-02-18 00:00:00,Quickway Air Services,Landing (descent or approach),Operational,United States of America,North America,1,1,0,0,0,0,1,Human Factor
2004-02-20 00:00:00,Skylink Jets,Landing (descent or approach),Humanitarian,United States of America,North America,4,2,0,2,0,0,4,Human Factor
2004-03-01 00:00:00,Pakistan International Airlines - PIA,Takeoff (climb),Commercial,Saudi Arabia,Asia,273,12,0,261,0,0,273,Technical Failure
2004-03-05 00:00:00,Aeropacsa - Aerolineas del Pacifico,Flight,Commercial,Ecuador,South America,14,2,0,12,0,0,14,Technical Failure
2004-03-17 00:00:00,Regional Air Services,Takeoff (climb),Commercial,Tanzania,Africa,9,1,0,8,0,0,9,Technical Failure
2004-03-19 00:00:00,AirNet Systems,Landing (descent or approach),Operational,United States of America,North America,2,2,0,0,0,0,2,Human Factor
2004-03-20 00:00:00,Tropic Air,Flight,Operational,Belize,Central America,1,1,0,0,0,0,1,Technical Failure
2004-03-29 00:00:00,Aero Condor - Servicio de Transporte Aéreo Turistico - STAT,Flight,Humanitarian,Venezuela,South America,2,2,0,0,0,0,2,Unknown
2004-03-31 00:00:00,Tropic Air Charters,Landing (descent or approach),Operational,Bahamas,Central America,1,1,0,0,0,0,1,Technical Failure
2004-04-02 00:00:00,Air Memphis,Takeoff (climb),Operational,Egypt,Africa,7,7,0,0,0,0,7,Technical Failure
2004-04-03 00:00:00,Central African Cargo,Landing (descent or approach),Operational,Democratic Republic of Congo,Africa,4,3,0,1,0,0,4,Human Factor
2004-04-04 00:00:00,Peruvian Armed Forces - Ejército del Perú,Landing (descent or approach),Military / Government,Peru,South America,0,0,0,0,0,0,0,Human Factor
2004-04-07 00:00:00,SMD Investments,Landing (descent or approach),Operational,United Kingdom,Europe,1,1,0,0,0,0,1,Technical Failure
2004-04-14 00:00:00,Mass Bay Kustom Leasing,Landing (descent or approach),Business,United States of America,North America,2,1,0,1,0,0,2,Human Factor
2004-04-16 00:00:00,Air Archipels,Takeoff (climb),Specialised Services,French Polynesia,Oceania,2,1,0,1,0,0,2,Technical Failure
2004-04-19 00:00:00,Myrand Aviation,Landing (descent or approach),Commercial,Canada,North America,5,2,0,3,0,0,5,Human Factor
2004-04-20 00:00:00,Alitalia - Linee Aeree Italiane,Landing (descent or approach),Commercial,Italy,Europe,96,4,0,92,0,0,96,Human Factor
2004-04-27 00:00:00,Federal Express - FedEx,Landing (descent or approach),Operational,Uruguay,South America,3,3,0,0,0,0,3,Other
2004-04-28 00:00:00,Centurion Air Cargo,Landing (descent or approach),Operational,Colombia,South America,3,3,0,0,0,0,3,Human Factor
2004-05-06 00:00:00,French Air Force - Armée de l'Air,Taxiing,Specialised Services,Martinique,Central America,8,8,0,0,0,0,8,Technical Failure
2004-05-07 00:00:00,Brooks Fuel,Parking,Operational,United States of America,North America,2,2,0,0,0,0,2,Technical Failure
2004-05-09 00:00:00,American Eagle,Landing (descent or approach),Commercial,Puerto Rico,Central America,26,4,0,22,0,0,26,Human Factor
2004-05-27 00:00:00,Raytheon Aircraft Services,Landing (descent or approach),Operational,United States of America,North America,2,1,0,1,0,0,2,Human Factor
2004-06-01 00:00:00,Sun Air,Landing (descent or approach),Operational,Rwanda,Africa,12,4,0,8,0,0,12,Technical Failure
2004-06-03 00:00:00,Atlant,Flight,Military / Government,Ukraine,Europe,2,2,0,0,0,0,2,Technical Failure
2004-06-07 00:00:00,Ababeel Aviation,Landing (descent or approach),Operational,Sudan,Africa,16,4,0,12,0,0,16,Human Factor
2004-06-16 00:00:00,Pakistan International Airlines - PIA,Landing (descent or approach),Commercial,Pakistan,Asia,40,4,0,36,0,0,40,Unknown
2004-06-21 00:00:00,VIARCO - Vias Aéreas Colombianas,Takeoff (climb),Commercial,Colombia,South America,20,2,0,18,0,0,20,Technical Failure
2004-06-23 00:00:00,Islandsflug,Landing (descent or approach),Operational,Iceland,Europe,2,2,0,0,0,0,2,Human Factor
2004-06-26 00:00:00,Sarit Airlines,Takeoff (climb),Operational,South Sudan,Africa,5,5,0,0,0,0,5,Other
2004-06-30 00:00:00,Frontline Aviation,Takeoff (climb),Commercial,United States of America,North America,8,1,0,7,0,0,8,Technical Failure
2004-07-03 00:00:00,Green Airways,Landing (descent or approach),Commercial,Canada,North America,5,1,0,4,0,0,5,Technical Failure
2004-07-04 00:00:00,Aérea - Escuela de Pilotos,Landing (descent or approach),Business,Spain,Europe,6,1,0,5,0,0,6,Human Factor
2004-07-04 00:00:00,North-Wright Airways,Takeoff (climb),Operational,Canada,North America,2,2,0,0,0,0,2,Weather
2004-07-09 00:00:00,SOREM - Società Ricerche Esperienze Meteorologiche,Takeoff (climb),Humanitarian,Portugal,Europe,2,2,0,0,0,0,2,Human Factor
2004-07-09 00:00:00,Kostroma Air - Kostromskoye Aviapredpriatie,Takeoff (climb),Military / Government,Russia,Asia,2,2,0,0,0,0,2,Technical Failure
2004-07-13 00:00:00,Aviation Jet Charters,Landing (descent or approach),Humanitarian,Saint Kitts and Nevis,Central America,4,2,0,2,0,0,4,Weather
2004-07-13 00:00:00,Little Red Air Service,Landing (descent or approach),Humanitarian,Canada,North America,5,2,0,3,0,0,5,Human Factor
2004-07-16 00:00:00,Rigas Aeroklubs,Landing (descent or approach),Humanitarian,Norway,Europe,2,2,0,0,0,0,2,Human Factor
2004-07-19 00:00:00,Hop-a-Jet,Landing (descent or approach),Operational,United States of America,North America,2,2,0,0,0,0,2,Human Factor
2004-07-21 00:00:00,Aero California,Takeoff (climb),Commercial,Mexico,Central America,56,4,0,52,0,0,56,Weather
2004-07-23 00:00:00,Salvadorian Air Force - Fuerza Aérea Salvadoreña,Landing (descent or approach),Military / Government,Salvador,Central America,24,2,0,22,0,0,24,Technical Failure
2004-07-24 00:00:00,Wyngs Aviation,Landing (descent or approach),Humanitarian,Venezuela,South America,4,2,0,2,0,0,4,Human Factor
2004-07-28 00:00:00,Policía Federal,Landing (descent or approach),Military / Government,Mexico,Central America,6,2,0,4,0,0,6,Human Factor
2004-07-29 00:00:00,Flying Air Service,Landing (descent or approach),Operational,Democratic Republic of Congo,Africa,0,0,0,0,0,0,0,Unknown
2004-08-05 00:00:00,Venezuelan Navy - Armada Venezolana,Landing (descent or approach),Military / Government,Venezuela,South America,12,2,0,10,0,0,12,Unknown
2004-08-11 00:00:00,Air Guinée Express,Takeoff (climb),Commercial,Sierra Leone,Africa,127,8,0,119,0,0,127,Human Factor
2004-08-12 00:00:00,Air Spray,Takeoff (climb),Humanitarian,Canada,North America,1,1,0,0,0,0,1,Technical Failure
2004-08-16 00:00:00,Aeroperlas,Takeoff (climb),Commercial,Panama,Central America,7,2,0,5,0,0,7,Technical Failure
2004-08-17 00:00:00,Eclipse Enterprises,Takeoff (climb),Business,United States of America,North America,2,1,0,1,0,0,2,Human Factor
2004-08-27 00:00:00,Kiki Lemaire,Landing (descent or approach),Operational,Rwanda,Africa,8,3,0,5,0,0,8,Technical Failure
2004-09-05 00:00:00,Antonov Design Bureau,Landing (descent or approach),Operational,Ukraine,Europe,5,5,0,0,0,0,5,Unknown
2004-09-10 00:00:00,Ryan Blake Air Charter,Landing (descent or approach),Operational,South Africa,Africa,2,2,0,0,0,0,2,Other
2004-09-21 00:00:00,Norcanair - North Canada Air,Landing (descent or approach),Commercial,Canada,North America,11,2,0,9,0,0,11,Human Factor
2004-09-23 00:00:00,Eagle Air Cargo,Landing (descent or approach),Operational,United States of America,North America,1,1,0,0,0,0,1,Human Factor
2004-09-23 00:00:00,Homer Air,Takeoff (climb),Commercial,United States of America,North America,7,1,0,6,0,0,7,Human Factor
2004-09-25 00:00:00,Richard Fuchs,Takeoff (climb),Operational,United States of America,North America,2,2,0,0,0,0,2,Human Factor
2004-10-01 00:00:00,Naturelink Charter,Takeoff (climb),Commercial,Cameroon,Africa,4,2,0,2,0,0,4,Technical Failure
2004-10-03 00:00:00,American Airpower Heritage Museum,Takeoff (climb),Business,United States of America,North America,5,2,0,3,0,0,5,Human Factor
2004-10-06 00:00:00,Rutaca - Rutas Aéreas,Landing (descent or approach),Commercial,Venezuela,South America,2,1,0,1,0,0,2,Unknown
2004-10-08 00:00:00,Biman Bangladesh Airlines,Landing (descent or approach),Commercial,Bangladesh,Asia,84,5,0,79,0,0,84,Human Factor
2004-10-09 00:00:00,El Amiron Plus,Flight,Operational,Democratic Republic of Congo,Africa,2,2,0,0,0,0,2,Weather
2004-10-19 00:00:00,Spanish Air Force - Ejército del Aire,Landing (descent or approach),Military / Government,Spain,Europe,0,0,0,0,0,0,0,Unknown
2004-10-21 00:00:00,Twin Air - USA,Flight,Operational,United States of America,North America,1,1,0,0,0,0,1,Human Factor
2004-10-22 00:00:00,Southern Air Charter,Landing (descent or approach),Commercial,Bahamas,Central America,10,2,0,8,0,0,10,Technical Failure
2004-10-23 00:00:00,BETA Cargo - Brazilian Express Transportes Aéreos,Takeoff (climb),Operational,Brazil,South America,3,3,0,0,0,0,3,Technical Failure
2004-11-07 00:00:00,Air Atlanta Iceland,Takeoff (climb),Operational,United Arab Emirates,Asia,4,4,0,0,0,0,4,Technical Failure
2004-11-17 00:00:00,Precision Air Services - Precisionair,Landing (descent or approach),Operational,Tanzania,Africa,2,2,0,0,0,0,2,Human Factor
2004-11-20 00:00:00,Umbufto Swaziland Defence Force,Takeoff (climb),Military / Government,Swaziland,Africa,2,2,0,0,0,0,2,Human Factor
2004-11-22 00:00:00,Royal Thai Air Force - Kong Thap Akat Thai,Landing (descent or approach),Military / Government,Thailand,Asia,0,0,0,0,0,0,0,Technical Failure
2004-11-27 00:00:00,Regional Air Services,Takeoff (climb),Commercial,Tanzania,Africa,7,1,0,6,0,0,7,Human Factor
2004-11-28 00:00:00,KLM Royal Dutch Airlines - Koninklijke Luchtvaart Maatschappij,Landing (descent or approach),Commercial,Spain,Europe,146,6,0,140,0,0,146,Other
2004-12-01 00:00:00,Gama Aviation,Landing (descent or approach),Commercial,United States of America,North America,9,3,0,6,0,0,9,Human Factor
2004-12-02 00:00:00,Devonshire Aviation,Landing (descent or approach),Specialised Services,United States of America,North America,4,2,0,2,0,0,4,Technical Failure
2004-12-04 00:00:00,IFL Group,Landing (descent or approach),Specialised Services,United States of America,North America,3,3,0,0,0,0,3,Human Factor
2004-12-04 00:00:00,Miami Air Lease,Takeoff (climb),Operational,United States of America,North America,2,2,0,0,0,0,2,Human Factor
2004-12-09 00:00:00,RNH Air 1,Landing (descent or approach),Business,United States of America,North America,1,1,0,0,0,0,1,Human Factor
2004-12-10 00:00:00,Charter One,Takeoff (climb),Commercial,United States of America,North America,6,1,0,5,0,0,6,Human Factor
2004-12-16 00:00:00,Air Cargo Carriers,Landing (descent or approach),Operational,Canada,North America,2,2,0,0,0,0,2,Human Factor
2004-12-18 00:00:00,Private American,Landing (descent or approach),Humanitarian,United States of America,North America,1,1,0,0,0,0,1,Human Factor
2004-12-29 00:00:00,United States Air Force - USAF,Landing (descent or approach),Military / Government,Iraq,Asia,11,7,0,4,0,0,11,Other
2004-12-30 00:00:00,Kline and Associates,Takeoff (climb),Business,United States of America,North America,1,1,0,0,0,0,1,Technical Failure
2004-12-30 00:00:00,Airline Transport,Landing (descent or approach),Operational,Tajikistan,Asia,8,8,0,0,0,0,8,Human Factor
2005-01-01 00:00:00,Jet Services,Landing (descent or approach),Business,United States of America,North America,5,1,0,4,0,0,5,Human Factor
2005-01-04 00:00:00,Tri-MG Intra Asia Airlines,Landing (descent or approach),Operational,Indonesia,Asia,2,2,0,0,0,0,2,Other
2005-01-08 00:00:00,AeroRepública,Landing (descent or approach),Commercial,Colombia,South America,170,6,0,164,0,0,170,Human Factor
2005-01-19 00:00:00,CFS Air,Landing (descent or approach),Business,United States of America,North America,9,2,0,7,0,0,9,Human Factor
2005-01-21 00:00:00,Línea Aérea Amaszonas,Flight,Commercial,Bolivia,South America,12,2,0,10,0,0,12,Weather
2005-01-22 00:00:00,Compagnie Aérienne des Grands Lacs,Landing (descent or approach),Humanitarian,Democratic Republic of Congo,Africa,10,7,0,3,0,0,10,Unknown
2005-01-24 00:00:00,Atlas Air,Landing (descent or approach),Operational,Germany,Europe,3,3,0,0,0,0,3,Human Factor
2005-01-25 00:00:00,Alfred Wegener Institute,Landing (descent or approach),Specialised Services,Antarctica,Antarctica,0,0,0,0,0,0,0,Unknown
2005-01-28 00:00:00,Million Air Charter,Landing (descent or approach),Operational,United States of America,North America,2,2,0,0,0,0,2,Human Factor
2005-01-31 00:00:00,Nordflyg - NTD Air Cargo,Takeoff (climb),Operational,Finland,Europe,1,1,0,0,0,0,1,Human Factor
2005-01-31 00:00:00,MBH Services,Landing (descent or approach),Commercial,France,Europe,0,0,0,0,0,0,0,Unknown
2005-02-02 00:00:00,Platinum Jet Management,Takeoff (climb),Commercial,United States of America,North America,11,3,0,8,0,0,11,Human Factor
2005-02-13 00:00:00,Jet Sul Taxi Aéreo,Landing (descent or approach),Operational,Netherlands,Central America,2,2,0,0,0,0,2,Unknown
2005-02-15 00:00:00,Jetcraft Corporation,Takeoff (climb),Operational,United States of America,North America,2,2,0,0,0,0,2,Human Factor
2005-02-15 00:00:00,African Commuter Services,Landing (descent or approach),Operational,South Sudan,Africa,3,3,0,0,0,0,3,Unknown
2005-02-21 00:00:00,Scott Aviation,Landing (descent or approach),Commercial,Canada,North America,6,2,0,4,0,0,6,Human Factor
2005-02-22 00:00:00,Bolivian Air Force - Fuerza Aérea Boliviana,Takeoff (climb),Military / Government,Bolivia,South America,49,4,0,45,0,0,49,Technical Failure
2005-02-28 00:00:00,Clair Aero,Takeoff (climb),Commercial,Puerto Rico,Central America,7,1,0,6,0,0,7,Human Factor
2005-03-04 00:00:00,Trans Air Congo,Takeoff (climb),Operational,Congo,Africa,5,5,0,0,0,0,5,Unknown
2005-03-09 00:00:00,Tropic Air,Takeoff (climb),Commercial,Belize,Central America,14,1,0,13,0,0,14,Weather
2005-03-11 00:00:00,Jaax Flying Service,Landing (descent or approach),Commercial,United States of America,North America,4,1,0,3,0,0,4,Human Factor
2005-03-18 00:00:00,Private Venezuelan,Landing (descent or approach),Business,Venezuela,South America,8,1,0,7,0,0,8,Technical Failure
2005-03-19 00:00:00,Cargo Plus Aviation,Landing (descent or approach),Operational,Uganda,Africa,5,5,0,0,0,0,5,Human Factor
2005-03-25 00:00:00,MMK im. Ilyicha,Flight,Military / Government,Ukraine,Europe,2,2,0,0,0,0,2,Technical Failure
2005-03-28 00:00:00,Aerocaribbean,Takeoff (climb),Commercial,Venezuela,South America,97,10,0,87,0,0,97,Technical Failure
2005-03-29 00:00:00,The Flying Bulls,Landing (descent or approach),Business,Italy,Europe,2,1,0,1,0,0,2,Human Factor
2005-03-29 00:00:00,PENTA - PENA Táxi Aéreo,Landing (descent or approach),Operational,Brazil,South America,1,1,0,0,0,0,1,Unknown
2005-03-30 00:00:00,IBC Airways,Landing (descent or approach),Operational,United States of America,North America,2,2,0,0,0,0,2,Other
2005-03-31 00:00:00,Air BAS Transportation,Takeoff (climb),Operational,Yemen,Asia,8,8,0,0,0,0,8,Human Factor
2005-04-07 00:00:00,Icaro,Landing (descent or approach),Commercial,Ecuador,South America,65,5,0,60,0,0,65,Human Factor
2005-04-18 00:00:00,Aero Condor - Servicio de Transporte Aéreo Turistico - STAT,Landing (descent or approach),Commercial,Peru,South America,12,2,0,10,0,0,12,Human Factor
2005-04-24 00:00:00,ROSTO,Takeoff (climb),Military / Government,Russia,Asia,2,2,0,0,0,0,2,Technical Failure
2005-04-25 00:00:00,Aviakhim,Takeoff (climb),Military / Government,Russia,Asia,2,2,0,0,0,0,2,Weather
2005-04-25 00:00:00,ATMA Aircompany,Landing (descent or approach),Operational,Afghanistan,Asia,6,6,0,0,0,0,6,Technical Failure
2005-04-26 00:00:00,Southland Leasing Company,Landing (descent or approach),Business,United States of America,North America,2,1,0,1,0,0,2,Human Factor
2005-05-01 00:00:00,Wideroe - Wideroe's Flyveselskap,Landing (descent or approach),Commercial,Norway,Europe,30,3,0,27,0,0,30,Weather
2005-05-10 00:00:00,Northwest Airlines,Taxiing,Commercial,United States of America,North America,99,5,0,94,0,0,99,Human Factor
2005-05-10 00:00:00,Perimeter Aviation,Landing (descent or approach),Commercial,Canada,North America,17,2,0,15,0,0,17,Human Factor
2005-05-16 00:00:00,Flamingo Air,Landing (descent or approach),Commercial,Bahamas,Central America,3,1,0,2,0,0,3,Human Factor
2005-05-20 00:00:00,Jet 2000,Landing (descent or approach),Commercial,Russia,Asia,0,0,0,0,0,0,0,Other
2005-05-31 00:00:00,Maci Leasing Corporation,Landing (descent or approach),Operational,United States of America,North America,1,1,0,0,0,0,1,Human Factor
2005-06-02 00:00:00,Transportes Aéreos Guatemaltecos,Takeoff (climb),Commercial,Guatemala,Central America,17,2,0,15,0,0,17,Technical Failure
2005-06-04 00:00:00,AerOhio Skydiving Center,Landing (descent or approach),Operational,United States of America,North America,2,2,0,0,0,0,2,Human Factor
2005-06-06 00:00:00,Transportes Aéreos del Ariari - TARI,Takeoff (climb),Military / Government,Colombia,South America,28,3,0,25,0,0,28,Technical Failure
2005-06-08 00:00:00,United Express,Landing (descent or approach),Commercial,United States of America,North America,30,3,0,27,0,0,30,Technical Failure
2005-06-10 00:00:00,Transafrik,Landing (descent or approach),Humanitarian,Kenya,Africa,5,5,0,0,0,0,5,Human Factor
2005-06-10 00:00:00,748 Air Services,Landing (descent or approach),Humanitarian,Kenya,Africa,3,3,0,0,0,0,3,Human Factor
2005-06-13 00:00:00,Air Pony Express,Takeoff (climb),Operational,United States of America,North America,3,2,0,1,0,0,3,Human Factor
2005-06-13 00:00:00,Davis Capital,Landing (descent or approach),Business,United States of America,North America,2,1,0,1,0,0,2,Human Factor
2005-06-15 00:00:00,Revemin-Bonanza Mining Group,Landing (descent or approach),Business,Venezuela,South America,3,1,0,2,0,0,3,Technical Failure
2005-06-19 00:00:00,Mahfooz Aviation,Landing (descent or approach),Operational,Ethiopia,Africa,5,5,0,0,0,0,5,Unknown
2005-06-19 00:00:00,Wimbi Dira Airways,Landing (descent or approach),Other,Democratic Republic of Congo,Africa,0,0,0,0,0,0,0,Unknown
2005-06-20 00:00:00,Amigo Aviation,Landing (descent or approach),Operational,United States of America,North America,1,1,0,0,0,0,1,Human Factor
2005-06-24 00:00:00,Air Tindi,Takeoff (climb),Commercial,Canada,North America,9,2,0,7,0,0,9,Human Factor
2005-06-28 00:00:00,Air Serv International,Landing (descent or approach),Commercial,Mozambique,Africa,11,1,0,10,0,0,11,Human Factor
2005-06-29 00:00:00,Mango Airlines,Landing (descent or approach),Operational,Democratic Republic of Congo,Africa,9,4,0,5,0,0,9,Technical Failure
2005-06-30 00:00:00,Gorkha Airlines,Landing (descent or approach),Commercial,Nepal,Asia,12,2,0,10,0,0,12,Unknown
2005-06-30 00:00:00,Aero Service Corporation - DRC,Takeoff (climb),Operational,South Sudan,Africa,0,0,0,0,0,0,0,Technical Failure
2005-07-01 00:00:00,Biman Bangladesh Airlines,Landing (descent or approach),Commercial,Bangladesh,Asia,216,15,0,201,0,0,216,Human Factor
2005-07-09 00:00:00,Private Colombian,Flight,Humanitarian,Nicaragua,Central America,0,0,0,0,0,0,0,Technical Failure
2005-07-15 00:00:00,Aspen Aviation,Landing (descent or approach),Humanitarian,United States of America,North America,4,2,0,2,0,0,4,Human Factor
2005-07-16 00:00:00,Agni Aviation,Takeoff (climb),Operational,India,Asia,2,2,0,0,0,0,2,Technical Failure
2005-07-19 00:00:00,Sécurité civile française,Flight,Humanitarian,France,Europe,1,1,0,0,0,0,1,Human Factor
2005-07-19 00:00:00,Interisland Airlines,Landing (descent or approach),Commercial,Philippines,Asia,23,3,0,20,0,0,23,Human Factor
2005-07-21 00:00:00,United States Forest Service - USFS,Takeoff (climb),Humanitarian,United States of America,North America,3,1,0,2,0,0,3,Human Factor
2005-07-22 00:00:00,Baltimore Air Transport,Takeoff (climb),Operational,United States of America,North America,1,1,0,0,0,0,1,Technical Failure
2005-08-02 00:00:00,Air France,Landing (descent or approach),Commercial,Canada,North America,309,12,0,297,0,0,309,Human Factor
2005-08-04 00:00:00,James W. Kincaid,Takeoff (climb),Specialised Services,United States of America,North America,1,1,0,0,0,0,1,Technical Failure
2005-08-05 00:00:00,Golden Eagle Company,Landing (descent or approach),Business,United States of America,North America,2,1,0,1,0,0,2,Human Factor
2005-08-08 00:00:00,Angola Air Force - Força Aérea Nacional Angolana,Landing (descent or approach),Military / Government,Angola,Africa,0,0,0,0,0,0,0,Unknown
2005-08-12 00:00:00,Safiran Airlines,Landing (descent or approach),Commercial,Iran,Asia,27,8,0,19,0,0,27,Technical Failure
2005-08-13 00:00:00,Twin Air - USA,Landing (descent or approach),Commercial,United States of America,North America,7,1,0,6,0,0,7,Technical Failure
2005-08-19 00:00:00,Northwest Airlines,Landing (descent or approach),Commercial,Guam Island,Asia,340,16,0,324,0,0,340,Human Factor
2005-08-21 00:00:00,B. D. Bandall,Landing (descent or approach),Commercial,South Africa,Africa,6,1,0,5,0,0,6,Human Factor
2005-08-28 00:00:00,Security Aviation,Landing (descent or approach),Business,United States of America,North America,2,1,0,1,0,0,2,Human Factor
2005-09-01 00:00:00,USA Jet Airlines,Takeoff (climb),Operational,United States of America,North America,2,2,0,0,0,0,2,Other
2005-09-02 00:00:00,Aeroklub Ziemi Lubuskiej - AZL,Takeoff (climb),Military / Government,Poland,Europe,3,2,0,1,0,0,3,Technical Failure
2005-09-08 00:00:00,TMK Air Commuter - Société de Transports et Messageries au Kivu,Takeoff (climb),Commercial,Democratic Republic of Congo,Africa,20,2,0,18,0,0,20,Technical Failure
2005-09-09 00:00:00,AeroItalia,Landing (descent or approach),Commercial,Italy,Europe,5,2,0,3,0,0,5,Unknown
2005-09-09 00:00:00,Dirgantara Air Service,Landing (descent or approach),Operational,Indonesia,Asia,2,2,0,0,0,0,2,Human Factor
2005-09-11 00:00:00,Phuket Airlines,Landing (descent or approach),Commercial,Thailand,Asia,28,4,0,24,0,0,28,Human Factor
2005-09-12 00:00:00,Polish Air Force - Polska Wojska Lotnicze i Obrony Powietrznej,Flight,Operational,Poland,Europe,11,3,0,8,0,0,11,Technical Failure
2005-09-13 00:00:00,Barken International,Landing (descent or approach),Operational,United States of America,North America,4,4,0,0,0,0,4,Technical Failure
2005-09-19 00:00:00,Dynamic Airlines,Takeoff (climb),Commercial,Netherlands,Europe,19,2,0,17,0,0,19,Technical Failure
2005-09-21 00:00:00,Sky Lifts,Takeoff (climb),Business,United States of America,North America,5,1,0,4,0,0,5,Human Factor
2005-09-28 00:00:00,Private Argentinian,Flight,Business,Argentina,South America,5,1,0,4,0,0,5,Technical Failure
2005-09-30 00:00:00,Golden Eagle Haulage Inc. Trustee,Landing (descent or approach),Business,United Kingdom,Europe,3,1,0,2,0,0,3,Human Factor
2005-09-30 00:00:00,University of North Dakota,Flight,Other,United States of America,North America,4,2,0,2,0,0,4,Human Factor
2005-10-03 00:00:00,Skydive DeLand,Takeoff (climb),Humanitarian,United States of America,North America,10,1,0,9,0,0,10,Human Factor
2005-10-09 00:00:00,Air Sahara,Landing (descent or approach),Commercial,India,Asia,117,6,0,111,0,0,117,Unknown
2005-10-09 00:00:00,Spanish Air Force - Ejército del Aire,Landing (descent or approach),Military / Government,Spain,Europe,0,0,0,0,0,0,0,Human Factor
2005-10-18 00:00:00,Federal Express - FedEx,Flight,Operational,United States of America,North America,1,1,0,0,0,0,1,Human Factor
2005-10-19 00:00:00,Naryan-Mar Air Enterprise - Naryan-Marskoe Aviapredpriatie,Flight,Commercial,Russia,Asia,15,2,0,13,0,0,15,Technical Failure
2005-10-26 00:00:00,Private American,Landing (descent or approach),Operational,United States of America,North America,2,2,0,0,0,0,2,Human Factor
2005-10-31 00:00:00,Miba Aviation - Société Minière de Bakwanga,Landing (descent or approach),Operational,Democratic Republic of Congo,Africa,3,3,0,0,0,0,3,Other
2005-11-02 00:00:00,SAT Airlines - Sakhalinskie Aviatrassy,Landing (descent or approach),Commercial,Russia,Asia,0,0,0,0,0,0,0,Technical Failure
2005-11-08 00:00:00,AirNow,Takeoff (climb),Operational,United States of America,North America,1,1,0,0,0,0,1,Technical Failure
2005-11-14 00:00:00,Asian Spirit,Landing (descent or approach),Commercial,Philippines,Asia,38,6,0,32,0,0,38,Other
2005-11-18 00:00:00,Polyarnye Avialinii,Flight,Humanitarian,Russia,Asia,12,2,0,10,0,0,12,Human Factor
2005-11-21 00:00:00,PMT Air - Progress Multitrade Company,Landing (descent or approach),Commercial,Cambodia,Asia,65,6,0,59,0,0,65,Human Factor
2005-12-09 00:00:00,AirNow,Landing (descent or approach),Operational,United States of America,North America,1,1,0,0,0,0,1,Technical Failure
2005-12-16 00:00:00,NatureAir,Landing (descent or approach),Commercial,Costa Rica,Central America,8,2,0,6,0,0,8,Technical Failure
2005-12-24 00:00:00,Federal Express - FedEx,Takeoff (climb),Operational,United States of America,North America,1,1,0,0,0,0,1,Technical Failure
2005-12-26 00:00:00,Frank Lara,Flight,Business,Venezuela,South America,3,2,0,1,0,0,3,Technical Failure
2005-12-27 00:00:00,Clay Nordman,Landing (descent or approach),Operational,United States of America,North America,2,2,0,0,0,0,2,Human Factor
2005-12-30 00:00:00,Transwest Air,Landing (descent or approach),Humanitarian,Canada,North America,2,2,0,0,0,0,2,Weather
2006-01-02 00:00:00,North Country Aviation,Landing (descent or approach),Humanitarian,United States of America,North America,3,1,0,2,0,0,3,Human Factor
2006-01-05 00:00:00,Buffalo Airways,Landing (descent or approach),Operational,Canada,North America,4,4,0,0,0,0,4,Technical Failure
2006-01-11 00:00:00,Sky Wings Aviation,Landing (descent or approach),Operational,Canada,North America,2,2,0,0,0,0,2,Human Factor
2006-01-24 00:00:00,Aerolift,Landing (descent or approach),Operational,Democratic Republic of Congo,Africa,4,4,0,0,0,0,4,Human Factor
2006-01-31 00:00:00,Caribintair,Takeoff (climb),Commercial,Haiti,Central America,0,0,0,0,0,0,0,Unknown
2006-02-01 00:00:00,Flite Services,Landing (descent or approach),Operational,United States of America,North America,2,2,0,0,0,0,2,Human Factor
2006-02-03 00:00:00,Private New Zealand,Landing (descent or approach),Business,New Zealand,Oceania,9,2,0,7,0,0,9,Technical Failure
2006-02-05 00:00:00,Air Cargo Carriers,Flight,Specialised Services,United States of America,North America,3,2,0,1,0,0,3,Human Factor
2006-02-08 00:00:00,United Parcel Service - UPS,Landing (descent or approach),Operational,United States of America,North America,3,3,0,0,0,0,3,Technical Failure
2006-02-15 00:00:00,Jet 2000,Landing (descent or approach),Business,Germany,Europe,6,3,0,3,0,0,6,Human Factor
2006-03-02 00:00:00,Blue Airlines,Flight,Operational,Democratic Republic of Congo,Africa,6,6,0,0,0,0,6,Technical Failure
2006-03-04 00:00:00,Lion Air,Landing (descent or approach),Commercial,Indonesia,Asia,144,6,0,138,0,0,144,Human Factor
2006-03-05 00:00:00,Servicios Aéreos Sucre - SASCA,Flight,Commercial,Venezuela,South America,13,2,0,11,0,0,13,Technical Failure
2006-03-08 00:00:00,Orca Airways,Landing (descent or approach),Operational,Canada,North America,2,2,0,0,0,0,2,Human Factor
2006-03-10 00:00:00,Charles L. Joekel,Landing (descent or approach),Business,United States of America,North America,3,3,0,0,0,0,3,Unknown
2006-03-11 00:00:00,Air Deccan,Landing (descent or approach),Commercial,India,Asia,44,4,0,40,0,0,44,Unknown
2006-03-17 00:00:00,Trackmark Cargo,Landing (descent or approach),Operational,South Sudan,Africa,2,2,0,0,0,0,2,Unknown
2006-03-22 00:00:00,Bankair,Takeoff (climb),Operational,United States of America,North America,2,2,0,0,0,0,2,Human Factor
2006-03-23 00:00:00,Valan International Cargo Charter - Valan ICC,Landing (descent or approach),Operational,Iraq,Asia,0,0,0,0,0,0,0,Technical Failure
2006-03-28 00:00:00,Phoenix Avia,Takeoff (climb),Operational,Iran,Asia,12,6,0,6,0,0,12,Other
2006-03-29 00:00:00,Libyan Government,Landing (descent or approach),Operational,Russia,Asia,6,6,0,0,0,0,6,Human Factor
2006-04-03 00:00:00,United States Air Force - USAF,Landing (descent or approach),Military / Government,United States of America,North America,17,14,0,3,0,0,17,Human Factor
2006-04-14 00:00:00,Congolese Air Force - Force Aérienne de la République Démocratique du Congo,Landing (descent or approach),Specialised Services,Democratic Republic of Congo,Africa,7,7,0,0,0,0,7,Technical Failure
2006-04-18 00:00:00,Department of Justice of the US Virgin Islands,Landing (descent or approach),Military / Government,United States of America,Central America,7,1,0,6,0,0,7,Technical Failure
2006-04-19 00:00:00,Nordair Québec 2000,Takeoff (climb),Operational,Canada,North America,1,1,0,0,0,0,1,Unknown
2006-04-20 00:00:00,Jordan Aviation,Landing (descent or approach),Operational,Egypt,Africa,3,3,0,0,0,0,3,Human Factor
2006-04-21 00:00:00,Cambridge Air Services,Landing (descent or approach),Commercial,Bahamas,Central America,4,1,0,3,0,0,4,Human Factor
2006-04-30 00:00:00,Tora Flight Adventures,Takeoff (climb),Commercial,United States of America,North America,5,1,0,4,0,0,5,Human Factor
2006-05-05 00:00:00,Terral Táxi Aéreo,Landing (descent or approach),Operational,Brazil,South America,2,1,0,1,0,0,2,Human Factor
2006-05-06 00:00:00,Moldaeroservice,Flight,Commercial,Turkey,Asia,6,4,0,2,0,0,6,Weather
2006-05-08 00:00:00,BCL,Landing (descent or approach),Operational,United States of America,North America,2,2,0,0,0,0,2,Human Factor
2006-05-18 00:00:00,Air Cargo Carriers,Landing (descent or approach),Operational,United States of America,North America,2,2,0,0,0,0,2,Unknown
2006-05-22 00:00:00,Andrew Airways,Takeoff (climb),Commercial,United States of America,North America,6,1,0,5,0,0,6,Human Factor
2006-05-24 00:00:00,Aerogryf Aviation,Takeoff (climb),Military / Government,Poland,Europe,2,2,0,0,0,0,2,Technical Failure
2006-05-24 00:00:00,Royal Air Force - RAF,Landing (descent or approach),Military / Government,Afghanistan,Asia,27,7,0,20,0,0,27,Terrorism
2006-05-24 00:00:00,Air Ambulance by Air Trek,Landing (descent or approach),Humanitarian,Bahamas,Central America,8,2,0,6,0,0,8,Technical Failure
2006-05-26 00:00:00,Private French,Landing (descent or approach),Business,France,Europe,2,1,0,1,0,0,2,Technical Failure
2006-06-01 00:00:00,Air Panama,Landing (descent or approach),Commercial,Panama,Central America,18,2,0,16,0,0,18,Unknown
2006-06-03 00:00:00,East Coast Flight Services,Takeoff (climb),Operational,United States of America,North America,8,3,0,5,0,0,8,Technical Failure
2006-06-04 00:00:00,Arrow Air,Landing (descent or approach),Operational,Nicaragua,Central America,3,3,0,0,0,0,3,Unknown
2006-06-05 00:00:00,Merpati Nusantara Airlines - MNA,Landing (descent or approach),Commercial,Indonesia,Asia,18,3,0,15,0,0,18,Unknown
2006-06-07 00:00:00,Tradewinds Airlines,Takeoff (climb),Operational,Colombia,South America,5,5,0,0,0,0,5,Human Factor
2006-06-15 00:00:00,TNT Airways,Landing (descent or approach),Operational,United Kingdom,Europe,2,2,0,0,0,0,2,Human Factor
2006-06-22 00:00:00,Excel Jet,Takeoff (climb),Specialised Services,United States of America,North America,2,1,0,1,0,0,2,Unknown
2006-06-26 00:00:00,Great Idea Corporation,Landing (descent or approach),Business,Venezuela,South America,8,2,0,6,0,0,8,Technical Failure
2006-06-28 00:00:00,United States Coast Guard - USCG,Landing (descent or approach),Operational,United States of America,North America,9,9,0,0,0,0,9,Unknown
2006-06-29 00:00:00,Miapet Avia,Landing (descent or approach),Operational,Afghanistan,Asia,6,6,0,0,0,0,6,Unknown
2006-07-01 00:00:00,Corporate Air - Australia,Landing (descent or approach),Commercial,Australia,Oceania,0,0,0,0,0,0,0,Human Factor
2006-07-05 00:00:00,Vigo Jet,Landing (descent or approach),Operational,Mexico,Central America,2,2,0,0,0,0,2,Human Factor
2006-07-06 00:00:00,Hellenic Air Force - Elleniki Polemiki Aeroporia,Landing (descent or approach),Humanitarian,Greece,Europe,2,2,0,0,0,0,2,Human Factor
2006-07-10 00:00:00,Russian Navy - Voyenno-morskoy Flot Rossii,Takeoff (climb),Military / Government,Ukraine,Europe,28,6,0,22,0,0,28,Other
2006-07-12 00:00:00,Transafrik,Landing (descent or approach),Humanitarian,Tanzania,Africa,5,5,0,0,0,0,5,Human Factor
2006-07-14 00:00:00,Sudanese Air Force - Al Quwwat al-Jawwiya As-Sudaniya,Landing (descent or approach),Military / Government,Sudan,Africa,0,0,0,0,0,0,0,Unknown
2006-07-19 00:00:00,TolAir Services,Takeoff (climb),Operational,United States of America,Central America,2,2,0,0,0,0,2,Technical Failure
2006-07-27 00:00:00,KNAAPO - Komsomolsk-na-Amure Aviatsionnoe PO im. Gagarina,Takeoff (climb),Business,Russia,Asia,3,2,0,1,0,0,3,Human Factor
2006-07-28 00:00:00,Federal Express - FedEx,Landing (descent or approach),Operational,United States of America,North America,3,3,0,0,0,0,3,Technical Failure
2006-08-04 00:00:00,Private Venezuelan,Flight,Humanitarian,Colombia,South America,0,0,0,0,0,0,0,Human Factor
2006-08-05 00:00:00,Private British,Landing (descent or approach),Business,United Kingdom,Europe,6,1,0,5,0,0,6,Technical Failure
2006-08-07 00:00:00,Sudanese Air Force - Al Quwwat al-Jawwiya As-Sudaniya,Landing (descent or approach),Military / Government,Sudan,Africa,0,0,0,0,0,0,0,Unknown
2006-08-17 00:00:00,Sierra West Airlines,Landing (descent or approach),Operational,United States of America,North America,2,2,0,0,0,0,2,Human Factor
2006-08-17 00:00:00,Aerosucre Colombia,Taxiing,Operational,Colombia,South America,3,3,0,0,0,0,3,Technical Failure
2006-08-25 00:00:00,Kirovski Konny Zavod,Flight,Military / Government,Russia,Asia,2,2,0,0,0,0,2,Technical Failure
2006-08-28 00:00:00,Paraguay Air Services,Landing (descent or approach),Commercial,Argentina,South America,12,2,0,10,0,0,12,Weather
2006-08-28 00:00:00,NetJets,Landing (descent or approach),Commercial,United States of America,North America,5,2,0,3,0,0,5,Human Factor
2006-08-28 00:00:00,Ababeel Aviation,Takeoff (climb),Operational,Sudan,Africa,0,0,0,0,0,0,0,Technical Failure
2006-09-07 00:00:00,DHL Worldwide Express - DHL Airways,Landing (descent or approach),Operational,Nigeria,Africa,3,3,0,0,0,0,3,Human Factor
2006-09-15 00:00:00,Zaabu International,Takeoff (climb),Commercial,Democratic Republic of Congo,Africa,5,2,0,3,0,0,5,Unknown
2006-09-19 00:00:00,Aerowest Flugcenter,Flight,Operational,United Kingdom,Europe,1,1,0,0,0,0,1,Human Factor
2006-09-26 00:00:00,United States Air Force - USAF,Taxiing,Military / Government,Kyrgyzstan,Asia,3,3,0,0,0,0,3,Human Factor
2006-10-02 00:00:00,United States Air Force - USAF,Landing (descent or approach),Operational,United States of America,North America,2,2,0,0,0,0,2,Human Factor
2006-10-02 00:00:00,Malu Aviation,Landing (descent or approach),Commercial,Democratic Republic of Congo,Africa,0,0,0,0,0,0,0,Unknown
2006-10-03 00:00:00,Mandala Airlines,Landing (descent or approach),Commercial,Indonesia,Asia,110,6,0,104,0,0,110,Human Factor
2006-10-10 00:00:00,Trigana Air Service,Landing (descent or approach),Operational,Indonesia,Asia,5,5,0,0,0,0,5,Other
2006-10-12 00:00:00,Tigress Air,Landing (descent or approach),Specialised Services,United States of America,North America,2,2,0,0,0,0,2,Human Factor
2006-10-13 00:00:00,Yute Air Alaska,Landing (descent or approach),Operational,United States of America,North America,1,1,0,0,0,0,1,Human Factor
2006-10-30 00:00:00,Aerotucán,Landing (descent or approach),Commercial,Mexico,Central America,14,2,0,12,0,0,14,Unknown
2006-10-31 00:00:00,Astral Aviation,Landing (descent or approach),Operational,South Sudan,Africa,5,5,0,0,0,0,5,Unknown
2006-11-01 00:00:00,748 Air Services,Landing (descent or approach),Operational,Kenya,Africa,9,6,0,3,0,0,9,Human Factor
2006-11-02 00:00:00,Interisland Airlines,Landing (descent or approach),Operational,Philippines,Asia,3,3,0,0,0,0,3,Technical Failure
2006-11-07 00:00:00,Tropic Air,Flight,Commercial,Belize,Central America,6,1,0,5,0,0,6,Technical Failure
2006-11-08 00:00:00,Perimeter Aviation,Landing (descent or approach),Commercial,Canada,North America,9,2,0,7,0,0,9,Technical Failure
2006-11-09 00:00:00,Goma Air,Landing (descent or approach),Commercial,Democratic Republic of Congo,Africa,4,2,0,2,0,0,4,Technical Failure
2006-11-11 00:00:00,Indian Navy - Bharatiya Nau Sena,Flight,Military / Government,India,Asia,5,2,0,3,0,0,5,Technical Failure
2006-11-12 00:00:00,Private Australian,Takeoff (climb),Business,Australia,Oceania,6,1,0,5,0,0,6,Other
2006-11-12 00:00:00,Tracep,Landing (descent or approach),Commercial,Democratic Republic of Congo,Africa,0,0,0,0,0,0,0,Unknown
2006-11-15 00:00:00,Mexican Navy - Armada de México,Flight,Military / Government,Mexico,Central America,7,7,0,0,0,0,7,Technical Failure
2006-11-16 00:00:00,Aboitiz Air,Landing (descent or approach),Commercial,Philippines,Asia,9,4,0,5,0,0,9,Unknown
2006-11-22 00:00:00,Private Guatemalan,Landing (descent or approach),Business,Guatemala,Central America,1,1,0,0,0,0,1,Technical Failure
2006-11-24 00:00:00,Josef Mörtl,Takeoff (climb),Business,Estonia,Europe,3,1,0,2,0,0,3,Human Factor
2006-12-03 00:00:00,Premier Air Management,Landing (descent or approach),Business,Mexico,Central America,0,0,0,0,0,0,0,Weather
2006-12-09 00:00:00,Wings Airline Services,Takeoff (climb),Business,Bahamas,Central America,1,1,0,0,0,0,1,Unknown
2006-12-12 00:00:00,Sudan Airways,Landing (descent or approach),Commercial,Sudan,Africa,0,0,0,0,0,0,0,Technical Failure
2006-12-15 00:00:00,Pescara Homes,Landing (descent or approach),Business,United States of America,North America,1,1,0,0,0,0,1,Human Factor
2006-12-15 00:00:00,Baires Fly,Takeoff (climb),Operational,Argentina,South America,2,2,0,0,0,0,2,Human Factor
2006-12-19 00:00:00,Jett Paquetería,Landing (descent or approach),Operational,Mexico,Central America,2,2,0,0,0,0,2,Human Factor
2006-12-24 00:00:00,Lion Air,Landing (descent or approach),Commercial,Indonesia,Asia,164,7,0,157,0,0,164,Human Factor
2006-12-26 00:00:00,Aramil-Uktus,Flight,Commercial,Russia,Asia,13,3,0,10,0,0,13,Technical Failure
2006-12-28 00:00:00,Island Air Charters,Flight,Operational,New Zealand,Oceania,1,1,0,0,0,0,1,Technical Failure
2006-12-29 00:00:00,Alpine Air,Landing (descent or approach),Operational,United States of America,North America,1,1,0,0,0,0,1,Human Factor
2006-12-30 00:00:00,Sky Relief Services,Takeoff (climb),Operational,Kenya,Africa,3,3,0,0,0,0,3,Technical Failure
2006-12-30 00:00:00,Dirgantara Air Service,Takeoff (climb),Commercial,Indonesia,Asia,0,0,0,0,0,0,0,Unknown
2007-01-09 00:00:00,Peace Air,Landing (descent or approach),Commercial,Canada,North America,12,2,0,10,0,0,12,Human Factor
2007-01-10 00:00:00,AirNet Systems,Landing (descent or approach),Operational,United States of America,North America,2,2,0,0,0,0,2,Human Factor
2007-01-12 00:00:00,Lyden Air Company,Landing (descent or approach),Business,United States of America,North America,3,1,0,2,0,0,3,Human Factor
2007-01-13 00:00:00,Gading Sari Aviation Services - GSAS,Landing (descent or approach),Operational,Malaysia,Asia,4,4,0,0,0,0,4,Unknown
2007-01-17 00:00:00,Brooks Fuel,Flight,Operational,United States of America,North America,2,2,0,0,0,0,2,Technical Failure
2007-01-21 00:00:00,PropAir,Flight,Commercial,Canada,North America,5,1,0,4,0,0,5,Technical Failure
2007-01-24 00:00:00,Freight Runners Express,Taxiing,Operational,United States of America,North America,1,1,0,0,0,0,1,Human Factor
2007-01-24 00:00:00,Air Ambulance by Air Trek,Landing (descent or approach),Humanitarian,United States of America,North America,4,2,0,2,0,0,4,Human Factor
2007-01-25 00:00:00,Regional Airlines,Takeoff (climb),Commercial,France,Europe,54,4,0,50,0,0,54,Unknown
2007-01-31 00:00:00,Private American,Landing (descent or approach),Business,Greenland,Europe,2,2,0,0,0,0,2,Technical Failure
2007-02-02 00:00:00,Hudson Timber Services,Flight,Business,United States of America,North America,2,2,0,0,0,0,2,Human Factor
2007-02-04 00:00:00,TAMPA Cargo,Landing (descent or approach),Operational,United States of America,North America,3,3,0,0,0,0,3,Human Factor
2007-02-04 00:00:00,P. Kekys,Takeoff (climb),Business,Greenland,Europe,2,2,0,0,0,0,2,Weather
2007-02-08 00:00:00,Suburban Air Freight,Landing (descent or approach),Operational,United States of America,North America,1,1,0,0,0,0,1,Human Factor
2007-02-12 00:00:00,Royal Air Force - RAF,Landing (descent or approach),Military / Government,Iraq,Asia,64,6,0,58,0,0,64,Terrorism
2007-02-13 00:00:00,FortAero Business Aviation,Takeoff (climb),Operational,Russia,Asia,3,3,0,0,0,0,3,Weather
2007-02-21 00:00:00,AdamAir,Landing (descent or approach),Commercial,Indonesia,Asia,155,7,0,148,0,0,155,Human Factor
2007-02-24 00:00:00,United Arabian Airlines,Landing (descent or approach),Operational,Sudan,Africa,0,0,0,0,0,0,0,Unknown
2007-03-03 00:00:00,Luftverkehr Friesland-Harle - LFH,Landing (descent or approach),Commercial,Estonia,Europe,3,1,0,2,0,0,3,Human Factor
2007-03-08 00:00:00,David Quinones,Takeoff (climb),Business,Colombia,South America,2,1,0,1,0,0,2,Unknown
2007-03-09 00:00:00,TransAviaExport Airlines,Landing (descent or approach),Operational,Somalia,Africa,15,9,0,6,0,0,15,Terrorism
2007-03-12 00:00:00,Biman Bangladesh Airlines,Takeoff (climb),Commercial,United Arab Emirates,Asia,250,14,0,236,0,0,250,Other
2007-03-12 00:00:00,First Kuwaiti General Trading %26 Contracting Company,Taxiing,Operational,Kuwait,Asia,2,2,0,0,0,0,2,Human Factor
2007-03-16 00:00:00,Kish Air,Landing (descent or approach),Commercial,Iran,Asia,158,4,0,154,0,0,158,Unknown
2007-03-23 00:00:00,Ariana Afghan Airlines,Landing (descent or approach),Commercial,Turkey,Asia,50,20,0,30,0,0,50,Unknown
2007-03-29 00:00:00,Paúl Víveres,Takeoff (climb),Operational,Venezuela,South America,1,1,0,0,0,0,1,Unknown
2007-04-09 00:00:00,Network Aviation,Landing (descent or approach),Commercial,Australia,Oceania,10,1,0,9,0,0,10,Technical Failure
2007-04-09 00:00:00,Comores Aviation,Takeoff (climb),Commercial,Comoros Islands,Africa,15,2,0,13,0,0,15,Unknown
2007-04-14 00:00:00,Aerobalas,Landing (descent or approach),Humanitarian,Spain,Europe,2,1,0,1,0,0,2,Unknown
2007-04-20 00:00:00,Bahamasair,Landing (descent or approach),Commercial,Bahamas,Central America,51,3,0,48,0,0,51,Technical Failure
2007-04-20 00:00:00,Vancouver Island Air,Takeoff (climb),Commercial,Canada,North America,7,1,0,6,0,0,7,Technical Failure
2007-04-23 00:00:00,Selkirk Remote Sensing,Landing (descent or approach),Specialised Services,Canada,North America,2,1,0,1,0,0,2,Technical Failure
2007-04-28 00:00:00,McCall Aviation,Takeoff (climb),Operational,United States of America,North America,1,1,0,0,0,0,1,Technical Failure
2007-04-30 00:00:00,Private Spanish,Flight,Business,Spain,Europe,4,1,0,3,0,0,4,Technical Failure
2007-05-19 00:00:00,Airlink Papua New Guinea,Landing (descent or approach),Commercial,Papua New Guinea,Oceania,4,1,0,3,0,0,4,Unknown
2007-05-20 00:00:00,Air Canada Jazz,Landing (descent or approach),Commercial,Canada,North America,40,37,0,3,0,0,40,Technical Failure
2007-05-23 00:00:00,Golden Eagle Air,Takeoff (climb),Business,United States of America,North America,1,1,0,0,0,0,1,Human Factor
2007-05-30 00:00:00,Brooks Fuel,Landing (descent or approach),Operational,United States of America,North America,2,2,0,0,0,0,2,Human Factor
2007-06-01 00:00:00,Steve Posluszny,Landing (descent or approach),Specialised Services,United States of America,North America,1,1,0,0,0,0,1,Technical Failure
2007-06-01 00:00:00,Tanzania Peoples Defence Forces,Landing (descent or approach),Military / Government,Tanzania,Africa,13,4,0,9,0,0,13,Technical Failure
2007-06-15 00:00:00,First Flight Aviation,Landing (descent or approach),Operational,India,Asia,2,2,0,0,0,0,2,Human Factor
2007-06-23 00:00:00,Kyrgyz Government,Flight,Specialised Services,Kyrgyzstan,Asia,14,5,0,9,0,0,14,Human Factor
2007-06-26 00:00:00,Business Aviation - DRC,Flight,Commercial,Congo,Africa,0,0,0,0,0,0,0,Technical Failure
2007-06-27 00:00:00,Golden Wings Charter,Landing (descent or approach),Operational,Bahamas,Central America,1,1,0,0,0,0,1,Technical Failure
2007-06-30 00:00:00,Private German,Takeoff (climb),Business,Germany,Europe,5,1,0,4,0,0,5,Human Factor
2007-06-30 00:00:00,Ilyas Aviation,Landing (descent or approach),Commercial,Tanzania,Africa,6,1,0,5,0,0,6,Unknown
2007-06-30 00:00:00,Aerodan,Landing (descent or approach),Commercial,Mexico,Central America,4,2,0,2,0,0,4,Unknown
2007-07-01 00:00:00,Jet Airways,Landing (descent or approach),Commercial,India,Asia,53,4,0,49,0,0,53,Human Factor
2007-07-11 00:00:00,Baer Air,Landing (descent or approach),Operational,United States of America,North America,1,1,0,0,0,0,1,Human Factor
2007-07-16 00:00:00,Pantanal Linhas Aéreas Sul-Matogrossenses,Landing (descent or approach),Commercial,Brazil,South America,25,4,0,21,0,0,25,Other
2007-07-17 00:00:00,AeroRepública,Landing (descent or approach),Commercial,Colombia,South America,60,6,0,54,0,0,60,Human Factor
2007-07-18 00:00:00,Cargo Bull Aviation,Takeoff (climb),Commercial,Democratic Republic of Congo,Africa,0,0,0,0,0,0,0,Other
2007-07-19 00:00:00,American Airpower Heritage Museum,Flight,Operational,United States of America,North America,2,2,0,0,0,0,2,Human Factor
2007-07-21 00:00:00,Linea Turistica Aerotuy - LTA,Takeoff (climb),Operational,Venezuela,South America,2,2,0,0,0,0,2,Technical Failure
2007-07-21 00:00:00,SK Logistics - SK Jets,Landing (descent or approach),Operational,United States of America,North America,2,2,0,0,0,0,2,Technical Failure
2007-07-31 00:00:00,Sound Flight,Landing (descent or approach),Commercial,Canada,North America,6,1,0,5,0,0,6,Unknown
2007-08-06 00:00:00,Bluebird Aviation,Landing (descent or approach),Operational,Kenya,Africa,2,2,0,0,0,0,2,Unknown
2007-08-11 00:00:00,World Jet II,Landing (descent or approach),Commercial,Dominica,Central America,6,2,0,4,0,0,6,Unknown
2007-08-12 00:00:00,Jeju Air,Landing (descent or approach),Commercial,South Korea,Asia,79,5,0,74,0,0,79,Technical Failure
2007-08-20 00:00:00,China Airlines,Parking,Commercial,Japan,Asia,165,8,0,157,0,0,165,Technical Failure
2007-08-22 00:00:00,Selva Colombia - Servicios Aéreos del Vaupés,Landing (descent or approach),Commercial,Colombia,South America,53,3,0,50,0,0,53,Technical Failure
2007-08-26 00:00:00,Private Kyrgyzstan,Flight,Humanitarian,Kyrgyzstan,Asia,4,2,0,2,0,0,4,Technical Failure
2007-08-26 00:00:00,Honduras Air,Takeoff (climb),Commercial,Honduras,Central America,10,1,0,9,0,0,10,Technical Failure
2007-08-27 00:00:00,Selva Colombia - Servicios Aéreos del Vaupés,Parking,Operational,Colombia,South America,4,4,0,0,0,0,4,Other
2007-08-29 00:00:00,Royal Air Force - RAF,Landing (descent or approach),Military / Government,Afghanistan,Asia,0,0,0,0,0,0,0,Unknown
2007-08-31 00:00:00,Caribintair,Takeoff (climb),Commercial,Haiti,Central America,6,1,0,5,0,0,6,Technical Failure
2007-08-31 00:00:00,Air Serv International,Flight,Operational,Democratic Republic of Congo,Africa,2,2,0,0,0,0,2,Unknown
2007-08-31 00:00:00,We-Lease,Landing (descent or approach),Business,United States of America,North America,2,1,0,1,0,0,2,Technical Failure
2007-09-03 00:00:00,Jet Lease,Takeoff (climb),Commercial,Costa Rica,Central America,6,2,0,4,0,0,6,Technical Failure
2007-09-05 00:00:00,Paragon Air Express,Landing (descent or approach),Operational,United States of America,North America,1,1,0,0,0,0,1,Technical Failure
2007-09-09 00:00:00,Scandinavian Airlines System - SAS,Landing (descent or approach),Commercial,Denmark,Europe,73,4,0,69,0,0,73,Technical Failure
2007-09-11 00:00:00,Caribintair,Takeoff (climb),Commercial,Haiti,Central America,9,1,0,8,0,0,9,Human Factor
2007-09-12 00:00:00,Scandinavian Airlines System - SAS,Landing (descent or approach),Commercial,Lithuania,Europe,52,4,0,48,0,0,52,Technical Failure
2007-09-14 00:00:00,Magnicharters,Landing (descent or approach),Commercial,Mexico,Central America,109,6,0,103,0,0,109,Technical Failure
2007-09-14 00:00:00,Hawk Flight,Landing (descent or approach),Business,United States of America,North America,4,2,0,2,0,0,4,Human Factor
2007-09-19 00:00:00,Air Amteck,Landing (descent or approach),Commercial,United States of America,North America,4,1,0,3,0,0,4,Human Factor
2007-09-21 00:00:00,Monarch Air Group,Takeoff (climb),Operational,United States of America,North America,1,1,0,0,0,0,1,Human Factor
2007-09-24 00:00:00,Donna Blue Aircraft,Flight,Humanitarian,Mexico,Central America,2,2,0,0,0,0,2,Human Factor
2007-10-04 00:00:00,Istanbul Büyükşehir Belediyesi,Landing (descent or approach),Humanitarian,Turkey,Asia,3,3,0,0,0,0,3,Unknown
2007-10-05 00:00:00,Sinarmas,Takeoff (climb),Military / Government,Indonesia,Asia,1,1,0,0,0,0,1,Human Factor
2007-10-11 00:00:00,AMC Airlines - Aircraft Maintenance Company,Landing (descent or approach),Commercial,Turkey,Asia,163,7,0,156,0,0,163,Technical Failure
2007-10-17 00:00:00,Imtrec Aviation,Takeoff (climb),Operational,Cambodia,Asia,5,5,0,0,0,0,5,Technical Failure
2007-10-17 00:00:00,JaGee Ventures,Landing (descent or approach),Business,United States of America,North America,2,2,0,0,0,0,2,Human Factor
2007-10-26 00:00:00,Philippine Airlines - PAL,Landing (descent or approach),Commercial,Philippines,Asia,154,6,0,148,0,0,154,Human Factor
2007-10-27 00:00:00,Empire Airways,Landing (descent or approach),Business,United States of America,North America,4,2,0,2,0,0,4,Human Factor
2007-10-28 00:00:00,Alexander Gray,Flight,Business,United States of America,North America,1,1,0,0,0,0,1,Technical Failure
2007-10-31 00:00:00,Air Panama,Takeoff (climb),Commercial,Panama,Central America,13,4,0,9,0,0,13,Human Factor
2007-10-31 00:00:00,Libyan Air Cargo,Flight,Operational,Libya,Africa,0,0,0,0,0,0,0,Unknown
2007-10-31 00:00:00,Jamahiriya Air Transport,Landing (descent or approach),Operational,Mali,Africa,6,6,0,0,0,0,6,Technical Failure
2007-11-01 00:00:00,Mandala Airlines,Landing (descent or approach),Commercial,Indonesia,Asia,94,5,0,89,0,0,94,Human Factor
2007-11-05 00:00:00,Calafia Airlines,Takeoff (climb),Commercial,Mexico,Central America,15,1,0,14,0,0,15,Unknown
2007-11-08 00:00:00,Juba Air Cargo,Landing (descent or approach),Operational,Sudan,Africa,4,4,0,0,0,0,4,Other
2007-11-09 00:00:00,Iberia - Lineas Aéreas de Espana,Landing (descent or approach),Commercial,Ecuador,South America,359,14,0,345,0,0,359,Human Factor
2007-11-11 00:00:00,Jetport,Landing (descent or approach),Business,Canada,North America,10,2,0,8,0,0,10,Human Factor
2007-11-15 00:00:00,Airbus Industrie,Parking,Specialised Services,France,Europe,9,9,0,0,0,0,9,Human Factor
2007-11-30 00:00:00,Hicks %26 Lawrence,Flight,Business,Canada,North America,3,2,0,1,0,0,3,Weather
2007-12-04 00:00:00,Maya Island Air,Takeoff (climb),Commercial,Belize,Central America,12,1,0,11,0,0,12,Unknown
2007-12-18 00:00:00,Arctic Circle Air Service,Takeoff (climb),Operational,United States of America,North America,2,1,0,1,0,0,2,Human Factor
2007-12-20 00:00:00,Agape Flights,Flight,Operational,Bahamas,Central America,2,2,0,0,0,0,2,Technical Failure
2007-12-30 00:00:00,TAROM - Transporturile Aeriene Române,Takeoff (climb),Commercial,Romania,Europe,123,6,0,117,0,0,123,Human Factor
2008-01-02 00:00:00,Asian Spirit,Landing (descent or approach),Commercial,Philippines,Asia,47,4,0,43,0,0,47,Unknown
2008-01-02 00:00:00,Iran Air,Takeoff (climb),Commercial,Iran,Asia,113,8,0,105,0,0,113,Human Factor
2008-01-03 00:00:00,Servicio Aéreo Nacional,Landing (descent or approach),Humanitarian,Panama,Central America,2,2,0,0,0,0,2,Technical Failure
2008-01-16 00:00:00,Inland Aviation Services,Landing (descent or approach),Operational,United States of America,North America,1,1,0,0,0,0,1,Unknown
2008-01-17 00:00:00,British Airways,Landing (descent or approach),Commercial,United Kingdom,Europe,152,16,0,136,0,0,152,Technical Failure
2008-01-25 00:00:00,Aéro-Service,Taxiing,Operational,Congo,Africa,6,6,0,0,0,0,6,Technical Failure
2008-01-25 00:00:00,Canadian Airways Congo,Parking,Commercial,Congo,Africa,0,0,0,0,0,0,0,Technical Failure
2008-01-28 00:00:00,Aires Colombia - Aerovias de Integracion Regional,Landing (descent or approach),Commercial,Colombia,South America,41,4,0,37,0,0,41,Technical Failure
2008-01-29 00:00:00,Wave Runner Aviation,Landing (descent or approach),Operational,United States of America,North America,2,1,0,1,0,0,2,Human Factor
2008-01-31 00:00:00,Super Air,Takeoff (climb),Military / Government,New Zealand,Oceania,1,1,0,0,0,0,1,Unknown
2008-02-01 00:00:00,Qualint,Taxiing,Operational,United States of America,North America,2,2,0,0,0,0,2,Technical Failure
2008-02-01 00:00:00,Lloyd Aéreo Boliviano - LAB Airlines,Landing (descent or approach),Commercial,Bolivia,South America,159,8,0,151,0,0,159,Human Factor
2008-02-02 00:00:00,MNG Kargo,Taxiing,Operational,United Kingdom,Europe,2,2,0,0,0,0,2,Human Factor
2008-02-02 00:00:00,Atlas Air,Takeoff (climb),Operational,Togo,Africa,3,3,0,0,0,0,3,Human Factor
2008-02-07 00:00:00,Caribair,Flight,Commercial,Dominican Republic,Central America,9,1,0,8,0,0,9,Technical Failure
2008-02-12 00:00:00,Aserca Airlines,Taxiing,Specialised Services,Venezuela,South America,2,2,0,0,0,0,2,Unknown
2008-02-13 00:00:00,Servicios Aéreos Sucre - SASCA,Landing (descent or approach),Commercial,Venezuela,South America,16,2,0,14,0,0,16,Technical Failure
2008-02-14 00:00:00,Belavia Belarusian Airlines,Takeoff (climb),Commercial,Armenia,Asia,21,3,0,18,0,0,21,Weather
2008-02-14 00:00:00,Asia Continental Airlines,Landing (descent or approach),Operational,Afghanistan,Asia,6,6,0,0,0,0,6,Technical Failure
2008-02-19 00:00:00,Air Bagan,Takeoff (climb),Commercial,Myanmar,Asia,57,4,0,53,0,0,57,Technical Failure
2008-02-22 00:00:00,Peabody Energy,Landing (descent or approach),Business,United States of America,North America,20,2,0,18,0,0,20,Human Factor
2008-02-29 00:00:00,Orenair - Orenburgskie Avialinii - Orenburg Airlines,Takeoff (climb),Operational,Russia,Asia,4,4,0,0,0,0,4,Human Factor
2008-03-06 00:00:00,Manunggal Air,Landing (descent or approach),Operational,Indonesia,Asia,7,7,0,0,0,0,7,Technical Failure
2008-03-10 00:00:00,AdamAir,Landing (descent or approach),Commercial,Indonesia,Asia,177,6,0,171,0,0,177,Technical Failure
2008-03-19 00:00:00,Cirrus Airlines,Landing (descent or approach),Commercial,Germany,Europe,27,3,0,24,0,0,27,Human Factor
2008-03-19 00:00:00,Ran Air Services,Landing (descent or approach),Business,India,Asia,7,2,0,5,0,0,7,Human Factor
2008-03-25 00:00:00,Saudi Arabian Airlines - SAUDIA,Landing (descent or approach),Commercial,Bangladesh,Asia,326,19,0,307,0,0,326,Technical Failure
2008-04-04 00:00:00,Argentinian Air Force - Fuerza Aérea Argentina,Takeoff (climb),Military / Government,Argentina,South America,6,2,0,4,0,0,6,Technical Failure
2008-04-07 00:00:00,Peruvian Air Force - Fuerza Aérea del Perú,Landing (descent or approach),Operational,Peru,South America,5,5,0,0,0,0,5,Unknown
2008-04-09 00:00:00,PenAir - Peninsula Airways - Alaska Airlines Commuter,Landing (descent or approach),Commercial,United States of America,North America,9,1,0,8,0,0,9,Human Factor
2008-04-20 00:00:00,Cubana de Aviación,Landing (descent or approach),Commercial,Dominican Republic,Central America,117,8,0,109,0,0,117,Technical Failure
2008-04-21 00:00:00,Rico Linhas Aéreas - Rondonia Importaçao e Comercio,Landing (descent or approach),Commercial,Brazil,South America,17,2,0,15,0,0,17,Human Factor
2008-04-22 00:00:00,Romavia,Landing (descent or approach),Commercial,Romania,Europe,73,6,0,67,0,0,73,Unknown
2008-04-25 00:00:00,Westair Aviation,Landing (descent or approach),Operational,Canada,North America,1,1,0,0,0,0,1,Human Factor
2008-04-25 00:00:00,Unipolares y Espectaculares del Norte,Takeoff (climb),Business,Mexico,Central America,6,1,0,5,0,0,6,Technical Failure
2008-04-26 00:00:00,Rowley Aviation,Takeoff (climb),Military / Government,New Zealand,Oceania,1,1,0,0,0,0,1,Human Factor
2008-04-28 00:00:00,AIM Air,Takeoff (climb),Humanitarian,South Sudan,Africa,5,1,0,4,0,0,5,Unknown
2008-05-07 00:00:00,Torquip Transmission Services,Landing (descent or approach),Business,South Africa,Africa,0,0,0,0,0,0,0,Other
2008-05-09 00:00:00,Federal Express - FedEx,Landing (descent or approach),Operational,United States of America,North America,1,1,0,0,0,0,1,Technical Failure
2008-05-21 00:00:00,United States Air Force - USAF,Landing (descent or approach),Operational,United States of America,North America,2,2,0,0,0,0,2,Weather
2008-05-25 00:00:00,Kalitta Air,Takeoff (climb),Operational,Belgium,Europe,5,5,0,0,0,0,5,Other
2008-05-26 00:00:00,Great Lakes Business Company,Landing (descent or approach),Operational,Democratic Republic of Congo,Africa,5,5,0,0,0,0,5,Technical Failure
2008-06-01 00:00:00,Private French,Takeoff (climb),Business,France,Europe,6,1,0,5,0,0,6,Human Factor
2008-06-06 00:00:00,Avionics International,Landing (descent or approach),Business,Panama,Central America,6,1,0,5,0,0,6,Unknown
2008-06-08 00:00:00,Waha Oil Company,Landing (descent or approach),Operational,Libya,Africa,2,2,0,0,0,0,2,Unknown
2008-06-09 00:00:00,Gramar 500,Landing (descent or approach),Operational,Bahamas,Central America,1,1,0,0,0,0,1,Technical Failure
2008-06-12 00:00:00,FAI rent-a-jet,Takeoff (climb),Operational,Democratic Republic of Congo,Africa,2,2,0,0,0,0,2,Unknown
2008-06-15 00:00:00,Aéroclub Paris-Est,Flight,Business,France,Europe,4,1,0,3,0,0,4,Technical Failure
2008-06-21 00:00:00,Air Patrol,Takeoff (climb),Operational,Austria,Europe,13,1,0,12,0,0,13,Human Factor
2008-06-27 00:00:00,United States Air Force - USAF,Takeoff (climb),Military / Government,Iraq,Asia,38,4,0,34,0,0,38,Technical Failure
2008-06-28 00:00:00,ABX Air,Parking,Operational,United States of America,North America,2,2,0,0,0,0,2,Technical Failure
2008-06-28 00:00:00,Chinar,Flight,Specialised Services,Russia,Asia,1,1,0,0,0,0,1,Technical Failure
2008-06-30 00:00:00,Aeroflot - Russian International Airlines,Takeoff (climb),Commercial,Russia,Asia,112,9,0,103,0,0,112,Technical Failure
2008-07-03 00:00:00,Eurojet Romania,Flight,Military / Government,Romania,Europe,2,2,0,0,0,0,2,Technical Failure
2008-07-07 00:00:00,Kalitta Air,Takeoff (climb),Operational,Colombia,South America,8,8,0,0,0,0,8,Technical Failure
2008-07-10 00:00:00,Safarilink,Takeoff (climb),Commercial,Kenya,Africa,13,2,0,11,0,0,13,Technical Failure
2008-07-14 00:00:00,Chanchangi Airlines,Landing (descent or approach),Commercial,Nigeria,Africa,47,6,0,41,0,0,47,Human Factor
2008-07-14 00:00:00,Maldivian Air Taxi,Landing (descent or approach),Commercial,Maldives,Asia,17,3,0,14,0,0,17,Human Factor
2008-07-14 00:00:00,Labrador Air Safari,Takeoff (climb),Commercial,Canada,North America,7,1,0,6,0,0,7,Technical Failure
2008-07-15 00:00:00,Líder Taxi Aéreo,Landing (descent or approach),Operational,Brazil,South America,2,2,0,0,0,0,2,Human Factor
2008-07-17 00:00:00,Savannah Aviation,Landing (descent or approach),Operational,Australia,Oceania,1,1,0,0,0,0,1,Technical Failure
2008-07-22 00:00:00,Jean P. Bayardelle,Flight,Business,United States of America,North America,1,1,0,0,0,0,1,Technical Failure
2008-07-26 00:00:00,Juan García Martínez,Landing (descent or approach),Business,Colombia,South America,2,1,0,1,0,0,2,Technical Failure
2008-07-30 00:00:00,My Aviation,Landing (descent or approach),Business,United States of America,North America,2,1,0,1,0,0,2,Human Factor
2008-08-02 00:00:00,Todo Para la Aeronáutica,Landing (descent or approach),Commercial,Mexico,Central America,6,2,0,4,0,0,6,Technical Failure
2008-08-03 00:00:00,Flanagan Enterprises - USA,Landing (descent or approach),Humanitarian,Canada,North America,8,1,0,7,0,0,8,Technical Failure
2008-08-03 00:00:00,Drug Plastics %26 Glass Company,Landing (descent or approach),Operational,United States of America,North America,2,2,0,0,0,0,2,Human Factor
2008-08-05 00:00:00,United Arab Emirates - Abu Dhabi Amiri Flight,Landing (descent or approach),Humanitarian,Afghanistan,Asia,0,0,0,0,0,0,0,Unknown
2008-08-21 00:00:00,Overeem Air Service,Takeoff (climb),Commercial,Suriname,South America,6,1,0,5,0,0,6,Technical Failure
2008-08-23 00:00:00,Aires Colombia - Aerovias de Integracion Regional,Landing (descent or approach),Commercial,Colombia,South America,31,5,0,26,0,0,31,Technical Failure
2008-08-27 00:00:00,Sriwijaya Air,Landing (descent or approach),Commercial,Indonesia,Asia,130,6,0,124,0,0,130,Technical Failure
2008-08-29 00:00:00,Aero-Tranzit,Flight,Specialised Services,Russia,Asia,4,2,0,2,0,0,4,Technical Failure
2008-08-31 00:00:00,Albert A. Norris,Landing (descent or approach),Business,United States of America,North America,1,1,0,0,0,0,1,Human Factor
2008-09-05 00:00:00,Royal Australian Air Force - RAAF,Landing (descent or approach),Military / Government,Papua New Guinea,Oceania,0,0,0,0,0,0,0,Unknown
2008-09-07 00:00:00,Tropic Air,Flight,Commercial,Belize,Central America,5,1,0,4,0,0,5,Technical Failure
2008-09-09 00:00:00,Kakadu Air,Takeoff (climb),Specialised Services,Australia,Oceania,1,1,0,0,0,0,1,Technical Failure
2008-09-18 00:00:00,EuroLine,Landing (descent or approach),Other,Georgia,Asia,0,0,0,0,0,0,0,Human Factor
2008-09-22 00:00:00,Icaro,Takeoff (climb),Commercial,Ecuador,South America,66,4,0,62,0,0,66,Human Factor
2008-09-22 00:00:00,German Air Force - Deutsche Luftwaffe,Flight,Operational,Germany,Europe,0,0,0,0,0,0,0,Unknown
2008-09-29 00:00:00,Trident Aviation,Landing (descent or approach),Operational,Kenya,Africa,3,3,0,0,0,0,3,Technical Failure
2008-09-29 00:00:00,Angola Air Force - Força Aérea Nacional Angolana,Taxiing,Military / Government,Angola,Africa,0,0,0,0,0,0,0,Technical Failure
2008-10-01 00:00:00,KD Avia - Kaliningrad Avia,Landing (descent or approach),Commercial,Russia,Asia,144,6,0,138,0,0,144,Human Factor
2008-10-16 00:00:00,Rutaca - Rutas Aéreas,Landing (descent or approach),Commercial,Venezuela,South America,54,7,0,47,0,0,54,Unknown
2008-10-21 00:00:00,United States Navy - USN,Landing (descent or approach),Military / Government,Afghanistan,Asia,0,0,0,0,0,0,0,Unknown
2008-10-27 00:00:00,Cargo B Airlines,Takeoff (climb),Operational,Belgium,Europe,6,5,0,1,0,0,6,Human Factor
2008-11-01 00:00:00,AAA Investments,Takeoff (climb),Commercial,South Africa,Africa,6,1,0,5,0,0,6,Human Factor
2008-11-06 00:00:00,Express Air,Landing (descent or approach),Commercial,Indonesia,Asia,36,4,0,32,0,0,36,Human Factor
2008-11-10 00:00:00,Ryanair,Landing (descent or approach),Commercial,Italy,Europe,172,8,0,164,0,0,172,Other
2008-11-10 00:00:00,Veteran Airlines,Landing (descent or approach),Operational,Congo,Africa,6,6,0,0,0,0,6,Technical Failure
2008-11-11 00:00:00,National Aviation,Landing (descent or approach),Operational,Canada,North America,2,2,0,0,0,0,2,Unknown
2008-11-22 00:00:00,Skynorth Air,Takeoff (climb),Humanitarian,Canada,North America,5,2,0,3,0,0,5,Technical Failure
2008-11-22 00:00:00,Gum Air,Takeoff (climb),Commercial,Suriname,South America,0,0,0,0,0,0,0,Technical Failure
2008-11-27 00:00:00,Northwestern Air Leasing,Landing (descent or approach),Commercial,Canada,North America,5,2,0,3,0,0,5,Human Factor
2008-11-28 00:00:00,Eurofly Service,Landing (descent or approach),Commercial,Italy,Europe,6,3,0,3,0,0,6,Unknown
2008-12-01 00:00:00,Kim Dosung,Landing (descent or approach),Business,Nicaragua,Central America,6,1,0,5,0,0,6,Human Factor
2008-12-09 00:00:00,Briggs Tobacco %26 Specialty Company,Landing (descent or approach),Operational,United States of America,North America,1,1,0,0,0,0,1,Human Factor
2008-12-13 00:00:00,Summit Air Charters,Landing (descent or approach),Commercial,Canada,North America,14,2,0,12,0,0,14,Human Factor
2008-12-16 00:00:00,Freight Runners Express,Landing (descent or approach),Operational,United States of America,North America,1,1,0,0,0,0,1,Human Factor
2008-12-20 00:00:00,Continental Airlines,Takeoff (climb),Commercial,United States of America,North America,115,5,0,110,0,0,115,Human Factor
2008-12-21 00:00:00,Ameristar Jet Charter,Landing (descent or approach),Operational,United States of America,North America,2,2,0,0,0,0,2,Other
2008-12-23 00:00:00,CNS Corporation,Landing (descent or approach),Business,United States of America,North America,4,2,0,2,0,0,4,Human Factor
2009-01-02 00:00:00,British Gulf International Airlines,Takeoff (climb),Operational,United Arab Emirates,Asia,6,6,0,0,0,0,6,Technical Failure
2009-01-03 00:00:00,Aero Jet Services,Landing (descent or approach),Operational,United States of America,North America,2,2,0,0,0,0,2,Human Factor
2009-01-04 00:00:00,Caribair,Landing (descent or approach),Commercial,United States of America,North America,7,2,0,5,0,0,7,Technical Failure
2009-01-09 00:00:00,Peruvian Armed Forces - Ejército del Perú,Takeoff (climb),Military / Government,Peru,South America,8,2,0,6,0,0,8,Unknown
2009-01-11 00:00:00,Zest Airways,Landing (descent or approach),Commercial,Philippines,Asia,27,5,0,22,0,0,27,Human Factor
2009-01-13 00:00:00,Daallo Airlines,Landing (descent or approach),Commercial,Somalia,Africa,15,4,0,11,0,0,15,Technical Failure
2009-01-15 00:00:00,USAir - US Airways,Takeoff (climb),Commercial,United States of America,North America,155,5,0,150,0,0,155,Other
2009-01-16 00:00:00,Skynorth Air,Landing (descent or approach),Operational,Canada,North America,2,2,0,0,0,0,2,Human Factor
2009-01-16 00:00:00,Tiriac Air,Landing (descent or approach),Commercial,Romania,Europe,13,3,0,10,0,0,13,Human Factor
2009-01-19 00:00:00,Iran Air,Landing (descent or approach),Commercial,Iran,Asia,114,8,0,106,0,0,114,Technical Failure
2009-01-21 00:00:00,Kalahari Air Services,Landing (descent or approach),Commercial,Botswana,Africa,0,0,0,0,0,0,0,Human Factor
2009-01-27 00:00:00,Federal Express - FedEx,Landing (descent or approach),Operational,United States of America,North America,2,2,0,0,0,0,2,Human Factor
2009-02-04 00:00:00,Transwest Air,Takeoff (climb),Commercial,Canada,North America,7,2,0,5,0,0,7,Human Factor
2009-02-04 00:00:00,National Test Pilot School,Takeoff (climb),Operational,United States of America,North America,2,2,0,0,0,0,2,Human Factor
2009-02-06 00:00:00,CSG Services,Takeoff (climb),Commercial,Australia,Oceania,6,1,0,5,0,0,6,Technical Failure
2009-02-11 00:00:00,Russian Air Force - Voyenno-vozdushnye sily Rossii,Takeoff (climb),Humanitarian,Russia,Asia,13,3,0,10,0,0,13,Technical Failure
2009-02-11 00:00:00,Airworks,Landing (descent or approach),Humanitarian,South Sudan,Africa,3,2,0,1,0,0,3,Technical Failure
2009-02-12 00:00:00,Sky Express,Landing (descent or approach),Commercial,Greece,Europe,18,3,0,15,0,0,18,Technical Failure
2009-02-13 00:00:00,British Airways,Landing (descent or approach),Commercial,United Kingdom,Europe,72,5,0,67,0,0,72,Technical Failure
2009-02-18 00:00:00,Policía Nacional de Colombia,Parking,Military / Government,Colombia,South America,27,2,0,25,0,0,27,Other
2009-02-19 00:00:00,Frontier Flying Service,Landing (descent or approach),Commercial,United States of America,North America,6,1,0,5,0,0,6,Human Factor
2009-02-20 00:00:00,Civil Air Patrol,Takeoff (climb),Operational,United States of America,North America,3,3,0,0,0,0,3,Human Factor
2009-02-22 00:00:00,Golden Rule Airlines,Takeoff (climb),Commercial,Kyrgyzstan,Asia,4,2,0,2,0,0,4,Technical Failure
2009-02-24 00:00:00,Egyptian Air Force and Air Defence Command,Landing (descent or approach),Operational,Egypt,Africa,0,0,0,0,0,0,0,Unknown
2009-03-07 00:00:00,ROSTO,Takeoff (climb),Humanitarian,Russia,Asia,11,1,0,10,0,0,11,Unknown
2009-03-09 00:00:00,Lion Air,Landing (descent or approach),Commercial,Indonesia,Asia,172,6,0,166,0,0,172,Human Factor
2009-03-19 00:00:00,United States Navy - USN,Landing (descent or approach),Operational,United States of America,North America,0,0,0,0,0,0,0,Technical Failure
2009-03-26 00:00:00,Russian Air Force - Voyenno-vozdushnye sily Rossii,Takeoff (climb),Military / Government,Russia,Asia,0,0,0,0,0,0,0,Other
2009-04-06 00:00:00,Private Botswana,Landing (descent or approach),Business,Botswana,Africa,5,1,0,4,0,0,5,Unknown
2009-04-24 00:00:00,Ellumax Leasing,Takeoff (climb),Business,United States of America,North America,2,1,0,1,0,0,2,Technical Failure
2009-04-26 00:00:00,Four Star Air Cargo,Taxiing,Operational,Puerto Rico,Central America,4,2,0,2,0,0,4,Technical Failure
2009-04-27 00:00:00,Magnicharters,Landing (descent or approach),Commercial,Mexico,Central America,116,8,0,108,0,0,116,Technical Failure
2009-04-28 00:00:00,Flugschule Gregor Stahnke,Takeoff (climb),Operational,Germany,Europe,1,1,0,0,0,0,1,Unknown
2009-05-04 00:00:00,Republic of Korea Air Force,Landing (descent or approach),Operational,South Korea,Asia,2,2,0,0,0,0,2,Unknown
2009-05-06 00:00:00,World Airways,Landing (descent or approach),Commercial,United States of America,North America,180,12,0,168,0,0,180,Human Factor
2009-05-08 00:00:00,Saudi Arabian Airlines - SAUDIA,Landing (descent or approach),Operational,Saudi Arabia,Asia,7,7,0,0,0,0,7,Human Factor
2009-05-18 00:00:00,Air Atlantic-Congo,Takeoff (climb),Operational,Ethiopia,Africa,4,4,0,0,0,0,4,Unknown
2009-05-28 00:00:00,Ecuadorian Air Force - Fuerza Aérea Ecuatoriana,Landing (descent or approach),Military / Government,Ecuador,South America,8,8,0,0,0,0,8,Unknown
2009-06-02 00:00:00,Maldivian Air Taxi,Landing (descent or approach),Specialised Services,Maldives,Asia,7,3,0,4,0,0,7,Human Factor
2009-06-06 00:00:00,Myanma Airways,Landing (descent or approach),Commercial,Myanmar,Asia,68,6,0,62,0,0,68,Human Factor
2009-06-07 00:00:00,James M. Eule,Takeoff (climb),Business,United States of America,North America,4,1,0,3,0,0,4,Human Factor
2009-06-09 00:00:00,Valor Air,Flight,Military / Government,Kyrgyzstan,Asia,2,2,0,0,0,0,2,Technical Failure
2009-06-13 00:00:00,ROSTO,Flight,Military / Government,Russia,Asia,1,1,0,0,0,0,1,Technical Failure
2009-06-16 00:00:00,Bush-Tell,Landing (descent or approach),Commercial,United States of America,North America,3,1,0,2,0,0,3,Technical Failure
2009-06-18 00:00:00,Alex Lyon %26 Son,Taxiing,Specialised Services,United States of America,North America,2,2,0,0,0,0,2,Unknown
2009-06-25 00:00:00,Zest Airways,Landing (descent or approach),Commercial,Philippines,Asia,59,4,0,55,0,0,59,Human Factor
2009-06-26 00:00:00,Transporte Aéreo de Colombia,Landing (descent or approach),Commercial,Colombia,South America,18,2,0,16,0,0,18,Human Factor
2009-06-27 00:00:00,Vecolair,Takeoff (climb),Military / Government,Afghanistan,Asia,0,0,0,0,0,0,0,Unknown
2009-07-05 00:00:00,Great Barrier Airlines,Takeoff (climb),Commercial,New Zealand,Oceania,11,1,0,10,0,0,11,Technical Failure
2009-07-06 00:00:00,Eldinder Aviation,Landing (descent or approach),Operational,Sudan,Africa,2,2,0,0,0,0,2,Weather
2009-07-11 00:00:00,Renfro's Alaskan Adventures,Landing (descent or approach),Commercial,United States of America,North America,2,1,0,1,0,0,2,Technical Failure
2009-07-24 00:00:00,Private Turks and Caicos,Flight,Business,Turks and Caicos Islands,Central America,1,1,0,0,0,0,1,Unknown
2009-08-03 00:00:00,Saha Airlines,Takeoff (climb),Commercial,Iran,Asia,174,12,0,162,0,0,174,Technical Failure
2009-08-13 00:00:00,Nestor Aviation %26 Aerobatics,Flight,Business,United States of America,North America,2,1,0,1,0,0,2,Human Factor
2009-08-16 00:00:00,Islas Aviation Services,Landing (descent or approach),Commercial,Venezuela,South America,10,1,0,9,0,0,10,Human Factor
2009-08-26 00:00:00,Linea Turistica Aerotuy - LTA,Flight,Commercial,Venezuela,South America,13,2,0,11,0,0,13,Technical Failure
2009-08-27 00:00:00,Angola Air Force - Força Aérea Nacional Angolana,Takeoff (climb),Military / Government,Angola,Africa,0,0,0,0,0,0,0,Human Factor
2009-08-28 00:00:00,United States Air Force - USAF,Landing (descent or approach),Operational,United States of America,North America,32,4,0,28,0,0,32,Technical Failure
2009-08-31 00:00:00,Uzbekistan Airways - Uzbekistan Havo Jullary,Takeoff (climb),Commercial,Uzbekistan,Asia,0,0,0,0,0,0,0,Human Factor
2009-09-09 00:00:00,Dniproaviaservis,Takeoff (climb),Military / Government,Ukraine,Europe,3,2,0,1,0,0,3,Technical Failure
2009-09-15 00:00:00,North American Flight Services,Flight,Commercial,United States of America,North America,6,1,0,5,0,0,6,Technical Failure
2009-09-16 00:00:00,Henry Broadcasting Nevada,Takeoff (climb),Operational,United States of America,North America,1,1,0,0,0,0,1,Human Factor
2009-09-28 00:00:00,Japan Maritime Self-Defense Force - Kaijō Jieitai,Landing (descent or approach),Military / Government,Japan,Asia,11,11,0,0,0,0,11,Unknown
2009-10-03 00:00:00,Brazoria County Mosquito Control District,Flight,Military / Government,United States of America,North America,1,1,0,0,0,0,1,Human Factor
2009-10-06 00:00:00,Robert J. Schumacher,Flight,Business,United States of America,North America,4,1,0,3,0,0,4,Human Factor
2009-10-08 00:00:00,Afghan Republican Air Force - Afghan Hanai Qurah,Landing (descent or approach),Military / Government,Afghanistan,Asia,0,0,0,0,0,0,0,Unknown
2009-10-09 00:00:00,Private Venezuelan,Landing (descent or approach),Humanitarian,Honduras,Central America,0,0,0,0,0,0,0,Human Factor
2009-10-12 00:00:00,SAVE Comercial e Importadora,Landing (descent or approach),Operational,Brazil,South America,2,2,0,0,0,0,2,Human Factor
2009-10-13 00:00:00,Safari Airlines,Landing (descent or approach),Operational,Kenya,Africa,3,3,0,0,0,0,3,Human Factor
2009-10-14 00:00:00,Nicaraguayan Air Force - Fuerza Aérea - Ejercito de Nicaragua,Landing (descent or approach),Specialised Services,Nicaragua,Central America,5,5,0,0,0,0,5,Technical Failure
2009-10-15 00:00:00,Blue Wing Airlines,Landing (descent or approach),Commercial,Suriname,South America,8,2,0,6,0,0,8,Unknown
2009-10-16 00:00:00,Golden Falcon Aviation,Landing (descent or approach),Operational,Greenland,Europe,1,1,0,0,0,0,1,Technical Failure
2009-11-02 00:00:00,United States Air Force - USAF,Landing (descent or approach),Operational,Iraq,Asia,2,2,0,0,0,0,2,Human Factor
2009-11-03 00:00:00,Air Zimbabwe,Takeoff (climb),Commercial,Zimbabwe,Africa,38,4,0,34,0,0,38,Other
2009-11-05 00:00:00,Albatross Adventures,Takeoff (climb),Operational,United States of America,North America,3,2,0,1,0,0,3,Technical Failure
2009-11-07 00:00:00,Russian Air Force - Voyenno-vozdushnye sily Rossii,Takeoff (climb),Military / Government,Russia,Asia,0,0,0,0,0,0,0,Technical Failure
2009-11-09 00:00:00,MDTR Holdings,Landing (descent or approach),Specialised Services,United States of America,North America,3,1,0,2,0,0,3,Human Factor
2009-11-10 00:00:00,Kingfisher Airlines,Landing (descent or approach),Commercial,India,Asia,42,4,0,38,0,0,42,Human Factor
2009-11-14 00:00:00,Low %26 Slow Aviation Ventures,Landing (descent or approach),Operational,United States of America,North America,3,1,0,2,0,0,3,Human Factor
2009-11-18 00:00:00,Pel-Air,Landing (descent or approach),Humanitarian,Australia,Oceania,6,2,0,4,0,0,6,Technical Failure
2009-11-19 00:00:00,Win Win Aviation,Flight,Military / Government,Mali,Africa,9,3,0,6,0,0,9,Human Factor
2009-11-19 00:00:00,Compagnie Africaine d'Aviation,Landing (descent or approach),Commercial,Democratic Republic of Congo,Africa,117,6,0,111,0,0,117,Unknown
2009-12-01 00:00:00,TAF Linhas Aéreas - Taxi Aéreo Fortaleza,Taxiing,Operational,Brazil,South America,3,3,0,0,0,0,3,Technical Failure
2009-12-02 00:00:00,Merpati Nusantara Airlines - MNA,Landing (descent or approach),Commercial,Indonesia,Asia,95,7,0,88,0,0,95,Technical Failure
2009-12-05 00:00:00,Private Colombian,Landing (descent or approach),Humanitarian,Honduras,Central America,1,1,0,0,0,0,1,Human Factor
2009-12-07 00:00:00,South African Airlink,Landing (descent or approach),Commercial,South Africa,Africa,35,3,0,32,0,0,35,Other
2009-12-13 00:00:00,Tahoe Investments,Landing (descent or approach),Business,United States of America,North America,2,1,0,1,0,0,2,Human Factor
2009-12-20 00:00:00,Western Air,Landing (descent or approach),Commercial,Haiti,Central America,21,2,0,19,0,0,21,Unknown
2009-12-20 00:00:00,748 Air Services,Landing (descent or approach),Commercial,South Sudan,Africa,41,4,0,37,0,0,41,Unknown
2009-12-21 00:00:00,Merpati Nusantara Airlines - MNA,Landing (descent or approach),Commercial,Indonesia,Asia,108,6,0,102,0,0,108,Unknown
2009-12-22 00:00:00,American Airlines,Landing (descent or approach),Commercial,Jamaica,Central America,154,6,0,148,0,0,154,Human Factor
2009-12-29 00:00:00,Pacific Island Air,Landing (descent or approach),Commercial,Fiji Islands,Oceania,6,1,0,5,0,0,6,Unknown
2010-01-02 00:00:00,Compagnie Africaine d'Aviation,Landing (descent or approach),Operational,Democratic Republic of Congo,Africa,4,4,0,0,0,0,4,Other
2010-01-04 00:00:00,El Magal Aviation,Landing (descent or approach),Operational,Sudan,Africa,4,4,0,0,0,0,4,Human Factor
2010-01-07 00:00:00,Sky Bahamas,Parking,Commercial,Bahamas,Central America,2,2,0,0,0,0,2,Human Factor
2010-01-08 00:00:00,Aerotaxis Dos Mil,Takeoff (climb),Commercial,United States of America,North America,7,2,0,5,0,0,7,Human Factor
2010-01-13 00:00:00,DAC Aviation,Landing (descent or approach),Humanitarian,Democratic Republic of Congo,Africa,22,4,0,18,0,0,22,Unknown
2010-01-14 00:00:00,Broome Aviation,Landing (descent or approach),Operational,Australia,Oceania,1,1,0,0,0,0,1,Technical Failure
2010-01-15 00:00:00,King's Way,Takeoff (climb),Operational,Switzerland,Europe,4,2,0,2,0,0,4,Human Factor
2010-01-19 00:00:00,Blue Cross %26 Blue Shield of Iowa,Landing (descent or approach),Business,United States of America,North America,4,2,0,2,0,0,4,Human Factor
2010-01-23 00:00:00,Agape Flights,Landing (descent or approach),Operational,Haiti,Central America,2,2,0,0,0,0,2,Technical Failure
2010-01-24 00:00:00,Taban Airlines,Landing (descent or approach),Commercial,Iran,Asia,170,13,0,157,0,0,170,Human Factor
2010-01-31 00:00:00,Guicango,Landing (descent or approach),Commercial,Angola,Africa,37,3,0,34,0,0,37,Technical Failure
2010-02-02 00:00:00,Aerowest,Landing (descent or approach),Humanitarian,Germany,Europe,2,2,0,0,0,0,2,Human Factor
2010-02-11 00:00:00,Trigana Air Service,Flight,Commercial,Indonesia,Asia,52,6,0,46,0,0,52,Technical Failure
2010-03-01 00:00:00,Nova Aviation,Landing (descent or approach),Operational,United States of America,North America,1,1,0,0,0,0,1,Human Factor
2010-03-01 00:00:00,ACT Airlines,Landing (descent or approach),Operational,Afghanistan,Asia,5,5,0,0,0,0,5,Technical Failure
2010-03-01 00:00:00,Air Tanzania,Landing (descent or approach),Commercial,Tanzania,Africa,80,4,0,76,0,0,80,Unknown
2010-03-04 00:00:00,Safe Air Company,Landing (descent or approach),Operational,Somalia,Africa,2,2,0,0,0,0,2,Human Factor
2010-03-07 00:00:00,Líder Taxi Aéreo,Takeoff (climb),Humanitarian,Brazil,South America,6,2,0,4,0,0,6,Technical Failure
2010-03-12 00:00:00,Nigerian Air Force,Landing (descent or approach),Military / Government,Nigeria,Africa,52,5,0,47,0,0,52,Unknown
2010-03-15 00:00:00,Servant Air,Takeoff (climb),Commercial,United States of America,North America,3,1,0,2,0,0,3,Human Factor
2010-03-18 00:00:00,Exin,Landing (descent or approach),Operational,Estonia,Europe,6,6,0,0,0,0,6,Technical Failure
2010-03-21 00:00:00,Bluegrass Aviation Partners,Landing (descent or approach),Business,United States of America,North America,0,0,0,0,0,0,0,Unknown
2010-03-22 00:00:00,Aviastar-TU,Landing (descent or approach),Operational,Russia,Asia,8,8,0,0,0,0,8,Human Factor
2010-03-30 00:00:00,Polartrans,Takeoff (climb),Business,Russia,Asia,5,5,0,0,0,0,5,Technical Failure
2010-04-01 00:00:00,Aero Ermes,Landing (descent or approach),Commercial,Mexico,Central America,6,2,0,4,0,0,6,Technical Failure
2010-04-13 00:00:00,Merpati Nusantara Airlines - MNA,Landing (descent or approach),Commercial,Indonesia,Asia,110,7,0,103,0,0,110,Human Factor
2010-04-15 00:00:00,A. G. Yakunchev,Flight,Military / Government,Russia,Asia,0,0,0,0,0,0,0,Technical Failure
2010-04-20 00:00:00,Ag Aviation,Takeoff (climb),Military / Government,New Zealand,Oceania,1,1,0,0,0,0,1,Unknown
2010-04-27 00:00:00,THS Hélicoptères - Trans Hélicoptère Service,Landing (descent or approach),Commercial,Niger,Africa,10,2,0,8,0,0,10,Human Factor
2010-05-04 00:00:00,Proskurov Avia,Takeoff (climb),Military / Government,Ukraine,Europe,2,2,0,0,0,0,2,Technical Failure
2010-05-05 00:00:00,SATENA - Servicio de Aeronavegacion a Territorios Nacionales,Landing (descent or approach),Commercial,Colombia,South America,42,5,0,37,0,0,42,Human Factor
2010-05-06 00:00:00,IE Batak SG,Takeoff (climb),Military / Government,Russia,Asia,2,2,0,0,0,0,2,Other
2010-05-06 00:00:00,Royal Air Force - RAF,Landing (descent or approach),Military / Government,United Kingdom,Europe,4,4,0,0,0,0,4,Human Factor
2010-05-10 00:00:00,Kenn Borek Air,Landing (descent or approach),Specialised Services,Canada,North America,5,2,0,3,0,0,5,Unknown
2010-05-12 00:00:00,ROSTO,Takeoff (climb),Humanitarian,Russia,Asia,12,2,0,10,0,0,12,Technical Failure
2010-05-16 00:00:00,Private Mexican,Takeoff (climb),Business,United States of America,North America,3,1,0,2,0,0,3,Human Factor
2010-05-19 00:00:00,Taxi Aéreo Weiss,Landing (descent or approach),Operational,Brazil,South America,2,2,0,0,0,0,2,Human Factor
2010-06-04 00:00:00,National Airlines - National Air Cargo,Landing (descent or approach),Operational,Afghanistan,Asia,4,4,0,0,0,0,4,Human Factor
2010-06-10 00:00:00,Theodore Joseph Poelking,Landing (descent or approach),Operational,United States of America,North America,2,2,0,0,0,0,2,Human Factor
2010-06-13 00:00:00,African Skies Aviation,Landing (descent or approach),Commercial,South Africa,Africa,15,2,0,13,0,0,15,Human Factor
2010-06-18 00:00:00,Peruvian Air Force - Fuerza Aérea del Perú,Landing (descent or approach),Military / Government,Peru,South America,8,2,0,6,0,0,8,Technical Failure
2010-06-19 00:00:00,Oasis Flight Services,Landing (descent or approach),Specialised Services,United States of America,North America,3,1,0,2,0,0,3,Technical Failure
2010-06-19 00:00:00,Air Service Berlin,Takeoff (climb),Commercial,Germany,Europe,28,3,0,25,0,0,28,Technical Failure
2010-06-21 00:00:00,Hewa Bora Airways,Landing (descent or approach),Commercial,Democratic Republic of Congo,Africa,110,7,0,103,0,0,110,Technical Failure
2010-06-27 00:00:00,Royal Wolf Lodge,Takeoff (climb),Commercial,United States of America,North America,7,1,0,6,0,0,7,Human Factor
2010-06-27 00:00:00,Avialesookhrana,Flight,Humanitarian,Russia,Asia,3,2,0,1,0,0,3,Technical Failure
2010-06-30 00:00:00,United States Army,Landing (descent or approach),Operational,Germany,Europe,2,2,0,0,0,0,2,Technical Failure
2010-07-06 00:00:00,Air Freight Solutions,Landing (descent or approach),Operational,Australia,Oceania,1,1,0,0,0,0,1,Human Factor
2010-07-15 00:00:00,Prince Aviation,Landing (descent or approach),Commercial,Croatia,Europe,5,3,0,2,0,0,5,Human Factor
2010-07-17 00:00:00,Saudi Arabian Airlines - SAUDIA,Takeoff (climb),Operational,Egypt,Africa,22,22,0,0,0,0,22,Technical Failure
2010-07-18 00:00:00,Aircraft Guaranty Corporation Trustee,Takeoff (climb),Operational,Canada,North America,3,3,0,0,0,0,3,Human Factor
2010-07-20 00:00:00,Air Kasai,Landing (descent or approach),Commercial,Democratic Republic of Congo,Africa,0,0,0,0,0,0,0,Technical Failure
2010-07-21 00:00:00,Khabarovsk Airlines,Takeoff (climb),Operational,Russia,Asia,8,7,0,1,0,0,8,Technical Failure
2010-07-22 00:00:00,Aeropremiere,Takeoff (climb),Operational,United States of America,North America,1,1,0,0,0,0,1,Human Factor
2010-07-27 00:00:00,Roush Fenway Racing,Landing (descent or approach),Business,United States of America,North America,2,1,0,1,0,0,2,Human Factor
2010-07-27 00:00:00,Lufthansa Cargo,Landing (descent or approach),Operational,Saudi Arabia,Asia,2,2,0,0,0,0,2,Human Factor
2010-07-28 00:00:00,Cebu Pacific Air,Landing (descent or approach),Commercial,Philippines,Asia,0,0,0,0,0,0,0,Human Factor
2010-07-28 00:00:00,Mauritania Airways,Landing (descent or approach),Commercial,Guinea,Africa,97,6,0,91,0,0,97,Human Factor
2010-07-28 00:00:00,Private Guinean,Landing (descent or approach),Operational,Afghanistan,Asia,6,6,0,0,0,0,6,Unknown
2010-08-03 00:00:00,Private Ukrainian,Flight,Military / Government,Ukraine,Europe,2,2,0,0,0,0,2,Technical Failure
2010-08-12 00:00:00,OceanAir Taxi Aéreo,Landing (descent or approach),Operational,Brazil,South America,3,3,0,0,0,0,3,Technical Failure
2010-08-13 00:00:00,Policía de Buenos Aires,Takeoff (climb),Military / Government,Argentina,South America,4,2,0,2,0,0,4,Human Factor
2010-08-25 00:00:00,Exin,Takeoff (climb),Operational,Estonia,Europe,4,4,0,0,0,0,4,Human Factor
2010-08-25 00:00:00,Passaredo Linhas Aéreas,Landing (descent or approach),Commercial,Brazil,South America,38,3,0,35,0,0,38,Human Factor
2010-08-26 00:00:00,Iran Aseman Airlines,Landing (descent or approach),Commercial,Iran,Asia,110,7,0,103,0,0,110,Unknown
2010-09-03 00:00:00,Grant Aviation,Takeoff (climb),Commercial,United States of America,North America,3,1,0,2,0,0,3,Human Factor
2010-09-19 00:00:00,Pioneer Air Service,Landing (descent or approach),Commercial,Bahamas,Central America,7,1,0,6,0,0,7,Technical Failure
2010-09-22 00:00:00,Max Aviation - Canada,Takeoff (climb),Commercial,Canada,North America,6,2,0,4,0,0,6,Other
2010-09-23 00:00:00,Rolando Velasco,Landing (descent or approach),Business,Dominican Republic,Central America,4,2,0,2,0,0,4,Human Factor
2010-09-24 00:00:00,Wind Jet,Landing (descent or approach),Commercial,Italy,Europe,129,5,0,124,0,0,129,Human Factor
2010-10-01 00:00:00,Colnan Inc.,Landing (descent or approach),Business,United States of America,North America,7,2,0,5,0,0,7,Human Factor
2010-10-02 00:00:00,Weltall-Avia,Flight,Commercial,Russia,Asia,9,2,0,7,0,0,9,Technical Failure
2010-10-15 00:00:00,Flinders Island Aviation Services,Landing (descent or approach),Commercial,Australia,Oceania,7,1,0,6,0,0,7,Human Factor
2010-10-16 00:00:00,Zambia Air Force,Landing (descent or approach),Military / Government,Zambia,Africa,0,0,0,0,0,0,0,Unknown
2010-10-24 00:00:00,Paracaidismo Casares,Landing (descent or approach),Humanitarian,Argentina,South America,10,1,0,9,0,0,10,Technical Failure
2010-10-26 00:00:00,Private British,Landing (descent or approach),Business,United Kingdom,Europe,1,1,0,0,0,0,1,Human Factor
2010-10-27 00:00:00,Private American,Flight,Business,Puerto Rico,Central America,1,1,0,0,0,0,1,Technical Failure
2010-10-29 00:00:00,Sitton Enterprises,Takeoff (climb),Business,United States of America,North America,3,1,0,2,0,0,3,Technical Failure
2010-11-02 00:00:00,Lion Air,Landing (descent or approach),Commercial,Indonesia,Asia,175,6,0,169,0,0,175,Technical Failure
2010-11-05 00:00:00,LC Busre,Landing (descent or approach),Commercial,Peru,South America,9,2,0,7,0,0,9,Human Factor
2010-11-10 00:00:00,Texas Parks %26 Wildlife Department,Flight,Military / Government,United States of America,North America,3,1,0,2,0,0,3,Weather
2010-11-13 00:00:00,LC Busre,Landing (descent or approach),Commercial,Peru,South America,19,2,0,17,0,0,19,Technical Failure
2010-11-17 00:00:00,Premier Jets,Landing (descent or approach),Operational,United States of America,North America,2,2,0,0,0,0,2,Human Factor
2010-11-18 00:00:00,Yemeni Air Force,Landing (descent or approach),Military / Government,Yemen,Asia,0,0,0,0,0,0,0,Unknown
2010-11-19 00:00:00,Frandley Aviation Partnership,Landing (descent or approach),Humanitarian,United Kingdom,Europe,2,2,0,0,0,0,2,Human Factor
2010-11-19 00:00:00,Algerian Air Force - Al Quwwat Aljawwija Aljaza'Eriiya,Landing (descent or approach),Operational,France,Europe,9,9,0,0,0,0,9,Technical Failure
2010-11-28 00:00:00,The Boogie Club,Takeoff (climb),Humanitarian,United Kingdom,Europe,9,1,0,8,0,0,9,Human Factor
2010-11-29 00:00:00,Ferdinand Noel Mison,Flight,Business,Philippines,Asia,13,2,0,11,0,0,13,Technical Failure
2010-12-03 00:00:00,Kaya Airlines,Landing (descent or approach),Commercial,Mozambique,Africa,17,2,0,15,0,0,17,Human Factor
2010-12-04 00:00:00,Side Stick,Flight,Business,World,World,4,2,0,2,0,0,4,Technical Failure
2010-12-12 00:00:00,Saneamento Servicos Avancados,Landing (descent or approach),Business,Brazil,South America,7,2,0,5,0,0,7,Weather
2010-12-14 00:00:00,Nordavia,Landing (descent or approach),Commercial,Russia,Asia,39,7,0,32,0,0,39,Unknown
2010-12-22 00:00:00,5583 N.W.T.,Flight,Business,Canada,North America,1,1,0,0,0,0,1,Technical Failure
2010-12-27 00:00:00,Central Air Southwest,Landing (descent or approach),Operational,United States of America,North America,1,1,0,0,0,0,1,Technical Failure
2011-01-03 00:00:00,Air Supply Alaska,Landing (descent or approach),Operational,United States of America,North America,1,1,0,0,0,0,1,Human Factor
2011-01-06 00:00:00,Priester Aviation,Landing (descent or approach),Commercial,United States of America,North America,6,2,0,4,0,0,6,Human Factor
2011-01-10 00:00:00,Africa Charter Airline,Taxiing,Operational,South Africa,Africa,3,3,0,0,0,0,3,Human Factor
2011-01-27 00:00:00,Fly540,Takeoff (climb),Specialised Services,Kenya,Africa,4,2,0,2,0,0,4,Unknown
2011-01-30 00:00:00,Prime Aviation,Taxiing,Business,French Polynesia,Oceania,0,0,0,0,0,0,0,Unknown
2011-02-08 00:00:00,Daytona Beach Aviation Leasing,Landing (descent or approach),Business,United States of America,North America,0,0,0,0,0,0,0,Unknown
2011-02-16 00:00:00,Saudi Arabian Airlines - SAUDIA,Landing (descent or approach),Commercial,Saudi Arabia,Asia,277,17,0,260,0,0,277,Unknown
2011-02-21 00:00:00,TRIP Linhas Aéreas,Landing (descent or approach),Commercial,Brazil,South America,51,4,0,47,0,0,51,Technical Failure
2011-02-27 00:00:00,Línea Aérea Amaszonas,Landing (descent or approach),Commercial,Bolivia,South America,8,2,0,6,0,0,8,Technical Failure
2011-03-02 00:00:00,Air Norway,Landing (descent or approach),Commercial,Norway,Europe,11,2,0,9,0,0,11,Technical Failure
2011-03-04 00:00:00,Flugfélag Íslands,Landing (descent or approach),Commercial,Greenland,Europe,34,3,0,31,0,0,34,Human Factor
2011-03-20 00:00:00,Nolinor Aviation,Taxiing,Operational,United States of America,North America,2,2,0,0,0,0,2,Unknown
2011-03-28 00:00:00,Crown Supply Company,Landing (descent or approach),Business,United States of America,North America,7,1,0,6,0,0,7,Human Factor
2011-03-30 00:00:00,Mykolayiv-Aero,Flight,Military / Government,Ukraine,Europe,2,2,0,0,0,0,2,Technical Failure
2011-04-02 00:00:00,Skydive Pull Out Ravenna,Takeoff (climb),Humanitarian,Italy,Europe,11,1,0,10,0,0,11,Unknown
2011-04-08 00:00:00,U.S. Department of Commerce,Landing (descent or approach),Operational,United States of America,North America,2,2,0,0,0,0,2,Human Factor
2011-04-09 00:00:00,Sabre 60 Jet,Landing (descent or approach),Business,United States of America,North America,2,2,0,0,0,0,2,Unknown
2011-04-11 00:00:00,AirNet Systems,Takeoff (climb),Operational,United States of America,North America,1,1,0,0,0,0,1,Human Factor
2011-04-11 00:00:00,Vertol Systems Company,Flight,Business,United States of America,North America,3,1,0,2,0,0,3,Technical Failure
2011-04-13 00:00:00,Aviation Services Saint Lucia,Landing (descent or approach),Operational,Saint Lucia,Central America,1,1,0,0,0,0,1,Technical Failure
2011-04-15 00:00:00,Línea de Aeroservicios - LASSA,Landing (descent or approach),Operational,Chile,South America,2,1,0,1,0,0,2,Other
2011-04-16 00:00:00,Petropavlosvk-Khamchatsky Air Enterprise,Takeoff (climb),Commercial,Russia,Asia,26,5,0,21,0,0,26,Unknown
2011-04-20 00:00:00,Argentinian Navy - Armada Argentina,Flight,Operational,Argentina,South America,2,2,0,0,0,0,2,Technical Failure
2011-04-28 00:00:00,Dniproavia,Landing (descent or approach),Commercial,Russia,Asia,34,4,0,30,0,0,34,Unknown
2011-05-05 00:00:00,JODA LLC,Landing (descent or approach),Operational,Mexico,Central America,2,2,0,0,0,0,2,Technical Failure
2011-05-16 00:00:00,North Slope Borough,Landing (descent or approach),Humanitarian,United States of America,North America,3,1,0,2,0,0,3,Human Factor
2011-05-17 00:00:00,Private Russian,Flight,Military / Government,Russia,Asia,1,1,0,0,0,0,1,Technical Failure
2011-05-18 00:00:00,Omega Air,Takeoff (climb),Operational,United States of America,North America,3,3,0,0,0,0,3,Technical Failure
2011-05-18 00:00:00,Sherborne Aviation,Takeoff (climb),Business,United Kingdom,Europe,2,1,0,1,0,0,2,Technical Failure
2011-05-19 00:00:00,Urschel Air,Landing (descent or approach),Business,United States of America,North America,4,1,0,3,0,0,4,Human Factor
2011-05-23 00:00:00,Air Grand Canyon,Landing (descent or approach),Commercial,United States of America,North America,6,1,0,5,0,0,6,Human Factor
2011-05-23 00:00:00,Mega Linhas Aéreas,Takeoff (climb),Operational,Brazil,South America,1,1,0,0,0,0,1,Human Factor
2011-05-25 00:00:00,JetSuite,Landing (descent or approach),Commercial,United States of America,North America,5,2,0,3,0,0,5,Human Factor
2011-05-31 00:00:00,Société de Développement et de Promotion de l'Aviation,Takeoff (climb),Business,France,Europe,2,1,0,1,0,0,2,Technical Failure
2011-06-01 00:00:00,James Teng %26 Sons,Landing (descent or approach),Business,United States of America,North America,2,1,0,1,0,0,2,Human Factor
2011-06-06 00:00:00,Solenta Aviation,Landing (descent or approach),Operational,Gabon,Africa,4,3,0,1,0,0,4,Technical Failure
2011-06-12 00:00:00,Universal Airlines,Landing (descent or approach),Operational,United States of America,North America,4,4,0,0,0,0,4,Human Factor
2011-06-13 00:00:00,Liberty Foundation,Takeoff (climb),Operational,United States of America,North America,7,2,0,5,0,0,7,Human Factor
2011-06-15 00:00:00,Dynamic Aviation,Flight,Operational,United States of America,North America,2,2,0,0,0,0,2,Weather
2011-06-16 00:00:00,Transbanca,Flight,Operational,Venezuela,South America,2,1,0,1,0,0,2,Technical Failure
2011-06-17 00:00:00,Skycharter,Landing (descent or approach),Operational,Canada,North America,2,2,0,0,0,0,2,Human Factor
2011-07-11 00:00:00,Trans Maldivian Airways,Landing (descent or approach),Operational,Maldives,Asia,2,2,0,0,0,0,2,Human Factor
2011-07-14 00:00:00,EuroLOT,Taxiing,Commercial,Poland,Europe,37,4,0,33,0,0,37,Human Factor
2011-07-14 00:00:00,Bristow Helicopters,Landing (descent or approach),Business,Nigeria,Africa,6,2,0,4,0,0,6,Human Factor
2011-07-17 00:00:00,Aer Arann,Landing (descent or approach),Commercial,Ireland,Europe,25,4,0,21,0,0,25,Human Factor
2011-07-23 00:00:00,South African Air Force,Landing (descent or approach),Military / Government,South Africa,Africa,2,2,0,0,0,0,2,Unknown
2011-07-29 00:00:00,Egyptair,Parking,Commercial,Egypt,Africa,317,10,0,307,0,0,317,Technical Failure
2011-07-30 00:00:00,Caribbean Airlines - Trinidad %26 Tobago,Landing (descent or approach),Commercial,Guyana,South America,163,6,0,157,0,0,163,Human Factor
2011-08-01 00:00:00,Air Taxi,Flight,Commercial,Vanuatu,Oceania,7,1,0,6,0,0,7,Weather
2011-08-03 00:00:00,Nolinor Aviation,Landing (descent or approach),Commercial,Canada,North America,0,0,0,0,0,0,0,Other
2011-08-08 00:00:00,IrAero,Landing (descent or approach),Commercial,Russia,Asia,41,5,0,36,0,0,41,Human Factor
2011-08-20 00:00:00,Trans Guyana Airways,Landing (descent or approach),Commercial,Guyana,South America,4,1,0,3,0,0,4,Weather
2011-09-02 00:00:00,Ryan Air,Flight,Operational,United States of America,North America,1,1,0,0,0,0,1,Human Factor
2011-09-04 00:00:00,United Express,Landing (descent or approach),Commercial,Canada,North America,47,3,0,44,0,0,47,Other
2011-09-16 00:00:00,Transportes Aéreos Mercantiles Ecuatorianos - TAME,Landing (descent or approach),Commercial,Ecuador,South America,103,6,0,97,0,0,103,Human Factor
2011-09-17 00:00:00,Ivan T. Brigman,Landing (descent or approach),Humanitarian,United States of America,North America,1,1,0,0,0,0,1,Human Factor
2011-09-26 00:00:00,Linea Aeropostal Venezolana - LAV,Landing (descent or approach),Commercial,Venezuela,South America,130,5,0,125,0,0,130,Human Factor
2011-09-28 00:00:00,Laurel Mountain Aviation,Landing (descent or approach),Commercial,United States of America,North America,3,1,0,2,0,0,3,Human Factor
2011-10-02 00:00:00,Sudan Airways,Landing (descent or approach),Commercial,Sudan,Africa,45,4,0,41,0,0,45,Technical Failure
2011-10-03 00:00:00,Aerotaxis Dos Mil,Taxiing,Specialised Services,United States of America,North America,1,1,0,0,0,0,1,Unknown
2011-10-07 00:00:00,Agência Marítima Universal,Landing (descent or approach),Business,Brazil,South America,5,2,0,3,0,0,5,Human Factor
2011-10-09 00:00:00,Adygeya-Avia,Flight,Military / Government,Russia,Asia,1,1,0,0,0,0,1,Human Factor
2011-10-10 00:00:00,Sky Airlines,Landing (descent or approach),Commercial,Turkey,Asia,162,6,0,156,0,0,162,Technical Failure
2011-10-12 00:00:00,Socata,Landing (descent or approach),Specialised Services,United States of America,North America,2,2,0,0,0,0,2,Human Factor
2011-10-12 00:00:00,Nationale Régionale Transport - NRT,Landing (descent or approach),Commercial,Gabon,Africa,30,3,0,27,0,0,30,Unknown
2011-10-31 00:00:00,Jimmie Johnson Racing II,Landing (descent or approach),Business,United States of America,North America,4,2,0,2,0,0,4,Human Factor
2011-10-31 00:00:00,Swala Aviation,Landing (descent or approach),Commercial,Democratic Republic of Congo,Africa,19,3,0,16,0,0,19,Technical Failure
2011-11-01 00:00:00,LOT Polish Airlines - Polskie Linie Lotnicze,Landing (descent or approach),Commercial,Poland,Europe,231,10,0,221,0,0,231,Technical Failure
2011-11-07 00:00:00,Hageland Aviation Services,Takeoff (climb),Commercial,United States of America,North America,6,1,0,5,0,0,6,Human Factor
2011-11-10 00:00:00,Bluebird Aviation,Landing (descent or approach),Operational,Somalia,Africa,3,3,0,0,0,0,3,Unknown
2011-11-11 00:00:00,Kreuter Engineering,Landing (descent or approach),Business,United States of America,North America,0,0,0,0,0,0,0,Other
2011-11-12 00:00:00,Timothy W. Taylor,Landing (descent or approach),Business,United States of America,North America,5,1,0,4,0,0,5,Human Factor
2011-11-16 00:00:00,Avantair,Landing (descent or approach),Commercial,United States of America,North America,4,2,0,2,0,0,4,Technical Failure
2011-11-21 00:00:00,Makalu Air,Landing (descent or approach),Commercial,Nepal,Asia,12,3,0,9,0,0,12,Unknown
2011-11-24 00:00:00,Boeck %26 Boeck,Flight,Operational,World,World,2,1,0,1,0,0,2,Technical Failure
2011-11-26 00:00:00,Wings over Africa,Takeoff (climb),Business,Angola,Africa,10,3,0,7,0,0,10,Unknown
2011-11-30 00:00:00,Bolivian Air Force - Fuerza Aérea Boliviana,Landing (descent or approach),Military / Government,Bolivia,South America,7,3,0,4,0,0,7,Unknown
2011-12-02 00:00:00,Quality Lease Air Services,Landing (descent or approach),Operational,United States of America,North America,1,1,0,0,0,0,1,Human Factor
2011-12-03 00:00:00,Merpati Nusantara Airlines - MNA,Landing (descent or approach),Commercial,Indonesia,Asia,23,4,0,19,0,0,23,Human Factor
2011-12-04 00:00:00,Air Tropiques,Landing (descent or approach),Commercial,Congo,Africa,10,2,0,8,0,0,10,Unknown
2011-12-12 00:00:00,Private Uganda,Takeoff (climb),Military / Government,Uganda,Africa,7,3,0,4,0,0,7,Technical Failure
2011-12-15 00:00:00,Indian Air Force - Bharatiya Vayu Sena,Landing (descent or approach),Military / Government,India,Asia,0,0,0,0,0,0,0,Unknown
2011-12-18 00:00:00,United States Air Force - USAF,Landing (descent or approach),Military / Government,Afghanistan,Asia,7,3,0,4,0,0,7,Unknown
2011-12-20 00:00:00,Sriwijaya Air,Landing (descent or approach),Commercial,Indonesia,Asia,137,6,0,131,0,0,137,Human Factor
2011-12-28 00:00:00,Kyrgyzstan Airlines - Kyrgyzstan Aba Zholdoru,Landing (descent or approach),Commercial,Kyrgyzstan,Asia,88,6,0,82,0,0,88,Human Factor
2011-12-28 00:00:00,Citation 7063 Corporation,Takeoff (climb),Business,United States of America,North America,8,2,0,6,0,0,8,Technical Failure
2011-12-31 00:00:00,Katekavia,Landing (descent or approach),Commercial,Russia,Asia,0,0,0,0,0,0,0,Unknown
2012-01-05 00:00:00,Norman B. Ivans,Landing (descent or approach),Business,United States of America,North America,1,1,0,0,0,0,1,Human Factor
2012-01-12 00:00:00,Bluesky Aviation,Takeoff (climb),Commercial,Kenya,Africa,6,2,0,4,0,0,6,Other
2012-01-13 00:00:00,Central Air Southwest,Landing (descent or approach),Operational,United States of America,North America,1,1,0,0,0,0,1,Human Factor
2012-01-19 00:00:00,Compañía Chilena de Fósforos,Landing (descent or approach),Business,Chile,South America,8,1,0,7,0,0,8,Human Factor
2012-01-24 00:00:00,Swiftair,Landing (descent or approach),Commercial,Afghanistan,Asia,91,5,0,86,0,0,91,Human Factor
2012-02-08 00:00:00,Mônaco Diesel Caminhões e Ônibus,Landing (descent or approach),Business,Brazil,South America,4,2,0,2,0,0,4,Human Factor
2012-02-09 00:00:00,Transcarga International Airways,Landing (descent or approach),Operational,Venezuela,South America,3,2,0,1,0,0,3,Technical Failure
2012-02-10 00:00:00,Private German,Landing (descent or approach),Business,France,Europe,3,1,0,2,0,0,3,Human Factor
2012-02-13 00:00:00,Jet ICU Air Ambulance Service,Takeoff (climb),Operational,United States of America,North America,3,3,0,0,0,0,3,Unknown
2012-02-13 00:00:00,Carpatair,Takeoff (climb),Commercial,Romania,Europe,55,4,0,51,0,0,55,Other
2012-02-17 00:00:00,Air KBZ,Landing (descent or approach),Commercial,Myanmar,Asia,54,4,0,50,0,0,54,Human Factor
2012-03-09 00:00:00,Southern Air Charter,Landing (descent or approach),Commercial,Bahamas,Central America,0,0,0,0,0,0,0,Technical Failure
2012-03-09 00:00:00,Peruvian Air Force - Fuerza Aérea del Perú,Landing (descent or approach),Military / Government,Peru,South America,11,2,0,9,0,0,11,Unknown
2012-03-13 00:00:00,Southeast Aviation,Flight,Commercial,United States of America,North America,2,1,0,1,0,0,2,Human Factor
2012-03-22 00:00:00,Jet One Express,Taxiing,Operational,Puerto Rico,Central America,2,2,0,0,0,0,2,Technical Failure
2012-03-22 00:00:00,Private Russian,Flight,Business,Russia,Asia,0,0,0,0,0,0,0,Unknown
2012-03-23 00:00:00,Mascaro Air,Takeoff (climb),Business,United States of America,North America,1,1,0,0,0,0,1,Human Factor
2012-03-23 00:00:00,Royal Thai Air Force - Kong Thap Akat Thai,Flight,Operational,Thailand,Asia,3,2,0,1,0,0,3,Technical Failure
2012-03-27 00:00:00,Bil Mar Foods,Landing (descent or approach),Business,United States of America,North America,3,1,0,2,0,0,3,Human Factor
2012-03-29 00:00:00,Feeder Airlines,Landing (descent or approach),Commercial,South Sudan,Africa,55,5,0,50,0,0,55,Human Factor
2012-04-02 00:00:00,Timbis Air Services,Landing (descent or approach),Operational,South Sudan,Africa,3,3,0,0,0,0,3,Unknown
2012-04-03 00:00:00,Líder Taxi Aéreo,Flight,Operational,Netherlands,Central America,2,2,0,0,0,0,2,Human Factor
2012-04-09 00:00:00,Air Tanzania,Takeoff (climb),Commercial,Tanzania,Africa,39,4,0,35,0,0,39,Technical Failure
2012-04-15 00:00:00,Sky Relief Services,Landing (descent or approach),Operational,South Sudan,Africa,3,3,0,0,0,0,3,Technical Failure
2012-04-20 00:00:00,Mexican Air Force - Fuerza Aérea Mexicana,Takeoff (climb),Military / Government,Mexico,Central America,7,2,0,5,0,0,7,Technical Failure
2012-04-21 00:00:00,Great American Transportation Company,Landing (descent or approach),Business,United States of America,North America,1,1,0,0,0,0,1,Unknown
2012-04-23 00:00:00,Proskurov Avia,Takeoff (climb),Military / Government,Ukraine,Europe,2,2,0,0,0,0,2,Human Factor
2012-04-23 00:00:00,Aerogetic,Flight,Military / Government,Romania,Europe,2,2,0,0,0,0,2,Human Factor
2012-04-27 00:00:00,Private Mexican,Landing (descent or approach),Specialised Services,Mexico,Central America,0,0,0,0,0,0,0,Unknown
2012-04-28 00:00:00,Jubba Airways,Landing (descent or approach),Commercial,Somalia,Africa,36,4,0,32,0,0,36,Human Factor
2012-04-30 00:00:00,Royal Thai Air Force - Kong Thap Akat Thai,Landing (descent or approach),Military / Government,Bangladesh,Asia,15,7,0,8,0,0,15,Unknown
2012-05-01 00:00:00,Saudi Arabian Airlines - SAUDIA,Landing (descent or approach),Operational,Saudi Arabia,Asia,10,10,0,0,0,0,10,Technical Failure
2012-05-02 00:00:00,Airworks,Landing (descent or approach),Humanitarian,South Sudan,Africa,11,2,0,9,0,0,11,Other
2012-05-17 00:00:00,Air Cargo Carriers,Taxiing,Operational,United States of America,North America,2,2,0,0,0,0,2,Human Factor
2012-05-23 00:00:00,Russian Air Force - Voyenno-vozdushnye sily Rossii,Landing (descent or approach),Operational,Czech Republic,Europe,23,4,0,19,0,0,23,Human Factor
2012-05-25 00:00:00,Skydive Flyzone,Landing (descent or approach),Humanitarian,France,Europe,1,1,0,0,0,0,1,Technical Failure
2012-06-01 00:00:00,Sriwijaya Air,Landing (descent or approach),Commercial,Indonesia,Asia,163,8,0,155,0,0,163,Weather
2012-06-02 00:00:00,Allied Air,Landing (descent or approach),Operational,Ghana,Africa,4,4,0,0,0,0,4,Human Factor
2012-06-07 00:00:00,Performance Aircraft Leasing,Landing (descent or approach),Business,United States of America,North America,8,2,0,6,0,0,8,Human Factor
2012-06-12 00:00:00,Wasaya Airways,Parking,Operational,Canada,North America,2,2,0,0,0,0,2,Other
2012-06-16 00:00:00,Blue Islands,Landing (descent or approach),Commercial,United Kingdom,Europe,43,3,0,40,0,0,43,Technical Failure
2012-06-18 00:00:00,N79TE LLC,Landing (descent or approach),Business,United States of America,North America,4,2,0,2,0,0,4,Human Factor
2012-06-20 00:00:00,International Trans Air Business,Landing (descent or approach),Commercial,Democratic Republic of Congo,Africa,5,2,0,3,0,0,5,Human Factor
2012-06-23 00:00:00,S. C. Frederici,Takeoff (climb),Humanitarian,Romania,Europe,4,1,0,3,0,0,4,Technical Failure
2012-06-27 00:00:00,Russian Air Force - Voyenno-vozdushnye sily Rossii,Landing (descent or approach),Operational,Russia,Asia,4,4,0,0,0,0,4,Human Factor
2012-07-01 00:00:00,Swallow Aviación,Takeoff (climb),Humanitarian,Spain,Europe,10,2,0,8,0,0,10,Human Factor
2012-07-04 00:00:00,Argentinian Air Force - Fuerza Aérea Argentina,Landing (descent or approach),Military / Government,Argentina,South America,9,3,0,6,0,0,9,Technical Failure
2012-07-19 00:00:00,Dalnevostochnaya,Flight,Military / Government,Russia,Asia,3,3,0,0,0,0,3,Technical Failure
2012-07-24 00:00:00,Fugro Airborne Surveys,Landing (descent or approach),Military / Government,Brazil,South America,3,1,0,2,0,0,3,Technical Failure
2012-08-06 00:00:00,Dalia Air,Landing (descent or approach),Commercial,Switzerland,Europe,3,2,0,1,0,0,3,Human Factor
2012-08-18 00:00:00,Abalone Parachutisme,Landing (descent or approach),Humanitarian,France,Europe,1,1,0,0,0,0,1,Unknown
2012-08-25 00:00:00,High Adventure Air Charter,Landing (descent or approach),Commercial,United States of America,North America,6,1,0,5,0,0,6,Human Factor
2012-08-31 00:00:00,Pakistan International Airlines - PIA,Landing (descent or approach),Commercial,Pakistan,Asia,46,4,0,42,0,0,46,Human Factor
2012-09-05 00:00:00,John Campbell,Takeoff (climb),Business,United States of America,North America,2,2,0,0,0,0,2,Human Factor
2012-09-07 00:00:00,Finolex Industries,Landing (descent or approach),Operational,India,Asia,3,3,0,0,0,0,3,Unknown
2012-09-15 00:00:00,Private German,Landing (descent or approach),Business,Denmark,Europe,2,2,0,0,0,0,2,Human Factor
2012-09-18 00:00:00,Dewberry Air,Landing (descent or approach),Business,United States of America,North America,3,2,0,1,0,0,3,Human Factor
2012-09-22 00:00:00,Government of Uttar Pradesh,Landing (descent or approach),Military / Government,India,Asia,6,3,0,3,0,0,6,Technical Failure
2012-10-13 00:00:00,Centurion Air Cargo,Landing (descent or approach),Operational,Brazil,South America,3,3,0,0,0,0,3,Technical Failure
2012-10-14 00:00:00,Corendon Airlines,Taxiing,Commercial,Turkey,Asia,196,7,0,189,0,0,196,Technical Failure
2012-10-19 00:00:00,Air Armenia,Landing (descent or approach),Operational,Afghanistan,Asia,6,6,0,0,0,0,6,Unknown
2012-10-22 00:00:00,Direct Aviation,Landing (descent or approach),Business,United States of America,North America,2,1,0,1,0,0,2,Human Factor
2012-10-25 00:00:00,Taraba State Government,Landing (descent or approach),Military / Government,Nigeria,Africa,4,1,0,3,0,0,4,Human Factor
2012-10-28 00:00:00,Chadian Government,Landing (descent or approach),Military / Government,Chad,Africa,17,2,0,15,0,0,17,Unknown
2012-10-30 00:00:00,Cetraca Aviation Service,Landing (descent or approach),Commercial,Democratic Republic of Congo,Africa,18,3,0,15,0,0,18,Unknown
2012-10-30 00:00:00,Can-West Corporate Air Charters,Landing (descent or approach),Operational,Canada,North America,2,2,0,0,0,0,2,Unknown
2012-11-11 00:00:00,Tropic Air Taxi Aéreo,Landing (descent or approach),Commercial,Brazil,South America,3,2,0,1,0,0,3,Human Factor
2012-11-15 00:00:00,Skyward International Aviation,Landing (descent or approach),Commercial,South Sudan,Africa,57,4,0,53,0,0,57,Technical Failure
2012-11-16 00:00:00,DHL Worldwide Express - DHL Airways,Landing (descent or approach),Operational,Slovakia,Europe,3,3,0,0,0,0,3,Human Factor
2012-11-17 00:00:00,Stevens Aviation,Landing (descent or approach),Specialised Services,United States of America,North America,2,2,0,0,0,0,2,Other
2012-11-19 00:00:00,Ultimate Air,Landing (descent or approach),Operational,South Sudan,Africa,4,4,0,0,0,0,4,Unknown
2012-11-21 00:00:00,Polyarnye Avialinii,Landing (descent or approach),Commercial,Russia,Asia,29,6,0,23,0,0,29,Human Factor
2012-11-25 00:00:00,Devenco Trading,Landing (descent or approach),Operational,South Africa,Africa,1,1,0,0,0,0,1,Human Factor
2012-11-27 00:00:00,Inter Iles Air,Takeoff (climb),Commercial,Comoros Islands,Africa,29,4,0,25,0,0,29,Technical Failure
2012-11-28 00:00:00,Bog Hog Mud Motors,Landing (descent or approach),Business,United States of America,North America,2,1,0,1,0,0,2,Human Factor
2012-12-07 00:00:00,Government of the State of Nayarit,Takeoff (climb),Humanitarian,Mexico,Central America,3,1,0,2,0,0,3,Weather
2012-12-11 00:00:00,Ravensdown Aerowork,Flight,Military / Government,New Zealand,Oceania,1,1,0,0,0,0,1,Unknown
2012-12-21 00:00:00,U.S. Customs %26 Border Protection,Landing (descent or approach),Operational,United States of America,North America,2,2,0,0,0,0,2,Other
2012-12-31 00:00:00,EasySky,Landing (descent or approach),Commercial,Honduras,Central America,19,2,0,17,0,0,19,Unknown
2013-01-02 00:00:00,Managed Aviation,Landing (descent or approach),Operational,United States of America,North America,2,2,0,0,0,0,2,Human Factor
2013-01-02 00:00:00,SOL Lineas Aéreas,Taxiing,Commercial,Argentina,South America,33,3,0,30,0,0,33,Technical Failure
2013-01-13 00:00:00,Din S. Vimadalal,Landing (descent or approach),Business,Mexico,Central America,0,0,0,0,0,0,0,Unknown
2013-01-17 00:00:00,South African Air Force,Landing (descent or approach),Humanitarian,South Africa,Africa,5,5,0,0,0,0,5,Unknown
2013-01-25 00:00:00,Fly My Sky,Landing (descent or approach),Commercial,New Zealand,Oceania,9,1,0,8,0,0,9,Weather
2013-01-29 00:00:00,1649808 Alberta,Landing (descent or approach),Business,Canada,North America,3,1,0,2,0,0,3,Unknown
2013-02-02 00:00:00,Alitalia - Linee Aeree Italiane,Landing (descent or approach),Commercial,Italy,Europe,50,4,0,46,0,0,50,Human Factor
2013-02-06 00:00:00,Tunis Air,Landing (descent or approach),Commercial,Tunisia,Africa,83,8,0,75,0,0,83,Unknown
2013-02-07 00:00:00,Private Ukrainian,Flight,Business,Ukraine,Europe,1,1,0,0,0,0,1,Human Factor
2013-02-11 00:00:00,Pakistan International Airlines - PIA,Landing (descent or approach),Commercial,Oman,Asia,114,7,0,107,0,0,114,Technical Failure
2013-02-24 00:00:00,Frank Leroy Bell,Landing (descent or approach),Business,United States of America,North America,1,1,0,0,0,0,1,Human Factor
2013-02-28 00:00:00,Heli Air Services,Landing (descent or approach),Humanitarian,South Sudan,Africa,2,2,0,0,0,0,2,Technical Failure
2013-03-01 00:00:00,Houston Air,Takeoff (climb),Specialised Services,United States of America,North America,2,1,0,1,0,0,2,Technical Failure
2013-03-02 00:00:00,DOSAAF,Takeoff (climb),Humanitarian,Russia,Asia,14,2,0,12,0,0,14,Technical Failure
2013-03-22 00:00:00,Malu Aviation,Takeoff (climb),Operational,Democratic Republic of Congo,Africa,3,3,0,0,0,0,3,Other
2013-03-29 00:00:00,Aircraft Guaranty Corporation Trustee,Flight,Operational,France,Europe,2,1,0,1,0,0,2,Technical Failure
2013-04-03 00:00:00,Sandy Lake Seaplane Service,Takeoff (climb),Operational,Canada,North America,1,1,0,0,0,0,1,Human Factor
2013-04-04 00:00:00,LeAir Charter Services,Landing (descent or approach),Humanitarian,Bahamas,Central America,2,2,0,0,0,0,2,Human Factor
2013-04-05 00:00:00,Luis A. Terry,Landing (descent or approach),Business,United States of America,North America,2,1,0,1,0,0,2,Technical Failure
2013-04-06 00:00:00,Private Mexican,Landing (descent or approach),Business,Mexico,Central America,6,1,0,5,0,0,6,Technical Failure
2013-04-10 00:00:00,South Airlines - Pivdenni Avialinii - Yuzhnye Avialinii,Landing (descent or approach),Humanitarian,South Sudan,Africa,4,4,0,0,0,0,4,Unknown
2013-04-13 00:00:00,Lion Air,Landing (descent or approach),Commercial,Indonesia,Asia,108,7,0,101,0,0,108,Human Factor
2013-04-17 00:00:00,Lao Air,Takeoff (climb),Commercial,Laos,Asia,18,2,0,16,0,0,18,Unknown
2013-04-28 00:00:00,Shairplane,Takeoff (climb),Business,Netherlands,Europe,5,2,0,3,0,0,5,Human Factor
2013-05-10 00:00:00,Aero Scoroget,Flight,Military / Government,Romania,Europe,3,2,0,1,0,0,3,Human Factor
2013-05-13 00:00:00,Evergreen International Airlines,Landing (descent or approach),Operational,United States of America,North America,3,2,0,1,0,0,3,Human Factor
2013-05-16 00:00:00,Myanma Airways,Landing (descent or approach),Commercial,Myanmar,Asia,55,4,0,51,0,0,55,Human Factor
2013-05-16 00:00:00,China Flying Dragon Special Aviation Company,Landing (descent or approach),Other,China,Asia,3,3,0,0,0,0,3,Unknown
2013-05-16 00:00:00,Nepal Airlines,Landing (descent or approach),Commercial,Nepal,Asia,21,3,0,18,0,0,21,Human Factor
2013-05-19 00:00:00,United States Air Force - USAF,Landing (descent or approach),Humanitarian,Afghanistan,Asia,13,11,0,2,0,0,13,Human Factor
2013-05-26 00:00:00,Brazilian Air Force - Força Aérea Brasileira,Takeoff (climb),Military / Government,Haiti,Central America,143,12,0,131,0,0,143,Technical Failure
2013-05-31 00:00:00,Deraya Air Taxi,Landing (descent or approach),Operational,Indonesia,Asia,3,3,0,0,0,0,3,Human Factor
2013-06-01 00:00:00,Sita Air,Landing (descent or approach),Commercial,Nepal,Asia,7,2,0,5,0,0,7,Human Factor
2013-06-07 00:00:00,China Eastern Airlines,Landing (descent or approach),Commercial,China,Asia,49,5,0,44,0,0,49,Technical Failure
2013-06-10 00:00:00,Flycie Aviation,Landing (descent or approach),Specialised Services,Canada,North America,4,1,0,3,0,0,4,Human Factor
2013-06-10 00:00:00,Myanma Airways,Landing (descent or approach),Commercial,Myanmar,Asia,64,4,0,60,0,0,64,Technical Failure
2013-06-10 00:00:00,Merpati Nusantara Airlines - MNA,Landing (descent or approach),Commercial,Indonesia,Asia,50,4,0,46,0,0,50,Human Factor
2013-06-13 00:00:00,Grady International,Parking,Specialised Services,United States of America,North America,2,2,0,0,0,0,2,Human Factor
2013-06-13 00:00:00,Sky Bahamas,Landing (descent or approach),Commercial,Bahamas,Central America,24,3,0,21,0,0,24,Human Factor
2013-06-19 00:00:00,Gergely Air,Takeoff (climb),Military / Government,Hungary,Europe,2,2,0,0,0,0,2,Human Factor
2013-06-19 00:00:00,Private German,Landing (descent or approach),Business,Germany,Europe,1,1,0,0,0,0,1,Technical Failure
2013-06-25 00:00:00,Tennair,Landing (descent or approach),Operational,United States of America,North America,1,1,0,0,0,0,1,Human Factor
2013-06-28 00:00:00,DOSAAF,Flight,Commercial,Russia,Asia,9,2,0,7,0,0,9,Technical Failure
2013-07-03 00:00:00,Government of Newfoundland and Labrador,Takeoff (climb),Humanitarian,Canada,North America,2,2,0,0,0,0,2,Human Factor
2013-07-05 00:00:00,Eseasa Construcciones,Landing (descent or approach),Business,United States of America,North America,6,2,0,4,0,0,6,Human Factor
2013-07-16 00:00:00,Southern Mapping,Flight,Operational,Malawi,Africa,2,1,0,1,0,0,2,Technical Failure
2013-07-19 00:00:00,My Flight Corp.,Landing (descent or approach),Commercial,Panama,Central America,8,1,0,7,0,0,8,Technical Failure
2013-07-21 00:00:00,Albatross Avia,Flight,Military / Government,Ukraine,Europe,2,2,0,0,0,0,2,Technical Failure
2013-07-22 00:00:00,Southwest Airlines,Landing (descent or approach),Commercial,United States of America,North America,150,5,0,145,0,0,150,Human Factor
2013-07-24 00:00:00,Promech Air,Flight,Commercial,United States of America,North America,4,1,0,3,0,0,4,Technical Failure
2013-07-28 00:00:00,Private Russian,Takeoff (climb),Specialised Services,Russia,Asia,1,1,0,0,0,0,1,Technical Failure
2013-07-30 00:00:00,African Medical Research Foundation,Takeoff (climb),Commercial,Tanzania,Africa,7,2,0,5,0,0,7,Unknown
2013-08-02 00:00:00,Milford Sound Scenic Flights,Flight,Operational,New Zealand,Oceania,2,2,0,0,0,0,2,Unknown
2013-08-09 00:00:00,Ukraine Air Alliance,Parking,Operational,Germany,Europe,7,7,0,0,0,0,7,Technical Failure
2013-08-12 00:00:00,Private British,Flight,Business,United Kingdom,Europe,2,1,0,1,0,0,2,Technical Failure
2013-08-16 00:00:00,Polyarnye Avialinii,Flight,Commercial,Russia,Asia,11,2,0,9,0,0,11,Technical Failure
2013-08-19 00:00:00,Buffalo Airways,Landing (descent or approach),Commercial,Canada,North America,24,3,0,21,0,0,24,Technical Failure
2013-08-20 00:00:00,Aerocon - Aero Comercial Oriente Norte,Landing (descent or approach),Commercial,Bolivia,South America,10,2,0,8,0,0,10,Technical Failure
2013-08-22 00:00:00,Government of the State of Chihuahua,Flight,Military / Government,Mexico,Central America,5,1,0,4,0,0,5,Human Factor
2013-08-22 00:00:00,Tanzanair - Tanzanian Air Services,Flight,Commercial,Tanzania,Africa,7,1,0,6,0,0,7,Technical Failure
2013-08-25 00:00:00,Transom Airways,Landing (descent or approach),Commercial,Somalia,Africa,50,5,0,45,0,0,50,Human Factor
2013-08-25 00:00:00,Pure Beauty Farms,Takeoff (climb),Business,Bahamas,Central America,5,1,0,4,0,0,5,Human Factor
2013-09-04 00:00:00,Sanborn Map Company,Takeoff (climb),Military / Government,United States of America,North America,2,1,0,1,0,0,2,Human Factor
2013-09-07 00:00:00,Europe Jet,Landing (descent or approach),Commercial,Russia,Asia,11,4,0,7,0,0,11,Technical Failure
2013-09-08 00:00:00,Thai Airways International,Landing (descent or approach),Commercial,Thailand,Asia,302,14,0,288,0,0,302,Technical Failure
2013-09-08 00:00:00,Machinery Parts Company,Landing (descent or approach),Business,United States of America,North America,1,1,0,0,0,0,1,Technical Failure
2013-09-13 00:00:00,Air Kasai,Landing (descent or approach),Commercial,Democratic Republic of Congo,Africa,6,1,0,5,0,0,6,Weather
2013-09-18 00:00:00,Taks-Avia,Flight,Commercial,Russia,Asia,7,2,0,5,0,0,7,Human Factor
2013-09-19 00:00:00,We Fly,Landing (descent or approach),Commercial,United States of America,North America,3,1,0,2,0,0,3,Human Factor
2013-10-06 00:00:00,Sputnik,Flight,Specialised Services,Russia,Asia,2,1,0,1,0,0,2,Technical Failure
2013-10-06 00:00:00,Nok mini,Taxiing,Commercial,Thailand,Asia,28,3,0,25,0,0,28,Technical Failure
2013-10-11 00:00:00,Tropical Air,Takeoff (climb),Commercial,Tanzania,Africa,3,2,0,1,0,0,3,Unknown
2013-10-19 00:00:00,Skyjet Airlines,Landing (descent or approach),Commercial,Philippines,Asia,75,7,0,68,0,0,75,Unknown
2013-10-19 00:00:00,Air Niugini Cargo,Takeoff (climb),Operational,Papua New Guinea,Oceania,3,3,0,0,0,0,3,Human Factor
2013-10-25 00:00:00,MiniLiner,Takeoff (climb),Operational,France,Europe,2,2,0,0,0,0,2,Technical Failure
2013-11-03 00:00:00,Channel Islands Air Search,Flight,Military / Government,United Kingdom,Europe,5,1,0,4,0,0,5,Human Factor
2013-11-30 00:00:00,Namibian Air Force,Landing (descent or approach),Military / Government,Namibia,Africa,6,6,0,0,0,0,6,Human Factor
2013-12-03 00:00:00,Frits G. H. Abbing,Takeoff (climb),Business,United States of America,North America,4,1,0,3,0,0,4,Human Factor
2013-12-04 00:00:00,Saudi Arabian Airlines - SAUDIA,Landing (descent or approach),Operational,Nigeria,Africa,6,6,0,0,0,0,6,Human Factor
2013-12-19 00:00:00,ATA Aerolineas - Aero Transportes Araucanía,Landing (descent or approach),Operational,Chile,South America,2,2,0,0,0,0,2,Technical Failure
2013-12-22 00:00:00,British Airways,Taxiing,Commercial,South Africa,Africa,202,17,0,185,0,0,202,Human Factor
2013-12-28 00:00:00,Aeroseed,Landing (descent or approach),Operational,Chile,South America,1,1,0,0,0,0,1,Human Factor
2014-01-05 00:00:00,Air India,Landing (descent or approach),Commercial,India,Asia,179,6,0,173,0,0,179,Human Factor
2014-01-06 00:00:00,Yankee Lima Finance,Takeoff (climb),Operational,Guyana,South America,2,1,0,1,0,0,2,Technical Failure
2014-01-18 00:00:00,Aeronaves TSM,Landing (descent or approach),Operational,Mexico,Central America,4,2,0,2,0,0,4,Human Factor
2014-01-20 00:00:00,Private Ukrainian,Landing (descent or approach),Operational,Ethiopia,Africa,2,2,0,0,0,0,2,Technical Failure
2014-01-22 00:00:00,Pskovavia,Landing (descent or approach),Commercial,Russia,Asia,28,4,0,24,0,0,28,Human Factor
2014-01-26 00:00:00,Pacific Air Express - Solomon Islands,Landing (descent or approach),Operational,Solomon Islands,Oceania,3,3,0,0,0,0,3,Technical Failure
2014-01-27 00:00:00,Axis Jet,Landing (descent or approach),Operational,United States of America,North America,2,2,0,0,0,0,2,Human Factor
2014-01-28 00:00:00,Etihad Regional,Landing (descent or approach),Commercial,France,Europe,19,3,0,16,0,0,19,Human Factor
2014-01-29 00:00:00,Private Australian,Takeoff (climb),Business,Australia,Oceania,2,1,0,1,0,0,2,Human Factor
2014-01-29 00:00:00,Air Greenland,Landing (descent or approach),Commercial,Greenland,Europe,15,3,0,12,0,0,15,Human Factor
2014-02-02 00:00:00,East Air,Landing (descent or approach),Commercial,Tajikistan,Asia,192,5,0,187,0,0,192,Other
2014-02-03 00:00:00,Brink Constructors,Landing (descent or approach),Business,United States of America,North America,7,1,0,6,0,0,7,Human Factor
2014-02-04 00:00:00,Aerospread,Landing (descent or approach),Military / Government,New Zealand,Oceania,2,1,0,1,0,0,2,Human Factor
2014-02-12 00:00:00,Sirius-Aero Aviakompania,Landing (descent or approach),Operational,Russia,Asia,2,2,0,0,0,0,2,Technical Failure
2014-02-15 00:00:00,Kelly Panteluk Construction,Landing (descent or approach),Business,Bahamas,Central America,0,0,0,0,0,0,0,Human Factor
2014-02-25 00:00:00,Guicango,Landing (descent or approach),Commercial,Angola,Africa,17,3,0,14,0,0,17,Technical Failure
2014-02-27 00:00:00,Affordable Casket Outlet,Landing (descent or approach),Business,United States of America,North America,1,1,0,0,0,0,1,Human Factor
2014-03-02 00:00:00,Yemeni Air Force,Flight,Military / Government,Yemen,Asia,19,8,0,11,0,0,19,Technical Failure
2014-03-03 00:00:00,Private Venezuelan,Flight,Humanitarian,Venezuela,South America,2,2,0,0,0,0,2,Human Factor
2014-03-09 00:00:00,Calm Air International,Landing (descent or approach),Commercial,Canada,North America,5,3,0,2,0,0,5,Technical Failure
2014-03-13 00:00:00,USAir - US Airways,Takeoff (climb),Commercial,United States of America,North America,154,5,0,149,0,0,154,Human Factor
2014-03-14 00:00:00,Mardon Inc.,Landing (descent or approach),Business,United States of America,North America,1,1,0,0,0,0,1,Human Factor
2014-03-15 00:00:00,Private American,Landing (descent or approach),Business,France,Europe,5,1,0,4,0,0,5,Human Factor
2014-03-27 00:00:00,Government of Haryana,Takeoff (climb),Military / Government,India,Asia,10,2,0,8,0,0,10,Human Factor
2014-03-28 00:00:00,Avianca Brasil,Landing (descent or approach),Commercial,Brazil,South America,49,5,0,44,0,0,49,Technical Failure
2014-04-09 00:00:00,Aeroflight Executive Services,Flight,Operational,United Kingdom,Europe,1,1,0,0,0,0,1,Technical Failure
2014-04-20 00:00:00,Bluebird Aviation,Landing (descent or approach),Operational,Somalia,Africa,2,2,0,0,0,0,2,Unknown
2014-04-27 00:00:00,Private Argentinian,Landing (descent or approach),Business,Argentina,South America,7,1,0,6,0,0,7,Technical Failure
2014-04-29 00:00:00,Air Contractors,Landing (descent or approach),Operational,United Kingdom,Europe,2,2,0,0,0,0,2,Technical Failure
2014-05-08 00:00:00,Ariana Afghan Airlines,Landing (descent or approach),Commercial,Afghanistan,Asia,132,10,0,122,0,0,132,Human Factor
2014-05-09 00:00:00,DOSAAF,Takeoff (climb),Business,Russia,Asia,9,2,0,7,0,0,9,Technical Failure
2014-05-10 00:00:00,IRS Airlines,Flight,Operational,Niger,Africa,2,2,0,0,0,0,2,Unknown
2014-05-10 00:00:00,Iran Aseman Airlines,Landing (descent or approach),Commercial,Iran,Asia,103,5,0,98,0,0,103,Technical Failure
2014-05-30 00:00:00,Total Linhas Aéreas,Takeoff (climb),Commercial,Brazil,South America,49,4,0,45,0,0,49,Other
2014-06-02 00:00:00,Policía Nacional de Colombia,Takeoff (climb),Military / Government,Colombia,South America,3,2,0,1,0,0,3,Technical Failure
2014-06-03 00:00:00,Aeroflot - Russian International Airlines,Parking,Other,Russia,Asia,0,0,0,0,0,0,0,Unknown
2014-06-08 00:00:00,Aeroklub Warmińsko-Mazurski,Landing (descent or approach),Humanitarian,Poland,Europe,2,2,0,0,0,0,2,Human Factor
2014-06-12 00:00:00,Jardine Lloyd Thompson,Flight,Business,Australia,Oceania,2,1,0,1,0,0,2,Technical Failure
2014-06-13 00:00:00,Planalto Indústria Mecânica,Landing (descent or approach),Business,Brazil,South America,7,2,0,5,0,0,7,Human Factor
2014-06-15 00:00:00,Minden Air,Landing (descent or approach),Humanitarian,United States of America,North America,2,2,0,0,0,0,2,Technical Failure
2014-06-25 00:00:00,Sudbury Aviation,Landing (descent or approach),Commercial,Canada,North America,3,1,0,2,0,0,3,Weather
2014-06-25 00:00:00,BECS LLC,Landing (descent or approach),Business,United States of America,North America,5,2,0,3,0,0,5,Human Factor
2014-06-26 00:00:00,Tango Two Aviation,Landing (descent or approach),Business,United States of America,North America,1,1,0,0,0,0,1,Technical Failure
2014-07-06 00:00:00,International Trans Air Business,Flight,Operational,Zambia,Africa,2,2,0,0,0,0,2,Technical Failure
2014-07-06 00:00:00,Domestic Airways,Landing (descent or approach),Commercial,Guyana,South America,2,1,0,1,0,0,2,Human Factor
2014-07-07 00:00:00,Sirius-Aero Aviakompania,Landing (descent or approach),Operational,Russia,Asia,3,3,0,0,0,0,3,Technical Failure
2014-07-11 00:00:00,0784238 BC,Takeoff (climb),Business,Canada,North America,4,1,0,3,0,0,4,Unknown
2014-07-19 00:00:00,Niugini Aviation Services,Landing (descent or approach),Commercial,Papua New Guinea,Oceania,7,1,0,6,0,0,7,Human Factor
2014-07-20 00:00:00,United Airways - Bangladesh,Landing (descent or approach),Commercial,Bangladesh,Asia,48,5,0,43,0,0,48,Technical Failure
2014-07-22 00:00:00,Italian Air Force - Aeronautica Militare Italiana,Landing (descent or approach),Military / Government,Afghanistan,Asia,4,4,0,0,0,0,4,Unknown
2014-07-28 00:00:00,Táxi Aéreo Ribeiro,Takeoff (climb),Commercial,Brazil,South America,4,2,0,2,0,0,4,Technical Failure
2014-08-01 00:00:00,ETS Aviation,Landing (descent or approach),Business,United States of America,North America,4,1,0,3,0,0,4,Human Factor
2014-08-06 00:00:00,Yug Line,Takeoff (climb),Military / Government,Russia,Asia,2,2,0,0,0,0,2,Technical Failure
2014-08-15 00:00:00,LinksAir,Landing (descent or approach),Commercial,United Kingdom,Europe,3,2,0,1,0,0,3,Technical Failure
2014-09-03 00:00:00,Philburto Aviation,Landing (descent or approach),Operational,United States of America,North America,2,2,0,0,0,0,2,Human Factor
2014-09-06 00:00:00,Skyward International Aviation,Landing (descent or approach),Commercial,Somalia,Africa,24,3,0,21,0,0,24,Technical Failure
2014-09-09 00:00:00,Air Loyauté,Landing (descent or approach),Humanitarian,New Caledonia,Oceania,4,2,0,2,0,0,4,Technical Failure
2014-09-20 00:00:00,Indian Air Force - Bharatiya Vayu Sena,Landing (descent or approach),Military / Government,India,Asia,9,4,0,5,0,0,9,Unknown
2014-09-24 00:00:00,2nd United Arkhangelsk Aviation Division,Takeoff (climb),Commercial,Russia,Asia,10,2,0,8,0,0,10,Weather
2014-09-25 00:00:00,Remote Area Medical,Landing (descent or approach),Business,United States of America,North America,1,1,0,0,0,0,1,Human Factor
2014-09-26 00:00:00,Air Creebec,Landing (descent or approach),Commercial,Canada,North America,9,2,0,7,0,0,9,Technical Failure
2014-10-05 00:00:00,TBM 850 536,Flight,Business,United States of America,North America,2,1,0,1,0,0,2,Human Factor
2014-10-10 00:00:00,Private Venezuelan,Takeoff (climb),Business,Venezuela,South America,7,2,0,5,0,0,7,Unknown
2014-10-12 00:00:00,Air Century,Landing (descent or approach),Commercial,Dominican Republic,Central America,13,3,0,10,0,0,13,Technical Failure
2014-10-24 00:00:00,FlyWet,Takeoff (climb),Operational,Mexico,Central America,2,2,0,0,0,0,2,Weather
2014-10-25 00:00:00,FAI rent-a-jet,Takeoff (climb),Humanitarian,Algeria,Africa,4,2,0,2,0,0,4,Unknown
2014-10-25 00:00:00,Mango Airlines,Landing (descent or approach),Operational,Democratic Republic of Congo,Africa,2,2,0,0,0,0,2,Technical Failure
2014-11-07 00:00:00,Ariana Afghan Airlines,Landing (descent or approach),Commercial,Afghanistan,Asia,0,0,0,0,0,0,0,Technical Failure
2014-11-14 00:00:00,Phoenix Aviation - New Zealand,Flight,Military / Government,New Zealand,Oceania,1,1,0,0,0,0,1,Unknown
2014-11-17 00:00:00,Heartland Air,Takeoff (climb),Business,United States of America,North America,3,2,0,1,0,0,3,Technical Failure
2014-11-20 00:00:00,Air Tindi,Flight,Commercial,Canada,North America,6,1,0,5,0,0,6,Weather
2014-11-21 00:00:00,JetSuite,Landing (descent or approach),Operational,United States of America,North America,2,2,0,0,0,0,2,Human Factor
2014-11-24 00:00:00,World Heir,Takeoff (climb),Business,United Kingdom,Europe,7,2,0,5,0,0,7,Human Factor
2014-11-27 00:00:00,Brazilian Air Force - Força Aérea Brasileira,Landing (descent or approach),Military / Government,Antarctica,Antarctica,0,0,0,0,0,0,0,Technical Failure
2014-12-03 00:00:00,American King Air,Landing (descent or approach),Operational,Saudi Arabia,Asia,2,2,0,0,0,0,2,Human Factor
2014-12-04 00:00:00,Tropic Air,Landing (descent or approach),Commercial,Belize,Central America,6,1,0,5,0,0,6,Unknown
2014-12-12 00:00:00,Burundaiavia,Landing (descent or approach),Operational,Central African Republic,Africa,7,3,0,4,0,0,7,Human Factor
2014-12-30 00:00:00,Shaheen Air,Landing (descent or approach),Commercial,Pakistan,Asia,172,6,0,166,0,0,172,Other
2015-01-02 00:00:00,FlyBe,Takeoff (climb),Commercial,United Kingdom,Europe,29,3,0,26,0,0,29,Weather
2015-01-03 00:00:00,Kazan Aircraft Production Association,Takeoff (climb),Operational,Russia,Asia,8,8,0,0,0,0,8,Human Factor
2015-01-04 00:00:00,Skyward Express,Landing (descent or approach),Operational,Kenya,Africa,10,4,0,6,0,0,10,Other
2015-01-07 00:00:00,Skydive Taupo,Flight,Humanitarian,New Zealand,Oceania,13,1,0,12,0,0,13,Technical Failure
2015-01-10 00:00:00,Ethiopian Airlines,Landing (descent or approach),Operational,Ghana,Africa,3,3,0,0,0,0,3,Unknown
2015-01-12 00:00:00,British Airways,Parking,Specialised Services,Germany,Europe,2,2,0,0,0,0,2,Unknown
2015-01-15 00:00:00,Private German,Landing (descent or approach),Business,Germany,Europe,5,1,0,4,0,0,5,Human Factor
2015-01-16 00:00:00,Chapi Air Travel,Landing (descent or approach),Commercial,Venezuela,South America,10,1,0,9,0,0,10,Unknown
2015-01-17 00:00:00,Challenger Aero Corporation Metro Manila,Takeoff (climb),Commercial,Philippines,Asia,16,2,0,14,0,0,16,Human Factor
2015-01-20 00:00:00,Xcel Aviation,Flight,Specialised Services,Afghanistan,Asia,2,2,0,0,0,0,2,Unknown
2015-02-02 00:00:00,Sky Express,Landing (descent or approach),Commercial,Greece,Europe,19,3,0,16,0,0,19,Human Factor
2015-02-08 00:00:00,Private Venezuelan,Landing (descent or approach),Business,Dominica,Central America,7,1,0,6,0,0,7,Unknown
2015-02-13 00:00:00,Volando Aviation,Takeoff (climb),Business,Sweden,Europe,3,1,0,2,0,0,3,Technical Failure
2015-02-14 00:00:00,Angola Air Force - Força Aérea Nacional Angolana,Landing (descent or approach),Military / Government,Angola,Africa,50,3,0,47,0,0,50,Technical Failure
2015-02-14 00:00:00,Mozambique Air Force - Força Aérea de Moçambique,Takeoff (climb),Military / Government,Mozambique,Africa,6,6,0,0,0,0,6,Technical Failure
2015-03-01 00:00:00,Six Hundred NP,Landing (descent or approach),Business,United States of America,North America,9,3,0,6,0,0,9,Technical Failure
2015-03-04 00:00:00,Deraya Air Taxi,Landing (descent or approach),Operational,Indonesia,Asia,2,2,0,0,0,0,2,Unknown
2015-03-04 00:00:00,Turkish Airlines - THY Türk Hava Yollari,Landing (descent or approach),Commercial,Nepal,Asia,235,11,0,224,0,0,235,Human Factor
2015-03-05 00:00:00,Icar Air,Landing (descent or approach),Operational,Italy,Europe,3,3,0,0,0,0,3,Technical Failure
2015-03-05 00:00:00,Delta Airlines,Landing (descent or approach),Commercial,United States of America,North America,130,5,0,125,0,0,130,Human Factor
2015-03-08 00:00:00,SpiceJet,Landing (descent or approach),Commercial,India,Asia,82,4,0,78,0,0,82,Human Factor
2015-03-08 00:00:00,Torres Strait Air,Takeoff (climb),Commercial,Australia,Oceania,6,1,0,5,0,0,6,Technical Failure
2015-03-12 00:00:00,Pool Aviation,Landing (descent or approach),Commercial,United Kingdom,Europe,4,2,0,2,0,0,4,Technical Failure
2015-03-24 00:00:00,Private American,Flight,Specialised Services,United States of America,North America,2,1,0,1,0,0,2,Technical Failure
2015-03-29 00:00:00,Air Canada,Landing (descent or approach),Commercial,Canada,North America,138,5,0,133,0,0,138,Human Factor
2015-04-03 00:00:00,FMBZ A. I. Burnazyan,Landing (descent or approach),Commercial,Russia,Asia,17,7,0,10,0,0,17,Human Factor
2015-04-14 00:00:00,Asiana Airlines,Landing (descent or approach),Commercial,Japan,Asia,82,8,0,74,0,0,82,Human Factor
2015-04-24 00:00:00,Servicios Aéreos Corporativos,Landing (descent or approach),Business,Mexico,Central America,6,1,0,5,0,0,6,Human Factor
2015-04-25 00:00:00,Servicio Autónomo de Transporte Aéreo - SATA,Landing (descent or approach),Commercial,Venezuela,South America,5,2,0,3,0,0,5,Technical Failure
2015-04-25 00:00:00,Turkish Airlines - THY Türk Hava Yollari,Landing (descent or approach),Commercial,Turkey,Asia,97,6,0,91,0,0,97,Other
2015-04-28 00:00:00,Japan Maritime Self-Defense Force - Kaijō Jieitai,Flight,Operational,Japan,Asia,19,19,0,0,0,0,19,Unknown
2015-05-10 00:00:00,DOSAAF,Takeoff (climb),Humanitarian,Russia,Asia,13,1,0,12,0,0,13,Technical Failure
2015-05-10 00:00:00,Joy Air,Landing (descent or approach),Commercial,China,Asia,52,7,0,45,0,0,52,Technical Failure
2015-05-18 00:00:00,S. V. Etapin,Flight,Business,Russia,Asia,1,1,0,0,0,0,1,Technical Failure
2015-05-19 00:00:00,Airworks,Landing (descent or approach),Commercial,South Sudan,Africa,0,0,0,0,0,0,0,Unknown
2015-05-21 00:00:00,Constructora Maíz Mier,Takeoff (climb),Business,Mexico,Central America,5,1,0,4,0,0,5,Unknown
2015-05-24 00:00:00,Mato Grosso do Sul Taxi Aéreo,Flight,Commercial,Brazil,South America,9,2,0,7,0,0,9,Technical Failure
2015-05-30 00:00:00,Inversiones PTT,Landing (descent or approach),Business,Venezuela,South America,4,1,0,3,0,0,4,Unknown
2015-06-08 00:00:00,Swat Technology,Landing (descent or approach),Business,Nigeria,Africa,5,3,0,2,0,0,5,Human Factor
2015-06-15 00:00:00,Vodoley,Flight,Military / Government,Russia,Asia,2,1,0,1,0,0,2,Technical Failure
2015-06-16 00:00:00,SCAT Airlines,Parking,Commercial,Kazakhstan,Asia,0,0,0,0,0,0,0,Technical Failure
2015-06-19 00:00:00,Vostok Aviakompania - East Air,Flight,Military / Government,Russia,Asia,4,4,0,0,0,0,4,Technical Failure
2015-06-25 00:00:00,Republic of Korea Air Force,Flight,Operational,South Korea,Asia,4,4,0,0,0,0,4,Technical Failure
2015-06-30 00:00:00,Ameriflight,Takeoff (climb),Operational,United States of America,North America,2,2,0,0,0,0,2,Unknown
2015-07-02 00:00:00,Trans Maldivian Airways,Landing (descent or approach),Commercial,Maldives,Asia,14,3,0,11,0,0,14,Human Factor
2015-07-06 00:00:00,Viridian,Takeoff (climb),Operational,Russia,Asia,2,2,0,0,0,0,2,Technical Failure
2015-07-07 00:00:00,Skydive Dubai,Takeoff (climb),Humanitarian,United Arab Emirates,Asia,15,1,0,14,0,0,15,Technical Failure
2015-07-17 00:00:00,Hellenic Air Force - Elleniki Polemiki Aeroporia,Flight,Humanitarian,Greece,Europe,2,2,0,0,0,0,2,Technical Failure
2015-07-19 00:00:00,Private Venezuelan,Landing (descent or approach),Operational,Panama,Central America,2,2,0,0,0,0,2,Unknown
2015-07-22 00:00:00,DLM Holding Group,Landing (descent or approach),Business,United States of America,North America,5,1,0,4,0,0,5,Human Factor
2015-07-24 00:00:00,Air Bagan,Landing (descent or approach),Commercial,Myanmar,Asia,54,5,0,49,0,0,54,Human Factor
2015-07-27 00:00:00,Brazilian Air Force - Força Aérea Brasileira,Takeoff (climb),Operational,Brazil,South America,3,3,0,0,0,0,3,Human Factor
2015-07-31 00:00:00,RusLine,Landing (descent or approach),Commercial,Russia,Asia,31,3,0,28,0,0,31,Technical Failure
2015-08-01 00:00:00,Absher Air,Landing (descent or approach),Business,United States of America,North America,4,1,0,3,0,0,4,Unknown
2015-08-09 00:00:00,James L. Bostwick,Landing (descent or approach),Business,United States of America,North America,1,1,0,0,0,0,1,Human Factor
2015-08-12 00:00:00,Federal Express - FedEx,Flight,Operational,Netherlands,Central America,1,1,0,0,0,0,1,Technical Failure
2015-08-16 00:00:00,Maritime Air Charter,Landing (descent or approach),Commercial,Canada,North America,4,2,0,2,0,0,4,Human Factor
2015-08-21 00:00:00,UF Equipment,Landing (descent or approach),Business,United States of America,North America,3,1,0,2,0,0,3,Human Factor
2015-08-26 00:00:00,Private Venezuelan,Landing (descent or approach),Commercial,Venezuela,South America,8,2,0,6,0,0,8,Human Factor
2015-08-27 00:00:00,Private Mexican,Landing (descent or approach),Operational,Mexico,Central America,2,2,0,0,0,0,2,Unknown
2015-08-28 00:00:00,Cardig Air,Landing (descent or approach),Operational,Indonesia,Asia,2,2,0,0,0,0,2,Human Factor
2015-08-28 00:00:00,Chopaire,Landing (descent or approach),Business,United States of America,North America,1,1,0,0,0,0,1,Technical Failure
2015-08-29 00:00:00,Private Hungarian,Takeoff (climb),Humanitarian,Italy,Europe,11,1,0,10,0,0,11,Technical Failure
2015-08-31 00:00:00,Private German,Takeoff (climb),Business,France,Europe,2,1,0,1,0,0,2,Human Factor
2015-09-03 00:00:00,Jet24,Landing (descent or approach),Commercial,Austria,Europe,5,2,0,3,0,0,5,Technical Failure
2015-09-06 00:00:00,Rampart Aviation,Landing (descent or approach),Military / Government,United States of America,North America,3,2,0,1,0,0,3,Technical Failure
2015-09-15 00:00:00,Keystone Air Service,Takeoff (climb),Commercial,Canada,North America,8,2,0,6,0,0,8,Human Factor
2015-09-16 00:00:00,Yenisei Aviation Enterprise,Flight,Operational,Russia,Asia,3,2,0,1,0,0,3,Technical Failure
2015-09-21 00:00:00,James R. Metzger,Landing (descent or approach),Business,United States of America,North America,1,1,0,0,0,0,1,Human Factor
2015-09-25 00:00:00,Yulgilbar Pastoral Company,Takeoff (climb),Operational,Australia,Oceania,2,2,0,0,0,0,2,Human Factor
2015-09-25 00:00:00,Buffalo Airways,Landing (descent or approach),Operational,Canada,North America,4,4,0,0,0,0,4,Technical Failure
2015-09-30 00:00:00,Luxair,Takeoff (climb),Commercial,Germany,Europe,20,4,0,16,0,0,20,Human Factor
2015-10-02 00:00:00,Skydive Dubai,Landing (descent or approach),Humanitarian,United Arab Emirates,Asia,1,1,0,0,0,0,1,Unknown
2015-10-06 00:00:00,Starbow,Landing (descent or approach),Commercial,Ghana,Africa,76,5,0,71,0,0,76,Unknown
2015-10-12 00:00:00,Tristar Air,Landing (descent or approach),Operational,Somalia,Africa,6,6,0,0,0,0,6,Human Factor
2015-10-15 00:00:00,Paul R. Boak,Landing (descent or approach),Business,United States of America,North America,1,1,0,0,0,0,1,Human Factor
2015-10-19 00:00:00,Top Air,Takeoff (climb),Operational,Argentina,South America,2,2,0,0,0,0,2,Technical Failure
2015-10-23 00:00:00,Peruvian Airlines,Landing (descent or approach),Commercial,Peru,South America,139,6,0,133,0,0,139,Human Factor
2015-10-26 00:00:00,Spohrer %26 Dodd Aviation,Landing (descent or approach),Business,United States of America,North America,3,1,0,2,0,0,3,Human Factor
2015-10-26 00:00:00,Comair - South Africa,Landing (descent or approach),Commercial,South Africa,Africa,100,6,0,94,0,0,100,Human Factor
2015-10-29 00:00:00,Dynamic International Airways,Taxiing,Commercial,United States of America,North America,101,11,0,90,0,0,101,Technical Failure
2015-11-01 00:00:00,Malu Aviation,Landing (descent or approach),Commercial,Democratic Republic of Congo,Africa,26,4,0,22,0,0,26,Technical Failure
2015-11-02 00:00:00,Senegalese Air Force - Armée de l'Air Sénégalaise,Flight,Military / Government,Mali,Africa,10,3,0,7,0,0,10,Technical Failure
2015-11-03 00:00:00,Shaheen Air,Landing (descent or approach),Commercial,Pakistan,Asia,121,7,0,114,0,0,121,Human Factor
2015-11-10 00:00:00,Westwind Aviation,Takeoff (climb),Humanitarian,South Sudan,Africa,4,4,0,0,0,0,4,Unknown
2015-11-16 00:00:00,Servicios Aéreos Estrella,Landing (descent or approach),Operational,Mexico,Central America,2,2,0,0,0,0,2,Human Factor
2015-11-21 00:00:00,Three T’s Auto Sale,Takeoff (climb),Operational,Guatemala,Central America,2,2,0,0,0,0,2,Human Factor
2015-11-22 00:00:00,Avia Traffic Company,Landing (descent or approach),Commercial,Kyrgyzstan,Asia,154,6,0,148,0,0,154,Human Factor
2015-11-26 00:00:00,Magnicharters,Landing (descent or approach),Commercial,Mexico,Central America,144,5,0,139,0,0,144,Human Factor
2015-12-03 00:00:00,Private American,Takeoff (climb),Business,United States of America,North America,2,1,0,1,0,0,2,Weather
2015-12-04 00:00:00,SpiceJet,Landing (descent or approach),Commercial,India,Asia,53,4,0,49,0,0,53,Other
2015-12-04 00:00:00,Washington Corporation Leasing,Landing (descent or approach),Operational,United States of America,North America,2,2,0,0,0,0,2,Technical Failure
2015-12-08 00:00:00,Private German,Landing (descent or approach),Business,Germany,Europe,5,1,0,4,0,0,5,Human Factor
2015-12-15 00:00:00,Southwest Airlines,Taxiing,Commercial,United States of America,North America,138,5,0,133,0,0,138,Human Factor
2015-12-21 00:00:00,KalStar Aviation,Landing (descent or approach),Commercial,Indonesia,Asia,125,5,0,120,0,0,125,Human Factor
2015-12-23 00:00:00,Aerolíneas Ejecutivas,Landing (descent or approach),Commercial,United States of America,North America,7,2,0,5,0,0,7,Human Factor
2015-12-24 00:00:00,Serve Air,Landing (descent or approach),Operational,Democratic Republic of Congo,Africa,5,5,0,0,0,0,5,Unknown
2015-12-24 00:00:00,North Mississippi Pulmonology Clinic,Takeoff (climb),Business,United States of America,North America,4,1,0,3,0,0,4,Human Factor
2015-12-28 00:00:00,Private Venezuelan,Flight,Business,Venezuela,South America,3,1,0,2,0,0,3,Technical Failure
2016-01-02 00:00:00,Wright Air Service,Flight,Commercial,United States of America,North America,8,1,0,7,0,0,8,Human Factor
2016-01-06 00:00:00,PlaneSense,Takeoff (climb),Operational,United States of America,North America,2,2,0,0,0,0,2,Human Factor
2016-01-19 00:00:00,No Boundaries Aviation,Flight,Operational,United States of America,North America,2,2,0,0,0,0,2,Weather
2016-01-28 00:00:00,Zagros Airlines,Landing (descent or approach),Commercial,Iran,Asia,162,8,0,154,0,0,162,Human Factor
2016-01-28 00:00:00,Hamilton Island Air,Landing (descent or approach),Commercial,Australia,Oceania,11,1,0,10,0,0,11,Human Factor
2016-01-30 00:00:00,Private American,Landing (descent or approach),Humanitarian,Mexico,Central America,0,0,0,0,0,0,0,Human Factor
2016-02-16 00:00:00,Agropecuária Jogil,Flight,Business,Brazil,South America,3,1,0,2,0,0,3,Unknown
2016-02-26 00:00:00,Royal Malaysian Air Force - Tentera Udara Diraja Malaysia,Flight,Operational,Malaysia,Asia,8,8,0,0,0,0,8,Technical Failure
2016-03-03 00:00:00,South African Air Force,Flight,Operational,South Africa,Africa,2,2,0,0,0,0,2,Unknown
2016-03-05 00:00:00,United States Army,Flight,Military / Government,Iraq,Asia,4,2,0,2,0,0,4,Technical Failure
2016-03-14 00:00:00,Flight Options,Landing (descent or approach),Operational,United States of America,North America,2,2,0,0,0,0,2,Human Factor
2016-03-18 00:00:00,Ciro Nogueira Comercio de Motocicletas,Landing (descent or approach),Business,Brazil,South America,8,1,0,7,0,0,8,Human Factor
2016-03-18 00:00:00,Aircraft Sales %26 Services Ltd,Takeoff (climb),Commercial,Pakistan,Asia,21,3,0,18,0,0,21,Technical Failure
2016-03-27 00:00:00,Bek Air,Landing (descent or approach),Commercial,Kazakhstan,Asia,121,5,0,116,0,0,121,Technical Failure
2016-03-29 00:00:00,Russian Air Force - Voyenno-vozdushnye sily Rossii,Takeoff (climb),Military / Government,Russia,Asia,0,0,0,0,0,0,0,Technical Failure
2016-04-01 00:00:00,Private Dominican,Flight,Business,Venezuela,South America,0,0,0,0,0,0,0,Unknown
2016-04-03 00:00:00,Private Isreali,Takeoff (climb),Business,Israel,Asia,2,1,0,1,0,0,2,Technical Failure
2016-04-03 00:00:00,Technoservis-A,Takeoff (climb),Military / Government,Russia,Asia,1,1,0,0,0,0,1,Human Factor
2016-04-04 00:00:00,TransNusa Aviation Mandiri,Taxiing,Other,Indonesia,Asia,2,2,0,0,0,0,2,Human Factor
2016-04-06 00:00:00,Arall Colombia - Aerolineas Llaneras,Takeoff (climb),Operational,Colombia,South America,3,3,0,0,0,0,3,Technical Failure
2016-04-09 00:00:00,Skydive San Marcos,Landing (descent or approach),Humanitarian,United States of America,North America,2,2,0,0,0,0,2,Human Factor
2016-04-20 00:00:00,Air Canada Express,Landing (descent or approach),Commercial,Canada,North America,16,2,0,14,0,0,16,Human Factor
2016-04-21 00:00:00,Agropecuária Otura,Landing (descent or approach),Business,Brazil,South America,10,1,0,9,0,0,10,Human Factor
2016-04-24 00:00:00,Flightline - Spain,Landing (descent or approach),Operational,Spain,Europe,2,2,0,0,0,0,2,Human Factor
2016-04-26 00:00:00,Medelair,Landing (descent or approach),Business,Spain,Europe,5,1,0,4,0,0,5,Technical Failure
2016-04-26 00:00:00,Russell N. Smith,Takeoff (climb),Business,United States of America,North America,1,1,0,0,0,0,1,Human Factor
2016-04-28 00:00:00,Transportes Aéreos Mercantiles Ecuatorianos - TAME,Landing (descent or approach),Commercial,Ecuador,South America,93,6,0,87,0,0,93,Human Factor
2016-04-30 00:00:00,Air Vallée,Landing (descent or approach),Commercial,Italy,Europe,21,3,0,18,0,0,21,Technical Failure
2016-05-05 00:00:00,Conair Aviation,Landing (descent or approach),Humanitarian,Canada,North America,2,2,0,0,0,0,2,Unknown
2016-05-06 00:00:00,American Airpower Heritage Museum,Landing (descent or approach),Operational,United States of America,North America,2,1,0,1,0,0,2,Technical Failure
2016-05-10 00:00:00,Rennie Equipment,Takeoff (climb),Business,Canada,North America,3,1,0,2,0,0,3,Technical Failure
2016-05-12 00:00:00,Flanagan Enterprises - USA,Takeoff (climb),Humanitarian,United States of America,North America,18,1,0,17,0,0,18,Technical Failure
2016-05-19 00:00:00,United States Air Force - USAF,Takeoff (climb),Military / Government,Guam Island,Asia,7,7,0,0,0,0,7,Other
2016-05-31 00:00:00,Ecom Systems,Flight,Business,Canada,North America,6,1,0,5,0,0,6,Technical Failure
2016-05-31 00:00:00,Piaggio Aerospace,Flight,Specialised Services,Italy,Europe,0,0,0,0,0,0,0,Technical Failure
2016-06-03 00:00:00,Lady Lori Ltd,Takeoff (climb),Commercial,South Sudan,Africa,5,1,0,4,0,0,5,Human Factor
2016-06-06 00:00:00,Red Wing Aeroplane Company,Landing (descent or approach),Business,United States of America,North America,3,2,0,1,0,0,3,Unknown
2016-06-06 00:00:00,United Parcel Service - UPS,Takeoff (climb),Operational,South Korea,Asia,4,4,0,0,0,0,4,Technical Failure
2016-06-14 00:00:00,Associated Mission Aviation - AMA,Landing (descent or approach),Operational,Indonesia,Asia,3,1,0,2,0,0,3,Unknown
2016-06-14 00:00:00,Coco Aviation,Landing (descent or approach),Humanitarian,South Sudan,Africa,3,3,0,0,0,0,3,Unknown
2016-06-17 00:00:00,Renfro's Alaskan Adventures,Flight,Operational,United States of America,North America,1,1,0,0,0,0,1,Human Factor
2016-06-19 00:00:00,Mahan Air,Landing (descent or approach),Commercial,Iran,Asia,89,10,0,79,0,0,89,Human Factor
2016-06-20 00:00:00,Ponderosa Air,Landing (descent or approach),Operational,United States of America,North America,2,2,0,0,0,0,2,Human Factor
2016-06-26 00:00:00,Hellenic Air Force - Elleniki Polemiki Aeroporia,Flight,Humanitarian,Greece,Europe,2,2,0,0,0,0,2,Technical Failure
2016-07-17 00:00:00,Air Nunavut,Landing (descent or approach),Operational,Canada,North America,2,2,0,0,0,0,2,Human Factor
2016-07-26 00:00:00,Flexjet,Landing (descent or approach),Commercial,United States of America,North America,3,2,0,1,0,0,3,Human Factor
2016-08-03 00:00:00,Emirates,Landing (descent or approach),Commercial,United Arab Emirates,Asia,300,18,0,282,0,0,300,Human Factor
2016-08-05 00:00:00,ASL Airlines,Landing (descent or approach),Operational,Italy,Europe,2,2,0,0,0,0,2,Human Factor
2016-08-08 00:00:00,Rapids Camp Lodge,Takeoff (climb),Commercial,United States of America,North America,7,1,0,6,0,0,7,Human Factor
2016-09-01 00:00:00,Private Paraguayan,Flight,Business,Paraguay,South America,2,1,0,1,0,0,2,Unknown
2016-09-10 00:00:00,Joaquin Hurricane,Landing (descent or approach),Business,United States of America,North America,1,1,0,0,0,0,1,Human Factor
2016-09-13 00:00:00,Trigana Air Service,Landing (descent or approach),Operational,Indonesia,Asia,3,3,0,0,0,0,3,Human Factor
2016-09-21 00:00:00,OIA Enterprises,Landing (descent or approach),Operational,United States of America,North America,1,1,0,0,0,0,1,Human Factor
2016-09-24 00:00:00,Yeti Airlines,Landing (descent or approach),Commercial,Nepal,Asia,32,3,0,29,0,0,32,Unknown
2016-09-25 00:00:00,Nusantara Air Charter,Landing (descent or approach),Humanitarian,Indonesia,Asia,8,3,0,5,0,0,8,Unknown
2016-09-28 00:00:00,King Air Charter,Landing (descent or approach),Commercial,Democratic Republic of Congo,Africa,10,2,0,8,0,0,10,Technical Failure
2016-09-30 00:00:00,Kenmore Air,Landing (descent or approach),Commercial,United States of America,North America,4,1,0,3,0,0,4,Human Factor
2016-10-11 00:00:00,Polyarnye Avialinii,Landing (descent or approach),Commercial,Russia,Asia,33,6,0,27,0,0,33,Human Factor
2016-10-15 00:00:00,Sterna Aviation,Landing (descent or approach),Business,United Kingdom,Europe,2,1,0,1,0,0,2,Human Factor
2016-10-17 00:00:00,Private American,Landing (descent or approach),Business,Germany,Europe,1,1,0,0,0,0,1,Human Factor
2016-10-20 00:00:00,Ian McMahon,Flight,Business,United States of America,North America,1,1,0,0,0,0,1,Human Factor
2016-10-21 00:00:00,Sterna Linhas Aéreas,Landing (descent or approach),Operational,Brazil,South America,4,3,0,1,0,0,4,Human Factor
2016-10-23 00:00:00,Bob McCully,Landing (descent or approach),Business,United States of America,North America,1,1,0,0,0,0,1,Human Factor
2016-10-24 00:00:00,FlyMex,Landing (descent or approach),Operational,Mexico,Central America,4,4,0,0,0,0,4,Other
2016-10-24 00:00:00,Ethiopian Airlines,Takeoff (climb),Commercial,Ethiopia,Africa,80,6,0,74,0,0,80,Other
2016-10-28 00:00:00,Policía Nacional de Colombia,Landing (descent or approach),Military / Government,Colombia,South America,11,3,0,8,0,0,11,Unknown
2016-10-28 00:00:00,Federal Express - FedEx,Landing (descent or approach),Operational,United States of America,North America,2,2,0,0,0,0,2,Technical Failure
2016-10-28 00:00:00,American Airlines,Takeoff (climb),Commercial,United States of America,North America,170,9,0,161,0,0,170,Unknown
2016-10-30 00:00:00,Honaker Aviation,Takeoff (climb),Business,United States of America,North America,10,2,0,8,0,0,10,Human Factor
2016-11-23 00:00:00,Flight Development,Landing (descent or approach),Commercial,United States of America,North America,7,1,0,6,0,0,7,Human Factor
2016-11-27 00:00:00,Indonesian Navy - TNI-AL Tentara Nasional Indonesia - Angkatan Laut,Landing (descent or approach),Military / Government,Indonesia,Asia,14,5,0,9,0,0,14,Unknown
2016-11-29 00:00:00,Private American,Landing (descent or approach),Humanitarian,Mexico,Central America,3,1,0,2,0,0,3,Human Factor
2016-12-04 00:00:00,Yatish Air,Landing (descent or approach),Business,United States of America,North America,1,1,0,0,0,0,1,Human Factor
2016-12-10 00:00:00,Safi Airways,Landing (descent or approach),Commercial,Afghanistan,Asia,173,9,0,164,0,0,173,Human Factor
2016-12-12 00:00:00,Grondair Aviation,Takeoff (climb),Operational,Canada,North America,2,2,0,0,0,0,2,Unknown
2016-12-13 00:00:00,Falco Joco Trading,Landing (descent or approach),Business,South Africa,Africa,3,1,0,2,0,0,3,Technical Failure
2016-12-13 00:00:00,Royal Flying Doctor Service - RFDS,Landing (descent or approach),Humanitarian,Australia,Oceania,3,1,0,2,0,0,3,Human Factor
2016-12-19 00:00:00,Russian Air Force - Voyenno-vozdushnye sily Rossii,Landing (descent or approach),Military / Government,Russia,Asia,38,7,0,31,0,0,38,Human Factor
2016-12-25 00:00:00,Wings Air,Landing (descent or approach),Commercial,Indonesia,Asia,72,4,0,68,0,0,72,Human Factor
2016-12-29 00:00:00,Cambusmoon,Landing (descent or approach),Business,United States of America,North America,3,1,0,2,0,0,3,Weather
2017-01-02 00:00:00,Doren Air Congo,Landing (descent or approach),Operational,Democratic Republic of Congo,Africa,2,2,0,0,0,0,2,Technical Failure
2017-01-02 00:00:00,Air Excel,Takeoff (climb),Commercial,Tanzania,Africa,6,1,0,5,0,0,6,Unknown
2017-01-16 00:00:00,Zeliff Aviation,Landing (descent or approach),Business,United States of America,North America,1,1,0,0,0,0,1,Human Factor
2017-01-27 00:00:00,Eastern Air Express,Landing (descent or approach),Operational,United States of America,North America,2,2,0,0,0,0,2,Human Factor
2017-02-09 00:00:00,Líder Taxi Aéreo,Landing (descent or approach),Commercial,Brazil,South America,3,2,0,1,0,0,3,Technical Failure
2017-02-11 00:00:00,Tropical Transport Services,Landing (descent or approach),Commercial,British Virgin Islands,Central America,9,1,0,8,0,0,9,Technical Failure
2017-02-14 00:00:00,Grant Aviation,Landing (descent or approach),Commercial,United States of America,North America,3,2,0,1,0,0,3,Human Factor
2017-02-14 00:00:00,EagleMed,Flight,Humanitarian,United States of America,North America,3,1,0,2,0,0,3,Human Factor
2017-02-15 00:00:00,Private American,Landing (descent or approach),Business,Mexico,Central America,5,1,0,4,0,0,5,Technical Failure
2017-02-27 00:00:00,4197802 Manitoba,Takeoff (climb),Business,United States of America,North America,1,1,0,0,0,0,1,Human Factor
2017-03-03 00:00:00,Point to Point,Landing (descent or approach),Business,United States of America,North America,2,2,0,0,0,0,2,Technical Failure
2017-03-08 00:00:00,Ameristar Jet Charter,Takeoff (climb),Commercial,United States of America,North America,116,6,0,110,0,0,116,Technical Failure
2017-03-08 00:00:00,Tomcat Air,Landing (descent or approach),Business,Bahamas,Central America,1,1,0,0,0,0,1,Human Factor
2017-03-20 00:00:00,South Supreme Airlines,Landing (descent or approach),Commercial,South Sudan,Africa,45,5,0,40,0,0,45,Human Factor
2017-03-28 00:00:00,Peruvian Airlines,Landing (descent or approach),Commercial,Peru,South America,149,7,0,142,0,0,149,Technical Failure
2017-03-29 00:00:00,Alas de Socorro del Ecuador,Takeoff (climb),Commercial,Ecuador,South America,7,1,0,6,0,0,7,Unknown
2017-03-30 00:00:00,Transmandu - Transportes Aéreos Manduca,Flight,Other,Venezuela,South America,0,0,0,0,0,0,0,Unknown
2017-04-01 00:00:00,Eagle Air - Uganda,Takeoff (climb),Commercial,South Sudan,Africa,20,3,0,17,0,0,20,Technical Failure
2017-04-09 00:00:00,GAME S.A.,Flight,Operational,Colombia,South America,1,1,0,0,0,0,1,Human Factor
2017-04-22 00:00:00,GSL Aviation - Australia,Landing (descent or approach),Humanitarian,Australia,Oceania,3,2,0,1,0,0,3,Technical Failure
2017-05-20 00:00:00,Homovolants,Landing (descent or approach),Humanitarian,Italy,Europe,1,1,0,0,0,0,1,Unknown
2017-05-24 00:00:00,Perris Valley Aviation,Landing (descent or approach),Humanitarian,United States of America,North America,2,2,0,0,0,0,2,Human Factor
2017-05-26 00:00:00,SkyCare Air Ambulance,Landing (descent or approach),Humanitarian,Canada,North America,3,2,0,1,0,0,3,Human Factor
2017-05-30 00:00:00,Heidi Aviation,Landing (descent or approach),Operational,Somalia,Africa,4,4,0,0,0,0,4,Unknown
2017-05-31 00:00:00,Policía Federal Argentina,Flight,Operational,Argentina,South America,3,2,0,1,0,0,3,Technical Failure
2017-05-31 00:00:00,Sriwijaya Air,Landing (descent or approach),Commercial,Indonesia,Asia,152,6,0,146,0,0,152,Unknown
2017-06-02 00:00:00,Aeronaves TSM,Landing (descent or approach),Operational,Mexico,Central America,2,2,0,0,0,0,2,Human Factor
2017-06-03 00:00:00,Safari Express Cargo,Landing (descent or approach),Humanitarian,Somalia,Africa,4,4,0,0,0,0,4,Human Factor
2017-06-11 00:00:00,AerCaribe Colombia,Landing (descent or approach),Commercial,Colombia,South America,45,5,0,40,0,0,45,Human Factor
2017-06-14 00:00:00,Malian Aéro Company,Landing (descent or approach),Other,Mali,Africa,1,1,0,0,0,0,1,Unknown
2017-06-26 00:00:00,Penobscot Island Air,Landing (descent or approach),Operational,United States of America,North America,1,1,0,0,0,0,1,Human Factor
2017-06-27 00:00:00,Kharkiv Aeroklub,Flight,Military / Government,Ukraine,Europe,2,2,0,0,0,0,2,Human Factor
2017-07-03 00:00:00,Alaska Air Taxi,Flight,Business,United States of America,North America,1,1,0,0,0,0,1,Human Factor
2017-07-18 00:00:00,Tri-MG Intra Asia Airlines,Landing (descent or approach),Operational,Indonesia,Asia,5,5,0,0,0,0,5,Unknown
2017-07-29 00:00:00,Cavok Air,Takeoff (climb),Operational,São Tomé and Principe,Africa,6,6,0,0,0,0,6,Human Factor
2017-08-03 00:00:00,Wings Air,Taxiing,Commercial,Indonesia,Asia,72,5,0,67,0,0,72,Human Factor
2017-08-19 00:00:00,Kurt Heitmeier,Takeoff (climb),Business,United States of America,North America,1,1,0,0,0,0,1,Human Factor
2017-08-26 00:00:00,Feniks,Flight,Military / Government,Russia,Asia,2,2,0,0,0,0,2,Technical Failure
2017-08-28 00:00:00,Coco Aviation,Landing (descent or approach),Humanitarian,South Sudan,Africa,0,0,0,0,0,0,0,Unknown
2017-09-10 00:00:00,Serve Air,Landing (descent or approach),Operational,Democratic Republic of Congo,Africa,4,4,0,0,0,0,4,Technical Failure
2017-09-13 00:00:00,Theresa Madeline,Takeoff (climb),Business,United States of America,North America,1,1,0,0,0,0,1,Technical Failure
2017-09-21 00:00:00,Avione Jet,Landing (descent or approach),Commercial,Turkey,Asia,4,3,0,1,0,0,4,Technical Failure
2017-09-26 00:00:00,Private Dominican,Landing (descent or approach),Business,Venezuela,South America,1,1,0,0,0,0,1,Unknown
2017-10-18 00:00:00,Noble Air Charter,Landing (descent or approach),Commercial,United States of America,North America,2,1,0,1,0,0,2,Human Factor
2017-10-19 00:00:00,Air Majoro,Flight,Commercial,Peru,South America,13,2,0,11,0,0,13,Human Factor
2017-10-25 00:00:00,Coastal Aviation,Landing (descent or approach),Commercial,Tanzania,Africa,11,1,0,10,0,0,11,Unknown
2017-11-02 00:00:00,Perimeter Aviation,Landing (descent or approach),Operational,Canada,North America,2,2,0,0,0,0,2,Technical Failure
2017-11-05 00:00:00,Oso Rio,Landing (descent or approach),Business,United States of America,North America,2,1,0,1,0,0,2,Human Factor
2017-11-10 00:00:00,Mid-Continent Aviation Services,Takeoff (climb),Business,Brazil,South America,4,1,0,3,0,0,4,Human Factor
2017-11-17 00:00:00,Tropic Air,Takeoff (climb),Commercial,Belize,Central America,11,1,0,10,0,0,11,Human Factor
2017-11-22 00:00:00,Fresh Air,Takeoff (climb),Humanitarian,United States of America,North America,4,1,0,3,0,0,4,Technical Failure
2017-11-22 00:00:00,Multimanaged Investments,Landing (descent or approach),Business,South Africa,Africa,2,2,0,0,0,0,2,Human Factor
2017-11-25 00:00:00,BelleAire,Takeoff (climb),Business,United States of America,North America,1,1,0,0,0,0,1,Technical Failure
2017-12-05 00:00:00,Edward B. Noakes III,Landing (descent or approach),Business,United States of America,North America,4,1,0,3,0,0,4,Human Factor
2017-12-20 00:00:00,Aeroejecutivos Colombia - Aeroservicios Ejecutivos de Colombia,Takeoff (climb),Commercial,Colombia,South America,9,2,0,7,0,0,9,Human Factor
2017-12-21 00:00:00,Aero Saab,Takeoff (climb),Commercial,Mexico,Central America,5,1,0,4,0,0,5,Technical Failure
2017-12-27 00:00:00,Van E Aviation,Landing (descent or approach),Operational,United States of America,North America,2,1,0,1,0,0,2,Human Factor
2018-01-02 00:00:00,HRH Holdings,Takeoff (climb),Commercial,Mozambique,Africa,7,1,0,6,0,0,7,Human Factor
2018-01-06 00:00:00,Rutaca - Rutas Aéreas,Takeoff (climb),Operational,Venezuela,South America,2,2,0,0,0,0,2,Unknown
2018-01-07 00:00:00,AMREF - Flying Doctor Service,Takeoff (climb),Commercial,South Sudan,Africa,11,2,0,9,0,0,11,Unknown
2018-01-13 00:00:00,Pegasus Airlines,Landing (descent or approach),Commercial,Turkey,Asia,168,6,0,162,0,0,168,Unknown
2018-01-29 00:00:00,Nestoil,Landing (descent or approach),Business,Nigeria,Africa,7,3,0,4,0,0,7,Human Factor
2018-02-23 00:00:00,Island Express Air,Takeoff (climb),Commercial,Canada,North America,10,1,0,9,0,0,10,Human Factor
2018-02-28 00:00:00,Smartlynx Airlines,Landing (descent or approach),Operational,Estonia,Europe,7,7,0,0,0,0,7,Human Factor
2018-03-01 00:00:00,Mike %26 Mayo Partners,Flight,Business,United States of America,North America,1,1,0,0,0,0,1,Human Factor
2018-03-04 00:00:00,Serve Air,Landing (descent or approach),Operational,Democratic Republic of Congo,Africa,6,5,0,1,0,0,6,Human Factor
2018-03-15 00:00:00,École de Parachutisme de Besançon Franche-Comté,Landing (descent or approach),Specialised Services,France,Europe,2,1,0,1,0,0,2,Technical Failure
2018-03-15 00:00:00,Private Venezuelan,Landing (descent or approach),Humanitarian,Belize,Central America,1,1,0,0,0,0,1,Human Factor
2018-03-16 00:00:00,Ameriflight,Landing (descent or approach),Operational,United States of America,North America,2,2,0,0,0,0,2,Human Factor
2018-04-01 00:00:00,Private Russian,Flight,Business,Russia,Asia,1,1,0,0,0,0,1,Technical Failure
2018-04-02 00:00:00,Avis Industrial Corporation,Landing (descent or approach),Business,United States of America,North America,5,1,0,4,0,0,5,Human Factor
2018-04-11 00:00:00,Ravn Alaska,Landing (descent or approach),Operational,United States of America,North America,1,1,0,0,0,0,1,Human Factor
2018-04-14 00:00:00,Ayk Avia,Landing (descent or approach),Humanitarian,South Sudan,Africa,5,5,0,0,0,0,5,Unknown
2018-04-20 00:00:00,World Atlantic Airlines,Landing (descent or approach),Commercial,United States of America,North America,101,7,0,94,0,0,101,Technical Failure
2018-04-24 00:00:00,Aberdeen Flying Service,Flight,Commercial,United States of America,North America,4,1,0,3,0,0,4,Weather
2018-04-26 00:00:00,AC Research Inc.,Landing (descent or approach),Business,United States of America,North America,3,1,0,2,0,0,3,Human Factor
2018-05-01 00:00:00,Wheaton Brasil Vidros,Landing (descent or approach),Business,Brazil,South America,10,2,0,8,0,0,10,Technical Failure
2018-05-05 00:00:00,Embraer,Landing (descent or approach),Specialised Services,Brazil,South America,3,3,0,0,0,0,3,Unknown
2018-05-20 00:00:00,Star Jet - China,Landing (descent or approach),Operational,China,Asia,3,3,0,0,0,0,3,Human Factor
2018-05-21 00:00:00,Saudi Arabian Airlines - SAUDIA,Landing (descent or approach),Commercial,Saudi Arabia,Asia,152,10,0,142,0,0,152,Technical Failure
2018-05-22 00:00:00,Silver Air,Landing (descent or approach),Business,Honduras,Central America,6,2,0,4,0,0,6,Human Factor
2018-05-22 00:00:00,Amazonaves Táxi Aéreo,Landing (descent or approach),Operational,Brazil,South America,1,1,0,0,0,0,1,Technical Failure
2018-05-24 00:00:00,Aeronaves TSM,Landing (descent or approach),Operational,Mexico,Central America,3,3,0,0,0,0,3,Unknown
2018-05-29 00:00:00,1st Avenue Malibu Services LLC,Landing (descent or approach),Business,United States of America,North America,3,1,0,2,0,0,3,Technical Failure
2018-05-30 00:00:00,Air Serv International,Takeoff (climb),Humanitarian,Democratic Republic of Congo,Africa,5,2,0,3,0,0,5,Human Factor
2018-06-03 00:00:00,Private German,Landing (descent or approach),Business,Denmark,Europe,4,1,0,3,0,0,4,Human Factor
2018-06-04 00:00:00,GippsAero,Flight,Specialised Services,United States of America,North America,2,2,0,0,0,0,2,Human Factor
2018-06-06 00:00:00,Aeroserv,Flight,Military / Government,Romania,Europe,2,2,0,0,0,0,2,Human Factor
2018-06-06 00:00:00,ProAir Aviation,Landing (descent or approach),Operational,France,Europe,2,1,0,1,0,0,2,Human Factor
2018-06-14 00:00:00,Bravo Airways,Landing (descent or approach),Commercial,Ukraine,Europe,167,7,0,160,0,0,167,Human Factor
2018-06-26 00:00:00,Southern Aircraft Consultancy,Takeoff (climb),Business,United Kingdom,Europe,2,1,0,1,0,0,2,Technical Failure
2018-06-27 00:00:00,Feniks,Takeoff (climb),Humanitarian,Russia,Asia,4,2,0,2,0,0,4,Technical Failure
2018-07-10 00:00:00,Taquan Air,Flight,Commercial,United States of America,North America,11,1,0,10,0,0,11,Human Factor
2018-07-11 00:00:00,Air Colombia,Landing (descent or approach),Humanitarian,Colombia,South America,12,3,0,9,0,0,12,Other
2018-07-16 00:00:00,Everts Air Cargo,Landing (descent or approach),Operational,United States of America,North America,2,2,0,0,0,0,2,Human Factor
2018-07-20 00:00:00,Robert T. Knight Sr.,Takeoff (climb),Specialised Services,United States of America,North America,2,1,0,1,0,0,2,Technical Failure
2018-07-20 00:00:00,Kaz Air Trans,Flight,Operational,Egypt,Africa,6,6,0,0,0,0,6,Technical Failure
2018-07-21 00:00:00,Commemorative Air Force,Takeoff (climb),Business,United States of America,North America,13,3,0,10,0,0,13,Human Factor
2018-07-30 00:00:00,Private Russian,Takeoff (climb),Business,Russia,Asia,7,2,0,5,0,0,7,Technical Failure
2018-07-31 00:00:00,AeroMéxico Connect,Takeoff (climb),Commercial,Mexico,Central America,103,5,0,98,0,0,103,Weather
2018-08-07 00:00:00,Alliance Air Charter,Landing (descent or approach),Operational,Mexico,Central America,2,2,0,0,0,0,2,Technical Failure
2018-08-11 00:00:00,Historic Flight Foundation,Takeoff (climb),Operational,Canada,North America,5,1,0,4,0,0,5,Unknown
2018-08-16 00:00:00,Xiamen Air,Landing (descent or approach),Commercial,Philippines,Asia,165,8,0,157,0,0,165,Human Factor
2018-08-21 00:00:00,IMAO,Landing (descent or approach),Specialised Services,France,Europe,2,1,0,1,0,0,2,Human Factor
2018-08-25 00:00:00,Stargazer Aero,Takeoff (climb),Other,World,World,5,5,0,0,0,0,5,Unknown
2018-09-01 00:00:00,UTAir,Landing (descent or approach),Commercial,Russia,Asia,170,6,0,164,0,0,170,Human Factor
2018-09-05 00:00:00,Gabriel Claudio de Sales,Landing (descent or approach),Business,Brazil,South America,6,1,0,5,0,0,6,Human Factor
2018-09-06 00:00:00,VOAR Aviação,Landing (descent or approach),Commercial,Brazil,South America,10,1,0,9,0,0,10,Human Factor
2018-09-18 00:00:00,STS Aviation,Flight,Military / Government,Serbia,Europe,3,3,0,0,0,0,3,Technical Failure
2018-09-20 00:00:00,Rainbow River Lodge,Takeoff (climb),Commercial,United States of America,North America,7,1,0,6,0,0,7,Human Factor
2018-09-24 00:00:00,América Latina Tecnologia Agrícola,Landing (descent or approach),Business,Brazil,South America,3,2,0,1,0,0,3,Weather
2018-10-01 00:00:00,Anibal Von Winitzki,Flight,Business,Venezuela,South America,2,2,0,0,0,0,2,Technical Failure
2018-10-03 00:00:00,Sudanese Air Force - Al Quwwat al-Jawwiya As-Sudaniya,Landing (descent or approach),Military / Government,Sudan,Africa,0,0,0,0,0,0,0,Human Factor
2018-10-03 00:00:00,Sudanese Air Force - Al Quwwat al-Jawwiya As-Sudaniya,Landing (descent or approach),Military / Government,Sudan,Africa,0,0,0,0,0,0,0,Human Factor
2018-10-10 00:00:00,Yakutia Airlines,Landing (descent or approach),Commercial,Russia,Asia,92,5,0,87,0,0,92,Human Factor
2018-10-21 00:00:00,Keystone Aviation,Takeoff (climb),Business,United States of America,North America,5,1,0,4,0,0,5,Human Factor
2018-10-28 00:00:00,Gospel Ministries International,Takeoff (climb),Humanitarian,Bolivia,South America,2,1,0,1,0,0,2,Technical Failure
2018-11-07 00:00:00,Skylease Cargo,Landing (descent or approach),Operational,Canada,North America,4,3,0,1,0,0,4,Human Factor
2018-11-08 00:00:00,2nd United Arkhangelsk Aviation Division,Flight,Commercial,Russia,Asia,14,2,0,12,0,0,14,Weather
2018-11-09 00:00:00,Pakistan Air Force - Pakistan Fiza'ya,Landing (descent or approach),Operational,Pakistan,Asia,9,9,0,0,0,0,9,Other
2018-11-12 00:00:00,C%26C Flying,Landing (descent or approach),Operational,United States of America,North America,1,1,0,0,0,0,1,Unknown
2018-11-13 00:00:00,Lyle Boman,Landing (descent or approach),Business,Canada,North America,1,1,0,0,0,0,1,Technical Failure
2018-11-30 00:00:00,Dirt Dynamics,Landing (descent or approach),Business,United States of America,North America,11,1,0,10,0,0,11,Human Factor
2018-12-24 00:00:00,Congolese Air Force - Force Aérienne de la République Démocratique du Congo,Landing (descent or approach),Military / Government,Democratic Republic of Congo,Africa,72,4,0,68,0,0,72,Unknown
2019-01-13 00:00:00,TW 601-C Investment LLC,Landing (descent or approach),Business,United States of America,North America,9,3,0,6,0,0,9,Weather
2019-01-25 00:00:00,Société de Location Air Frégate/Siage,Takeoff (climb),Operational,Guyana,South America,1,1,0,0,0,0,1,Technical Failure
2019-02-06 00:00:00,Vivid Hosting,Landing (descent or approach),Operational,United States of America,North America,2,2,0,0,0,0,2,Human Factor
2019-02-07 00:00:00,Jet Rescue - Mexico,Landing (descent or approach),Humanitarian,Mexico,Central America,9,2,0,7,0,0,9,Technical Failure
2019-02-09 00:00:00,Rico Taxi Aéreo - Rondonia Importaçao e Comercio,Landing (descent or approach),Commercial,Brazil,South America,10,2,0,8,0,0,10,Human Factor
2019-02-25 00:00:00,United States Army,Landing (descent or approach),Military / Government,South Korea,Asia,0,0,0,0,0,0,0,Unknown
2019-02-26 00:00:00,Silk Way Business Aviation,Landing (descent or approach),Commercial,Russia,Asia,6,3,0,3,0,0,6,Human Factor
2019-03-04 00:00:00,United Express,Landing (descent or approach),Commercial,United States of America,North America,31,3,0,28,0,0,31,Unknown
2019-03-05 00:00:00,Royal Thai Air Force - Kong Thap Akat Thai,Flight,Military / Government,Thailand,Asia,3,3,0,0,0,0,3,Technical Failure
2019-03-07 00:00:00,Baires Fly,Landing (descent or approach),Commercial,Argentina,South America,4,2,0,2,0,0,4,Weather
2019-03-22 00:00:00,Private American,Landing (descent or approach),Humanitarian,Honduras,Central America,0,0,0,0,0,0,0,Human Factor
2019-04-02 00:00:00,Solution Air Locadora de Aeronaves - Eireli,Landing (descent or approach),Business,Brazil,South America,5,2,0,3,0,0,5,Technical Failure
2019-04-03 00:00:00,Spanish Air Force - Ejército del Aire,Landing (descent or approach),Military / Government,Spain,Europe,10,4,0,6,0,0,10,Unknown
2019-04-05 00:00:00,Private Venezuelan,Flight,Humanitarian,Dominican Republic,Central America,0,0,0,0,0,0,0,Human Factor
2019-04-23 00:00:00,Tropic Ocean Airways,Takeoff (climb),Business,United States of America,North America,5,1,0,4,0,0,5,Human Factor
2019-04-24 00:00:00,Keewatin Air,Landing (descent or approach),Humanitarian,Canada,North America,4,2,0,2,0,0,4,Human Factor
2019-04-24 00:00:00,Advance Air,Landing (descent or approach),Operational,Germany,Europe,2,2,0,0,0,0,2,Human Factor
2019-05-03 00:00:00,Miami Air International,Landing (descent or approach),Commercial,United States of America,North America,143,7,0,136,0,0,143,Other
2019-05-04 00:00:00,Motor Aviation Enterprise,Landing (descent or approach),Operational,Russia,Asia,2,2,0,0,0,0,2,Unknown
2019-05-08 00:00:00,Biman Bangladesh Airlines,Landing (descent or approach),Commercial,Myanmar,Asia,34,6,0,28,0,0,34,Human Factor
2019-05-08 00:00:00,Private Venezuelan,Flight,Business,Venezuela,South America,2,2,0,0,0,0,2,Unknown
2019-06-09 00:00:00,Feniks,Flight,Military / Government,Russia,Asia,2,2,0,0,0,0,2,Human Factor
2019-06-23 00:00:00,Phoenix Air - Ukraine,Flight,Military / Government,Ukraine,Europe,2,2,0,0,0,0,2,Technical Failure
2019-06-27 00:00:00,Transmandu - Transportes Aéreos Manduca,Landing (descent or approach),Commercial,Venezuela,South America,0,0,0,0,0,0,0,Technical Failure
2019-07-01 00:00:00,SpiceJet,Landing (descent or approach),Commercial,India,Asia,167,7,0,160,0,0,167,Human Factor
2019-07-08 00:00:00,Grant Aviation,Landing (descent or approach),Commercial,United States of America,North America,6,1,0,5,0,0,6,Human Factor
2019-07-16 00:00:00,Private Russian,Flight,Specialised Services,Russia,Asia,1,1,0,0,0,0,1,Technical Failure
2019-07-17 00:00:00,Avia Jet,Landing (descent or approach),Business,United States of America,North America,1,1,0,0,0,0,1,Human Factor
2019-07-18 00:00:00,Go Comores,Takeoff (climb),Commercial,Comoros Islands,Africa,11,1,0,10,0,0,11,Unknown
2019-07-19 00:00:00,Akron Aerostar,Landing (descent or approach),Business,United States of America,North America,4,1,0,3,0,0,4,Technical Failure
2019-07-20 00:00:00,Pakistan International Airlines - PIA,Landing (descent or approach),Commercial,Pakistan,Asia,53,5,0,48,0,0,53,Unknown
2019-07-30 00:00:00,Robin R. Reichman,Flight,Business,Canada,North America,3,1,0,2,0,0,3,Technical Failure
2019-07-30 00:00:00,Equatorial Guinea Air Corps,Flight,Military / Government,Cameroon,Africa,7,7,0,0,0,0,7,Unknown
2019-08-01 00:00:00,Everts Air Cargo,Landing (descent or approach),Operational,United States of America,North America,3,3,0,0,0,0,3,Human Factor
2019-08-06 00:00:00,Aerowest,Landing (descent or approach),Commercial,Denmark,Europe,10,3,0,7,0,0,10,Unknown
2019-08-06 00:00:00,Tropical Air,Takeoff (climb),Commercial,Tanzania,Africa,9,1,0,8,0,0,9,Unknown
2019-08-15 00:00:00,JRM Air,Landing (descent or approach),Business,United States of America,North America,5,2,0,3,0,0,5,Human Factor
2019-08-15 00:00:00,Ural Airlines - Uralskie Avialinii,Takeoff (climb),Commercial,Russia,Asia,233,7,0,226,0,0,233,Other
2019-08-16 00:00:00,Safarilink,Landing (descent or approach),Commercial,Kenya,Africa,0,0,0,0,0,0,0,Other
2019-08-21 00:00:00,Delta Private Jets,Takeoff (climb),Commercial,United States of America,North America,10,2,0,8,0,0,10,Unknown
2019-08-21 00:00:00,Venezuelan Air Force - Fuerza Aérea Venezolana,Takeoff (climb),Specialised Services,Venezuela,South America,2,2,0,0,0,0,2,Technical Failure
2019-08-27 00:00:00,Air China,Parking,Commercial,China,Asia,161,14,0,147,0,0,161,Unknown
2019-08-27 00:00:00,Air Charter Services,Landing (descent or approach),Operational,India,Asia,6,2,0,4,0,0,6,Human Factor
2019-08-31 00:00:00,Star Jet - USA,Takeoff (climb),Business,United States of America,North America,2,1,0,1,0,0,2,Unknown
2019-09-15 00:00:00,Mailworks,Flight,Business,United States of America,North America,1,1,0,0,0,0,1,Technical Failure
2019-09-16 00:00:00,twoFlex,Takeoff (climb),Commercial,Brazil,South America,10,2,0,8,0,0,10,Unknown
2019-09-24 00:00:00,Venezuelan Government,Landing (descent or approach),Military / Government,Venezuela,South America,7,1,0,6,0,0,7,Unknown
2019-09-26 00:00:00,Aerotax,Flight,Commercial,Paraguay,South America,4,1,0,3,0,0,4,Technical Failure
2019-09-30 00:00:00,Private Mexican,Landing (descent or approach),Humanitarian,Belize,Central America,0,0,0,0,0,0,0,Human Factor
2019-10-07 00:00:00,Grupo HDA,Takeoff (climb),Other,Mexico,Central America,1,1,0,0,0,0,1,Unknown
2019-10-11 00:00:00,Silverstone Air,Takeoff (climb),Commercial,Kenya,Africa,55,5,0,50,0,0,55,Unknown
2019-10-14 00:00:00,MT Margaret,Landing (descent or approach),Business,United States of America,North America,2,1,0,1,0,0,2,Human Factor
2019-10-18 00:00:00,Atlantic Air Cargo,Landing (descent or approach),Operational,Bahamas,Central America,2,2,0,0,0,0,2,Technical Failure
2019-10-25 00:00:00,Private American,Flight,Humanitarian,Guatemala,Central America,2,2,0,0,0,0,2,Unknown
2019-10-27 00:00:00,Abeer Air Services,Flight,Operational,South Sudan,Africa,4,2,0,2,0,0,4,Unknown
2019-11-21 00:00:00,Turkish Airlines - THY Türk Hava Yollari,Landing (descent or approach),Commercial,Ukraine,Europe,142,6,0,136,0,0,142,Human Factor
2019-11-23 00:00:00,Private Mexican,Landing (descent or approach),Humanitarian,Haiti,Central America,2,2,0,0,0,0,2,Human Factor
2019-12-02 00:00:00,Private Mexican,Landing (descent or approach),Humanitarian,Guatemala,Central America,0,0,0,0,0,0,0,Human Factor
2019-12-18 00:00:00,WL Aviation,Taxiing,Humanitarian,United States of America,North America,1,1,0,0,0,0,1,Human Factor
2019-12-28 00:00:00,Air Fast Congo,Landing (descent or approach),Commercial,Democratic Republic of Congo,Africa,18,2,0,16,0,0,18,Unknown
2020-01-09 00:00:00,South African Air Force,Landing (descent or approach),Military / Government,Democratic Republic of Congo,Africa,67,8,0,59,0,0,67,Unknown
2020-01-16 00:00:00,LifeMed Alaska,Takeoff (climb),Humanitarian,United States of America,North America,3,1,0,2,0,0,3,Unknown
2020-01-27 00:00:00,Caspian Airlines,Landing (descent or approach),Commercial,Iran,Asia,144,8,0,136,0,0,144,Human Factor
2020-01-29 00:00:00,7X Oilfield Services,Landing (descent or approach),Business,United States of America,North America,1,1,0,0,0,0,1,Human Factor
2020-02-06 00:00:00,Redding Aero Enterprises,Landing (descent or approach),Operational,United States of America,North America,1,1,0,0,0,0,1,Human Factor
2020-02-09 00:00:00,UTAir,Landing (descent or approach),Commercial,Russia,Asia,100,6,0,94,0,0,100,Human Factor
2020-02-20 00:00:00,Ejets,Landing (descent or approach),Operational,United States of America,North America,2,2,0,0,0,0,2,Human Factor
2020-02-20 00:00:00,T-Cement,Takeoff (climb),Commercial,Russia,Asia,14,2,0,12,0,0,14,Other
2020-02-25 00:00:00,Expectra Aviation,Landing (descent or approach),Commercial,United States of America,North America,5,2,0,3,0,0,5,Human Factor
2020-02-26 00:00:00,Orlan 2000,Takeoff (climb),Humanitarian,Kazakhstan,Asia,5,2,0,3,0,0,5,Technical Failure
2020-03-05 00:00:00,Federal Express - FedEx,Landing (descent or approach),Operational,United States of America,North America,1,1,0,0,0,0,1,Human Factor
2020-03-13 00:00:00,Private Venezuelan,Landing (descent or approach),Business,Venezuela,South America,2,2,0,0,0,0,2,Technical Failure
2020-03-14 00:00:00,Gemini Air Group,Landing (descent or approach),Business,United States of America,North America,2,2,0,0,0,0,2,Unknown
2020-03-22 00:00:00,Private Mexican,Landing (descent or approach),Humanitarian,Guatemala,Central America,0,0,0,0,0,0,0,Human Factor
2020-04-23 00:00:00,Boutique Air,Landing (descent or approach),Operational,United States of America,North America,1,1,0,0,0,0,1,Technical Failure
2020-05-09 00:00:00,Private American,Landing (descent or approach),Military / Government,United States of America,North America,2,2,0,0,0,0,2,Human Factor
2020-05-28 00:00:00,Alaska Department of Natural Resources,Takeoff (climb),Military / Government,United States of America,North America,4,1,0,3,0,0,4,Human Factor
2020-05-28 00:00:00,Private American,Landing (descent or approach),Humanitarian,Belize,Central America,0,0,0,0,0,0,0,Human Factor
2020-06-08 00:00:00,United States Air Force - USAF,Landing (descent or approach),Military / Government,Iraq,Asia,26,7,0,19,0,0,26,Human Factor
2020-06-12 00:00:00,Private Czech,Flight,Business,Czech Republic,Europe,1,1,0,0,0,0,1,Technical Failure
2020-07-14 00:00:00,Bluebird Aviation,Landing (descent or approach),Operational,Somalia,Africa,3,3,0,0,0,0,3,Unknown
2020-07-20 00:00:00,Private American,Landing (descent or approach),Humanitarian,Honduras,Central America,0,0,0,0,0,0,0,Human Factor
2020-07-22 00:00:00,Ethiopian Airlines,Parking,Operational,China,Asia,2,2,0,0,0,0,2,Other
2020-07-26 00:00:00,Private Australian,Takeoff (climb),Humanitarian,Papua New Guinea,Oceania,1,1,0,0,0,0,1,Human Factor
2020-08-01 00:00:00,Terraquest,Flight,Specialised Services,United States of America,North America,2,1,0,1,0,0,2,Unknown
2020-08-01 00:00:00,Solo Energy Drink,Flight,Humanitarian,Venezuela,South America,3,1,0,2,0,0,3,Human Factor
2020-08-03 00:00:00,UTAir Cargo,Landing (descent or approach),Humanitarian,Mali,Africa,11,7,0,4,0,0,11,Technical Failure
2020-08-04 00:00:00,Kenya Air Force,Takeoff (climb),Humanitarian,Somalia,Africa,10,2,0,8,0,0,10,Unknown
2020-08-10 00:00:00,Private American,Landing (descent or approach),Business,France,Europe,2,1,0,1,0,0,2,Unknown
2020-08-16 00:00:00,City Link,Takeoff (climb),Humanitarian,South Sudan,Africa,7,2,0,5,0,0,7,Unknown
2020-08-23 00:00:00,Private Mexican,Landing (descent or approach),Humanitarian,Honduras,Central America,0,0,0,0,0,0,0,Human Factor
2020-08-28 00:00:00,Aircraft Guaranty Corporation Trustee,Landing (descent or approach),Business,Germany,Europe,3,1,0,2,0,0,3,Unknown
2020-08-29 00:00:00,Private Mexican,Landing (descent or approach),Humanitarian,Mexico,Central America,2,2,0,0,0,0,2,Human Factor
2020-08-31 00:00:00,United States Navy - USN,Flight,Operational,United States of America,North America,4,4,0,0,0,0,4,Unknown
2020-09-07 00:00:00,WRV Empreendimentos e Participações,Landing (descent or approach),Operational,Brazil,South America,3,2,0,1,0,0,3,Unknown
2020-09-11 00:00:00,Private Kenyan,Landing (descent or approach),Business,Kenya,Africa,3,2,0,1,0,0,3,Unknown
2020-09-16 00:00:00,Drive Line,Landing (descent or approach),Operational,United States of America,North America,2,2,0,0,0,0,2,Human Factor
2020-09-19 00:00:00,Proair Holding Company,Flight,Business,United States of America,North America,3,3,0,0,0,0,3,Unknown
2020-09-19 00:00:00,Silverstone Air,Landing (descent or approach),Operational,Somalia,Africa,4,4,0,0,0,0,4,Unknown
2020-09-21 00:00:00,Private Mexican,Landing (descent or approach),Humanitarian,Belize,Central America,0,0,0,0,0,0,0,Human Factor
2020-09-22 00:00:00,Henry Moreno Cortazar,Takeoff (climb),Business,Colombia,South America,4,1,0,3,0,0,4,Technical Failure
2020-10-02 00:00:00,Maria Squared Aviation,Takeoff (climb),Commercial,United States of America,North America,2,1,0,1,0,0,2,Unknown
2020-10-05 00:00:00,Indigo Aviation,Takeoff (climb),Business,France,Europe,2,1,0,1,0,0,2,Human Factor
2020-10-08 00:00:00,Sierra AE,Takeoff (climb),Business,United States of America,North America,7,1,0,6,0,0,7,Unknown
2020-10-10 00:00:00,Aero-Mobil,Takeoff (climb),Business,Germany,Europe,2,1,0,1,0,0,2,Technical Failure
2020-10-10 00:00:00,Newton Air,Takeoff (climb),Commercial,South Sudan,Africa,0,0,0,0,0,0,0,Unknown
2020-10-14 00:00:00,AerCaribe Peru,Landing (descent or approach),Operational,Peru,South America,4,4,0,0,0,0,4,Unknown
2020-10-30 00:00:00,Tracbel Group,Landing (descent or approach),Business,Brazil,South America,4,2,0,2,0,0,4,Unknown
2020-11-06 00:00:00,Private American,Flight,Operational,World,World,2,2,0,0,0,0,2,Technical Failure
2020-11-13 00:00:00,Volga-Dnepr Airlines,Landing (descent or approach),Operational,Russia,Asia,14,14,0,0,0,0,14,Technical Failure
2020-12-02 00:00:00,Air Djibouti,Landing (descent or approach),Commercial,Somalia,Africa,39,8,0,31,0,0,39,Human Factor
2020-12-02 00:00:00,Aviation Stars II,Landing (descent or approach),Business,United States of America,North America,3,1,0,2,0,0,3,Unknown
2020-12-04 00:00:00,303 Flyers,Landing (descent or approach),Business,France,Europe,3,1,0,2,0,0,3,Unknown
2020-12-05 00:00:00,Private American,Flight,Humanitarian,Venezuela,South America,0,0,0,0,0,0,0,Human Factor
2020-12-13 00:00:00,Private American,Landing (descent or approach),Business,United States of America,North America,1,1,0,0,0,0,1,Human Factor
2020-12-16 00:00:00,Private American,Landing (descent or approach),Humanitarian,Guatemala,Central America,0,0,0,0,0,0,0,Unknown
2020-12-19 00:00:00,Plane Fun Inc.,Landing (descent or approach),Business,United States of America,North America,2,1,0,1,0,0,2,Unknown
2020-12-20 00:00:00,Talon Air,Landing (descent or approach),Operational,United States of America,North America,2,2,0,0,0,0,2,Unknown
2021-01-02 00:00:00,Brasil Vida Táxi Aéreo,Landing (descent or approach),Humanitarian,Brazil,South America,4,2,0,2,0,0,4,Unknown
2021-01-10 00:00:00,850 Atlantic Collision,Takeoff (climb),Business,United States of America,North America,1,1,0,0,0,0,1,Technical Failure
2021-01-19 00:00:00,Moscamed,Flight,Business,Mexico,Central America,1,1,0,0,0,0,1,Unknown
2021-01-19 00:00:00,West Atlantic,Landing (descent or approach),Operational,United Kingdom,Europe,2,2,0,0,0,0,2,Unknown
2021-01-23 00:00:00,Aviación Ejecutiva del Bajío,Landing (descent or approach),Humanitarian,Jamaica,Central America,2,2,0,0,0,0,2,Human Factor
2021-01-26 00:00:00,Zambia Air Force,Landing (descent or approach),Military / Government,Zambia,Africa,5,5,0,0,0,0,5,Unknown
2021-02-02 00:00:00,Forza Management Company,Landing (descent or approach),Business,United States of America,North America,3,1,0,2,0,0,3,Unknown
2021-02-13 00:00:00,Aerospike Iron,Takeoff (climb),Business,United States of America,North America,5,3,0,2,0,0,5,Unknown
2021-02-26 00:00:00,Nadezhda,Takeoff (climb),Humanitarian,Kazakhstan,Asia,5,2,0,3,0,0,5,Technical Failure
2021-03-03 00:00:00,Marc Inc,Flight,Commercial,Mexico,Central America,2,1,0,1,0,0,2,Technical Failure
2021-03-07 00:00:00,Berry Aviation,Landing (descent or approach),Operational,United States of America,North America,2,2,0,0,0,0,2,Technical Failure
2021-03-11 00:00:00,Private American,Takeoff (climb),Business,United States of America,North America,4,1,0,3,0,0,4,Unknown
2021-03-20 00:00:00,Trigana Air Service,Landing (descent or approach),Operational,Indonesia,Asia,2,2,0,0,0,0,2,Technical Failure
2021-03-26 00:00:00,Phoenix Aviation - Kenya,Flight,Commercial,Kenya,Africa,0,0,0,0,0,0,0,Unknown
2021-03-27 00:00:00,Pinnacle Air,Takeoff (climb),Business,India,Asia,3,3,0,0,0,0,3,Unknown
2021-04-18 00:00:00,GJV - Sistemas de Seguridad Privada y Mantenimiento,Landing (descent or approach),Business,Mexico,Central America,9,2,0,7,0,0,9,Technical Failure
2021-04-29 00:00:00,ZeroAvia,Landing (descent or approach),Specialised Services,United Kingdom,Europe,2,2,0,0,0,0,2,Unknown
2021-05-06 00:00:00,Government of Madhya Pradesh,Landing (descent or approach),Humanitarian,India,Asia,3,2,0,1,0,0,3,Human Factor
2021-05-12 00:00:00,Key Lime Air,Landing (descent or approach),Operational,United States of America,North America,2,2,0,0,0,0,2,Human Factor
2021-06-25 00:00:00,Skydive Teuge,Takeoff (climb),Humanitarian,Netherlands,Europe,18,1,0,17,0,0,18,Technical Failure
2021-07-01 00:00:00,JA Mach 3,Landing (descent or approach),Business,United States of America,North America,1,1,0,0,0,0,1,Technical Failure
2021-07-02 00:00:00,Transair,Takeoff (climb),Operational,United States of America,North America,2,2,0,0,0,0,2,Technical Failure
2021-07-10 00:00:00,Private American,Takeoff (climb),Business,United States of America,North America,4,1,0,3,0,0,4,Unknown
2021-07-16 00:00:00,SiLA-Avia,Flight,Commercial,Russia,Asia,19,4,0,15,0,0,19,Unknown
2021-07-21 00:00:00,Skyward Express,Landing (descent or approach),Commercial,Somalia,Africa,41,4,0,37,0,0,41,Unknown
2021-07-27 00:00:00,Abyssinian Flight Services,Flight,Humanitarian,Ethiopia,Africa,4,2,0,2,0,0,4,Unknown
2021-08-11 00:00:00,K-Aero,Landing (descent or approach),Business,United States of America,North America,3,1,0,2,0,0,3,Technical Failure
2021-08-21 00:00:00,Enrique Aurelio Parada Lanza,Takeoff (climb),Business,Venezuela,South America,1,1,0,0,0,0,1,Technical Failure
2021-08-21 00:00:00,SN 1124 LLC,Takeoff (climb),Commercial,United States of America,North America,14,3,0,11,0,0,14,Unknown
2021-08-24 00:00:00,N1GG,Takeoff (climb),Business,United States of America,North America,4,1,0,3,0,0,4,Unknown
2021-09-09 00:00:00,Cape Air,Landing (descent or approach),Commercial,United States of America,North America,7,1,0,6,0,0,7,Unknown
2021-09-14 00:00:00,Aerial Advantage,Takeoff (climb),Business,France,Europe,3,1,0,2,0,0,3,Unknown
2021-09-23 00:00:00,Action Air - France,Flight,Military / Government,Ireland,Europe,4,1,0,3,0,0,4,Unknown
2021-09-29 00:00:00,SVG Air - Saint Vincent %26 Grenadines Air,Landing (descent or approach),Commercial,Montserrat,Central America,7,1,0,6,0,0,7,Unknown
2021-10-10 00:00:00,1364254 Alberta,Landing (descent or approach),Business,Canada,North America,4,1,0,3,0,0,4,Unknown
2021-10-14 00:00:00,Priority Farms,Takeoff (climb),Business,United States of America,North America,4,1,0,3,0,0,4,Unknown
2021-10-19 00:00:00,987 Investments,Takeoff (climb),Business,United States of America,North America,21,3,0,18,0,0,21,Unknown
2021-10-29 00:00:00,Reven Global Airtranspor,Landing (descent or approach),Operational,Indonesia,Asia,2,2,0,0,0,0,2,Unknown
2021-11-03 00:00:00,Private Tajik,Landing (descent or approach),Operational,Somalia,Africa,2,2,0,0,0,0,2,Unknown
2021-11-20 00:00:00,Yute Commuter Service,Landing (descent or approach),Commercial,United States of America,North America,6,1,0,5,0,0,6,Unknown
2021-12-29 00:00:00,Two Zero Seven Inc.,Takeoff (climb),Business,United States of America,North America,3,1,0,2,0,0,3,Unknown
2022-01-05 00:00:00,Noble Air Charter,Flight,Commercial,Bahamas,Central America,2,1,0,1,0,0,2,Technical Failure
2022-01-08 00:00:00,Aviastar-TU,Parking,Operational,China,Asia,8,8,0,0,0,0,8,Unknown
2022-01-31 00:00:00,Air Tindi,Landing (descent or approach),Commercial,Canada,North America,3,3,0,0,0,0,3,Unknown
2022-01-31 00:00:00,Renato Joner,Landing (descent or approach),Business,Brazil,South America,5,1,0,4,0,0,5,Unknown
2022-02-13 00:00:00,Private Mexican,Flight,Business,Mexico,Central America,6,1,0,5,0,0,6,Technical Failure
2022-02-14 00:00:00,Doren Air Congo,Landing (descent or approach),Operational,Democratic Republic of Congo,Africa,2,2,0,0,0,0,2,Unknown
2022-02-15 00:00:00,Air Flamenco,Landing (descent or approach),Commercial,Puerto Rico,Central America,0,0,0,0,0,0,0,Unknown
2022-02-23 00:00:00,Taraz Zhana Alem,Flight,Humanitarian,Kazakhstan,Asia,3,2,0,1,0,0,3,Unknown
2022-02-24 00:00:00,Russian Air Force - Voyenno-vozdushnye sily Rossii,Flight,Military / Government,Russia,Asia,0,0,0,0,0,0,0,Unknown
2022-03-08 00:00:00,Bamaji Air,Flight,Commercial,Canada,North America,2,1,0,1,0,0,2,Unknown
2022-04-02 00:00:00,Georgia Crown Distributing Company,Landing (descent or approach),Business,United States of America,North America,4,2,0,2,0,0,4,Unknown
2022-04-03 00:00:00,Private Brazilian,Landing (descent or approach),Humanitarian,Guatemala,Central America,0,0,0,0,0,0,0,Human Factor
2022-04-06 00:00:00,Private Mexican,Landing (descent or approach),Business,Mexico,Central America,1,1,0,0,0,0,1,Technical Failure
2022-04-07 00:00:00,DHL Worldwide Express - DHL Airways,Landing (descent or approach),Operational,Costa Rica,Central America,2,2,0,0,0,0,2,Technical Failure
2022-04-13 00:00:00,Policía Nacional de Colombia,Landing (descent or approach),Military / Government,Colombia,South America,14,4,0,10,0,0,14,Unknown
2022-05-06 00:00:00,Private Mexican,Takeoff (climb),Business,United States of America,North America,4,1,0,3,0,0,4,Technical Failure
2022-05-12 00:00:00,Tibet Airlines,Takeoff (climb),Commercial,China,Asia,122,9,0,113,0,0,122,Unknown
2022-05-20 00:00:00,Sales Serviços Aéreos,Landing (descent or approach),Operational,Brazil,South America,2,2,0,0,0,0,2,Unknown
2022-05-24 00:00:00,Yakutat Coastal Airlines,Landing (descent or approach),Commercial,United States of America,North America,4,1,0,3,0,0,4,Unknown